,A,C,G,T,coverage,level,pos,ref,ref_base
2640@TOP@human_GAPDH_TAA_len41_fa0_ta20_fm6_tm14*114*t,0,1,0,8997,8998,0.0,114,2640@TOP@human_GAPDH_TAA_len41_fa0_ta20_fm6_tm14,t
2640@TOP@human_GAPDH_TAA_len41_fa0_ta20_fm6_tm14*115*c,0,9051,0,2,9053,0.0,115,2640@TOP@human_GAPDH_TAA_len41_fa0_ta20_fm6_tm14,c
2640@TOP@human_GAPDH_TAA_len41_fa0_ta20_fm6_tm14*116*c,0,9027,0,0,9027,0.0,116,2640@TOP@human_GAPDH_TAA_len41_fa0_ta20_fm6_tm14,c
2640@TOP@human_GAPDH_TAA_len41_fa0_ta20_fm6_tm14*117*a,9001,0,11,0,9012,0.001,117,2640@TOP@human_GAPDH_TAA_len41_fa0_ta20_fm6_tm14,a
2640@TOP@human_GAPDH_TAA_len41_fa0_ta20_fm6_tm14*118*a,8797,0,153,3,8953,0.017,118,2640@TOP@human_GAPDH_TAA_len41_fa0_ta20_fm6_tm14,a
2640@TOP@human_GAPDH_TAA_len41_fa0_ta20_fm6_tm14*119*g,0,0,8948,0,8948,1.0,119,2640@TOP@human_GAPDH_TAA_len41_fa0_ta20_fm6_tm14,g
2640@TOP@human_GAPDH_TAA_len41_fa0_ta20_fm6_tm14*120*g,1,0,8908,1,8910,1.0,120,2640@TOP@human_GAPDH_TAA_len41_fa0_ta20_fm6_tm14,g
2640@TOP@human_GAPDH_TAA_len41_fa0_ta20_fm6_tm14*121*a,9001,0,4,0,9005,0.0,121,2640@TOP@human_GAPDH_TAA_len41_fa0_ta20_fm6_tm14,a
2640@TOP@human_GAPDH_TAA_len41_fa0_ta20_fm6_tm14*122*g,1,0,9015,0,9016,1.0,122,2640@TOP@human_GAPDH_TAA_len41_fa0_ta20_fm6_tm14,g
2640@TOP@human_GAPDH_TAA_len41_fa0_ta20_fm6_tm14*123*t,1,2,1,8902,8906,0.0,123,2640@TOP@human_GAPDH_TAA_len41_fa0_ta20_fm6_tm14,t
2640@TOP@human_GAPDH_TAA_len41_fa0_ta20_fm6_tm14*124*a,5102,1,3775,0,8878,0.425,124,2640@TOP@human_GAPDH_TAA_len41_fa0_ta20_fm6_tm14,a
2640@TOP@human_GAPDH_TAA_len41_fa0_ta20_fm6_tm14*125*a,6033,0,2840,0,8873,0.32,125,2640@TOP@human_GAPDH_TAA_len41_fa0_ta20_fm6_tm14,a
2640@TOP@human_GAPDH_TAA_len41_fa0_ta20_fm6_tm14*126*g,0,0,8914,0,8914,1.0,126,2640@TOP@human_GAPDH_TAA_len41_fa0_ta20_fm6_tm14,g
2640@TOP@human_GAPDH_TAA_len41_fa0_ta20_fm6_tm14*127*a,8955,2,27,0,8984,0.003,127,2640@TOP@human_GAPDH_TAA_len41_fa0_ta20_fm6_tm14,a
2640@TOP@human_GAPDH_TAA_len41_fa0_ta20_fm6_tm14*128*c,0,9031,1,0,9032,0.0,128,2640@TOP@human_GAPDH_TAA_len41_fa0_ta20_fm6_tm14,c
2640@TOP@human_GAPDH_TAA_len41_fa0_ta20_fm6_tm14*129*c,0,8978,1,3,8982,0.0,129,2640@TOP@human_GAPDH_TAA_len41_fa0_ta20_fm6_tm14,c
2640@TOP@human_GAPDH_TAA_len41_fa0_ta20_fm6_tm14*130*c,0,9019,2,0,9021,0.0,130,2640@TOP@human_GAPDH_TAA_len41_fa0_ta20_fm6_tm14,c
2640@TOP@human_GAPDH_TAA_len41_fa0_ta20_fm6_tm14*131*c,0,9040,0,0,9040,0.0,131,2640@TOP@human_GAPDH_TAA_len41_fa0_ta20_fm6_tm14,c
2640@TOP@human_GAPDH_TAA_len41_fa0_ta20_fm6_tm14*132*t,1,4,0,8931,8936,0.0,132,2640@TOP@human_GAPDH_TAA_len41_fa0_ta20_fm6_tm14,t
2640@TOP@human_GAPDH_TAA_len41_fa0_ta20_fm6_tm14*133*g,0,0,8901,0,8901,1.0,133,2640@TOP@human_GAPDH_TAA_len41_fa0_ta20_fm6_tm14,g
2640@TOP@human_GAPDH_TAA_len41_fa0_ta20_fm6_tm14*134*g,1,2,8935,0,8938,1.0,134,2640@TOP@human_GAPDH_TAA_len41_fa0_ta20_fm6_tm14,g
2641@TOP@human_GAPDH_TAA_len41_fa0_ta20_fm6_tm14*114*t,0,0,0,682,682,0.0,114,2641@TOP@human_GAPDH_TAA_len41_fa0_ta20_fm6_tm14,t
2641@TOP@human_GAPDH_TAA_len41_fa0_ta20_fm6_tm14*115*c,0,697,0,0,697,0.0,115,2641@TOP@human_GAPDH_TAA_len41_fa0_ta20_fm6_tm14,c
2641@TOP@human_GAPDH_TAA_len41_fa0_ta20_fm6_tm14*116*c,0,692,0,1,693,0.0,116,2641@TOP@human_GAPDH_TAA_len41_fa0_ta20_fm6_tm14,c
2641@TOP@human_GAPDH_TAA_len41_fa0_ta20_fm6_tm14*117*a,691,0,0,0,691,0.0,117,2641@TOP@human_GAPDH_TAA_len41_fa0_ta20_fm6_tm14,a
2641@TOP@human_GAPDH_TAA_len41_fa0_ta20_fm6_tm14*118*a,668,0,14,0,682,0.021,118,2641@TOP@human_GAPDH_TAA_len41_fa0_ta20_fm6_tm14,a
2641@TOP@human_GAPDH_TAA_len41_fa0_ta20_fm6_tm14*119*g,0,0,683,0,683,1.0,119,2641@TOP@human_GAPDH_TAA_len41_fa0_ta20_fm6_tm14,g
2641@TOP@human_GAPDH_TAA_len41_fa0_ta20_fm6_tm14*120*g,0,0,683,0,683,1.0,120,2641@TOP@human_GAPDH_TAA_len41_fa0_ta20_fm6_tm14,g
2641@TOP@human_GAPDH_TAA_len41_fa0_ta20_fm6_tm14*121*a,689,0,0,0,689,0.0,121,2641@TOP@human_GAPDH_TAA_len41_fa0_ta20_fm6_tm14,a
2641@TOP@human_GAPDH_TAA_len41_fa0_ta20_fm6_tm14*122*g,0,0,693,0,693,1.0,122,2641@TOP@human_GAPDH_TAA_len41_fa0_ta20_fm6_tm14,g
2641@TOP@human_GAPDH_TAA_len41_fa0_ta20_fm6_tm14*123*t,0,0,0,682,682,0.0,123,2641@TOP@human_GAPDH_TAA_len41_fa0_ta20_fm6_tm14,t
2641@TOP@human_GAPDH_TAA_len41_fa0_ta20_fm6_tm14*124*a,353,0,324,0,677,0.479,124,2641@TOP@human_GAPDH_TAA_len41_fa0_ta20_fm6_tm14,a
2641@TOP@human_GAPDH_TAA_len41_fa0_ta20_fm6_tm14*125*a,428,0,247,0,675,0.366,125,2641@TOP@human_GAPDH_TAA_len41_fa0_ta20_fm6_tm14,a
2641@TOP@human_GAPDH_TAA_len41_fa0_ta20_fm6_tm14*126*g,0,0,682,0,682,1.0,126,2641@TOP@human_GAPDH_TAA_len41_fa0_ta20_fm6_tm14,g
2641@TOP@human_GAPDH_TAA_len41_fa0_ta20_fm6_tm14*127*a,688,0,0,0,688,0.0,127,2641@TOP@human_GAPDH_TAA_len41_fa0_ta20_fm6_tm14,a
2641@TOP@human_GAPDH_TAA_len41_fa0_ta20_fm6_tm14*128*c,0,694,0,0,694,0.0,128,2641@TOP@human_GAPDH_TAA_len41_fa0_ta20_fm6_tm14,c
2641@TOP@human_GAPDH_TAA_len41_fa0_ta20_fm6_tm14*129*c,0,688,0,0,688,0.0,129,2641@TOP@human_GAPDH_TAA_len41_fa0_ta20_fm6_tm14,c
2641@TOP@human_GAPDH_TAA_len41_fa0_ta20_fm6_tm14*130*c,0,693,0,0,693,0.0,130,2641@TOP@human_GAPDH_TAA_len41_fa0_ta20_fm6_tm14,c
2641@TOP@human_GAPDH_TAA_len41_fa0_ta20_fm6_tm14*131*c,0,696,0,0,696,0.0,131,2641@TOP@human_GAPDH_TAA_len41_fa0_ta20_fm6_tm14,c
2641@TOP@human_GAPDH_TAA_len41_fa0_ta20_fm6_tm14*132*t,0,0,0,686,686,0.0,132,2641@TOP@human_GAPDH_TAA_len41_fa0_ta20_fm6_tm14,t
2641@TOP@human_GAPDH_TAA_len41_fa0_ta20_fm6_tm14*133*g,0,0,686,0,686,1.0,133,2641@TOP@human_GAPDH_TAA_len41_fa0_ta20_fm6_tm14,g
2641@TOP@human_GAPDH_TAA_len41_fa0_ta20_fm6_tm14*134*g,0,0,681,0,681,1.0,134,2641@TOP@human_GAPDH_TAA_len41_fa0_ta20_fm6_tm14,g
2642@TOP@human_GAPDH_TAA_len41_fa0_ta20_fm6_tm14*114*t,0,0,0,894,894,0.0,114,2642@TOP@human_GAPDH_TAA_len41_fa0_ta20_fm6_tm14,t
2642@TOP@human_GAPDH_TAA_len41_fa0_ta20_fm6_tm14*115*c,0,900,0,0,900,0.0,115,2642@TOP@human_GAPDH_TAA_len41_fa0_ta20_fm6_tm14,c
2642@TOP@human_GAPDH_TAA_len41_fa0_ta20_fm6_tm14*116*c,0,894,0,0,894,0.0,116,2642@TOP@human_GAPDH_TAA_len41_fa0_ta20_fm6_tm14,c
2642@TOP@human_GAPDH_TAA_len41_fa0_ta20_fm6_tm14*117*a,896,0,0,0,896,0.0,117,2642@TOP@human_GAPDH_TAA_len41_fa0_ta20_fm6_tm14,a
2642@TOP@human_GAPDH_TAA_len41_fa0_ta20_fm6_tm14*118*a,887,0,6,0,893,0.007,118,2642@TOP@human_GAPDH_TAA_len41_fa0_ta20_fm6_tm14,a
2642@TOP@human_GAPDH_TAA_len41_fa0_ta20_fm6_tm14*119*g,0,0,885,0,885,1.0,119,2642@TOP@human_GAPDH_TAA_len41_fa0_ta20_fm6_tm14,g
2642@TOP@human_GAPDH_TAA_len41_fa0_ta20_fm6_tm14*120*g,0,0,881,2,883,0.998,120,2642@TOP@human_GAPDH_TAA_len41_fa0_ta20_fm6_tm14,g
2642@TOP@human_GAPDH_TAA_len41_fa0_ta20_fm6_tm14*121*a,896,0,0,0,896,0.0,121,2642@TOP@human_GAPDH_TAA_len41_fa0_ta20_fm6_tm14,a
2642@TOP@human_GAPDH_TAA_len41_fa0_ta20_fm6_tm14*122*g,0,0,895,0,895,1.0,122,2642@TOP@human_GAPDH_TAA_len41_fa0_ta20_fm6_tm14,g
2642@TOP@human_GAPDH_TAA_len41_fa0_ta20_fm6_tm14*123*t,0,0,0,878,878,0.0,123,2642@TOP@human_GAPDH_TAA_len41_fa0_ta20_fm6_tm14,t
2642@TOP@human_GAPDH_TAA_len41_fa0_ta20_fm6_tm14*124*a,684,0,203,0,887,0.229,124,2642@TOP@human_GAPDH_TAA_len41_fa0_ta20_fm6_tm14,a
2642@TOP@human_GAPDH_TAA_len41_fa0_ta20_fm6_tm14*125*a,776,0,106,0,882,0.12,125,2642@TOP@human_GAPDH_TAA_len41_fa0_ta20_fm6_tm14,a
2642@TOP@human_GAPDH_TAA_len41_fa0_ta20_fm6_tm14*126*g,0,0,883,0,883,1.0,126,2642@TOP@human_GAPDH_TAA_len41_fa0_ta20_fm6_tm14,g
2642@TOP@human_GAPDH_TAA_len41_fa0_ta20_fm6_tm14*127*a,894,0,0,0,894,0.0,127,2642@TOP@human_GAPDH_TAA_len41_fa0_ta20_fm6_tm14,a
2642@TOP@human_GAPDH_TAA_len41_fa0_ta20_fm6_tm14*128*c,0,901,0,0,901,0.0,128,2642@TOP@human_GAPDH_TAA_len41_fa0_ta20_fm6_tm14,c
2642@TOP@human_GAPDH_TAA_len41_fa0_ta20_fm6_tm14*129*c,0,888,0,0,888,0.0,129,2642@TOP@human_GAPDH_TAA_len41_fa0_ta20_fm6_tm14,c
2642@TOP@human_GAPDH_TAA_len41_fa0_ta20_fm6_tm14*130*c,0,898,0,0,898,0.0,130,2642@TOP@human_GAPDH_TAA_len41_fa0_ta20_fm6_tm14,c
2642@TOP@human_GAPDH_TAA_len41_fa0_ta20_fm6_tm14*131*c,0,897,0,0,897,0.0,131,2642@TOP@human_GAPDH_TAA_len41_fa0_ta20_fm6_tm14,c
2642@TOP@human_GAPDH_TAA_len41_fa0_ta20_fm6_tm14*132*t,0,0,0,891,891,0.0,132,2642@TOP@human_GAPDH_TAA_len41_fa0_ta20_fm6_tm14,t
2642@TOP@human_GAPDH_TAA_len41_fa0_ta20_fm6_tm14*133*g,0,0,886,0,886,1.0,133,2642@TOP@human_GAPDH_TAA_len41_fa0_ta20_fm6_tm14,g
2642@TOP@human_GAPDH_TAA_len41_fa0_ta20_fm6_tm14*134*g,0,0,895,0,895,1.0,134,2642@TOP@human_GAPDH_TAA_len41_fa0_ta20_fm6_tm14,g
2643@TOP@human_GAPDH_TAA_len41_fa0_ta20_fm6_tm14*114*t,1,9,0,21703,21713,0.0,114,2643@TOP@human_GAPDH_TAA_len41_fa0_ta20_fm6_tm14,t
2643@TOP@human_GAPDH_TAA_len41_fa0_ta20_fm6_tm14*115*c,1,21827,0,2,21830,0.0,115,2643@TOP@human_GAPDH_TAA_len41_fa0_ta20_fm6_tm14,c
2643@TOP@human_GAPDH_TAA_len41_fa0_ta20_fm6_tm14*116*c,1,21738,0,0,21739,0.0,116,2643@TOP@human_GAPDH_TAA_len41_fa0_ta20_fm6_tm14,c
2643@TOP@human_GAPDH_TAA_len41_fa0_ta20_fm6_tm14*117*a,21656,0,32,0,21688,0.001,117,2643@TOP@human_GAPDH_TAA_len41_fa0_ta20_fm6_tm14,a
2643@TOP@human_GAPDH_TAA_len41_fa0_ta20_fm6_tm14*118*a,21302,1,266,1,21570,0.012,118,2643@TOP@human_GAPDH_TAA_len41_fa0_ta20_fm6_tm14,a
2643@TOP@human_GAPDH_TAA_len41_fa0_ta20_fm6_tm14*119*g,2,0,21591,1,21594,1.0,119,2643@TOP@human_GAPDH_TAA_len41_fa0_ta20_fm6_tm14,g
2643@TOP@human_GAPDH_TAA_len41_fa0_ta20_fm6_tm14*120*g,1,0,21476,2,21479,1.0,120,2643@TOP@human_GAPDH_TAA_len41_fa0_ta20_fm6_tm14,g
2643@TOP@human_GAPDH_TAA_len41_fa0_ta20_fm6_tm14*121*a,21695,0,18,0,21713,0.001,121,2643@TOP@human_GAPDH_TAA_len41_fa0_ta20_fm6_tm14,a
2643@TOP@human_GAPDH_TAA_len41_fa0_ta20_fm6_tm14*122*g,0,2,21729,0,21731,1.0,122,2643@TOP@human_GAPDH_TAA_len41_fa0_ta20_fm6_tm14,g
2643@TOP@human_GAPDH_TAA_len41_fa0_ta20_fm6_tm14*123*t,3,1,2,21478,21484,0.0,123,2643@TOP@human_GAPDH_TAA_len41_fa0_ta20_fm6_tm14,t
2643@TOP@human_GAPDH_TAA_len41_fa0_ta20_fm6_tm14*124*a,8858,0,12652,1,21511,0.588,124,2643@TOP@human_GAPDH_TAA_len41_fa0_ta20_fm6_tm14,a
2643@TOP@human_GAPDH_TAA_len41_fa0_ta20_fm6_tm14*125*a,10627,0,10796,2,21425,0.504,125,2643@TOP@human_GAPDH_TAA_len41_fa0_ta20_fm6_tm14,a
2643@TOP@human_GAPDH_TAA_len41_fa0_ta20_fm6_tm14*126*g,0,0,21561,2,21563,1.0,126,2643@TOP@human_GAPDH_TAA_len41_fa0_ta20_fm6_tm14,g
2643@TOP@human_GAPDH_TAA_len41_fa0_ta20_fm6_tm14*127*a,21511,0,153,0,21664,0.007,127,2643@TOP@human_GAPDH_TAA_len41_fa0_ta20_fm6_tm14,a
2643@TOP@human_GAPDH_TAA_len41_fa0_ta20_fm6_tm14*128*c,0,21776,1,0,21777,0.0,128,2643@TOP@human_GAPDH_TAA_len41_fa0_ta20_fm6_tm14,c
2643@TOP@human_GAPDH_TAA_len41_fa0_ta20_fm6_tm14*129*c,0,21688,0,1,21689,0.0,129,2643@TOP@human_GAPDH_TAA_len41_fa0_ta20_fm6_tm14,c
2643@TOP@human_GAPDH_TAA_len41_fa0_ta20_fm6_tm14*130*c,2,21745,4,0,21751,0.0,130,2643@TOP@human_GAPDH_TAA_len41_fa0_ta20_fm6_tm14,c
2643@TOP@human_GAPDH_TAA_len41_fa0_ta20_fm6_tm14*131*c,1,21794,0,1,21796,0.0,131,2643@TOP@human_GAPDH_TAA_len41_fa0_ta20_fm6_tm14,c
2643@TOP@human_GAPDH_TAA_len41_fa0_ta20_fm6_tm14*132*t,0,3,3,21506,21512,0.0,132,2643@TOP@human_GAPDH_TAA_len41_fa0_ta20_fm6_tm14,t
2643@TOP@human_GAPDH_TAA_len41_fa0_ta20_fm6_tm14*133*g,0,0,21467,1,21468,1.0,133,2643@TOP@human_GAPDH_TAA_len41_fa0_ta20_fm6_tm14,g
2643@TOP@human_GAPDH_TAA_len41_fa0_ta20_fm6_tm14*134*g,0,2,21577,0,21579,1.0,134,2643@TOP@human_GAPDH_TAA_len41_fa0_ta20_fm6_tm14,g
2644@TOP@human_GAPDH_TAA_len41_fa0_ta20_fm6_tm14*114*t,2,5,0,34409,34416,0.0,114,2644@TOP@human_GAPDH_TAA_len41_fa0_ta20_fm6_tm14,t
2644@TOP@human_GAPDH_TAA_len41_fa0_ta20_fm6_tm14*115*c,2,34624,0,0,34626,0.0,115,2644@TOP@human_GAPDH_TAA_len41_fa0_ta20_fm6_tm14,c
2644@TOP@human_GAPDH_TAA_len41_fa0_ta20_fm6_tm14*116*c,5,34485,0,4,34494,0.0,116,2644@TOP@human_GAPDH_TAA_len41_fa0_ta20_fm6_tm14,c
2644@TOP@human_GAPDH_TAA_len41_fa0_ta20_fm6_tm14*117*a,34399,0,33,1,34433,0.001,117,2644@TOP@human_GAPDH_TAA_len41_fa0_ta20_fm6_tm14,a
2644@TOP@human_GAPDH_TAA_len41_fa0_ta20_fm6_tm14*118*a,33921,0,412,1,34334,0.012,118,2644@TOP@human_GAPDH_TAA_len41_fa0_ta20_fm6_tm14,a
2644@TOP@human_GAPDH_TAA_len41_fa0_ta20_fm6_tm14*119*g,4,0,34248,0,34252,1.0,119,2644@TOP@human_GAPDH_TAA_len41_fa0_ta20_fm6_tm14,g
2644@TOP@human_GAPDH_TAA_len41_fa0_ta20_fm6_tm14*120*g,1,0,34115,1,34117,1.0,120,2644@TOP@human_GAPDH_TAA_len41_fa0_ta20_fm6_tm14,g
2644@TOP@human_GAPDH_TAA_len41_fa0_ta20_fm6_tm14*121*a,34443,0,14,0,34457,0.0,121,2644@TOP@human_GAPDH_TAA_len41_fa0_ta20_fm6_tm14,a
2644@TOP@human_GAPDH_TAA_len41_fa0_ta20_fm6_tm14*122*g,0,0,34507,1,34508,1.0,122,2644@TOP@human_GAPDH_TAA_len41_fa0_ta20_fm6_tm14,g
2644@TOP@human_GAPDH_TAA_len41_fa0_ta20_fm6_tm14*123*t,1,3,2,34073,34079,0.0,123,2644@TOP@human_GAPDH_TAA_len41_fa0_ta20_fm6_tm14,t
2644@TOP@human_GAPDH_TAA_len41_fa0_ta20_fm6_tm14*124*a,12155,0,21973,0,34128,0.644,124,2644@TOP@human_GAPDH_TAA_len41_fa0_ta20_fm6_tm14,a
2644@TOP@human_GAPDH_TAA_len41_fa0_ta20_fm6_tm14*125*a,20788,2,13305,1,34096,0.39,125,2644@TOP@human_GAPDH_TAA_len41_fa0_ta20_fm6_tm14,a
2644@TOP@human_GAPDH_TAA_len41_fa0_ta20_fm6_tm14*126*g,4,0,34230,5,34239,1.0,126,2644@TOP@human_GAPDH_TAA_len41_fa0_ta20_fm6_tm14,g
2644@TOP@human_GAPDH_TAA_len41_fa0_ta20_fm6_tm14*127*a,34217,2,181,4,34404,0.005,127,2644@TOP@human_GAPDH_TAA_len41_fa0_ta20_fm6_tm14,a
2644@TOP@human_GAPDH_TAA_len41_fa0_ta20_fm6_tm14*128*c,1,34540,2,4,34547,0.0,128,2644@TOP@human_GAPDH_TAA_len41_fa0_ta20_fm6_tm14,c
2644@TOP@human_GAPDH_TAA_len41_fa0_ta20_fm6_tm14*129*c,0,34401,1,0,34402,0.0,129,2644@TOP@human_GAPDH_TAA_len41_fa0_ta20_fm6_tm14,c
2644@TOP@human_GAPDH_TAA_len41_fa0_ta20_fm6_tm14*130*c,0,34523,0,0,34523,0.0,130,2644@TOP@human_GAPDH_TAA_len41_fa0_ta20_fm6_tm14,c
2644@TOP@human_GAPDH_TAA_len41_fa0_ta20_fm6_tm14*131*c,4,34567,0,0,34571,0.0,131,2644@TOP@human_GAPDH_TAA_len41_fa0_ta20_fm6_tm14,c
2644@TOP@human_GAPDH_TAA_len41_fa0_ta20_fm6_tm14*132*t,6,8,5,34167,34186,0.0,132,2644@TOP@human_GAPDH_TAA_len41_fa0_ta20_fm6_tm14,t
2644@TOP@human_GAPDH_TAA_len41_fa0_ta20_fm6_tm14*133*g,0,0,34059,0,34059,1.0,133,2644@TOP@human_GAPDH_TAA_len41_fa0_ta20_fm6_tm14,g
2644@TOP@human_GAPDH_TAA_len41_fa0_ta20_fm6_tm14*134*g,0,2,34238,0,34240,1.0,134,2644@TOP@human_GAPDH_TAA_len41_fa0_ta20_fm6_tm14,g
2645@TOP@human_GAPDH_TAA_len41_fa0_ta20_fm6_tm14*114*t,0,0,0,1703,1703,0.0,114,2645@TOP@human_GAPDH_TAA_len41_fa0_ta20_fm6_tm14,t
2645@TOP@human_GAPDH_TAA_len41_fa0_ta20_fm6_tm14*115*c,0,1718,0,0,1718,0.0,115,2645@TOP@human_GAPDH_TAA_len41_fa0_ta20_fm6_tm14,c
2645@TOP@human_GAPDH_TAA_len41_fa0_ta20_fm6_tm14*116*c,0,1705,0,0,1705,0.0,116,2645@TOP@human_GAPDH_TAA_len41_fa0_ta20_fm6_tm14,c
2645@TOP@human_GAPDH_TAA_len41_fa0_ta20_fm6_tm14*117*a,1697,0,4,0,1701,0.002,117,2645@TOP@human_GAPDH_TAA_len41_fa0_ta20_fm6_tm14,a
2645@TOP@human_GAPDH_TAA_len41_fa0_ta20_fm6_tm14*118*a,1640,0,52,0,1692,0.031,118,2645@TOP@human_GAPDH_TAA_len41_fa0_ta20_fm6_tm14,a
2645@TOP@human_GAPDH_TAA_len41_fa0_ta20_fm6_tm14*119*g,0,0,1696,0,1696,1.0,119,2645@TOP@human_GAPDH_TAA_len41_fa0_ta20_fm6_tm14,g
2645@TOP@human_GAPDH_TAA_len41_fa0_ta20_fm6_tm14*120*g,0,0,1687,0,1687,1.0,120,2645@TOP@human_GAPDH_TAA_len41_fa0_ta20_fm6_tm14,g
2645@TOP@human_GAPDH_TAA_len41_fa0_ta20_fm6_tm14*121*a,1709,0,1,0,1710,0.001,121,2645@TOP@human_GAPDH_TAA_len41_fa0_ta20_fm6_tm14,a
2645@TOP@human_GAPDH_TAA_len41_fa0_ta20_fm6_tm14*122*g,1,0,1706,0,1707,0.999,122,2645@TOP@human_GAPDH_TAA_len41_fa0_ta20_fm6_tm14,g
2645@TOP@human_GAPDH_TAA_len41_fa0_ta20_fm6_tm14*123*t,0,1,0,1677,1678,0.0,123,2645@TOP@human_GAPDH_TAA_len41_fa0_ta20_fm6_tm14,t
2645@TOP@human_GAPDH_TAA_len41_fa0_ta20_fm6_tm14*124*a,1538,0,127,0,1665,0.076,124,2645@TOP@human_GAPDH_TAA_len41_fa0_ta20_fm6_tm14,a
2645@TOP@human_GAPDH_TAA_len41_fa0_ta20_fm6_tm14*125*a,1249,0,424,0,1673,0.253,125,2645@TOP@human_GAPDH_TAA_len41_fa0_ta20_fm6_tm14,a
2645@TOP@human_GAPDH_TAA_len41_fa0_ta20_fm6_tm14*126*g,0,0,1677,0,1677,1.0,126,2645@TOP@human_GAPDH_TAA_len41_fa0_ta20_fm6_tm14,g
2645@TOP@human_GAPDH_TAA_len41_fa0_ta20_fm6_tm14*127*a,1555,0,142,0,1697,0.084,127,2645@TOP@human_GAPDH_TAA_len41_fa0_ta20_fm6_tm14,a
2645@TOP@human_GAPDH_TAA_len41_fa0_ta20_fm6_tm14*128*c,0,1704,0,0,1704,0.0,128,2645@TOP@human_GAPDH_TAA_len41_fa0_ta20_fm6_tm14,c
2645@TOP@human_GAPDH_TAA_len41_fa0_ta20_fm6_tm14*129*c,0,1705,0,0,1705,0.0,129,2645@TOP@human_GAPDH_TAA_len41_fa0_ta20_fm6_tm14,c
2645@TOP@human_GAPDH_TAA_len41_fa0_ta20_fm6_tm14*130*c,0,1711,0,0,1711,0.0,130,2645@TOP@human_GAPDH_TAA_len41_fa0_ta20_fm6_tm14,c
2645@TOP@human_GAPDH_TAA_len41_fa0_ta20_fm6_tm14*131*c,0,1715,0,0,1715,0.0,131,2645@TOP@human_GAPDH_TAA_len41_fa0_ta20_fm6_tm14,c
2645@TOP@human_GAPDH_TAA_len41_fa0_ta20_fm6_tm14*132*t,1,0,0,1681,1682,0.0,132,2645@TOP@human_GAPDH_TAA_len41_fa0_ta20_fm6_tm14,t
2645@TOP@human_GAPDH_TAA_len41_fa0_ta20_fm6_tm14*133*g,1,0,1686,0,1687,0.999,133,2645@TOP@human_GAPDH_TAA_len41_fa0_ta20_fm6_tm14,g
2645@TOP@human_GAPDH_TAA_len41_fa0_ta20_fm6_tm14*134*g,1,1,1692,0,1694,0.999,134,2645@TOP@human_GAPDH_TAA_len41_fa0_ta20_fm6_tm14,g
2646@TOP@human_GAPDH_TAA_len41_fa0_ta20_fm6_tm14*114*t,0,2,2,10159,10163,0.0,114,2646@TOP@human_GAPDH_TAA_len41_fa0_ta20_fm6_tm14,t
2646@TOP@human_GAPDH_TAA_len41_fa0_ta20_fm6_tm14*115*c,0,10210,0,0,10210,0.0,115,2646@TOP@human_GAPDH_TAA_len41_fa0_ta20_fm6_tm14,c
2646@TOP@human_GAPDH_TAA_len41_fa0_ta20_fm6_tm14*116*c,0,10178,0,0,10178,0.0,116,2646@TOP@human_GAPDH_TAA_len41_fa0_ta20_fm6_tm14,c
2646@TOP@human_GAPDH_TAA_len41_fa0_ta20_fm6_tm14*117*a,10131,0,15,0,10146,0.001,117,2646@TOP@human_GAPDH_TAA_len41_fa0_ta20_fm6_tm14,a
2646@TOP@human_GAPDH_TAA_len41_fa0_ta20_fm6_tm14*118*a,9990,0,127,0,10117,0.013,118,2646@TOP@human_GAPDH_TAA_len41_fa0_ta20_fm6_tm14,a
2646@TOP@human_GAPDH_TAA_len41_fa0_ta20_fm6_tm14*119*g,0,1,10090,0,10091,1.0,119,2646@TOP@human_GAPDH_TAA_len41_fa0_ta20_fm6_tm14,g
2646@TOP@human_GAPDH_TAA_len41_fa0_ta20_fm6_tm14*120*g,0,0,10051,6,10057,0.999,120,2646@TOP@human_GAPDH_TAA_len41_fa0_ta20_fm6_tm14,g
2646@TOP@human_GAPDH_TAA_len41_fa0_ta20_fm6_tm14*121*a,10171,0,3,0,10174,0.0,121,2646@TOP@human_GAPDH_TAA_len41_fa0_ta20_fm6_tm14,a
2646@TOP@human_GAPDH_TAA_len41_fa0_ta20_fm6_tm14*122*g,0,0,10174,0,10174,1.0,122,2646@TOP@human_GAPDH_TAA_len41_fa0_ta20_fm6_tm14,g
2646@TOP@human_GAPDH_TAA_len41_fa0_ta20_fm6_tm14*123*t,3,2,2,10040,10047,0.0,123,2646@TOP@human_GAPDH_TAA_len41_fa0_ta20_fm6_tm14,t
2646@TOP@human_GAPDH_TAA_len41_fa0_ta20_fm6_tm14*124*a,9189,0,813,0,10002,0.081,124,2646@TOP@human_GAPDH_TAA_len41_fa0_ta20_fm6_tm14,a
2646@TOP@human_GAPDH_TAA_len41_fa0_ta20_fm6_tm14*125*a,9323,1,639,3,9966,0.064,125,2646@TOP@human_GAPDH_TAA_len41_fa0_ta20_fm6_tm14,a
2646@TOP@human_GAPDH_TAA_len41_fa0_ta20_fm6_tm14*126*g,0,0,10054,0,10054,1.0,126,2646@TOP@human_GAPDH_TAA_len41_fa0_ta20_fm6_tm14,g
2646@TOP@human_GAPDH_TAA_len41_fa0_ta20_fm6_tm14*127*a,9941,0,201,0,10142,0.02,127,2646@TOP@human_GAPDH_TAA_len41_fa0_ta20_fm6_tm14,a
2646@TOP@human_GAPDH_TAA_len41_fa0_ta20_fm6_tm14*128*c,0,10197,1,0,10198,0.0,128,2646@TOP@human_GAPDH_TAA_len41_fa0_ta20_fm6_tm14,c
2646@TOP@human_GAPDH_TAA_len41_fa0_ta20_fm6_tm14*129*c,3,10135,0,0,10138,0.0,129,2646@TOP@human_GAPDH_TAA_len41_fa0_ta20_fm6_tm14,c
2646@TOP@human_GAPDH_TAA_len41_fa0_ta20_fm6_tm14*130*c,0,10176,0,0,10176,0.0,130,2646@TOP@human_GAPDH_TAA_len41_fa0_ta20_fm6_tm14,c
2646@TOP@human_GAPDH_TAA_len41_fa0_ta20_fm6_tm14*131*c,0,10189,0,2,10191,0.0,131,2646@TOP@human_GAPDH_TAA_len41_fa0_ta20_fm6_tm14,c
2646@TOP@human_GAPDH_TAA_len41_fa0_ta20_fm6_tm14*132*t,1,1,3,10045,10050,0.0,132,2646@TOP@human_GAPDH_TAA_len41_fa0_ta20_fm6_tm14,t
2646@TOP@human_GAPDH_TAA_len41_fa0_ta20_fm6_tm14*133*g,0,2,10046,0,10048,1.0,133,2646@TOP@human_GAPDH_TAA_len41_fa0_ta20_fm6_tm14,g
2646@TOP@human_GAPDH_TAA_len41_fa0_ta20_fm6_tm14*134*g,2,3,10085,0,10090,1.0,134,2646@TOP@human_GAPDH_TAA_len41_fa0_ta20_fm6_tm14,g
2647@TOP@human_GAPDH_TAA_len41_fa0_ta20_fm6_tm14*114*t,0,0,0,939,939,0.0,114,2647@TOP@human_GAPDH_TAA_len41_fa0_ta20_fm6_tm14,t
2647@TOP@human_GAPDH_TAA_len41_fa0_ta20_fm6_tm14*115*c,0,948,0,0,948,0.0,115,2647@TOP@human_GAPDH_TAA_len41_fa0_ta20_fm6_tm14,c
2647@TOP@human_GAPDH_TAA_len41_fa0_ta20_fm6_tm14*116*c,0,943,0,0,943,0.0,116,2647@TOP@human_GAPDH_TAA_len41_fa0_ta20_fm6_tm14,c
2647@TOP@human_GAPDH_TAA_len41_fa0_ta20_fm6_tm14*117*a,937,0,2,0,939,0.002,117,2647@TOP@human_GAPDH_TAA_len41_fa0_ta20_fm6_tm14,a
2647@TOP@human_GAPDH_TAA_len41_fa0_ta20_fm6_tm14*118*a,918,0,17,0,935,0.018,118,2647@TOP@human_GAPDH_TAA_len41_fa0_ta20_fm6_tm14,a
2647@TOP@human_GAPDH_TAA_len41_fa0_ta20_fm6_tm14*119*g,0,0,931,0,931,1.0,119,2647@TOP@human_GAPDH_TAA_len41_fa0_ta20_fm6_tm14,g
2647@TOP@human_GAPDH_TAA_len41_fa0_ta20_fm6_tm14*120*g,0,0,925,0,925,1.0,120,2647@TOP@human_GAPDH_TAA_len41_fa0_ta20_fm6_tm14,g
2647@TOP@human_GAPDH_TAA_len41_fa0_ta20_fm6_tm14*121*a,940,0,0,0,940,0.0,121,2647@TOP@human_GAPDH_TAA_len41_fa0_ta20_fm6_tm14,a
2647@TOP@human_GAPDH_TAA_len41_fa0_ta20_fm6_tm14*122*g,0,0,936,0,936,1.0,122,2647@TOP@human_GAPDH_TAA_len41_fa0_ta20_fm6_tm14,g
2647@TOP@human_GAPDH_TAA_len41_fa0_ta20_fm6_tm14*123*t,0,0,0,914,914,0.0,123,2647@TOP@human_GAPDH_TAA_len41_fa0_ta20_fm6_tm14,t
2647@TOP@human_GAPDH_TAA_len41_fa0_ta20_fm6_tm14*124*a,834,0,93,0,927,0.1,124,2647@TOP@human_GAPDH_TAA_len41_fa0_ta20_fm6_tm14,a
2647@TOP@human_GAPDH_TAA_len41_fa0_ta20_fm6_tm14*125*a,860,0,63,0,923,0.068,125,2647@TOP@human_GAPDH_TAA_len41_fa0_ta20_fm6_tm14,a
2647@TOP@human_GAPDH_TAA_len41_fa0_ta20_fm6_tm14*126*g,0,0,923,0,923,1.0,126,2647@TOP@human_GAPDH_TAA_len41_fa0_ta20_fm6_tm14,g
2647@TOP@human_GAPDH_TAA_len41_fa0_ta20_fm6_tm14*127*a,924,0,8,0,932,0.009,127,2647@TOP@human_GAPDH_TAA_len41_fa0_ta20_fm6_tm14,a
2647@TOP@human_GAPDH_TAA_len41_fa0_ta20_fm6_tm14*128*c,0,944,0,0,944,0.0,128,2647@TOP@human_GAPDH_TAA_len41_fa0_ta20_fm6_tm14,c
2647@TOP@human_GAPDH_TAA_len41_fa0_ta20_fm6_tm14*129*c,0,932,0,0,932,0.0,129,2647@TOP@human_GAPDH_TAA_len41_fa0_ta20_fm6_tm14,c
2647@TOP@human_GAPDH_TAA_len41_fa0_ta20_fm6_tm14*130*c,0,940,0,0,940,0.0,130,2647@TOP@human_GAPDH_TAA_len41_fa0_ta20_fm6_tm14,c
2647@TOP@human_GAPDH_TAA_len41_fa0_ta20_fm6_tm14*131*c,0,944,0,0,944,0.0,131,2647@TOP@human_GAPDH_TAA_len41_fa0_ta20_fm6_tm14,c
2647@TOP@human_GAPDH_TAA_len41_fa0_ta20_fm6_tm14*132*t,0,0,0,933,933,0.0,132,2647@TOP@human_GAPDH_TAA_len41_fa0_ta20_fm6_tm14,t
2647@TOP@human_GAPDH_TAA_len41_fa0_ta20_fm6_tm14*133*g,0,0,920,0,920,1.0,133,2647@TOP@human_GAPDH_TAA_len41_fa0_ta20_fm6_tm14,g
2647@TOP@human_GAPDH_TAA_len41_fa0_ta20_fm6_tm14*134*g,0,1,927,0,928,0.999,134,2647@TOP@human_GAPDH_TAA_len41_fa0_ta20_fm6_tm14,g
2648@TOP@human_GAPDH_TAA_len41_fa0_ta20_fm6_tm14*114*t,0,0,0,2062,2062,0.0,114,2648@TOP@human_GAPDH_TAA_len41_fa0_ta20_fm6_tm14,t
2648@TOP@human_GAPDH_TAA_len41_fa0_ta20_fm6_tm14*115*c,0,2079,0,0,2079,0.0,115,2648@TOP@human_GAPDH_TAA_len41_fa0_ta20_fm6_tm14,c
2648@TOP@human_GAPDH_TAA_len41_fa0_ta20_fm6_tm14*116*c,0,2066,0,1,2067,0.0,116,2648@TOP@human_GAPDH_TAA_len41_fa0_ta20_fm6_tm14,c
2648@TOP@human_GAPDH_TAA_len41_fa0_ta20_fm6_tm14*117*a,2057,0,12,0,2069,0.006,117,2648@TOP@human_GAPDH_TAA_len41_fa0_ta20_fm6_tm14,a
2648@TOP@human_GAPDH_TAA_len41_fa0_ta20_fm6_tm14*118*a,1955,1,96,0,2052,0.047,118,2648@TOP@human_GAPDH_TAA_len41_fa0_ta20_fm6_tm14,a
2648@TOP@human_GAPDH_TAA_len41_fa0_ta20_fm6_tm14*119*g,0,0,2054,0,2054,1.0,119,2648@TOP@human_GAPDH_TAA_len41_fa0_ta20_fm6_tm14,g
2648@TOP@human_GAPDH_TAA_len41_fa0_ta20_fm6_tm14*120*g,0,0,2045,0,2045,1.0,120,2648@TOP@human_GAPDH_TAA_len41_fa0_ta20_fm6_tm14,g
2648@TOP@human_GAPDH_TAA_len41_fa0_ta20_fm6_tm14*121*a,2071,0,2,0,2073,0.001,121,2648@TOP@human_GAPDH_TAA_len41_fa0_ta20_fm6_tm14,a
2648@TOP@human_GAPDH_TAA_len41_fa0_ta20_fm6_tm14*122*g,0,0,2066,0,2066,1.0,122,2648@TOP@human_GAPDH_TAA_len41_fa0_ta20_fm6_tm14,g
2648@TOP@human_GAPDH_TAA_len41_fa0_ta20_fm6_tm14*123*t,0,0,0,2043,2043,0.0,123,2648@TOP@human_GAPDH_TAA_len41_fa0_ta20_fm6_tm14,t
2648@TOP@human_GAPDH_TAA_len41_fa0_ta20_fm6_tm14*124*a,1768,0,273,0,2041,0.134,124,2648@TOP@human_GAPDH_TAA_len41_fa0_ta20_fm6_tm14,a
2648@TOP@human_GAPDH_TAA_len41_fa0_ta20_fm6_tm14*125*a,1918,1,113,0,2032,0.056,125,2648@TOP@human_GAPDH_TAA_len41_fa0_ta20_fm6_tm14,a
2648@TOP@human_GAPDH_TAA_len41_fa0_ta20_fm6_tm14*126*g,0,2,2045,0,2047,0.999,126,2648@TOP@human_GAPDH_TAA_len41_fa0_ta20_fm6_tm14,g
2648@TOP@human_GAPDH_TAA_len41_fa0_ta20_fm6_tm14*127*a,2061,0,8,0,2069,0.004,127,2648@TOP@human_GAPDH_TAA_len41_fa0_ta20_fm6_tm14,a
2648@TOP@human_GAPDH_TAA_len41_fa0_ta20_fm6_tm14*128*c,0,2075,0,0,2075,0.0,128,2648@TOP@human_GAPDH_TAA_len41_fa0_ta20_fm6_tm14,c
2648@TOP@human_GAPDH_TAA_len41_fa0_ta20_fm6_tm14*129*c,0,2060,0,0,2060,0.0,129,2648@TOP@human_GAPDH_TAA_len41_fa0_ta20_fm6_tm14,c
2648@TOP@human_GAPDH_TAA_len41_fa0_ta20_fm6_tm14*130*c,0,2073,0,0,2073,0.0,130,2648@TOP@human_GAPDH_TAA_len41_fa0_ta20_fm6_tm14,c
2648@TOP@human_GAPDH_TAA_len41_fa0_ta20_fm6_tm14*131*c,0,2076,0,0,2076,0.0,131,2648@TOP@human_GAPDH_TAA_len41_fa0_ta20_fm6_tm14,c
2648@TOP@human_GAPDH_TAA_len41_fa0_ta20_fm6_tm14*132*t,1,0,0,2031,2032,0.0,132,2648@TOP@human_GAPDH_TAA_len41_fa0_ta20_fm6_tm14,t
2648@TOP@human_GAPDH_TAA_len41_fa0_ta20_fm6_tm14*133*g,0,0,2046,0,2046,1.0,133,2648@TOP@human_GAPDH_TAA_len41_fa0_ta20_fm6_tm14,g
2648@TOP@human_GAPDH_TAA_len41_fa0_ta20_fm6_tm14*134*g,0,0,2051,0,2051,1.0,134,2648@TOP@human_GAPDH_TAA_len41_fa0_ta20_fm6_tm14,g
2649@TOP@human_GAPDH_TAA_len41_fa0_ta20_fm6_tm14*114*t,2,4,0,2169,2175,0.0,114,2649@TOP@human_GAPDH_TAA_len41_fa0_ta20_fm6_tm14,t
2649@TOP@human_GAPDH_TAA_len41_fa0_ta20_fm6_tm14*115*c,0,2185,0,0,2185,0.0,115,2649@TOP@human_GAPDH_TAA_len41_fa0_ta20_fm6_tm14,c
2649@TOP@human_GAPDH_TAA_len41_fa0_ta20_fm6_tm14*116*c,0,2178,0,0,2178,0.0,116,2649@TOP@human_GAPDH_TAA_len41_fa0_ta20_fm6_tm14,c
2649@TOP@human_GAPDH_TAA_len41_fa0_ta20_fm6_tm14*117*a,2161,0,9,0,2170,0.004,117,2649@TOP@human_GAPDH_TAA_len41_fa0_ta20_fm6_tm14,a
2649@TOP@human_GAPDH_TAA_len41_fa0_ta20_fm6_tm14*118*a,2090,0,69,5,2164,0.032,118,2649@TOP@human_GAPDH_TAA_len41_fa0_ta20_fm6_tm14,a
2649@TOP@human_GAPDH_TAA_len41_fa0_ta20_fm6_tm14*119*g,0,0,2161,0,2161,1.0,119,2649@TOP@human_GAPDH_TAA_len41_fa0_ta20_fm6_tm14,g
2649@TOP@human_GAPDH_TAA_len41_fa0_ta20_fm6_tm14*120*g,0,0,2149,0,2149,1.0,120,2649@TOP@human_GAPDH_TAA_len41_fa0_ta20_fm6_tm14,g
2649@TOP@human_GAPDH_TAA_len41_fa0_ta20_fm6_tm14*121*a,2177,0,0,0,2177,0.0,121,2649@TOP@human_GAPDH_TAA_len41_fa0_ta20_fm6_tm14,a
2649@TOP@human_GAPDH_TAA_len41_fa0_ta20_fm6_tm14*122*g,0,0,2175,0,2175,1.0,122,2649@TOP@human_GAPDH_TAA_len41_fa0_ta20_fm6_tm14,g
2649@TOP@human_GAPDH_TAA_len41_fa0_ta20_fm6_tm14*123*t,1,1,1,2138,2141,0.0,123,2649@TOP@human_GAPDH_TAA_len41_fa0_ta20_fm6_tm14,t
2649@TOP@human_GAPDH_TAA_len41_fa0_ta20_fm6_tm14*124*a,1916,0,228,0,2144,0.106,124,2649@TOP@human_GAPDH_TAA_len41_fa0_ta20_fm6_tm14,a
2649@TOP@human_GAPDH_TAA_len41_fa0_ta20_fm6_tm14*125*a,1594,0,546,0,2140,0.255,125,2649@TOP@human_GAPDH_TAA_len41_fa0_ta20_fm6_tm14,a
2649@TOP@human_GAPDH_TAA_len41_fa0_ta20_fm6_tm14*126*g,0,0,2144,0,2144,1.0,126,2649@TOP@human_GAPDH_TAA_len41_fa0_ta20_fm6_tm14,g
2649@TOP@human_GAPDH_TAA_len41_fa0_ta20_fm6_tm14*127*a,2084,0,88,0,2172,0.041,127,2649@TOP@human_GAPDH_TAA_len41_fa0_ta20_fm6_tm14,a
2649@TOP@human_GAPDH_TAA_len41_fa0_ta20_fm6_tm14*128*c,0,2182,0,0,2182,0.0,128,2649@TOP@human_GAPDH_TAA_len41_fa0_ta20_fm6_tm14,c
2649@TOP@human_GAPDH_TAA_len41_fa0_ta20_fm6_tm14*129*c,0,2159,0,1,2160,0.0,129,2649@TOP@human_GAPDH_TAA_len41_fa0_ta20_fm6_tm14,c
2649@TOP@human_GAPDH_TAA_len41_fa0_ta20_fm6_tm14*130*c,0,2179,0,1,2180,0.0,130,2649@TOP@human_GAPDH_TAA_len41_fa0_ta20_fm6_tm14,c
2649@TOP@human_GAPDH_TAA_len41_fa0_ta20_fm6_tm14*131*c,0,2179,0,0,2179,0.0,131,2649@TOP@human_GAPDH_TAA_len41_fa0_ta20_fm6_tm14,c
2649@TOP@human_GAPDH_TAA_len41_fa0_ta20_fm6_tm14*132*t,0,1,0,2147,2148,0.0,132,2649@TOP@human_GAPDH_TAA_len41_fa0_ta20_fm6_tm14,t
2649@TOP@human_GAPDH_TAA_len41_fa0_ta20_fm6_tm14*133*g,1,0,2137,0,2138,1.0,133,2649@TOP@human_GAPDH_TAA_len41_fa0_ta20_fm6_tm14,g
2649@TOP@human_GAPDH_TAA_len41_fa0_ta20_fm6_tm14*134*g,0,0,2163,0,2163,1.0,134,2649@TOP@human_GAPDH_TAA_len41_fa0_ta20_fm6_tm14,g
2650@TOP@human_GAPDH_TAA_len41_fa0_ta20_fm6_tm14*114*t,0,0,0,2990,2990,0.0,114,2650@TOP@human_GAPDH_TAA_len41_fa0_ta20_fm6_tm14,t
2650@TOP@human_GAPDH_TAA_len41_fa0_ta20_fm6_tm14*115*c,0,3010,0,1,3011,0.0,115,2650@TOP@human_GAPDH_TAA_len41_fa0_ta20_fm6_tm14,c
2650@TOP@human_GAPDH_TAA_len41_fa0_ta20_fm6_tm14*116*c,0,2993,0,0,2993,0.0,116,2650@TOP@human_GAPDH_TAA_len41_fa0_ta20_fm6_tm14,c
2650@TOP@human_GAPDH_TAA_len41_fa0_ta20_fm6_tm14*117*a,2989,0,5,0,2994,0.002,117,2650@TOP@human_GAPDH_TAA_len41_fa0_ta20_fm6_tm14,a
2650@TOP@human_GAPDH_TAA_len41_fa0_ta20_fm6_tm14*118*a,2922,0,50,0,2972,0.017,118,2650@TOP@human_GAPDH_TAA_len41_fa0_ta20_fm6_tm14,a
2650@TOP@human_GAPDH_TAA_len41_fa0_ta20_fm6_tm14*119*g,3,0,2972,0,2975,0.999,119,2650@TOP@human_GAPDH_TAA_len41_fa0_ta20_fm6_tm14,g
2650@TOP@human_GAPDH_TAA_len41_fa0_ta20_fm6_tm14*120*g,0,1,2956,0,2957,1.0,120,2650@TOP@human_GAPDH_TAA_len41_fa0_ta20_fm6_tm14,g
2650@TOP@human_GAPDH_TAA_len41_fa0_ta20_fm6_tm14*121*a,3001,0,1,0,3002,0.0,121,2650@TOP@human_GAPDH_TAA_len41_fa0_ta20_fm6_tm14,a
2650@TOP@human_GAPDH_TAA_len41_fa0_ta20_fm6_tm14*122*g,1,0,2999,0,3000,1.0,122,2650@TOP@human_GAPDH_TAA_len41_fa0_ta20_fm6_tm14,g
2650@TOP@human_GAPDH_TAA_len41_fa0_ta20_fm6_tm14*123*t,0,2,0,2947,2949,0.0,123,2650@TOP@human_GAPDH_TAA_len41_fa0_ta20_fm6_tm14,t
2650@TOP@human_GAPDH_TAA_len41_fa0_ta20_fm6_tm14*124*a,2538,0,418,0,2956,0.141,124,2650@TOP@human_GAPDH_TAA_len41_fa0_ta20_fm6_tm14,a
2650@TOP@human_GAPDH_TAA_len41_fa0_ta20_fm6_tm14*125*a,2740,0,196,0,2936,0.067,125,2650@TOP@human_GAPDH_TAA_len41_fa0_ta20_fm6_tm14,a
2650@TOP@human_GAPDH_TAA_len41_fa0_ta20_fm6_tm14*126*g,0,0,2948,0,2948,1.0,126,2650@TOP@human_GAPDH_TAA_len41_fa0_ta20_fm6_tm14,g
2650@TOP@human_GAPDH_TAA_len41_fa0_ta20_fm6_tm14*127*a,2971,0,26,0,2997,0.009,127,2650@TOP@human_GAPDH_TAA_len41_fa0_ta20_fm6_tm14,a
2650@TOP@human_GAPDH_TAA_len41_fa0_ta20_fm6_tm14*128*c,0,3000,0,0,3000,0.0,128,2650@TOP@human_GAPDH_TAA_len41_fa0_ta20_fm6_tm14,c
2650@TOP@human_GAPDH_TAA_len41_fa0_ta20_fm6_tm14*129*c,0,2982,0,0,2982,0.0,129,2650@TOP@human_GAPDH_TAA_len41_fa0_ta20_fm6_tm14,c
2650@TOP@human_GAPDH_TAA_len41_fa0_ta20_fm6_tm14*130*c,0,3002,0,1,3003,0.0,130,2650@TOP@human_GAPDH_TAA_len41_fa0_ta20_fm6_tm14,c
2650@TOP@human_GAPDH_TAA_len41_fa0_ta20_fm6_tm14*131*c,0,3003,0,0,3003,0.0,131,2650@TOP@human_GAPDH_TAA_len41_fa0_ta20_fm6_tm14,c
2650@TOP@human_GAPDH_TAA_len41_fa0_ta20_fm6_tm14*132*t,2,0,0,2958,2960,0.0,132,2650@TOP@human_GAPDH_TAA_len41_fa0_ta20_fm6_tm14,t
2650@TOP@human_GAPDH_TAA_len41_fa0_ta20_fm6_tm14*133*g,0,0,2961,0,2961,1.0,133,2650@TOP@human_GAPDH_TAA_len41_fa0_ta20_fm6_tm14,g
2650@TOP@human_GAPDH_TAA_len41_fa0_ta20_fm6_tm14*134*g,0,1,2981,0,2982,1.0,134,2650@TOP@human_GAPDH_TAA_len41_fa0_ta20_fm6_tm14,g
2651@TOP@human_GAPDH_TAA_len41_fa0_ta20_fm6_tm14*114*t,0,0,0,561,561,0.0,114,2651@TOP@human_GAPDH_TAA_len41_fa0_ta20_fm6_tm14,t
2651@TOP@human_GAPDH_TAA_len41_fa0_ta20_fm6_tm14*115*c,0,563,0,0,563,0.0,115,2651@TOP@human_GAPDH_TAA_len41_fa0_ta20_fm6_tm14,c
2651@TOP@human_GAPDH_TAA_len41_fa0_ta20_fm6_tm14*116*c,0,562,0,0,562,0.0,116,2651@TOP@human_GAPDH_TAA_len41_fa0_ta20_fm6_tm14,c
2651@TOP@human_GAPDH_TAA_len41_fa0_ta20_fm6_tm14*117*a,562,0,1,0,563,0.002,117,2651@TOP@human_GAPDH_TAA_len41_fa0_ta20_fm6_tm14,a
2651@TOP@human_GAPDH_TAA_len41_fa0_ta20_fm6_tm14*118*a,534,0,22,0,556,0.04,118,2651@TOP@human_GAPDH_TAA_len41_fa0_ta20_fm6_tm14,a
2651@TOP@human_GAPDH_TAA_len41_fa0_ta20_fm6_tm14*119*g,0,0,553,0,553,1.0,119,2651@TOP@human_GAPDH_TAA_len41_fa0_ta20_fm6_tm14,g
2651@TOP@human_GAPDH_TAA_len41_fa0_ta20_fm6_tm14*120*g,0,0,551,0,551,1.0,120,2651@TOP@human_GAPDH_TAA_len41_fa0_ta20_fm6_tm14,g
2651@TOP@human_GAPDH_TAA_len41_fa0_ta20_fm6_tm14*121*a,560,0,0,0,560,0.0,121,2651@TOP@human_GAPDH_TAA_len41_fa0_ta20_fm6_tm14,a
2651@TOP@human_GAPDH_TAA_len41_fa0_ta20_fm6_tm14*122*g,0,0,557,0,557,1.0,122,2651@TOP@human_GAPDH_TAA_len41_fa0_ta20_fm6_tm14,g
2651@TOP@human_GAPDH_TAA_len41_fa0_ta20_fm6_tm14*123*t,0,0,0,549,549,0.0,123,2651@TOP@human_GAPDH_TAA_len41_fa0_ta20_fm6_tm14,t
2651@TOP@human_GAPDH_TAA_len41_fa0_ta20_fm6_tm14*124*a,469,0,83,0,552,0.15,124,2651@TOP@human_GAPDH_TAA_len41_fa0_ta20_fm6_tm14,a
2651@TOP@human_GAPDH_TAA_len41_fa0_ta20_fm6_tm14*125*a,513,0,39,1,553,0.071,125,2651@TOP@human_GAPDH_TAA_len41_fa0_ta20_fm6_tm14,a
2651@TOP@human_GAPDH_TAA_len41_fa0_ta20_fm6_tm14*126*g,0,0,546,0,546,1.0,126,2651@TOP@human_GAPDH_TAA_len41_fa0_ta20_fm6_tm14,g
2651@TOP@human_GAPDH_TAA_len41_fa0_ta20_fm6_tm14*127*a,559,0,0,0,559,0.0,127,2651@TOP@human_GAPDH_TAA_len41_fa0_ta20_fm6_tm14,a
2651@TOP@human_GAPDH_TAA_len41_fa0_ta20_fm6_tm14*128*c,0,560,0,0,560,0.0,128,2651@TOP@human_GAPDH_TAA_len41_fa0_ta20_fm6_tm14,c
2651@TOP@human_GAPDH_TAA_len41_fa0_ta20_fm6_tm14*129*c,0,553,0,0,553,0.0,129,2651@TOP@human_GAPDH_TAA_len41_fa0_ta20_fm6_tm14,c
2651@TOP@human_GAPDH_TAA_len41_fa0_ta20_fm6_tm14*130*c,0,559,0,0,559,0.0,130,2651@TOP@human_GAPDH_TAA_len41_fa0_ta20_fm6_tm14,c
2651@TOP@human_GAPDH_TAA_len41_fa0_ta20_fm6_tm14*131*c,0,561,0,0,561,0.0,131,2651@TOP@human_GAPDH_TAA_len41_fa0_ta20_fm6_tm14,c
2651@TOP@human_GAPDH_TAA_len41_fa0_ta20_fm6_tm14*132*t,0,0,0,552,552,0.0,132,2651@TOP@human_GAPDH_TAA_len41_fa0_ta20_fm6_tm14,t
2651@TOP@human_GAPDH_TAA_len41_fa0_ta20_fm6_tm14*133*g,0,0,545,0,545,1.0,133,2651@TOP@human_GAPDH_TAA_len41_fa0_ta20_fm6_tm14,g
2651@TOP@human_GAPDH_TAA_len41_fa0_ta20_fm6_tm14*134*g,0,0,558,0,558,1.0,134,2651@TOP@human_GAPDH_TAA_len41_fa0_ta20_fm6_tm14,g
2652@TOP@human_GAPDH_TAA_len41_fa0_ta20_fm6_tm14*114*t,0,0,0,414,414,0.0,114,2652@TOP@human_GAPDH_TAA_len41_fa0_ta20_fm6_tm14,t
2652@TOP@human_GAPDH_TAA_len41_fa0_ta20_fm6_tm14*115*c,0,420,0,0,420,0.0,115,2652@TOP@human_GAPDH_TAA_len41_fa0_ta20_fm6_tm14,c
2652@TOP@human_GAPDH_TAA_len41_fa0_ta20_fm6_tm14*116*c,0,414,0,0,414,0.0,116,2652@TOP@human_GAPDH_TAA_len41_fa0_ta20_fm6_tm14,c
2652@TOP@human_GAPDH_TAA_len41_fa0_ta20_fm6_tm14*117*a,419,0,1,0,420,0.002,117,2652@TOP@human_GAPDH_TAA_len41_fa0_ta20_fm6_tm14,a
2652@TOP@human_GAPDH_TAA_len41_fa0_ta20_fm6_tm14*118*a,411,0,2,0,413,0.005,118,2652@TOP@human_GAPDH_TAA_len41_fa0_ta20_fm6_tm14,a
2652@TOP@human_GAPDH_TAA_len41_fa0_ta20_fm6_tm14*119*g,0,0,408,0,408,1.0,119,2652@TOP@human_GAPDH_TAA_len41_fa0_ta20_fm6_tm14,g
2652@TOP@human_GAPDH_TAA_len41_fa0_ta20_fm6_tm14*120*g,0,0,408,0,408,1.0,120,2652@TOP@human_GAPDH_TAA_len41_fa0_ta20_fm6_tm14,g
2652@TOP@human_GAPDH_TAA_len41_fa0_ta20_fm6_tm14*121*a,416,0,0,0,416,0.0,121,2652@TOP@human_GAPDH_TAA_len41_fa0_ta20_fm6_tm14,a
2652@TOP@human_GAPDH_TAA_len41_fa0_ta20_fm6_tm14*122*g,0,0,412,0,412,1.0,122,2652@TOP@human_GAPDH_TAA_len41_fa0_ta20_fm6_tm14,g
2652@TOP@human_GAPDH_TAA_len41_fa0_ta20_fm6_tm14*123*t,0,0,0,410,410,0.0,123,2652@TOP@human_GAPDH_TAA_len41_fa0_ta20_fm6_tm14,t
2652@TOP@human_GAPDH_TAA_len41_fa0_ta20_fm6_tm14*124*a,385,0,22,0,407,0.054,124,2652@TOP@human_GAPDH_TAA_len41_fa0_ta20_fm6_tm14,a
2652@TOP@human_GAPDH_TAA_len41_fa0_ta20_fm6_tm14*125*a,392,0,18,0,410,0.044,125,2652@TOP@human_GAPDH_TAA_len41_fa0_ta20_fm6_tm14,a
2652@TOP@human_GAPDH_TAA_len41_fa0_ta20_fm6_tm14*126*g,0,0,404,0,404,1.0,126,2652@TOP@human_GAPDH_TAA_len41_fa0_ta20_fm6_tm14,g
2652@TOP@human_GAPDH_TAA_len41_fa0_ta20_fm6_tm14*127*a,417,0,0,0,417,0.0,127,2652@TOP@human_GAPDH_TAA_len41_fa0_ta20_fm6_tm14,a
2652@TOP@human_GAPDH_TAA_len41_fa0_ta20_fm6_tm14*128*c,0,418,0,0,418,0.0,128,2652@TOP@human_GAPDH_TAA_len41_fa0_ta20_fm6_tm14,c
2652@TOP@human_GAPDH_TAA_len41_fa0_ta20_fm6_tm14*129*c,0,408,0,0,408,0.0,129,2652@TOP@human_GAPDH_TAA_len41_fa0_ta20_fm6_tm14,c
2652@TOP@human_GAPDH_TAA_len41_fa0_ta20_fm6_tm14*130*c,0,418,0,0,418,0.0,130,2652@TOP@human_GAPDH_TAA_len41_fa0_ta20_fm6_tm14,c
2652@TOP@human_GAPDH_TAA_len41_fa0_ta20_fm6_tm14*131*c,0,418,0,0,418,0.0,131,2652@TOP@human_GAPDH_TAA_len41_fa0_ta20_fm6_tm14,c
2652@TOP@human_GAPDH_TAA_len41_fa0_ta20_fm6_tm14*132*t,0,0,0,409,409,0.0,132,2652@TOP@human_GAPDH_TAA_len41_fa0_ta20_fm6_tm14,t
2652@TOP@human_GAPDH_TAA_len41_fa0_ta20_fm6_tm14*133*g,0,0,407,0,407,1.0,133,2652@TOP@human_GAPDH_TAA_len41_fa0_ta20_fm6_tm14,g
2652@TOP@human_GAPDH_TAA_len41_fa0_ta20_fm6_tm14*134*g,0,0,407,0,407,1.0,134,2652@TOP@human_GAPDH_TAA_len41_fa0_ta20_fm6_tm14,g
2653@TOP@human_GAPDH_TAA_len41_fa0_ta20_fm6_tm14*114*t,0,0,0,1021,1021,0.0,114,2653@TOP@human_GAPDH_TAA_len41_fa0_ta20_fm6_tm14,t
2653@TOP@human_GAPDH_TAA_len41_fa0_ta20_fm6_tm14*115*c,0,1024,0,0,1024,0.0,115,2653@TOP@human_GAPDH_TAA_len41_fa0_ta20_fm6_tm14,c
2653@TOP@human_GAPDH_TAA_len41_fa0_ta20_fm6_tm14*116*c,0,1022,0,0,1022,0.0,116,2653@TOP@human_GAPDH_TAA_len41_fa0_ta20_fm6_tm14,c
2653@TOP@human_GAPDH_TAA_len41_fa0_ta20_fm6_tm14*117*a,1014,0,6,0,1020,0.006,117,2653@TOP@human_GAPDH_TAA_len41_fa0_ta20_fm6_tm14,a
2653@TOP@human_GAPDH_TAA_len41_fa0_ta20_fm6_tm14*118*a,952,0,64,0,1016,0.063,118,2653@TOP@human_GAPDH_TAA_len41_fa0_ta20_fm6_tm14,a
2653@TOP@human_GAPDH_TAA_len41_fa0_ta20_fm6_tm14*119*g,0,0,1011,0,1011,1.0,119,2653@TOP@human_GAPDH_TAA_len41_fa0_ta20_fm6_tm14,g
2653@TOP@human_GAPDH_TAA_len41_fa0_ta20_fm6_tm14*120*g,0,0,1009,0,1009,1.0,120,2653@TOP@human_GAPDH_TAA_len41_fa0_ta20_fm6_tm14,g
2653@TOP@human_GAPDH_TAA_len41_fa0_ta20_fm6_tm14*121*a,1021,0,3,0,1024,0.003,121,2653@TOP@human_GAPDH_TAA_len41_fa0_ta20_fm6_tm14,a
2653@TOP@human_GAPDH_TAA_len41_fa0_ta20_fm6_tm14*122*g,0,0,1020,0,1020,1.0,122,2653@TOP@human_GAPDH_TAA_len41_fa0_ta20_fm6_tm14,g
2653@TOP@human_GAPDH_TAA_len41_fa0_ta20_fm6_tm14*123*t,0,0,2,1000,1002,0.002,123,2653@TOP@human_GAPDH_TAA_len41_fa0_ta20_fm6_tm14,t
2653@TOP@human_GAPDH_TAA_len41_fa0_ta20_fm6_tm14*124*a,660,0,348,0,1008,0.345,124,2653@TOP@human_GAPDH_TAA_len41_fa0_ta20_fm6_tm14,a
2653@TOP@human_GAPDH_TAA_len41_fa0_ta20_fm6_tm14*125*a,761,0,242,0,1003,0.241,125,2653@TOP@human_GAPDH_TAA_len41_fa0_ta20_fm6_tm14,a
2653@TOP@human_GAPDH_TAA_len41_fa0_ta20_fm6_tm14*126*g,0,0,1007,0,1007,1.0,126,2653@TOP@human_GAPDH_TAA_len41_fa0_ta20_fm6_tm14,g
2653@TOP@human_GAPDH_TAA_len41_fa0_ta20_fm6_tm14*127*a,1016,0,2,0,1018,0.002,127,2653@TOP@human_GAPDH_TAA_len41_fa0_ta20_fm6_tm14,a
2653@TOP@human_GAPDH_TAA_len41_fa0_ta20_fm6_tm14*128*c,0,1021,0,0,1021,0.0,128,2653@TOP@human_GAPDH_TAA_len41_fa0_ta20_fm6_tm14,c
2653@TOP@human_GAPDH_TAA_len41_fa0_ta20_fm6_tm14*129*c,0,1013,0,0,1013,0.0,129,2653@TOP@human_GAPDH_TAA_len41_fa0_ta20_fm6_tm14,c
2653@TOP@human_GAPDH_TAA_len41_fa0_ta20_fm6_tm14*130*c,0,1020,0,0,1020,0.0,130,2653@TOP@human_GAPDH_TAA_len41_fa0_ta20_fm6_tm14,c
2653@TOP@human_GAPDH_TAA_len41_fa0_ta20_fm6_tm14*131*c,0,1024,0,0,1024,0.0,131,2653@TOP@human_GAPDH_TAA_len41_fa0_ta20_fm6_tm14,c
2653@TOP@human_GAPDH_TAA_len41_fa0_ta20_fm6_tm14*132*t,0,0,0,1012,1012,0.0,132,2653@TOP@human_GAPDH_TAA_len41_fa0_ta20_fm6_tm14,t
2653@TOP@human_GAPDH_TAA_len41_fa0_ta20_fm6_tm14*133*g,0,0,1004,0,1004,1.0,133,2653@TOP@human_GAPDH_TAA_len41_fa0_ta20_fm6_tm14,g
2653@TOP@human_GAPDH_TAA_len41_fa0_ta20_fm6_tm14*134*g,0,0,1017,0,1017,1.0,134,2653@TOP@human_GAPDH_TAA_len41_fa0_ta20_fm6_tm14,g
2654@TOP@human_GAPDH_TAA_len41_fa0_ta20_fm6_tm14*114*t,0,0,0,641,641,0.0,114,2654@TOP@human_GAPDH_TAA_len41_fa0_ta20_fm6_tm14,t
2654@TOP@human_GAPDH_TAA_len41_fa0_ta20_fm6_tm14*115*c,0,645,0,1,646,0.0,115,2654@TOP@human_GAPDH_TAA_len41_fa0_ta20_fm6_tm14,c
2654@TOP@human_GAPDH_TAA_len41_fa0_ta20_fm6_tm14*116*c,0,641,0,0,641,0.0,116,2654@TOP@human_GAPDH_TAA_len41_fa0_ta20_fm6_tm14,c
2654@TOP@human_GAPDH_TAA_len41_fa0_ta20_fm6_tm14*117*a,635,0,5,0,640,0.008,117,2654@TOP@human_GAPDH_TAA_len41_fa0_ta20_fm6_tm14,a
2654@TOP@human_GAPDH_TAA_len41_fa0_ta20_fm6_tm14*118*a,622,0,16,0,638,0.025,118,2654@TOP@human_GAPDH_TAA_len41_fa0_ta20_fm6_tm14,a
2654@TOP@human_GAPDH_TAA_len41_fa0_ta20_fm6_tm14*119*g,0,0,634,0,634,1.0,119,2654@TOP@human_GAPDH_TAA_len41_fa0_ta20_fm6_tm14,g
2654@TOP@human_GAPDH_TAA_len41_fa0_ta20_fm6_tm14*120*g,0,1,628,0,629,0.998,120,2654@TOP@human_GAPDH_TAA_len41_fa0_ta20_fm6_tm14,g
2654@TOP@human_GAPDH_TAA_len41_fa0_ta20_fm6_tm14*121*a,634,0,0,0,634,0.0,121,2654@TOP@human_GAPDH_TAA_len41_fa0_ta20_fm6_tm14,a
2654@TOP@human_GAPDH_TAA_len41_fa0_ta20_fm6_tm14*122*g,0,0,642,0,642,1.0,122,2654@TOP@human_GAPDH_TAA_len41_fa0_ta20_fm6_tm14,g
2654@TOP@human_GAPDH_TAA_len41_fa0_ta20_fm6_tm14*123*t,0,0,0,632,632,0.0,123,2654@TOP@human_GAPDH_TAA_len41_fa0_ta20_fm6_tm14,t
2654@TOP@human_GAPDH_TAA_len41_fa0_ta20_fm6_tm14*124*a,537,0,92,0,629,0.146,124,2654@TOP@human_GAPDH_TAA_len41_fa0_ta20_fm6_tm14,a
2654@TOP@human_GAPDH_TAA_len41_fa0_ta20_fm6_tm14*125*a,572,0,61,0,633,0.096,125,2654@TOP@human_GAPDH_TAA_len41_fa0_ta20_fm6_tm14,a
2654@TOP@human_GAPDH_TAA_len41_fa0_ta20_fm6_tm14*126*g,0,0,621,0,621,1.0,126,2654@TOP@human_GAPDH_TAA_len41_fa0_ta20_fm6_tm14,g
2654@TOP@human_GAPDH_TAA_len41_fa0_ta20_fm6_tm14*127*a,640,0,1,0,641,0.002,127,2654@TOP@human_GAPDH_TAA_len41_fa0_ta20_fm6_tm14,a
2654@TOP@human_GAPDH_TAA_len41_fa0_ta20_fm6_tm14*128*c,0,642,0,0,642,0.0,128,2654@TOP@human_GAPDH_TAA_len41_fa0_ta20_fm6_tm14,c
2654@TOP@human_GAPDH_TAA_len41_fa0_ta20_fm6_tm14*129*c,0,629,0,0,629,0.0,129,2654@TOP@human_GAPDH_TAA_len41_fa0_ta20_fm6_tm14,c
2654@TOP@human_GAPDH_TAA_len41_fa0_ta20_fm6_tm14*130*c,0,638,0,0,638,0.0,130,2654@TOP@human_GAPDH_TAA_len41_fa0_ta20_fm6_tm14,c
2654@TOP@human_GAPDH_TAA_len41_fa0_ta20_fm6_tm14*131*c,0,639,0,0,639,0.0,131,2654@TOP@human_GAPDH_TAA_len41_fa0_ta20_fm6_tm14,c
2654@TOP@human_GAPDH_TAA_len41_fa0_ta20_fm6_tm14*132*t,0,0,0,634,634,0.0,132,2654@TOP@human_GAPDH_TAA_len41_fa0_ta20_fm6_tm14,t
2654@TOP@human_GAPDH_TAA_len41_fa0_ta20_fm6_tm14*133*g,0,0,631,0,631,1.0,133,2654@TOP@human_GAPDH_TAA_len41_fa0_ta20_fm6_tm14,g
2654@TOP@human_GAPDH_TAA_len41_fa0_ta20_fm6_tm14*134*g,0,0,639,0,639,1.0,134,2654@TOP@human_GAPDH_TAA_len41_fa0_ta20_fm6_tm14,g
2655@TOP@human_GAPDH_TAA_len41_fa0_ta20_fm6_tm14*114*t,0,0,0,264,264,0.0,114,2655@TOP@human_GAPDH_TAA_len41_fa0_ta20_fm6_tm14,t
2655@TOP@human_GAPDH_TAA_len41_fa0_ta20_fm6_tm14*115*c,0,267,0,0,267,0.0,115,2655@TOP@human_GAPDH_TAA_len41_fa0_ta20_fm6_tm14,c
2655@TOP@human_GAPDH_TAA_len41_fa0_ta20_fm6_tm14*116*c,0,261,0,0,261,0.0,116,2655@TOP@human_GAPDH_TAA_len41_fa0_ta20_fm6_tm14,c
2655@TOP@human_GAPDH_TAA_len41_fa0_ta20_fm6_tm14*117*a,264,0,2,0,266,0.008,117,2655@TOP@human_GAPDH_TAA_len41_fa0_ta20_fm6_tm14,a
2655@TOP@human_GAPDH_TAA_len41_fa0_ta20_fm6_tm14*118*a,259,0,8,0,267,0.03,118,2655@TOP@human_GAPDH_TAA_len41_fa0_ta20_fm6_tm14,a
2655@TOP@human_GAPDH_TAA_len41_fa0_ta20_fm6_tm14*119*g,0,0,259,0,259,1.0,119,2655@TOP@human_GAPDH_TAA_len41_fa0_ta20_fm6_tm14,g
2655@TOP@human_GAPDH_TAA_len41_fa0_ta20_fm6_tm14*120*g,0,0,255,0,255,1.0,120,2655@TOP@human_GAPDH_TAA_len41_fa0_ta20_fm6_tm14,g
2655@TOP@human_GAPDH_TAA_len41_fa0_ta20_fm6_tm14*121*a,268,0,0,0,268,0.0,121,2655@TOP@human_GAPDH_TAA_len41_fa0_ta20_fm6_tm14,a
2655@TOP@human_GAPDH_TAA_len41_fa0_ta20_fm6_tm14*122*g,0,0,263,0,263,1.0,122,2655@TOP@human_GAPDH_TAA_len41_fa0_ta20_fm6_tm14,g
2655@TOP@human_GAPDH_TAA_len41_fa0_ta20_fm6_tm14*123*t,0,0,0,258,258,0.0,123,2655@TOP@human_GAPDH_TAA_len41_fa0_ta20_fm6_tm14,t
2655@TOP@human_GAPDH_TAA_len41_fa0_ta20_fm6_tm14*124*a,205,0,46,0,251,0.183,124,2655@TOP@human_GAPDH_TAA_len41_fa0_ta20_fm6_tm14,a
2655@TOP@human_GAPDH_TAA_len41_fa0_ta20_fm6_tm14*125*a,235,0,25,0,260,0.096,125,2655@TOP@human_GAPDH_TAA_len41_fa0_ta20_fm6_tm14,a
2655@TOP@human_GAPDH_TAA_len41_fa0_ta20_fm6_tm14*126*g,0,0,264,0,264,1.0,126,2655@TOP@human_GAPDH_TAA_len41_fa0_ta20_fm6_tm14,g
2655@TOP@human_GAPDH_TAA_len41_fa0_ta20_fm6_tm14*127*a,264,0,0,0,264,0.0,127,2655@TOP@human_GAPDH_TAA_len41_fa0_ta20_fm6_tm14,a
2655@TOP@human_GAPDH_TAA_len41_fa0_ta20_fm6_tm14*128*c,0,266,0,0,266,0.0,128,2655@TOP@human_GAPDH_TAA_len41_fa0_ta20_fm6_tm14,c
2655@TOP@human_GAPDH_TAA_len41_fa0_ta20_fm6_tm14*129*c,0,261,0,0,261,0.0,129,2655@TOP@human_GAPDH_TAA_len41_fa0_ta20_fm6_tm14,c
2655@TOP@human_GAPDH_TAA_len41_fa0_ta20_fm6_tm14*130*c,0,264,0,0,264,0.0,130,2655@TOP@human_GAPDH_TAA_len41_fa0_ta20_fm6_tm14,c
2655@TOP@human_GAPDH_TAA_len41_fa0_ta20_fm6_tm14*131*c,0,265,0,0,265,0.0,131,2655@TOP@human_GAPDH_TAA_len41_fa0_ta20_fm6_tm14,c
2655@TOP@human_GAPDH_TAA_len41_fa0_ta20_fm6_tm14*132*t,0,0,0,263,263,0.0,132,2655@TOP@human_GAPDH_TAA_len41_fa0_ta20_fm6_tm14,t
2655@TOP@human_GAPDH_TAA_len41_fa0_ta20_fm6_tm14*133*g,1,0,261,0,262,0.996,133,2655@TOP@human_GAPDH_TAA_len41_fa0_ta20_fm6_tm14,g
2655@TOP@human_GAPDH_TAA_len41_fa0_ta20_fm6_tm14*134*g,0,0,261,0,261,1.0,134,2655@TOP@human_GAPDH_TAA_len41_fa0_ta20_fm6_tm14,g
2656@TOP@human_GAPDH_TAA_len41_fa0_ta20_fm6_tm14*114*t,0,8,0,19317,19325,0.0,114,2656@TOP@human_GAPDH_TAA_len41_fa0_ta20_fm6_tm14,t
2656@TOP@human_GAPDH_TAA_len41_fa0_ta20_fm6_tm14*115*c,0,19417,0,1,19418,0.0,115,2656@TOP@human_GAPDH_TAA_len41_fa0_ta20_fm6_tm14,c
2656@TOP@human_GAPDH_TAA_len41_fa0_ta20_fm6_tm14*116*c,0,19330,0,3,19333,0.0,116,2656@TOP@human_GAPDH_TAA_len41_fa0_ta20_fm6_tm14,c
2656@TOP@human_GAPDH_TAA_len41_fa0_ta20_fm6_tm14*117*a,19311,0,17,2,19330,0.001,117,2656@TOP@human_GAPDH_TAA_len41_fa0_ta20_fm6_tm14,a
2656@TOP@human_GAPDH_TAA_len41_fa0_ta20_fm6_tm14*118*a,19043,0,217,0,19260,0.011,118,2656@TOP@human_GAPDH_TAA_len41_fa0_ta20_fm6_tm14,a
2656@TOP@human_GAPDH_TAA_len41_fa0_ta20_fm6_tm14*119*g,6,0,19231,0,19237,1.0,119,2656@TOP@human_GAPDH_TAA_len41_fa0_ta20_fm6_tm14,g
2656@TOP@human_GAPDH_TAA_len41_fa0_ta20_fm6_tm14*120*g,0,0,19125,2,19127,1.0,120,2656@TOP@human_GAPDH_TAA_len41_fa0_ta20_fm6_tm14,g
2656@TOP@human_GAPDH_TAA_len41_fa0_ta20_fm6_tm14*121*a,19319,0,14,1,19334,0.001,121,2656@TOP@human_GAPDH_TAA_len41_fa0_ta20_fm6_tm14,a
2656@TOP@human_GAPDH_TAA_len41_fa0_ta20_fm6_tm14*122*g,0,0,19335,0,19335,1.0,122,2656@TOP@human_GAPDH_TAA_len41_fa0_ta20_fm6_tm14,g
2656@TOP@human_GAPDH_TAA_len41_fa0_ta20_fm6_tm14*123*t,1,6,3,19107,19117,0.0,123,2656@TOP@human_GAPDH_TAA_len41_fa0_ta20_fm6_tm14,t
2656@TOP@human_GAPDH_TAA_len41_fa0_ta20_fm6_tm14*124*a,10626,0,8509,1,19136,0.445,124,2656@TOP@human_GAPDH_TAA_len41_fa0_ta20_fm6_tm14,a
2656@TOP@human_GAPDH_TAA_len41_fa0_ta20_fm6_tm14*125*a,16480,1,2674,2,19157,0.14,125,2656@TOP@human_GAPDH_TAA_len41_fa0_ta20_fm6_tm14,a
2656@TOP@human_GAPDH_TAA_len41_fa0_ta20_fm6_tm14*126*g,3,0,19166,0,19169,1.0,126,2656@TOP@human_GAPDH_TAA_len41_fa0_ta20_fm6_tm14,g
2656@TOP@human_GAPDH_TAA_len41_fa0_ta20_fm6_tm14*127*a,19289,0,11,0,19300,0.001,127,2656@TOP@human_GAPDH_TAA_len41_fa0_ta20_fm6_tm14,a
2656@TOP@human_GAPDH_TAA_len41_fa0_ta20_fm6_tm14*128*c,0,19382,1,1,19384,0.0,128,2656@TOP@human_GAPDH_TAA_len41_fa0_ta20_fm6_tm14,c
2656@TOP@human_GAPDH_TAA_len41_fa0_ta20_fm6_tm14*129*c,0,19242,0,1,19243,0.0,129,2656@TOP@human_GAPDH_TAA_len41_fa0_ta20_fm6_tm14,c
2656@TOP@human_GAPDH_TAA_len41_fa0_ta20_fm6_tm14*130*c,3,19352,0,1,19356,0.0,130,2656@TOP@human_GAPDH_TAA_len41_fa0_ta20_fm6_tm14,c
2656@TOP@human_GAPDH_TAA_len41_fa0_ta20_fm6_tm14*131*c,1,19396,0,0,19397,0.0,131,2656@TOP@human_GAPDH_TAA_len41_fa0_ta20_fm6_tm14,c
2656@TOP@human_GAPDH_TAA_len41_fa0_ta20_fm6_tm14*132*t,2,5,1,19158,19166,0.0,132,2656@TOP@human_GAPDH_TAA_len41_fa0_ta20_fm6_tm14,t
2656@TOP@human_GAPDH_TAA_len41_fa0_ta20_fm6_tm14*133*g,1,1,19121,1,19124,1.0,133,2656@TOP@human_GAPDH_TAA_len41_fa0_ta20_fm6_tm14,g
2656@TOP@human_GAPDH_TAA_len41_fa0_ta20_fm6_tm14*134*g,2,2,19199,1,19204,1.0,134,2656@TOP@human_GAPDH_TAA_len41_fa0_ta20_fm6_tm14,g
2657@TOP@human_GAPDH_TAA_len41_fa0_ta20_fm6_tm14*114*t,0,0,0,583,583,0.0,114,2657@TOP@human_GAPDH_TAA_len41_fa0_ta20_fm6_tm14,t
2657@TOP@human_GAPDH_TAA_len41_fa0_ta20_fm6_tm14*115*c,0,588,0,0,588,0.0,115,2657@TOP@human_GAPDH_TAA_len41_fa0_ta20_fm6_tm14,c
2657@TOP@human_GAPDH_TAA_len41_fa0_ta20_fm6_tm14*116*c,0,583,0,0,583,0.0,116,2657@TOP@human_GAPDH_TAA_len41_fa0_ta20_fm6_tm14,c
2657@TOP@human_GAPDH_TAA_len41_fa0_ta20_fm6_tm14*117*a,584,0,1,0,585,0.002,117,2657@TOP@human_GAPDH_TAA_len41_fa0_ta20_fm6_tm14,a
2657@TOP@human_GAPDH_TAA_len41_fa0_ta20_fm6_tm14*118*a,568,0,15,0,583,0.026,118,2657@TOP@human_GAPDH_TAA_len41_fa0_ta20_fm6_tm14,a
2657@TOP@human_GAPDH_TAA_len41_fa0_ta20_fm6_tm14*119*g,0,0,580,0,580,1.0,119,2657@TOP@human_GAPDH_TAA_len41_fa0_ta20_fm6_tm14,g
2657@TOP@human_GAPDH_TAA_len41_fa0_ta20_fm6_tm14*120*g,0,0,572,0,572,1.0,120,2657@TOP@human_GAPDH_TAA_len41_fa0_ta20_fm6_tm14,g
2657@TOP@human_GAPDH_TAA_len41_fa0_ta20_fm6_tm14*121*a,583,0,1,0,584,0.002,121,2657@TOP@human_GAPDH_TAA_len41_fa0_ta20_fm6_tm14,a
2657@TOP@human_GAPDH_TAA_len41_fa0_ta20_fm6_tm14*122*g,0,0,585,0,585,1.0,122,2657@TOP@human_GAPDH_TAA_len41_fa0_ta20_fm6_tm14,g
2657@TOP@human_GAPDH_TAA_len41_fa0_ta20_fm6_tm14*123*t,0,0,0,569,569,0.0,123,2657@TOP@human_GAPDH_TAA_len41_fa0_ta20_fm6_tm14,t
2657@TOP@human_GAPDH_TAA_len41_fa0_ta20_fm6_tm14*124*a,434,0,140,0,574,0.244,124,2657@TOP@human_GAPDH_TAA_len41_fa0_ta20_fm6_tm14,a
2657@TOP@human_GAPDH_TAA_len41_fa0_ta20_fm6_tm14*125*a,486,0,92,0,578,0.159,125,2657@TOP@human_GAPDH_TAA_len41_fa0_ta20_fm6_tm14,a
2657@TOP@human_GAPDH_TAA_len41_fa0_ta20_fm6_tm14*126*g,0,0,579,0,579,1.0,126,2657@TOP@human_GAPDH_TAA_len41_fa0_ta20_fm6_tm14,g
2657@TOP@human_GAPDH_TAA_len41_fa0_ta20_fm6_tm14*127*a,574,0,8,0,582,0.014,127,2657@TOP@human_GAPDH_TAA_len41_fa0_ta20_fm6_tm14,a
2657@TOP@human_GAPDH_TAA_len41_fa0_ta20_fm6_tm14*128*c,0,586,0,0,586,0.0,128,2657@TOP@human_GAPDH_TAA_len41_fa0_ta20_fm6_tm14,c
2657@TOP@human_GAPDH_TAA_len41_fa0_ta20_fm6_tm14*129*c,0,585,0,0,585,0.0,129,2657@TOP@human_GAPDH_TAA_len41_fa0_ta20_fm6_tm14,c
2657@TOP@human_GAPDH_TAA_len41_fa0_ta20_fm6_tm14*130*c,0,584,0,0,584,0.0,130,2657@TOP@human_GAPDH_TAA_len41_fa0_ta20_fm6_tm14,c
2657@TOP@human_GAPDH_TAA_len41_fa0_ta20_fm6_tm14*131*c,0,586,0,0,586,0.0,131,2657@TOP@human_GAPDH_TAA_len41_fa0_ta20_fm6_tm14,c
2657@TOP@human_GAPDH_TAA_len41_fa0_ta20_fm6_tm14*132*t,1,0,0,578,579,0.0,132,2657@TOP@human_GAPDH_TAA_len41_fa0_ta20_fm6_tm14,t
2657@TOP@human_GAPDH_TAA_len41_fa0_ta20_fm6_tm14*133*g,0,0,572,0,572,1.0,133,2657@TOP@human_GAPDH_TAA_len41_fa0_ta20_fm6_tm14,g
2657@TOP@human_GAPDH_TAA_len41_fa0_ta20_fm6_tm14*134*g,0,0,581,0,581,1.0,134,2657@TOP@human_GAPDH_TAA_len41_fa0_ta20_fm6_tm14,g
2658@TOP@human_GAPDH_TAA_len41_fa0_ta20_fm6_tm14*114*t,0,0,0,908,908,0.0,114,2658@TOP@human_GAPDH_TAA_len41_fa0_ta20_fm6_tm14,t
2658@TOP@human_GAPDH_TAA_len41_fa0_ta20_fm6_tm14*115*c,0,917,0,0,917,0.0,115,2658@TOP@human_GAPDH_TAA_len41_fa0_ta20_fm6_tm14,c
2658@TOP@human_GAPDH_TAA_len41_fa0_ta20_fm6_tm14*116*c,0,914,0,0,914,0.0,116,2658@TOP@human_GAPDH_TAA_len41_fa0_ta20_fm6_tm14,c
2658@TOP@human_GAPDH_TAA_len41_fa0_ta20_fm6_tm14*117*a,903,0,11,0,914,0.012,117,2658@TOP@human_GAPDH_TAA_len41_fa0_ta20_fm6_tm14,a
2658@TOP@human_GAPDH_TAA_len41_fa0_ta20_fm6_tm14*118*a,869,0,34,0,903,0.038,118,2658@TOP@human_GAPDH_TAA_len41_fa0_ta20_fm6_tm14,a
2658@TOP@human_GAPDH_TAA_len41_fa0_ta20_fm6_tm14*119*g,0,0,906,0,906,1.0,119,2658@TOP@human_GAPDH_TAA_len41_fa0_ta20_fm6_tm14,g
2658@TOP@human_GAPDH_TAA_len41_fa0_ta20_fm6_tm14*120*g,0,0,897,0,897,1.0,120,2658@TOP@human_GAPDH_TAA_len41_fa0_ta20_fm6_tm14,g
2658@TOP@human_GAPDH_TAA_len41_fa0_ta20_fm6_tm14*121*a,912,0,0,0,912,0.0,121,2658@TOP@human_GAPDH_TAA_len41_fa0_ta20_fm6_tm14,a
2658@TOP@human_GAPDH_TAA_len41_fa0_ta20_fm6_tm14*122*g,0,0,913,0,913,1.0,122,2658@TOP@human_GAPDH_TAA_len41_fa0_ta20_fm6_tm14,g
2658@TOP@human_GAPDH_TAA_len41_fa0_ta20_fm6_tm14*123*t,0,0,0,892,892,0.0,123,2658@TOP@human_GAPDH_TAA_len41_fa0_ta20_fm6_tm14,t
2658@TOP@human_GAPDH_TAA_len41_fa0_ta20_fm6_tm14*124*a,710,0,190,0,900,0.211,124,2658@TOP@human_GAPDH_TAA_len41_fa0_ta20_fm6_tm14,a
2658@TOP@human_GAPDH_TAA_len41_fa0_ta20_fm6_tm14*125*a,776,0,125,1,902,0.139,125,2658@TOP@human_GAPDH_TAA_len41_fa0_ta20_fm6_tm14,a
2658@TOP@human_GAPDH_TAA_len41_fa0_ta20_fm6_tm14*126*g,0,0,902,0,902,1.0,126,2658@TOP@human_GAPDH_TAA_len41_fa0_ta20_fm6_tm14,g
2658@TOP@human_GAPDH_TAA_len41_fa0_ta20_fm6_tm14*127*a,908,0,6,0,914,0.007,127,2658@TOP@human_GAPDH_TAA_len41_fa0_ta20_fm6_tm14,a
2658@TOP@human_GAPDH_TAA_len41_fa0_ta20_fm6_tm14*128*c,0,916,0,0,916,0.0,128,2658@TOP@human_GAPDH_TAA_len41_fa0_ta20_fm6_tm14,c
2658@TOP@human_GAPDH_TAA_len41_fa0_ta20_fm6_tm14*129*c,0,908,1,0,909,0.001,129,2658@TOP@human_GAPDH_TAA_len41_fa0_ta20_fm6_tm14,c
2658@TOP@human_GAPDH_TAA_len41_fa0_ta20_fm6_tm14*130*c,0,913,0,0,913,0.0,130,2658@TOP@human_GAPDH_TAA_len41_fa0_ta20_fm6_tm14,c
2658@TOP@human_GAPDH_TAA_len41_fa0_ta20_fm6_tm14*131*c,0,912,0,0,912,0.0,131,2658@TOP@human_GAPDH_TAA_len41_fa0_ta20_fm6_tm14,c
2658@TOP@human_GAPDH_TAA_len41_fa0_ta20_fm6_tm14*132*t,0,0,0,904,904,0.0,132,2658@TOP@human_GAPDH_TAA_len41_fa0_ta20_fm6_tm14,t
2658@TOP@human_GAPDH_TAA_len41_fa0_ta20_fm6_tm14*133*g,0,0,897,0,897,1.0,133,2658@TOP@human_GAPDH_TAA_len41_fa0_ta20_fm6_tm14,g
2658@TOP@human_GAPDH_TAA_len41_fa0_ta20_fm6_tm14*134*g,0,1,905,0,906,0.999,134,2658@TOP@human_GAPDH_TAA_len41_fa0_ta20_fm6_tm14,g
2659@TOP@human_GAPDH_TAA_len41_fa0_ta20_fm6_tm14*114*t,0,0,0,917,917,0.0,114,2659@TOP@human_GAPDH_TAA_len41_fa0_ta20_fm6_tm14,t
2659@TOP@human_GAPDH_TAA_len41_fa0_ta20_fm6_tm14*115*c,0,928,0,0,928,0.0,115,2659@TOP@human_GAPDH_TAA_len41_fa0_ta20_fm6_tm14,c
2659@TOP@human_GAPDH_TAA_len41_fa0_ta20_fm6_tm14*116*c,0,926,0,0,926,0.0,116,2659@TOP@human_GAPDH_TAA_len41_fa0_ta20_fm6_tm14,c
2659@TOP@human_GAPDH_TAA_len41_fa0_ta20_fm6_tm14*117*a,920,0,2,0,922,0.002,117,2659@TOP@human_GAPDH_TAA_len41_fa0_ta20_fm6_tm14,a
2659@TOP@human_GAPDH_TAA_len41_fa0_ta20_fm6_tm14*118*a,897,0,13,0,910,0.014,118,2659@TOP@human_GAPDH_TAA_len41_fa0_ta20_fm6_tm14,a
2659@TOP@human_GAPDH_TAA_len41_fa0_ta20_fm6_tm14*119*g,0,0,909,0,909,1.0,119,2659@TOP@human_GAPDH_TAA_len41_fa0_ta20_fm6_tm14,g
2659@TOP@human_GAPDH_TAA_len41_fa0_ta20_fm6_tm14*120*g,0,0,908,0,908,1.0,120,2659@TOP@human_GAPDH_TAA_len41_fa0_ta20_fm6_tm14,g
2659@TOP@human_GAPDH_TAA_len41_fa0_ta20_fm6_tm14*121*a,921,0,0,0,921,0.0,121,2659@TOP@human_GAPDH_TAA_len41_fa0_ta20_fm6_tm14,a
2659@TOP@human_GAPDH_TAA_len41_fa0_ta20_fm6_tm14*122*g,0,0,924,0,924,1.0,122,2659@TOP@human_GAPDH_TAA_len41_fa0_ta20_fm6_tm14,g
2659@TOP@human_GAPDH_TAA_len41_fa0_ta20_fm6_tm14*123*t,0,0,0,899,899,0.0,123,2659@TOP@human_GAPDH_TAA_len41_fa0_ta20_fm6_tm14,t
2659@TOP@human_GAPDH_TAA_len41_fa0_ta20_fm6_tm14*124*a,588,0,318,0,906,0.351,124,2659@TOP@human_GAPDH_TAA_len41_fa0_ta20_fm6_tm14,a
2659@TOP@human_GAPDH_TAA_len41_fa0_ta20_fm6_tm14*125*a,733,0,174,0,907,0.192,125,2659@TOP@human_GAPDH_TAA_len41_fa0_ta20_fm6_tm14,a
2659@TOP@human_GAPDH_TAA_len41_fa0_ta20_fm6_tm14*126*g,0,0,909,0,909,1.0,126,2659@TOP@human_GAPDH_TAA_len41_fa0_ta20_fm6_tm14,g
2659@TOP@human_GAPDH_TAA_len41_fa0_ta20_fm6_tm14*127*a,903,0,18,0,921,0.02,127,2659@TOP@human_GAPDH_TAA_len41_fa0_ta20_fm6_tm14,a
2659@TOP@human_GAPDH_TAA_len41_fa0_ta20_fm6_tm14*128*c,0,927,0,0,927,0.0,128,2659@TOP@human_GAPDH_TAA_len41_fa0_ta20_fm6_tm14,c
2659@TOP@human_GAPDH_TAA_len41_fa0_ta20_fm6_tm14*129*c,0,909,0,0,909,0.0,129,2659@TOP@human_GAPDH_TAA_len41_fa0_ta20_fm6_tm14,c
2659@TOP@human_GAPDH_TAA_len41_fa0_ta20_fm6_tm14*130*c,0,923,0,2,925,0.0,130,2659@TOP@human_GAPDH_TAA_len41_fa0_ta20_fm6_tm14,c
2659@TOP@human_GAPDH_TAA_len41_fa0_ta20_fm6_tm14*131*c,1,922,0,0,923,0.0,131,2659@TOP@human_GAPDH_TAA_len41_fa0_ta20_fm6_tm14,c
2659@TOP@human_GAPDH_TAA_len41_fa0_ta20_fm6_tm14*132*t,0,2,0,902,904,0.0,132,2659@TOP@human_GAPDH_TAA_len41_fa0_ta20_fm6_tm14,t
2659@TOP@human_GAPDH_TAA_len41_fa0_ta20_fm6_tm14*133*g,0,0,900,0,900,1.0,133,2659@TOP@human_GAPDH_TAA_len41_fa0_ta20_fm6_tm14,g
2659@TOP@human_GAPDH_TAA_len41_fa0_ta20_fm6_tm14*134*g,0,0,915,1,916,0.999,134,2659@TOP@human_GAPDH_TAA_len41_fa0_ta20_fm6_tm14,g
2660@TOP@human_GAPDH_TAA_len41_fa0_ta20_fm6_tm14*114*t,2,2,0,9912,9916,0.0,114,2660@TOP@human_GAPDH_TAA_len41_fa0_ta20_fm6_tm14,t
2660@TOP@human_GAPDH_TAA_len41_fa0_ta20_fm6_tm14*115*c,1,9969,0,2,9972,0.0,115,2660@TOP@human_GAPDH_TAA_len41_fa0_ta20_fm6_tm14,c
2660@TOP@human_GAPDH_TAA_len41_fa0_ta20_fm6_tm14*116*c,0,9932,0,0,9932,0.0,116,2660@TOP@human_GAPDH_TAA_len41_fa0_ta20_fm6_tm14,c
2660@TOP@human_GAPDH_TAA_len41_fa0_ta20_fm6_tm14*117*a,9909,0,9,0,9918,0.001,117,2660@TOP@human_GAPDH_TAA_len41_fa0_ta20_fm6_tm14,a
2660@TOP@human_GAPDH_TAA_len41_fa0_ta20_fm6_tm14*118*a,9748,0,140,0,9888,0.014,118,2660@TOP@human_GAPDH_TAA_len41_fa0_ta20_fm6_tm14,a
2660@TOP@human_GAPDH_TAA_len41_fa0_ta20_fm6_tm14*119*g,0,0,9856,0,9856,1.0,119,2660@TOP@human_GAPDH_TAA_len41_fa0_ta20_fm6_tm14,g
2660@TOP@human_GAPDH_TAA_len41_fa0_ta20_fm6_tm14*120*g,0,0,9837,0,9837,1.0,120,2660@TOP@human_GAPDH_TAA_len41_fa0_ta20_fm6_tm14,g
2660@TOP@human_GAPDH_TAA_len41_fa0_ta20_fm6_tm14*121*a,9910,0,6,1,9917,0.001,121,2660@TOP@human_GAPDH_TAA_len41_fa0_ta20_fm6_tm14,a
2660@TOP@human_GAPDH_TAA_len41_fa0_ta20_fm6_tm14*122*g,0,0,9936,0,9936,1.0,122,2660@TOP@human_GAPDH_TAA_len41_fa0_ta20_fm6_tm14,g
2660@TOP@human_GAPDH_TAA_len41_fa0_ta20_fm6_tm14*123*t,3,3,0,9770,9776,0.0,123,2660@TOP@human_GAPDH_TAA_len41_fa0_ta20_fm6_tm14,t
2660@TOP@human_GAPDH_TAA_len41_fa0_ta20_fm6_tm14*124*a,8573,0,1196,0,9769,0.122,124,2660@TOP@human_GAPDH_TAA_len41_fa0_ta20_fm6_tm14,a
2660@TOP@human_GAPDH_TAA_len41_fa0_ta20_fm6_tm14*125*a,8999,0,743,0,9742,0.076,125,2660@TOP@human_GAPDH_TAA_len41_fa0_ta20_fm6_tm14,a
2660@TOP@human_GAPDH_TAA_len41_fa0_ta20_fm6_tm14*126*g,2,0,9817,0,9819,1.0,126,2660@TOP@human_GAPDH_TAA_len41_fa0_ta20_fm6_tm14,g
2660@TOP@human_GAPDH_TAA_len41_fa0_ta20_fm6_tm14*127*a,9839,0,54,0,9893,0.005,127,2660@TOP@human_GAPDH_TAA_len41_fa0_ta20_fm6_tm14,a
2660@TOP@human_GAPDH_TAA_len41_fa0_ta20_fm6_tm14*128*c,0,9953,2,0,9955,0.0,128,2660@TOP@human_GAPDH_TAA_len41_fa0_ta20_fm6_tm14,c
2660@TOP@human_GAPDH_TAA_len41_fa0_ta20_fm6_tm14*129*c,1,9884,0,0,9885,0.0,129,2660@TOP@human_GAPDH_TAA_len41_fa0_ta20_fm6_tm14,c
2660@TOP@human_GAPDH_TAA_len41_fa0_ta20_fm6_tm14*130*c,2,9924,0,2,9928,0.0,130,2660@TOP@human_GAPDH_TAA_len41_fa0_ta20_fm6_tm14,c
2660@TOP@human_GAPDH_TAA_len41_fa0_ta20_fm6_tm14*131*c,5,9943,0,0,9948,0.0,131,2660@TOP@human_GAPDH_TAA_len41_fa0_ta20_fm6_tm14,c
2660@TOP@human_GAPDH_TAA_len41_fa0_ta20_fm6_tm14*132*t,0,2,0,9807,9809,0.0,132,2660@TOP@human_GAPDH_TAA_len41_fa0_ta20_fm6_tm14,t
2660@TOP@human_GAPDH_TAA_len41_fa0_ta20_fm6_tm14*133*g,0,0,9802,0,9802,1.0,133,2660@TOP@human_GAPDH_TAA_len41_fa0_ta20_fm6_tm14,g
2660@TOP@human_GAPDH_TAA_len41_fa0_ta20_fm6_tm14*134*g,3,2,9831,0,9836,0.999,134,2660@TOP@human_GAPDH_TAA_len41_fa0_ta20_fm6_tm14,g
2661@TOP@human_GAPDH_TAA_len41_fa0_ta20_fm6_tm14*114*t,0,1,0,2456,2457,0.0,114,2661@TOP@human_GAPDH_TAA_len41_fa0_ta20_fm6_tm14,t
2661@TOP@human_GAPDH_TAA_len41_fa0_ta20_fm6_tm14*115*c,0,2475,0,0,2475,0.0,115,2661@TOP@human_GAPDH_TAA_len41_fa0_ta20_fm6_tm14,c
2661@TOP@human_GAPDH_TAA_len41_fa0_ta20_fm6_tm14*116*c,0,2461,0,0,2461,0.0,116,2661@TOP@human_GAPDH_TAA_len41_fa0_ta20_fm6_tm14,c
2661@TOP@human_GAPDH_TAA_len41_fa0_ta20_fm6_tm14*117*a,2457,0,3,0,2460,0.001,117,2661@TOP@human_GAPDH_TAA_len41_fa0_ta20_fm6_tm14,a
2661@TOP@human_GAPDH_TAA_len41_fa0_ta20_fm6_tm14*118*a,2391,1,59,0,2451,0.024,118,2661@TOP@human_GAPDH_TAA_len41_fa0_ta20_fm6_tm14,a
2661@TOP@human_GAPDH_TAA_len41_fa0_ta20_fm6_tm14*119*g,0,0,2444,0,2444,1.0,119,2661@TOP@human_GAPDH_TAA_len41_fa0_ta20_fm6_tm14,g
2661@TOP@human_GAPDH_TAA_len41_fa0_ta20_fm6_tm14*120*g,0,0,2428,0,2428,1.0,120,2661@TOP@human_GAPDH_TAA_len41_fa0_ta20_fm6_tm14,g
2661@TOP@human_GAPDH_TAA_len41_fa0_ta20_fm6_tm14*121*a,2450,0,5,0,2455,0.002,121,2661@TOP@human_GAPDH_TAA_len41_fa0_ta20_fm6_tm14,a
2661@TOP@human_GAPDH_TAA_len41_fa0_ta20_fm6_tm14*122*g,0,0,2462,0,2462,1.0,122,2661@TOP@human_GAPDH_TAA_len41_fa0_ta20_fm6_tm14,g
2661@TOP@human_GAPDH_TAA_len41_fa0_ta20_fm6_tm14*123*t,0,1,1,2435,2437,0.0,123,2661@TOP@human_GAPDH_TAA_len41_fa0_ta20_fm6_tm14,t
2661@TOP@human_GAPDH_TAA_len41_fa0_ta20_fm6_tm14*124*a,1496,0,926,0,2422,0.382,124,2661@TOP@human_GAPDH_TAA_len41_fa0_ta20_fm6_tm14,a
2661@TOP@human_GAPDH_TAA_len41_fa0_ta20_fm6_tm14*125*a,1938,0,493,0,2431,0.203,125,2661@TOP@human_GAPDH_TAA_len41_fa0_ta20_fm6_tm14,a
2661@TOP@human_GAPDH_TAA_len41_fa0_ta20_fm6_tm14*126*g,0,0,2437,1,2438,1.0,126,2661@TOP@human_GAPDH_TAA_len41_fa0_ta20_fm6_tm14,g
2661@TOP@human_GAPDH_TAA_len41_fa0_ta20_fm6_tm14*127*a,2449,0,8,0,2457,0.003,127,2661@TOP@human_GAPDH_TAA_len41_fa0_ta20_fm6_tm14,a
2661@TOP@human_GAPDH_TAA_len41_fa0_ta20_fm6_tm14*128*c,0,2469,0,0,2469,0.0,128,2661@TOP@human_GAPDH_TAA_len41_fa0_ta20_fm6_tm14,c
2661@TOP@human_GAPDH_TAA_len41_fa0_ta20_fm6_tm14*129*c,0,2454,0,0,2454,0.0,129,2661@TOP@human_GAPDH_TAA_len41_fa0_ta20_fm6_tm14,c
2661@TOP@human_GAPDH_TAA_len41_fa0_ta20_fm6_tm14*130*c,0,2466,0,0,2466,0.0,130,2661@TOP@human_GAPDH_TAA_len41_fa0_ta20_fm6_tm14,c
2661@TOP@human_GAPDH_TAA_len41_fa0_ta20_fm6_tm14*131*c,1,2470,0,0,2471,0.0,131,2661@TOP@human_GAPDH_TAA_len41_fa0_ta20_fm6_tm14,c
2661@TOP@human_GAPDH_TAA_len41_fa0_ta20_fm6_tm14*132*t,0,1,0,2436,2437,0.0,132,2661@TOP@human_GAPDH_TAA_len41_fa0_ta20_fm6_tm14,t
2661@TOP@human_GAPDH_TAA_len41_fa0_ta20_fm6_tm14*133*g,0,0,2430,1,2431,1.0,133,2661@TOP@human_GAPDH_TAA_len41_fa0_ta20_fm6_tm14,g
2661@TOP@human_GAPDH_TAA_len41_fa0_ta20_fm6_tm14*134*g,0,0,2453,0,2453,1.0,134,2661@TOP@human_GAPDH_TAA_len41_fa0_ta20_fm6_tm14,g
2662@TOP@human_GAPDH_TAA_len41_fa0_ta20_fm6_tm14*114*t,0,0,0,3977,3977,0.0,114,2662@TOP@human_GAPDH_TAA_len41_fa0_ta20_fm6_tm14,t
2662@TOP@human_GAPDH_TAA_len41_fa0_ta20_fm6_tm14*115*c,0,4003,0,1,4004,0.0,115,2662@TOP@human_GAPDH_TAA_len41_fa0_ta20_fm6_tm14,c
2662@TOP@human_GAPDH_TAA_len41_fa0_ta20_fm6_tm14*116*c,0,3981,0,0,3981,0.0,116,2662@TOP@human_GAPDH_TAA_len41_fa0_ta20_fm6_tm14,c
2662@TOP@human_GAPDH_TAA_len41_fa0_ta20_fm6_tm14*117*a,3955,0,37,0,3992,0.009,117,2662@TOP@human_GAPDH_TAA_len41_fa0_ta20_fm6_tm14,a
2662@TOP@human_GAPDH_TAA_len41_fa0_ta20_fm6_tm14*118*a,3796,0,165,0,3961,0.042,118,2662@TOP@human_GAPDH_TAA_len41_fa0_ta20_fm6_tm14,a
2662@TOP@human_GAPDH_TAA_len41_fa0_ta20_fm6_tm14*119*g,1,0,3954,0,3955,1.0,119,2662@TOP@human_GAPDH_TAA_len41_fa0_ta20_fm6_tm14,g
2662@TOP@human_GAPDH_TAA_len41_fa0_ta20_fm6_tm14*120*g,1,0,3920,0,3921,1.0,120,2662@TOP@human_GAPDH_TAA_len41_fa0_ta20_fm6_tm14,g
2662@TOP@human_GAPDH_TAA_len41_fa0_ta20_fm6_tm14*121*a,3978,0,3,0,3981,0.001,121,2662@TOP@human_GAPDH_TAA_len41_fa0_ta20_fm6_tm14,a
2662@TOP@human_GAPDH_TAA_len41_fa0_ta20_fm6_tm14*122*g,0,0,3982,0,3982,1.0,122,2662@TOP@human_GAPDH_TAA_len41_fa0_ta20_fm6_tm14,g
2662@TOP@human_GAPDH_TAA_len41_fa0_ta20_fm6_tm14*123*t,0,0,0,3942,3942,0.0,123,2662@TOP@human_GAPDH_TAA_len41_fa0_ta20_fm6_tm14,t
2662@TOP@human_GAPDH_TAA_len41_fa0_ta20_fm6_tm14*124*a,3660,0,226,0,3886,0.058,124,2662@TOP@human_GAPDH_TAA_len41_fa0_ta20_fm6_tm14,a
2662@TOP@human_GAPDH_TAA_len41_fa0_ta20_fm6_tm14*125*a,3374,0,532,1,3907,0.136,125,2662@TOP@human_GAPDH_TAA_len41_fa0_ta20_fm6_tm14,a
2662@TOP@human_GAPDH_TAA_len41_fa0_ta20_fm6_tm14*126*g,0,0,3945,0,3945,1.0,126,2662@TOP@human_GAPDH_TAA_len41_fa0_ta20_fm6_tm14,g
2662@TOP@human_GAPDH_TAA_len41_fa0_ta20_fm6_tm14*127*a,3854,0,120,0,3974,0.03,127,2662@TOP@human_GAPDH_TAA_len41_fa0_ta20_fm6_tm14,a
2662@TOP@human_GAPDH_TAA_len41_fa0_ta20_fm6_tm14*128*c,0,3999,1,0,4000,0.0,128,2662@TOP@human_GAPDH_TAA_len41_fa0_ta20_fm6_tm14,c
2662@TOP@human_GAPDH_TAA_len41_fa0_ta20_fm6_tm14*129*c,0,3960,0,0,3960,0.0,129,2662@TOP@human_GAPDH_TAA_len41_fa0_ta20_fm6_tm14,c
2662@TOP@human_GAPDH_TAA_len41_fa0_ta20_fm6_tm14*130*c,0,3981,0,0,3981,0.0,130,2662@TOP@human_GAPDH_TAA_len41_fa0_ta20_fm6_tm14,c
2662@TOP@human_GAPDH_TAA_len41_fa0_ta20_fm6_tm14*131*c,0,3998,0,0,3998,0.0,131,2662@TOP@human_GAPDH_TAA_len41_fa0_ta20_fm6_tm14,c
2662@TOP@human_GAPDH_TAA_len41_fa0_ta20_fm6_tm14*132*t,0,1,0,3921,3922,0.0,132,2662@TOP@human_GAPDH_TAA_len41_fa0_ta20_fm6_tm14,t
2662@TOP@human_GAPDH_TAA_len41_fa0_ta20_fm6_tm14*133*g,0,0,3932,0,3932,1.0,133,2662@TOP@human_GAPDH_TAA_len41_fa0_ta20_fm6_tm14,g
2662@TOP@human_GAPDH_TAA_len41_fa0_ta20_fm6_tm14*134*g,0,0,3945,0,3945,1.0,134,2662@TOP@human_GAPDH_TAA_len41_fa0_ta20_fm6_tm14,g
2663@TOP@human_GAPDH_TAA_len41_fa0_ta20_fm6_tm14*114*t,0,1,0,1246,1247,0.0,114,2663@TOP@human_GAPDH_TAA_len41_fa0_ta20_fm6_tm14,t
2663@TOP@human_GAPDH_TAA_len41_fa0_ta20_fm6_tm14*115*c,0,1262,0,0,1262,0.0,115,2663@TOP@human_GAPDH_TAA_len41_fa0_ta20_fm6_tm14,c
2663@TOP@human_GAPDH_TAA_len41_fa0_ta20_fm6_tm14*116*c,0,1252,0,0,1252,0.0,116,2663@TOP@human_GAPDH_TAA_len41_fa0_ta20_fm6_tm14,c
2663@TOP@human_GAPDH_TAA_len41_fa0_ta20_fm6_tm14*117*a,1252,0,2,0,1254,0.002,117,2663@TOP@human_GAPDH_TAA_len41_fa0_ta20_fm6_tm14,a
2663@TOP@human_GAPDH_TAA_len41_fa0_ta20_fm6_tm14*118*a,1184,0,61,0,1245,0.049,118,2663@TOP@human_GAPDH_TAA_len41_fa0_ta20_fm6_tm14,a
2663@TOP@human_GAPDH_TAA_len41_fa0_ta20_fm6_tm14*119*g,0,0,1237,0,1237,1.0,119,2663@TOP@human_GAPDH_TAA_len41_fa0_ta20_fm6_tm14,g
2663@TOP@human_GAPDH_TAA_len41_fa0_ta20_fm6_tm14*120*g,0,0,1228,0,1228,1.0,120,2663@TOP@human_GAPDH_TAA_len41_fa0_ta20_fm6_tm14,g
2663@TOP@human_GAPDH_TAA_len41_fa0_ta20_fm6_tm14*121*a,1257,0,1,0,1258,0.001,121,2663@TOP@human_GAPDH_TAA_len41_fa0_ta20_fm6_tm14,a
2663@TOP@human_GAPDH_TAA_len41_fa0_ta20_fm6_tm14*122*g,0,0,1256,0,1256,1.0,122,2663@TOP@human_GAPDH_TAA_len41_fa0_ta20_fm6_tm14,g
2663@TOP@human_GAPDH_TAA_len41_fa0_ta20_fm6_tm14*123*t,1,0,1,1228,1230,0.001,123,2663@TOP@human_GAPDH_TAA_len41_fa0_ta20_fm6_tm14,t
2663@TOP@human_GAPDH_TAA_len41_fa0_ta20_fm6_tm14*124*a,741,0,494,0,1235,0.4,124,2663@TOP@human_GAPDH_TAA_len41_fa0_ta20_fm6_tm14,a
2663@TOP@human_GAPDH_TAA_len41_fa0_ta20_fm6_tm14*125*a,931,0,297,0,1228,0.242,125,2663@TOP@human_GAPDH_TAA_len41_fa0_ta20_fm6_tm14,a
2663@TOP@human_GAPDH_TAA_len41_fa0_ta20_fm6_tm14*126*g,0,0,1239,0,1239,1.0,126,2663@TOP@human_GAPDH_TAA_len41_fa0_ta20_fm6_tm14,g
2663@TOP@human_GAPDH_TAA_len41_fa0_ta20_fm6_tm14*127*a,1248,0,1,0,1249,0.001,127,2663@TOP@human_GAPDH_TAA_len41_fa0_ta20_fm6_tm14,a
2663@TOP@human_GAPDH_TAA_len41_fa0_ta20_fm6_tm14*128*c,0,1259,0,0,1259,0.0,128,2663@TOP@human_GAPDH_TAA_len41_fa0_ta20_fm6_tm14,c
2663@TOP@human_GAPDH_TAA_len41_fa0_ta20_fm6_tm14*129*c,2,1241,0,0,1243,0.0,129,2663@TOP@human_GAPDH_TAA_len41_fa0_ta20_fm6_tm14,c
2663@TOP@human_GAPDH_TAA_len41_fa0_ta20_fm6_tm14*130*c,0,1252,0,0,1252,0.0,130,2663@TOP@human_GAPDH_TAA_len41_fa0_ta20_fm6_tm14,c
2663@TOP@human_GAPDH_TAA_len41_fa0_ta20_fm6_tm14*131*c,0,1252,0,2,1254,0.0,131,2663@TOP@human_GAPDH_TAA_len41_fa0_ta20_fm6_tm14,c
2663@TOP@human_GAPDH_TAA_len41_fa0_ta20_fm6_tm14*132*t,0,2,0,1226,1228,0.0,132,2663@TOP@human_GAPDH_TAA_len41_fa0_ta20_fm6_tm14,t
2663@TOP@human_GAPDH_TAA_len41_fa0_ta20_fm6_tm14*133*g,0,1,1228,0,1229,0.999,133,2663@TOP@human_GAPDH_TAA_len41_fa0_ta20_fm6_tm14,g
2663@TOP@human_GAPDH_TAA_len41_fa0_ta20_fm6_tm14*134*g,0,0,1238,0,1238,1.0,134,2663@TOP@human_GAPDH_TAA_len41_fa0_ta20_fm6_tm14,g
2664@TOP@human_GAPDH_TAA_len41_fa0_ta20_fm6_tm14*114*t,0,0,0,4160,4160,0.0,114,2664@TOP@human_GAPDH_TAA_len41_fa0_ta20_fm6_tm14,t
2664@TOP@human_GAPDH_TAA_len41_fa0_ta20_fm6_tm14*115*c,1,4184,0,0,4185,0.0,115,2664@TOP@human_GAPDH_TAA_len41_fa0_ta20_fm6_tm14,c
2664@TOP@human_GAPDH_TAA_len41_fa0_ta20_fm6_tm14*116*c,0,4169,0,0,4169,0.0,116,2664@TOP@human_GAPDH_TAA_len41_fa0_ta20_fm6_tm14,c
2664@TOP@human_GAPDH_TAA_len41_fa0_ta20_fm6_tm14*117*a,4156,0,8,0,4164,0.002,117,2664@TOP@human_GAPDH_TAA_len41_fa0_ta20_fm6_tm14,a
2664@TOP@human_GAPDH_TAA_len41_fa0_ta20_fm6_tm14*118*a,4058,0,97,0,4155,0.023,118,2664@TOP@human_GAPDH_TAA_len41_fa0_ta20_fm6_tm14,a
2664@TOP@human_GAPDH_TAA_len41_fa0_ta20_fm6_tm14*119*g,0,0,4130,0,4130,1.0,119,2664@TOP@human_GAPDH_TAA_len41_fa0_ta20_fm6_tm14,g
2664@TOP@human_GAPDH_TAA_len41_fa0_ta20_fm6_tm14*120*g,2,0,4123,0,4125,1.0,120,2664@TOP@human_GAPDH_TAA_len41_fa0_ta20_fm6_tm14,g
2664@TOP@human_GAPDH_TAA_len41_fa0_ta20_fm6_tm14*121*a,4163,0,1,0,4164,0.0,121,2664@TOP@human_GAPDH_TAA_len41_fa0_ta20_fm6_tm14,a
2664@TOP@human_GAPDH_TAA_len41_fa0_ta20_fm6_tm14*122*g,0,0,4165,0,4165,1.0,122,2664@TOP@human_GAPDH_TAA_len41_fa0_ta20_fm6_tm14,g
2664@TOP@human_GAPDH_TAA_len41_fa0_ta20_fm6_tm14*123*t,1,0,0,4121,4122,0.0,123,2664@TOP@human_GAPDH_TAA_len41_fa0_ta20_fm6_tm14,t
2664@TOP@human_GAPDH_TAA_len41_fa0_ta20_fm6_tm14*124*a,2413,0,1697,1,4111,0.413,124,2664@TOP@human_GAPDH_TAA_len41_fa0_ta20_fm6_tm14,a
2664@TOP@human_GAPDH_TAA_len41_fa0_ta20_fm6_tm14*125*a,3048,0,1086,0,4134,0.263,125,2664@TOP@human_GAPDH_TAA_len41_fa0_ta20_fm6_tm14,a
2664@TOP@human_GAPDH_TAA_len41_fa0_ta20_fm6_tm14*126*g,2,0,4122,0,4124,1.0,126,2664@TOP@human_GAPDH_TAA_len41_fa0_ta20_fm6_tm14,g
2664@TOP@human_GAPDH_TAA_len41_fa0_ta20_fm6_tm14*127*a,4156,0,2,0,4158,0.0,127,2664@TOP@human_GAPDH_TAA_len41_fa0_ta20_fm6_tm14,a
2664@TOP@human_GAPDH_TAA_len41_fa0_ta20_fm6_tm14*128*c,0,4170,1,0,4171,0.0,128,2664@TOP@human_GAPDH_TAA_len41_fa0_ta20_fm6_tm14,c
2664@TOP@human_GAPDH_TAA_len41_fa0_ta20_fm6_tm14*129*c,0,4155,0,0,4155,0.0,129,2664@TOP@human_GAPDH_TAA_len41_fa0_ta20_fm6_tm14,c
2664@TOP@human_GAPDH_TAA_len41_fa0_ta20_fm6_tm14*130*c,0,4164,0,0,4164,0.0,130,2664@TOP@human_GAPDH_TAA_len41_fa0_ta20_fm6_tm14,c
2664@TOP@human_GAPDH_TAA_len41_fa0_ta20_fm6_tm14*131*c,1,4174,0,0,4175,0.0,131,2664@TOP@human_GAPDH_TAA_len41_fa0_ta20_fm6_tm14,c
2664@TOP@human_GAPDH_TAA_len41_fa0_ta20_fm6_tm14*132*t,0,1,1,4126,4128,0.0,132,2664@TOP@human_GAPDH_TAA_len41_fa0_ta20_fm6_tm14,t
2664@TOP@human_GAPDH_TAA_len41_fa0_ta20_fm6_tm14*133*g,0,0,4112,0,4112,1.0,133,2664@TOP@human_GAPDH_TAA_len41_fa0_ta20_fm6_tm14,g
2664@TOP@human_GAPDH_TAA_len41_fa0_ta20_fm6_tm14*134*g,0,1,4136,0,4137,1.0,134,2664@TOP@human_GAPDH_TAA_len41_fa0_ta20_fm6_tm14,g
2665@TOP@human_GAPDH_TAA_len41_fa0_ta20_fm6_tm14*114*t,0,0,0,1266,1266,0.0,114,2665@TOP@human_GAPDH_TAA_len41_fa0_ta20_fm6_tm14,t
2665@TOP@human_GAPDH_TAA_len41_fa0_ta20_fm6_tm14*115*c,1,1272,0,0,1273,0.0,115,2665@TOP@human_GAPDH_TAA_len41_fa0_ta20_fm6_tm14,c
2665@TOP@human_GAPDH_TAA_len41_fa0_ta20_fm6_tm14*116*c,0,1270,0,0,1270,0.0,116,2665@TOP@human_GAPDH_TAA_len41_fa0_ta20_fm6_tm14,c
2665@TOP@human_GAPDH_TAA_len41_fa0_ta20_fm6_tm14*117*a,1267,0,4,0,1271,0.003,117,2665@TOP@human_GAPDH_TAA_len41_fa0_ta20_fm6_tm14,a
2665@TOP@human_GAPDH_TAA_len41_fa0_ta20_fm6_tm14*118*a,1227,0,33,0,1260,0.026,118,2665@TOP@human_GAPDH_TAA_len41_fa0_ta20_fm6_tm14,a
2665@TOP@human_GAPDH_TAA_len41_fa0_ta20_fm6_tm14*119*g,0,0,1256,1,1257,0.999,119,2665@TOP@human_GAPDH_TAA_len41_fa0_ta20_fm6_tm14,g
2665@TOP@human_GAPDH_TAA_len41_fa0_ta20_fm6_tm14*120*g,0,0,1249,0,1249,1.0,120,2665@TOP@human_GAPDH_TAA_len41_fa0_ta20_fm6_tm14,g
2665@TOP@human_GAPDH_TAA_len41_fa0_ta20_fm6_tm14*121*a,1266,0,1,0,1267,0.001,121,2665@TOP@human_GAPDH_TAA_len41_fa0_ta20_fm6_tm14,a
2665@TOP@human_GAPDH_TAA_len41_fa0_ta20_fm6_tm14*122*g,0,0,1269,0,1269,1.0,122,2665@TOP@human_GAPDH_TAA_len41_fa0_ta20_fm6_tm14,g
2665@TOP@human_GAPDH_TAA_len41_fa0_ta20_fm6_tm14*123*t,1,0,0,1252,1253,0.0,123,2665@TOP@human_GAPDH_TAA_len41_fa0_ta20_fm6_tm14,t
2665@TOP@human_GAPDH_TAA_len41_fa0_ta20_fm6_tm14*124*a,1089,0,154,0,1243,0.124,124,2665@TOP@human_GAPDH_TAA_len41_fa0_ta20_fm6_tm14,a
2665@TOP@human_GAPDH_TAA_len41_fa0_ta20_fm6_tm14*125*a,1134,0,113,0,1247,0.091,125,2665@TOP@human_GAPDH_TAA_len41_fa0_ta20_fm6_tm14,a
2665@TOP@human_GAPDH_TAA_len41_fa0_ta20_fm6_tm14*126*g,0,0,1250,0,1250,1.0,126,2665@TOP@human_GAPDH_TAA_len41_fa0_ta20_fm6_tm14,g
2665@TOP@human_GAPDH_TAA_len41_fa0_ta20_fm6_tm14*127*a,1254,0,7,0,1261,0.006,127,2665@TOP@human_GAPDH_TAA_len41_fa0_ta20_fm6_tm14,a
2665@TOP@human_GAPDH_TAA_len41_fa0_ta20_fm6_tm14*128*c,0,1270,1,0,1271,0.001,128,2665@TOP@human_GAPDH_TAA_len41_fa0_ta20_fm6_tm14,c
2665@TOP@human_GAPDH_TAA_len41_fa0_ta20_fm6_tm14*129*c,0,1259,0,0,1259,0.0,129,2665@TOP@human_GAPDH_TAA_len41_fa0_ta20_fm6_tm14,c
2665@TOP@human_GAPDH_TAA_len41_fa0_ta20_fm6_tm14*130*c,0,1267,0,0,1267,0.0,130,2665@TOP@human_GAPDH_TAA_len41_fa0_ta20_fm6_tm14,c
2665@TOP@human_GAPDH_TAA_len41_fa0_ta20_fm6_tm14*131*c,0,1271,0,0,1271,0.0,131,2665@TOP@human_GAPDH_TAA_len41_fa0_ta20_fm6_tm14,c
2665@TOP@human_GAPDH_TAA_len41_fa0_ta20_fm6_tm14*132*t,0,0,0,1253,1253,0.0,132,2665@TOP@human_GAPDH_TAA_len41_fa0_ta20_fm6_tm14,t
2665@TOP@human_GAPDH_TAA_len41_fa0_ta20_fm6_tm14*133*g,0,0,1257,0,1257,1.0,133,2665@TOP@human_GAPDH_TAA_len41_fa0_ta20_fm6_tm14,g
2665@TOP@human_GAPDH_TAA_len41_fa0_ta20_fm6_tm14*134*g,0,0,1251,0,1251,1.0,134,2665@TOP@human_GAPDH_TAA_len41_fa0_ta20_fm6_tm14,g
2666@TOP@human_GAPDH_TAA_len41_fa0_ta20_fm6_tm14*114*t,0,0,0,881,881,0.0,114,2666@TOP@human_GAPDH_TAA_len41_fa0_ta20_fm6_tm14,t
2666@TOP@human_GAPDH_TAA_len41_fa0_ta20_fm6_tm14*115*c,0,887,0,0,887,0.0,115,2666@TOP@human_GAPDH_TAA_len41_fa0_ta20_fm6_tm14,c
2666@TOP@human_GAPDH_TAA_len41_fa0_ta20_fm6_tm14*116*c,0,880,0,0,880,0.0,116,2666@TOP@human_GAPDH_TAA_len41_fa0_ta20_fm6_tm14,c
2666@TOP@human_GAPDH_TAA_len41_fa0_ta20_fm6_tm14*117*a,883,0,0,0,883,0.0,117,2666@TOP@human_GAPDH_TAA_len41_fa0_ta20_fm6_tm14,a
2666@TOP@human_GAPDH_TAA_len41_fa0_ta20_fm6_tm14*118*a,859,0,22,0,881,0.025,118,2666@TOP@human_GAPDH_TAA_len41_fa0_ta20_fm6_tm14,a
2666@TOP@human_GAPDH_TAA_len41_fa0_ta20_fm6_tm14*119*g,0,0,874,0,874,1.0,119,2666@TOP@human_GAPDH_TAA_len41_fa0_ta20_fm6_tm14,g
2666@TOP@human_GAPDH_TAA_len41_fa0_ta20_fm6_tm14*120*g,0,0,875,0,875,1.0,120,2666@TOP@human_GAPDH_TAA_len41_fa0_ta20_fm6_tm14,g
2666@TOP@human_GAPDH_TAA_len41_fa0_ta20_fm6_tm14*121*a,882,0,2,0,884,0.002,121,2666@TOP@human_GAPDH_TAA_len41_fa0_ta20_fm6_tm14,a
2666@TOP@human_GAPDH_TAA_len41_fa0_ta20_fm6_tm14*122*g,0,0,883,0,883,1.0,122,2666@TOP@human_GAPDH_TAA_len41_fa0_ta20_fm6_tm14,g
2666@TOP@human_GAPDH_TAA_len41_fa0_ta20_fm6_tm14*123*t,0,0,0,873,873,0.0,123,2666@TOP@human_GAPDH_TAA_len41_fa0_ta20_fm6_tm14,t
2666@TOP@human_GAPDH_TAA_len41_fa0_ta20_fm6_tm14*124*a,571,1,296,0,868,0.341,124,2666@TOP@human_GAPDH_TAA_len41_fa0_ta20_fm6_tm14,a
2666@TOP@human_GAPDH_TAA_len41_fa0_ta20_fm6_tm14*125*a,732,0,138,0,870,0.159,125,2666@TOP@human_GAPDH_TAA_len41_fa0_ta20_fm6_tm14,a
2666@TOP@human_GAPDH_TAA_len41_fa0_ta20_fm6_tm14*126*g,0,0,868,0,868,1.0,126,2666@TOP@human_GAPDH_TAA_len41_fa0_ta20_fm6_tm14,g
2666@TOP@human_GAPDH_TAA_len41_fa0_ta20_fm6_tm14*127*a,866,0,11,0,877,0.013,127,2666@TOP@human_GAPDH_TAA_len41_fa0_ta20_fm6_tm14,a
2666@TOP@human_GAPDH_TAA_len41_fa0_ta20_fm6_tm14*128*c,0,882,0,0,882,0.0,128,2666@TOP@human_GAPDH_TAA_len41_fa0_ta20_fm6_tm14,c
2666@TOP@human_GAPDH_TAA_len41_fa0_ta20_fm6_tm14*129*c,0,875,0,0,875,0.0,129,2666@TOP@human_GAPDH_TAA_len41_fa0_ta20_fm6_tm14,c
2666@TOP@human_GAPDH_TAA_len41_fa0_ta20_fm6_tm14*130*c,0,881,0,0,881,0.0,130,2666@TOP@human_GAPDH_TAA_len41_fa0_ta20_fm6_tm14,c
2666@TOP@human_GAPDH_TAA_len41_fa0_ta20_fm6_tm14*131*c,1,886,0,0,887,0.0,131,2666@TOP@human_GAPDH_TAA_len41_fa0_ta20_fm6_tm14,c
2666@TOP@human_GAPDH_TAA_len41_fa0_ta20_fm6_tm14*132*t,1,0,0,871,872,0.0,132,2666@TOP@human_GAPDH_TAA_len41_fa0_ta20_fm6_tm14,t
2666@TOP@human_GAPDH_TAA_len41_fa0_ta20_fm6_tm14*133*g,0,0,874,0,874,1.0,133,2666@TOP@human_GAPDH_TAA_len41_fa0_ta20_fm6_tm14,g
2666@TOP@human_GAPDH_TAA_len41_fa0_ta20_fm6_tm14*134*g,0,0,871,0,871,1.0,134,2666@TOP@human_GAPDH_TAA_len41_fa0_ta20_fm6_tm14,g
2667@TOP@human_GAPDH_TAA_len41_fa0_ta20_fm6_tm14*114*t,2,1,0,852,855,0.0,114,2667@TOP@human_GAPDH_TAA_len41_fa0_ta20_fm6_tm14,t
2667@TOP@human_GAPDH_TAA_len41_fa0_ta20_fm6_tm14*115*c,1,858,0,2,861,0.0,115,2667@TOP@human_GAPDH_TAA_len41_fa0_ta20_fm6_tm14,c
2667@TOP@human_GAPDH_TAA_len41_fa0_ta20_fm6_tm14*116*c,0,858,0,0,858,0.0,116,2667@TOP@human_GAPDH_TAA_len41_fa0_ta20_fm6_tm14,c
2667@TOP@human_GAPDH_TAA_len41_fa0_ta20_fm6_tm14*117*a,856,0,3,0,859,0.003,117,2667@TOP@human_GAPDH_TAA_len41_fa0_ta20_fm6_tm14,a
2667@TOP@human_GAPDH_TAA_len41_fa0_ta20_fm6_tm14*118*a,816,0,31,0,847,0.037,118,2667@TOP@human_GAPDH_TAA_len41_fa0_ta20_fm6_tm14,a
2667@TOP@human_GAPDH_TAA_len41_fa0_ta20_fm6_tm14*119*g,0,0,845,0,845,1.0,119,2667@TOP@human_GAPDH_TAA_len41_fa0_ta20_fm6_tm14,g
2667@TOP@human_GAPDH_TAA_len41_fa0_ta20_fm6_tm14*120*g,0,0,846,0,846,1.0,120,2667@TOP@human_GAPDH_TAA_len41_fa0_ta20_fm6_tm14,g
2667@TOP@human_GAPDH_TAA_len41_fa0_ta20_fm6_tm14*121*a,852,0,0,0,852,0.0,121,2667@TOP@human_GAPDH_TAA_len41_fa0_ta20_fm6_tm14,a
2667@TOP@human_GAPDH_TAA_len41_fa0_ta20_fm6_tm14*122*g,0,0,858,0,858,1.0,122,2667@TOP@human_GAPDH_TAA_len41_fa0_ta20_fm6_tm14,g
2667@TOP@human_GAPDH_TAA_len41_fa0_ta20_fm6_tm14*123*t,0,0,0,840,840,0.0,123,2667@TOP@human_GAPDH_TAA_len41_fa0_ta20_fm6_tm14,t
2667@TOP@human_GAPDH_TAA_len41_fa0_ta20_fm6_tm14*124*a,651,0,190,0,841,0.226,124,2667@TOP@human_GAPDH_TAA_len41_fa0_ta20_fm6_tm14,a
2667@TOP@human_GAPDH_TAA_len41_fa0_ta20_fm6_tm14*125*a,631,0,213,0,844,0.252,125,2667@TOP@human_GAPDH_TAA_len41_fa0_ta20_fm6_tm14,a
2667@TOP@human_GAPDH_TAA_len41_fa0_ta20_fm6_tm14*126*g,0,0,838,0,838,1.0,126,2667@TOP@human_GAPDH_TAA_len41_fa0_ta20_fm6_tm14,g
2667@TOP@human_GAPDH_TAA_len41_fa0_ta20_fm6_tm14*127*a,846,0,11,0,857,0.013,127,2667@TOP@human_GAPDH_TAA_len41_fa0_ta20_fm6_tm14,a
2667@TOP@human_GAPDH_TAA_len41_fa0_ta20_fm6_tm14*128*c,0,856,0,0,856,0.0,128,2667@TOP@human_GAPDH_TAA_len41_fa0_ta20_fm6_tm14,c
2667@TOP@human_GAPDH_TAA_len41_fa0_ta20_fm6_tm14*129*c,0,854,0,0,854,0.0,129,2667@TOP@human_GAPDH_TAA_len41_fa0_ta20_fm6_tm14,c
2667@TOP@human_GAPDH_TAA_len41_fa0_ta20_fm6_tm14*130*c,0,858,0,0,858,0.0,130,2667@TOP@human_GAPDH_TAA_len41_fa0_ta20_fm6_tm14,c
2667@TOP@human_GAPDH_TAA_len41_fa0_ta20_fm6_tm14*131*c,0,856,0,0,856,0.0,131,2667@TOP@human_GAPDH_TAA_len41_fa0_ta20_fm6_tm14,c
2667@TOP@human_GAPDH_TAA_len41_fa0_ta20_fm6_tm14*132*t,0,1,0,842,843,0.0,132,2667@TOP@human_GAPDH_TAA_len41_fa0_ta20_fm6_tm14,t
2667@TOP@human_GAPDH_TAA_len41_fa0_ta20_fm6_tm14*133*g,0,0,846,0,846,1.0,133,2667@TOP@human_GAPDH_TAA_len41_fa0_ta20_fm6_tm14,g
2667@TOP@human_GAPDH_TAA_len41_fa0_ta20_fm6_tm14*134*g,0,2,846,0,848,0.998,134,2667@TOP@human_GAPDH_TAA_len41_fa0_ta20_fm6_tm14,g
2668@TOP@human_GAPDH_TAA_len41_fa0_ta20_fm6_tm14*114*t,0,1,0,1089,1090,0.0,114,2668@TOP@human_GAPDH_TAA_len41_fa0_ta20_fm6_tm14,t
2668@TOP@human_GAPDH_TAA_len41_fa0_ta20_fm6_tm14*115*c,0,1098,0,0,1098,0.0,115,2668@TOP@human_GAPDH_TAA_len41_fa0_ta20_fm6_tm14,c
2668@TOP@human_GAPDH_TAA_len41_fa0_ta20_fm6_tm14*116*c,0,1087,0,0,1087,0.0,116,2668@TOP@human_GAPDH_TAA_len41_fa0_ta20_fm6_tm14,c
2668@TOP@human_GAPDH_TAA_len41_fa0_ta20_fm6_tm14*117*a,1089,0,3,0,1092,0.003,117,2668@TOP@human_GAPDH_TAA_len41_fa0_ta20_fm6_tm14,a
2668@TOP@human_GAPDH_TAA_len41_fa0_ta20_fm6_tm14*118*a,1055,0,27,0,1082,0.025,118,2668@TOP@human_GAPDH_TAA_len41_fa0_ta20_fm6_tm14,a
2668@TOP@human_GAPDH_TAA_len41_fa0_ta20_fm6_tm14*119*g,0,0,1085,0,1085,1.0,119,2668@TOP@human_GAPDH_TAA_len41_fa0_ta20_fm6_tm14,g
2668@TOP@human_GAPDH_TAA_len41_fa0_ta20_fm6_tm14*120*g,0,0,1078,0,1078,1.0,120,2668@TOP@human_GAPDH_TAA_len41_fa0_ta20_fm6_tm14,g
2668@TOP@human_GAPDH_TAA_len41_fa0_ta20_fm6_tm14*121*a,1094,0,0,0,1094,0.0,121,2668@TOP@human_GAPDH_TAA_len41_fa0_ta20_fm6_tm14,a
2668@TOP@human_GAPDH_TAA_len41_fa0_ta20_fm6_tm14*122*g,0,0,1094,0,1094,1.0,122,2668@TOP@human_GAPDH_TAA_len41_fa0_ta20_fm6_tm14,g
2668@TOP@human_GAPDH_TAA_len41_fa0_ta20_fm6_tm14*123*t,0,0,0,1079,1079,0.0,123,2668@TOP@human_GAPDH_TAA_len41_fa0_ta20_fm6_tm14,t
2668@TOP@human_GAPDH_TAA_len41_fa0_ta20_fm6_tm14*124*a,712,0,368,0,1080,0.341,124,2668@TOP@human_GAPDH_TAA_len41_fa0_ta20_fm6_tm14,a
2668@TOP@human_GAPDH_TAA_len41_fa0_ta20_fm6_tm14*125*a,952,0,124,0,1076,0.115,125,2668@TOP@human_GAPDH_TAA_len41_fa0_ta20_fm6_tm14,a
2668@TOP@human_GAPDH_TAA_len41_fa0_ta20_fm6_tm14*126*g,0,0,1075,0,1075,1.0,126,2668@TOP@human_GAPDH_TAA_len41_fa0_ta20_fm6_tm14,g
2668@TOP@human_GAPDH_TAA_len41_fa0_ta20_fm6_tm14*127*a,1080,0,13,0,1093,0.012,127,2668@TOP@human_GAPDH_TAA_len41_fa0_ta20_fm6_tm14,a
2668@TOP@human_GAPDH_TAA_len41_fa0_ta20_fm6_tm14*128*c,0,1090,0,0,1090,0.0,128,2668@TOP@human_GAPDH_TAA_len41_fa0_ta20_fm6_tm14,c
2668@TOP@human_GAPDH_TAA_len41_fa0_ta20_fm6_tm14*129*c,0,1083,0,2,1085,0.0,129,2668@TOP@human_GAPDH_TAA_len41_fa0_ta20_fm6_tm14,c
2668@TOP@human_GAPDH_TAA_len41_fa0_ta20_fm6_tm14*130*c,0,1092,0,0,1092,0.0,130,2668@TOP@human_GAPDH_TAA_len41_fa0_ta20_fm6_tm14,c
2668@TOP@human_GAPDH_TAA_len41_fa0_ta20_fm6_tm14*131*c,0,1098,0,0,1098,0.0,131,2668@TOP@human_GAPDH_TAA_len41_fa0_ta20_fm6_tm14,c
2668@TOP@human_GAPDH_TAA_len41_fa0_ta20_fm6_tm14*132*t,0,0,0,1085,1085,0.0,132,2668@TOP@human_GAPDH_TAA_len41_fa0_ta20_fm6_tm14,t
2668@TOP@human_GAPDH_TAA_len41_fa0_ta20_fm6_tm14*133*g,0,0,1075,0,1075,1.0,133,2668@TOP@human_GAPDH_TAA_len41_fa0_ta20_fm6_tm14,g
2668@TOP@human_GAPDH_TAA_len41_fa0_ta20_fm6_tm14*134*g,0,0,1075,0,1075,1.0,134,2668@TOP@human_GAPDH_TAA_len41_fa0_ta20_fm6_tm14,g
2669@TOP@human_GAPDH_TAA_len41_fa0_ta20_fm6_tm14*114*t,0,0,0,1182,1182,0.0,114,2669@TOP@human_GAPDH_TAA_len41_fa0_ta20_fm6_tm14,t
2669@TOP@human_GAPDH_TAA_len41_fa0_ta20_fm6_tm14*115*c,0,1192,0,0,1192,0.0,115,2669@TOP@human_GAPDH_TAA_len41_fa0_ta20_fm6_tm14,c
2669@TOP@human_GAPDH_TAA_len41_fa0_ta20_fm6_tm14*116*c,0,1189,0,0,1189,0.0,116,2669@TOP@human_GAPDH_TAA_len41_fa0_ta20_fm6_tm14,c
2669@TOP@human_GAPDH_TAA_len41_fa0_ta20_fm6_tm14*117*a,1179,0,5,0,1184,0.004,117,2669@TOP@human_GAPDH_TAA_len41_fa0_ta20_fm6_tm14,a
2669@TOP@human_GAPDH_TAA_len41_fa0_ta20_fm6_tm14*118*a,1139,0,34,0,1173,0.029,118,2669@TOP@human_GAPDH_TAA_len41_fa0_ta20_fm6_tm14,a
2669@TOP@human_GAPDH_TAA_len41_fa0_ta20_fm6_tm14*119*g,0,0,1166,0,1166,1.0,119,2669@TOP@human_GAPDH_TAA_len41_fa0_ta20_fm6_tm14,g
2669@TOP@human_GAPDH_TAA_len41_fa0_ta20_fm6_tm14*120*g,0,0,1166,0,1166,1.0,120,2669@TOP@human_GAPDH_TAA_len41_fa0_ta20_fm6_tm14,g
2669@TOP@human_GAPDH_TAA_len41_fa0_ta20_fm6_tm14*121*a,1187,0,0,0,1187,0.0,121,2669@TOP@human_GAPDH_TAA_len41_fa0_ta20_fm6_tm14,a
2669@TOP@human_GAPDH_TAA_len41_fa0_ta20_fm6_tm14*122*g,0,0,1187,0,1187,1.0,122,2669@TOP@human_GAPDH_TAA_len41_fa0_ta20_fm6_tm14,g
2669@TOP@human_GAPDH_TAA_len41_fa0_ta20_fm6_tm14*123*t,0,1,0,1161,1162,0.0,123,2669@TOP@human_GAPDH_TAA_len41_fa0_ta20_fm6_tm14,t
2669@TOP@human_GAPDH_TAA_len41_fa0_ta20_fm6_tm14*124*a,1024,0,148,0,1172,0.126,124,2669@TOP@human_GAPDH_TAA_len41_fa0_ta20_fm6_tm14,a
2669@TOP@human_GAPDH_TAA_len41_fa0_ta20_fm6_tm14*125*a,910,1,252,1,1164,0.216,125,2669@TOP@human_GAPDH_TAA_len41_fa0_ta20_fm6_tm14,a
2669@TOP@human_GAPDH_TAA_len41_fa0_ta20_fm6_tm14*126*g,0,0,1170,1,1171,0.999,126,2669@TOP@human_GAPDH_TAA_len41_fa0_ta20_fm6_tm14,g
2669@TOP@human_GAPDH_TAA_len41_fa0_ta20_fm6_tm14*127*a,1170,0,12,0,1182,0.01,127,2669@TOP@human_GAPDH_TAA_len41_fa0_ta20_fm6_tm14,a
2669@TOP@human_GAPDH_TAA_len41_fa0_ta20_fm6_tm14*128*c,0,1189,0,0,1189,0.0,128,2669@TOP@human_GAPDH_TAA_len41_fa0_ta20_fm6_tm14,c
2669@TOP@human_GAPDH_TAA_len41_fa0_ta20_fm6_tm14*129*c,0,1180,0,0,1180,0.0,129,2669@TOP@human_GAPDH_TAA_len41_fa0_ta20_fm6_tm14,c
2669@TOP@human_GAPDH_TAA_len41_fa0_ta20_fm6_tm14*130*c,0,1187,0,0,1187,0.0,130,2669@TOP@human_GAPDH_TAA_len41_fa0_ta20_fm6_tm14,c
2669@TOP@human_GAPDH_TAA_len41_fa0_ta20_fm6_tm14*131*c,1,1186,0,0,1187,0.0,131,2669@TOP@human_GAPDH_TAA_len41_fa0_ta20_fm6_tm14,c
2669@TOP@human_GAPDH_TAA_len41_fa0_ta20_fm6_tm14*132*t,0,0,0,1162,1162,0.0,132,2669@TOP@human_GAPDH_TAA_len41_fa0_ta20_fm6_tm14,t
2669@TOP@human_GAPDH_TAA_len41_fa0_ta20_fm6_tm14*133*g,0,0,1168,1,1169,0.999,133,2669@TOP@human_GAPDH_TAA_len41_fa0_ta20_fm6_tm14,g
2669@TOP@human_GAPDH_TAA_len41_fa0_ta20_fm6_tm14*134*g,0,3,1161,0,1164,0.997,134,2669@TOP@human_GAPDH_TAA_len41_fa0_ta20_fm6_tm14,g
2670@TOP@human_GAPDH_TAA_len41_fa0_ta20_fm6_tm14*114*t,0,0,0,1339,1339,0.0,114,2670@TOP@human_GAPDH_TAA_len41_fa0_ta20_fm6_tm14,t
2670@TOP@human_GAPDH_TAA_len41_fa0_ta20_fm6_tm14*115*c,0,1344,0,0,1344,0.0,115,2670@TOP@human_GAPDH_TAA_len41_fa0_ta20_fm6_tm14,c
2670@TOP@human_GAPDH_TAA_len41_fa0_ta20_fm6_tm14*116*c,0,1340,0,0,1340,0.0,116,2670@TOP@human_GAPDH_TAA_len41_fa0_ta20_fm6_tm14,c
2670@TOP@human_GAPDH_TAA_len41_fa0_ta20_fm6_tm14*117*a,1327,0,4,0,1331,0.003,117,2670@TOP@human_GAPDH_TAA_len41_fa0_ta20_fm6_tm14,a
2670@TOP@human_GAPDH_TAA_len41_fa0_ta20_fm6_tm14*118*a,1294,0,30,0,1324,0.023,118,2670@TOP@human_GAPDH_TAA_len41_fa0_ta20_fm6_tm14,a
2670@TOP@human_GAPDH_TAA_len41_fa0_ta20_fm6_tm14*119*g,0,0,1329,0,1329,1.0,119,2670@TOP@human_GAPDH_TAA_len41_fa0_ta20_fm6_tm14,g
2670@TOP@human_GAPDH_TAA_len41_fa0_ta20_fm6_tm14*120*g,0,0,1318,0,1318,1.0,120,2670@TOP@human_GAPDH_TAA_len41_fa0_ta20_fm6_tm14,g
2670@TOP@human_GAPDH_TAA_len41_fa0_ta20_fm6_tm14*121*a,1326,0,5,0,1331,0.004,121,2670@TOP@human_GAPDH_TAA_len41_fa0_ta20_fm6_tm14,a
2670@TOP@human_GAPDH_TAA_len41_fa0_ta20_fm6_tm14*122*g,0,0,1338,0,1338,1.0,122,2670@TOP@human_GAPDH_TAA_len41_fa0_ta20_fm6_tm14,g
2670@TOP@human_GAPDH_TAA_len41_fa0_ta20_fm6_tm14*123*t,0,0,0,1313,1313,0.0,123,2670@TOP@human_GAPDH_TAA_len41_fa0_ta20_fm6_tm14,t
2670@TOP@human_GAPDH_TAA_len41_fa0_ta20_fm6_tm14*124*a,1207,0,112,0,1319,0.085,124,2670@TOP@human_GAPDH_TAA_len41_fa0_ta20_fm6_tm14,a
2670@TOP@human_GAPDH_TAA_len41_fa0_ta20_fm6_tm14*125*a,1145,0,166,0,1311,0.127,125,2670@TOP@human_GAPDH_TAA_len41_fa0_ta20_fm6_tm14,a
2670@TOP@human_GAPDH_TAA_len41_fa0_ta20_fm6_tm14*126*g,0,0,1316,0,1316,1.0,126,2670@TOP@human_GAPDH_TAA_len41_fa0_ta20_fm6_tm14,g
2670@TOP@human_GAPDH_TAA_len41_fa0_ta20_fm6_tm14*127*a,1324,0,7,0,1331,0.005,127,2670@TOP@human_GAPDH_TAA_len41_fa0_ta20_fm6_tm14,a
2670@TOP@human_GAPDH_TAA_len41_fa0_ta20_fm6_tm14*128*c,0,1342,0,0,1342,0.0,128,2670@TOP@human_GAPDH_TAA_len41_fa0_ta20_fm6_tm14,c
2670@TOP@human_GAPDH_TAA_len41_fa0_ta20_fm6_tm14*129*c,0,1334,0,0,1334,0.0,129,2670@TOP@human_GAPDH_TAA_len41_fa0_ta20_fm6_tm14,c
2670@TOP@human_GAPDH_TAA_len41_fa0_ta20_fm6_tm14*130*c,0,1340,0,0,1340,0.0,130,2670@TOP@human_GAPDH_TAA_len41_fa0_ta20_fm6_tm14,c
2670@TOP@human_GAPDH_TAA_len41_fa0_ta20_fm6_tm14*131*c,0,1343,0,0,1343,0.0,131,2670@TOP@human_GAPDH_TAA_len41_fa0_ta20_fm6_tm14,c
2670@TOP@human_GAPDH_TAA_len41_fa0_ta20_fm6_tm14*132*t,0,0,0,1314,1314,0.0,132,2670@TOP@human_GAPDH_TAA_len41_fa0_ta20_fm6_tm14,t
2670@TOP@human_GAPDH_TAA_len41_fa0_ta20_fm6_tm14*133*g,0,0,1318,0,1318,1.0,133,2670@TOP@human_GAPDH_TAA_len41_fa0_ta20_fm6_tm14,g
2670@TOP@human_GAPDH_TAA_len41_fa0_ta20_fm6_tm14*134*g,0,0,1326,0,1326,1.0,134,2670@TOP@human_GAPDH_TAA_len41_fa0_ta20_fm6_tm14,g
2671@TOP@human_GAPDH_TAA_len41_fa0_ta20_fm6_tm14*114*t,0,0,0,2184,2184,0.0,114,2671@TOP@human_GAPDH_TAA_len41_fa0_ta20_fm6_tm14,t
2671@TOP@human_GAPDH_TAA_len41_fa0_ta20_fm6_tm14*115*c,0,2187,0,0,2187,0.0,115,2671@TOP@human_GAPDH_TAA_len41_fa0_ta20_fm6_tm14,c
2671@TOP@human_GAPDH_TAA_len41_fa0_ta20_fm6_tm14*116*c,0,2178,0,0,2178,0.0,116,2671@TOP@human_GAPDH_TAA_len41_fa0_ta20_fm6_tm14,c
2671@TOP@human_GAPDH_TAA_len41_fa0_ta20_fm6_tm14*117*a,2169,0,8,0,2177,0.004,117,2671@TOP@human_GAPDH_TAA_len41_fa0_ta20_fm6_tm14,a
2671@TOP@human_GAPDH_TAA_len41_fa0_ta20_fm6_tm14*118*a,2073,0,86,0,2159,0.04,118,2671@TOP@human_GAPDH_TAA_len41_fa0_ta20_fm6_tm14,a
2671@TOP@human_GAPDH_TAA_len41_fa0_ta20_fm6_tm14*119*g,0,0,2159,0,2159,1.0,119,2671@TOP@human_GAPDH_TAA_len41_fa0_ta20_fm6_tm14,g
2671@TOP@human_GAPDH_TAA_len41_fa0_ta20_fm6_tm14*120*g,0,0,2149,0,2149,1.0,120,2671@TOP@human_GAPDH_TAA_len41_fa0_ta20_fm6_tm14,g
2671@TOP@human_GAPDH_TAA_len41_fa0_ta20_fm6_tm14*121*a,2173,0,2,0,2175,0.001,121,2671@TOP@human_GAPDH_TAA_len41_fa0_ta20_fm6_tm14,a
2671@TOP@human_GAPDH_TAA_len41_fa0_ta20_fm6_tm14*122*g,0,0,2178,0,2178,1.0,122,2671@TOP@human_GAPDH_TAA_len41_fa0_ta20_fm6_tm14,g
2671@TOP@human_GAPDH_TAA_len41_fa0_ta20_fm6_tm14*123*t,1,0,1,2159,2161,0.0,123,2671@TOP@human_GAPDH_TAA_len41_fa0_ta20_fm6_tm14,t
2671@TOP@human_GAPDH_TAA_len41_fa0_ta20_fm6_tm14*124*a,782,0,1369,0,2151,0.636,124,2671@TOP@human_GAPDH_TAA_len41_fa0_ta20_fm6_tm14,a
2671@TOP@human_GAPDH_TAA_len41_fa0_ta20_fm6_tm14*125*a,774,0,1378,0,2152,0.64,125,2671@TOP@human_GAPDH_TAA_len41_fa0_ta20_fm6_tm14,a
2671@TOP@human_GAPDH_TAA_len41_fa0_ta20_fm6_tm14*126*g,0,0,2167,0,2167,1.0,126,2671@TOP@human_GAPDH_TAA_len41_fa0_ta20_fm6_tm14,g
2671@TOP@human_GAPDH_TAA_len41_fa0_ta20_fm6_tm14*127*a,2099,0,68,0,2167,0.031,127,2671@TOP@human_GAPDH_TAA_len41_fa0_ta20_fm6_tm14,a
2671@TOP@human_GAPDH_TAA_len41_fa0_ta20_fm6_tm14*128*c,0,2178,0,0,2178,0.0,128,2671@TOP@human_GAPDH_TAA_len41_fa0_ta20_fm6_tm14,c
2671@TOP@human_GAPDH_TAA_len41_fa0_ta20_fm6_tm14*129*c,0,2176,0,0,2176,0.0,129,2671@TOP@human_GAPDH_TAA_len41_fa0_ta20_fm6_tm14,c
2671@TOP@human_GAPDH_TAA_len41_fa0_ta20_fm6_tm14*130*c,0,2177,0,1,2178,0.0,130,2671@TOP@human_GAPDH_TAA_len41_fa0_ta20_fm6_tm14,c
2671@TOP@human_GAPDH_TAA_len41_fa0_ta20_fm6_tm14*131*c,0,2186,0,0,2186,0.0,131,2671@TOP@human_GAPDH_TAA_len41_fa0_ta20_fm6_tm14,c
2671@TOP@human_GAPDH_TAA_len41_fa0_ta20_fm6_tm14*132*t,0,5,0,2156,2161,0.0,132,2671@TOP@human_GAPDH_TAA_len41_fa0_ta20_fm6_tm14,t
2671@TOP@human_GAPDH_TAA_len41_fa0_ta20_fm6_tm14*133*g,0,0,2151,0,2151,1.0,133,2671@TOP@human_GAPDH_TAA_len41_fa0_ta20_fm6_tm14,g
2671@TOP@human_GAPDH_TAA_len41_fa0_ta20_fm6_tm14*134*g,0,0,2152,0,2152,1.0,134,2671@TOP@human_GAPDH_TAA_len41_fa0_ta20_fm6_tm14,g
2672@TOP@human_GAPDH_TAA_len41_fa0_ta20_fm6_tm14*114*t,3,0,0,13476,13479,0.0,114,2672@TOP@human_GAPDH_TAA_len41_fa0_ta20_fm6_tm14,t
2672@TOP@human_GAPDH_TAA_len41_fa0_ta20_fm6_tm14*115*c,0,13539,0,1,13540,0.0,115,2672@TOP@human_GAPDH_TAA_len41_fa0_ta20_fm6_tm14,c
2672@TOP@human_GAPDH_TAA_len41_fa0_ta20_fm6_tm14*116*c,0,13495,0,0,13495,0.0,116,2672@TOP@human_GAPDH_TAA_len41_fa0_ta20_fm6_tm14,c
2672@TOP@human_GAPDH_TAA_len41_fa0_ta20_fm6_tm14*117*a,13443,0,27,0,13470,0.002,117,2672@TOP@human_GAPDH_TAA_len41_fa0_ta20_fm6_tm14,a
2672@TOP@human_GAPDH_TAA_len41_fa0_ta20_fm6_tm14*118*a,13243,0,190,0,13433,0.014,118,2672@TOP@human_GAPDH_TAA_len41_fa0_ta20_fm6_tm14,a
2672@TOP@human_GAPDH_TAA_len41_fa0_ta20_fm6_tm14*119*g,2,0,13405,0,13407,1.0,119,2672@TOP@human_GAPDH_TAA_len41_fa0_ta20_fm6_tm14,g
2672@TOP@human_GAPDH_TAA_len41_fa0_ta20_fm6_tm14*120*g,2,0,13337,4,13343,1.0,120,2672@TOP@human_GAPDH_TAA_len41_fa0_ta20_fm6_tm14,g
2672@TOP@human_GAPDH_TAA_len41_fa0_ta20_fm6_tm14*121*a,13473,0,5,1,13479,0.0,121,2672@TOP@human_GAPDH_TAA_len41_fa0_ta20_fm6_tm14,a
2672@TOP@human_GAPDH_TAA_len41_fa0_ta20_fm6_tm14*122*g,0,0,13473,0,13473,1.0,122,2672@TOP@human_GAPDH_TAA_len41_fa0_ta20_fm6_tm14,g
2672@TOP@human_GAPDH_TAA_len41_fa0_ta20_fm6_tm14*123*t,0,3,2,13305,13310,0.0,123,2672@TOP@human_GAPDH_TAA_len41_fa0_ta20_fm6_tm14,t
2672@TOP@human_GAPDH_TAA_len41_fa0_ta20_fm6_tm14*124*a,11651,0,1660,0,13311,0.125,124,2672@TOP@human_GAPDH_TAA_len41_fa0_ta20_fm6_tm14,a
2672@TOP@human_GAPDH_TAA_len41_fa0_ta20_fm6_tm14*125*a,12308,1,947,0,13256,0.071,125,2672@TOP@human_GAPDH_TAA_len41_fa0_ta20_fm6_tm14,a
2672@TOP@human_GAPDH_TAA_len41_fa0_ta20_fm6_tm14*126*g,0,0,13329,0,13329,1.0,126,2672@TOP@human_GAPDH_TAA_len41_fa0_ta20_fm6_tm14,g
2672@TOP@human_GAPDH_TAA_len41_fa0_ta20_fm6_tm14*127*a,13402,0,35,0,13437,0.003,127,2672@TOP@human_GAPDH_TAA_len41_fa0_ta20_fm6_tm14,a
2672@TOP@human_GAPDH_TAA_len41_fa0_ta20_fm6_tm14*128*c,1,13506,0,2,13509,0.0,128,2672@TOP@human_GAPDH_TAA_len41_fa0_ta20_fm6_tm14,c
2672@TOP@human_GAPDH_TAA_len41_fa0_ta20_fm6_tm14*129*c,2,13418,0,2,13422,0.0,129,2672@TOP@human_GAPDH_TAA_len41_fa0_ta20_fm6_tm14,c
2672@TOP@human_GAPDH_TAA_len41_fa0_ta20_fm6_tm14*130*c,0,13493,0,0,13493,0.0,130,2672@TOP@human_GAPDH_TAA_len41_fa0_ta20_fm6_tm14,c
2672@TOP@human_GAPDH_TAA_len41_fa0_ta20_fm6_tm14*131*c,1,13513,0,1,13515,0.0,131,2672@TOP@human_GAPDH_TAA_len41_fa0_ta20_fm6_tm14,c
2672@TOP@human_GAPDH_TAA_len41_fa0_ta20_fm6_tm14*132*t,0,2,2,13334,13338,0.0,132,2672@TOP@human_GAPDH_TAA_len41_fa0_ta20_fm6_tm14,t
2672@TOP@human_GAPDH_TAA_len41_fa0_ta20_fm6_tm14*133*g,1,0,13290,1,13292,1.0,133,2672@TOP@human_GAPDH_TAA_len41_fa0_ta20_fm6_tm14,g
2672@TOP@human_GAPDH_TAA_len41_fa0_ta20_fm6_tm14*134*g,1,1,13351,1,13354,1.0,134,2672@TOP@human_GAPDH_TAA_len41_fa0_ta20_fm6_tm14,g
2673@TOP@human_GAPDH_TAA_len41_fa0_ta20_fm6_tm14*114*t,0,0,0,1193,1193,0.0,114,2673@TOP@human_GAPDH_TAA_len41_fa0_ta20_fm6_tm14,t
2673@TOP@human_GAPDH_TAA_len41_fa0_ta20_fm6_tm14*115*c,0,1200,0,0,1200,0.0,115,2673@TOP@human_GAPDH_TAA_len41_fa0_ta20_fm6_tm14,c
2673@TOP@human_GAPDH_TAA_len41_fa0_ta20_fm6_tm14*116*c,0,1196,0,0,1196,0.0,116,2673@TOP@human_GAPDH_TAA_len41_fa0_ta20_fm6_tm14,c
2673@TOP@human_GAPDH_TAA_len41_fa0_ta20_fm6_tm14*117*a,1190,0,1,0,1191,0.001,117,2673@TOP@human_GAPDH_TAA_len41_fa0_ta20_fm6_tm14,a
2673@TOP@human_GAPDH_TAA_len41_fa0_ta20_fm6_tm14*118*a,1154,0,26,0,1180,0.022,118,2673@TOP@human_GAPDH_TAA_len41_fa0_ta20_fm6_tm14,a
2673@TOP@human_GAPDH_TAA_len41_fa0_ta20_fm6_tm14*119*g,0,0,1185,0,1185,1.0,119,2673@TOP@human_GAPDH_TAA_len41_fa0_ta20_fm6_tm14,g
2673@TOP@human_GAPDH_TAA_len41_fa0_ta20_fm6_tm14*120*g,0,0,1182,0,1182,1.0,120,2673@TOP@human_GAPDH_TAA_len41_fa0_ta20_fm6_tm14,g
2673@TOP@human_GAPDH_TAA_len41_fa0_ta20_fm6_tm14*121*a,1180,0,0,0,1180,0.0,121,2673@TOP@human_GAPDH_TAA_len41_fa0_ta20_fm6_tm14,a
2673@TOP@human_GAPDH_TAA_len41_fa0_ta20_fm6_tm14*122*g,0,0,1192,0,1192,1.0,122,2673@TOP@human_GAPDH_TAA_len41_fa0_ta20_fm6_tm14,g
2673@TOP@human_GAPDH_TAA_len41_fa0_ta20_fm6_tm14*123*t,0,0,0,1177,1177,0.0,123,2673@TOP@human_GAPDH_TAA_len41_fa0_ta20_fm6_tm14,t
2673@TOP@human_GAPDH_TAA_len41_fa0_ta20_fm6_tm14*124*a,780,1,399,0,1180,0.338,124,2673@TOP@human_GAPDH_TAA_len41_fa0_ta20_fm6_tm14,a
2673@TOP@human_GAPDH_TAA_len41_fa0_ta20_fm6_tm14*125*a,811,0,362,1,1174,0.308,125,2673@TOP@human_GAPDH_TAA_len41_fa0_ta20_fm6_tm14,a
2673@TOP@human_GAPDH_TAA_len41_fa0_ta20_fm6_tm14*126*g,0,0,1175,0,1175,1.0,126,2673@TOP@human_GAPDH_TAA_len41_fa0_ta20_fm6_tm14,g
2673@TOP@human_GAPDH_TAA_len41_fa0_ta20_fm6_tm14*127*a,1166,0,23,0,1189,0.019,127,2673@TOP@human_GAPDH_TAA_len41_fa0_ta20_fm6_tm14,a
2673@TOP@human_GAPDH_TAA_len41_fa0_ta20_fm6_tm14*128*c,0,1195,1,0,1196,0.001,128,2673@TOP@human_GAPDH_TAA_len41_fa0_ta20_fm6_tm14,c
2673@TOP@human_GAPDH_TAA_len41_fa0_ta20_fm6_tm14*129*c,0,1195,0,0,1195,0.0,129,2673@TOP@human_GAPDH_TAA_len41_fa0_ta20_fm6_tm14,c
2673@TOP@human_GAPDH_TAA_len41_fa0_ta20_fm6_tm14*130*c,0,1197,0,0,1197,0.0,130,2673@TOP@human_GAPDH_TAA_len41_fa0_ta20_fm6_tm14,c
2673@TOP@human_GAPDH_TAA_len41_fa0_ta20_fm6_tm14*131*c,0,1198,0,1,1199,0.0,131,2673@TOP@human_GAPDH_TAA_len41_fa0_ta20_fm6_tm14,c
2673@TOP@human_GAPDH_TAA_len41_fa0_ta20_fm6_tm14*132*t,0,0,0,1178,1178,0.0,132,2673@TOP@human_GAPDH_TAA_len41_fa0_ta20_fm6_tm14,t
2673@TOP@human_GAPDH_TAA_len41_fa0_ta20_fm6_tm14*133*g,0,0,1187,0,1187,1.0,133,2673@TOP@human_GAPDH_TAA_len41_fa0_ta20_fm6_tm14,g
2673@TOP@human_GAPDH_TAA_len41_fa0_ta20_fm6_tm14*134*g,0,0,1189,0,1189,1.0,134,2673@TOP@human_GAPDH_TAA_len41_fa0_ta20_fm6_tm14,g
2674@TOP@human_GAPDH_TAA_len41_fa0_ta20_fm6_tm14*114*t,0,1,0,1929,1930,0.0,114,2674@TOP@human_GAPDH_TAA_len41_fa0_ta20_fm6_tm14,t
2674@TOP@human_GAPDH_TAA_len41_fa0_ta20_fm6_tm14*115*c,0,1949,0,0,1949,0.0,115,2674@TOP@human_GAPDH_TAA_len41_fa0_ta20_fm6_tm14,c
2674@TOP@human_GAPDH_TAA_len41_fa0_ta20_fm6_tm14*116*c,0,1941,0,0,1941,0.0,116,2674@TOP@human_GAPDH_TAA_len41_fa0_ta20_fm6_tm14,c
2674@TOP@human_GAPDH_TAA_len41_fa0_ta20_fm6_tm14*117*a,1928,0,8,0,1936,0.004,117,2674@TOP@human_GAPDH_TAA_len41_fa0_ta20_fm6_tm14,a
2674@TOP@human_GAPDH_TAA_len41_fa0_ta20_fm6_tm14*118*a,1892,0,42,0,1934,0.022,118,2674@TOP@human_GAPDH_TAA_len41_fa0_ta20_fm6_tm14,a
2674@TOP@human_GAPDH_TAA_len41_fa0_ta20_fm6_tm14*119*g,0,0,1920,0,1920,1.0,119,2674@TOP@human_GAPDH_TAA_len41_fa0_ta20_fm6_tm14,g
2674@TOP@human_GAPDH_TAA_len41_fa0_ta20_fm6_tm14*120*g,0,0,1912,1,1913,0.999,120,2674@TOP@human_GAPDH_TAA_len41_fa0_ta20_fm6_tm14,g
2674@TOP@human_GAPDH_TAA_len41_fa0_ta20_fm6_tm14*121*a,1935,0,0,0,1935,0.0,121,2674@TOP@human_GAPDH_TAA_len41_fa0_ta20_fm6_tm14,a
2674@TOP@human_GAPDH_TAA_len41_fa0_ta20_fm6_tm14*122*g,0,0,1936,0,1936,1.0,122,2674@TOP@human_GAPDH_TAA_len41_fa0_ta20_fm6_tm14,g
2674@TOP@human_GAPDH_TAA_len41_fa0_ta20_fm6_tm14*123*t,0,1,0,1909,1910,0.0,123,2674@TOP@human_GAPDH_TAA_len41_fa0_ta20_fm6_tm14,t
2674@TOP@human_GAPDH_TAA_len41_fa0_ta20_fm6_tm14*124*a,1360,0,543,0,1903,0.285,124,2674@TOP@human_GAPDH_TAA_len41_fa0_ta20_fm6_tm14,a
2674@TOP@human_GAPDH_TAA_len41_fa0_ta20_fm6_tm14*125*a,1694,1,213,0,1908,0.112,125,2674@TOP@human_GAPDH_TAA_len41_fa0_ta20_fm6_tm14,a
2674@TOP@human_GAPDH_TAA_len41_fa0_ta20_fm6_tm14*126*g,0,0,1907,0,1907,1.0,126,2674@TOP@human_GAPDH_TAA_len41_fa0_ta20_fm6_tm14,g
2674@TOP@human_GAPDH_TAA_len41_fa0_ta20_fm6_tm14*127*a,1924,0,14,0,1938,0.007,127,2674@TOP@human_GAPDH_TAA_len41_fa0_ta20_fm6_tm14,a
2674@TOP@human_GAPDH_TAA_len41_fa0_ta20_fm6_tm14*128*c,0,1945,0,0,1945,0.0,128,2674@TOP@human_GAPDH_TAA_len41_fa0_ta20_fm6_tm14,c
2674@TOP@human_GAPDH_TAA_len41_fa0_ta20_fm6_tm14*129*c,0,1922,0,0,1922,0.0,129,2674@TOP@human_GAPDH_TAA_len41_fa0_ta20_fm6_tm14,c
2674@TOP@human_GAPDH_TAA_len41_fa0_ta20_fm6_tm14*130*c,0,1938,0,0,1938,0.0,130,2674@TOP@human_GAPDH_TAA_len41_fa0_ta20_fm6_tm14,c
2674@TOP@human_GAPDH_TAA_len41_fa0_ta20_fm6_tm14*131*c,0,1947,0,1,1948,0.0,131,2674@TOP@human_GAPDH_TAA_len41_fa0_ta20_fm6_tm14,c
2674@TOP@human_GAPDH_TAA_len41_fa0_ta20_fm6_tm14*132*t,0,1,0,1909,1910,0.0,132,2674@TOP@human_GAPDH_TAA_len41_fa0_ta20_fm6_tm14,t
2674@TOP@human_GAPDH_TAA_len41_fa0_ta20_fm6_tm14*133*g,1,0,1897,0,1898,0.999,133,2674@TOP@human_GAPDH_TAA_len41_fa0_ta20_fm6_tm14,g
2674@TOP@human_GAPDH_TAA_len41_fa0_ta20_fm6_tm14*134*g,0,0,1923,0,1923,1.0,134,2674@TOP@human_GAPDH_TAA_len41_fa0_ta20_fm6_tm14,g
2675@TOP@human_GAPDH_TAA_len41_fa0_ta20_fm6_tm14*114*t,0,0,0,386,386,0.0,114,2675@TOP@human_GAPDH_TAA_len41_fa0_ta20_fm6_tm14,t
2675@TOP@human_GAPDH_TAA_len41_fa0_ta20_fm6_tm14*115*c,0,392,0,0,392,0.0,115,2675@TOP@human_GAPDH_TAA_len41_fa0_ta20_fm6_tm14,c
2675@TOP@human_GAPDH_TAA_len41_fa0_ta20_fm6_tm14*116*c,0,389,0,0,389,0.0,116,2675@TOP@human_GAPDH_TAA_len41_fa0_ta20_fm6_tm14,c
2675@TOP@human_GAPDH_TAA_len41_fa0_ta20_fm6_tm14*117*a,382,0,2,0,384,0.005,117,2675@TOP@human_GAPDH_TAA_len41_fa0_ta20_fm6_tm14,a
2675@TOP@human_GAPDH_TAA_len41_fa0_ta20_fm6_tm14*118*a,375,0,7,0,382,0.018,118,2675@TOP@human_GAPDH_TAA_len41_fa0_ta20_fm6_tm14,a
2675@TOP@human_GAPDH_TAA_len41_fa0_ta20_fm6_tm14*119*g,0,0,380,3,383,0.992,119,2675@TOP@human_GAPDH_TAA_len41_fa0_ta20_fm6_tm14,g
2675@TOP@human_GAPDH_TAA_len41_fa0_ta20_fm6_tm14*120*g,0,0,379,0,379,1.0,120,2675@TOP@human_GAPDH_TAA_len41_fa0_ta20_fm6_tm14,g
2675@TOP@human_GAPDH_TAA_len41_fa0_ta20_fm6_tm14*121*a,388,0,0,0,388,0.0,121,2675@TOP@human_GAPDH_TAA_len41_fa0_ta20_fm6_tm14,a
2675@TOP@human_GAPDH_TAA_len41_fa0_ta20_fm6_tm14*122*g,0,0,387,0,387,1.0,122,2675@TOP@human_GAPDH_TAA_len41_fa0_ta20_fm6_tm14,g
2675@TOP@human_GAPDH_TAA_len41_fa0_ta20_fm6_tm14*123*t,0,0,1,380,381,0.003,123,2675@TOP@human_GAPDH_TAA_len41_fa0_ta20_fm6_tm14,t
2675@TOP@human_GAPDH_TAA_len41_fa0_ta20_fm6_tm14*124*a,334,0,47,0,381,0.123,124,2675@TOP@human_GAPDH_TAA_len41_fa0_ta20_fm6_tm14,a
2675@TOP@human_GAPDH_TAA_len41_fa0_ta20_fm6_tm14*125*a,339,0,38,0,377,0.101,125,2675@TOP@human_GAPDH_TAA_len41_fa0_ta20_fm6_tm14,a
2675@TOP@human_GAPDH_TAA_len41_fa0_ta20_fm6_tm14*126*g,0,0,383,0,383,1.0,126,2675@TOP@human_GAPDH_TAA_len41_fa0_ta20_fm6_tm14,g
2675@TOP@human_GAPDH_TAA_len41_fa0_ta20_fm6_tm14*127*a,389,0,1,0,390,0.003,127,2675@TOP@human_GAPDH_TAA_len41_fa0_ta20_fm6_tm14,a
2675@TOP@human_GAPDH_TAA_len41_fa0_ta20_fm6_tm14*128*c,0,388,0,0,388,0.0,128,2675@TOP@human_GAPDH_TAA_len41_fa0_ta20_fm6_tm14,c
2675@TOP@human_GAPDH_TAA_len41_fa0_ta20_fm6_tm14*129*c,0,386,0,0,386,0.0,129,2675@TOP@human_GAPDH_TAA_len41_fa0_ta20_fm6_tm14,c
2675@TOP@human_GAPDH_TAA_len41_fa0_ta20_fm6_tm14*130*c,0,387,0,0,387,0.0,130,2675@TOP@human_GAPDH_TAA_len41_fa0_ta20_fm6_tm14,c
2675@TOP@human_GAPDH_TAA_len41_fa0_ta20_fm6_tm14*131*c,0,390,0,0,390,0.0,131,2675@TOP@human_GAPDH_TAA_len41_fa0_ta20_fm6_tm14,c
2675@TOP@human_GAPDH_TAA_len41_fa0_ta20_fm6_tm14*132*t,0,0,0,386,386,0.0,132,2675@TOP@human_GAPDH_TAA_len41_fa0_ta20_fm6_tm14,t
2675@TOP@human_GAPDH_TAA_len41_fa0_ta20_fm6_tm14*133*g,0,0,386,0,386,1.0,133,2675@TOP@human_GAPDH_TAA_len41_fa0_ta20_fm6_tm14,g
2675@TOP@human_GAPDH_TAA_len41_fa0_ta20_fm6_tm14*134*g,0,0,381,0,381,1.0,134,2675@TOP@human_GAPDH_TAA_len41_fa0_ta20_fm6_tm14,g
2676@TOP@human_GAPDH_TAA_len41_fa0_ta20_fm6_tm14*114*t,0,0,0,1210,1210,0.0,114,2676@TOP@human_GAPDH_TAA_len41_fa0_ta20_fm6_tm14,t
2676@TOP@human_GAPDH_TAA_len41_fa0_ta20_fm6_tm14*115*c,0,1221,0,0,1221,0.0,115,2676@TOP@human_GAPDH_TAA_len41_fa0_ta20_fm6_tm14,c
2676@TOP@human_GAPDH_TAA_len41_fa0_ta20_fm6_tm14*116*c,0,1220,0,0,1220,0.0,116,2676@TOP@human_GAPDH_TAA_len41_fa0_ta20_fm6_tm14,c
2676@TOP@human_GAPDH_TAA_len41_fa0_ta20_fm6_tm14*117*a,1217,0,0,0,1217,0.0,117,2676@TOP@human_GAPDH_TAA_len41_fa0_ta20_fm6_tm14,a
2676@TOP@human_GAPDH_TAA_len41_fa0_ta20_fm6_tm14*118*a,1187,0,21,0,1208,0.017,118,2676@TOP@human_GAPDH_TAA_len41_fa0_ta20_fm6_tm14,a
2676@TOP@human_GAPDH_TAA_len41_fa0_ta20_fm6_tm14*119*g,0,0,1206,0,1206,1.0,119,2676@TOP@human_GAPDH_TAA_len41_fa0_ta20_fm6_tm14,g
2676@TOP@human_GAPDH_TAA_len41_fa0_ta20_fm6_tm14*120*g,0,0,1201,0,1201,1.0,120,2676@TOP@human_GAPDH_TAA_len41_fa0_ta20_fm6_tm14,g
2676@TOP@human_GAPDH_TAA_len41_fa0_ta20_fm6_tm14*121*a,1209,0,2,0,1211,0.002,121,2676@TOP@human_GAPDH_TAA_len41_fa0_ta20_fm6_tm14,a
2676@TOP@human_GAPDH_TAA_len41_fa0_ta20_fm6_tm14*122*g,0,0,1218,0,1218,1.0,122,2676@TOP@human_GAPDH_TAA_len41_fa0_ta20_fm6_tm14,g
2676@TOP@human_GAPDH_TAA_len41_fa0_ta20_fm6_tm14*123*t,0,0,0,1204,1204,0.0,123,2676@TOP@human_GAPDH_TAA_len41_fa0_ta20_fm6_tm14,t
2676@TOP@human_GAPDH_TAA_len41_fa0_ta20_fm6_tm14*124*a,868,0,343,0,1211,0.283,124,2676@TOP@human_GAPDH_TAA_len41_fa0_ta20_fm6_tm14,a
2676@TOP@human_GAPDH_TAA_len41_fa0_ta20_fm6_tm14*125*a,994,0,208,0,1202,0.173,125,2676@TOP@human_GAPDH_TAA_len41_fa0_ta20_fm6_tm14,a
2676@TOP@human_GAPDH_TAA_len41_fa0_ta20_fm6_tm14*126*g,0,0,1205,0,1205,1.0,126,2676@TOP@human_GAPDH_TAA_len41_fa0_ta20_fm6_tm14,g
2676@TOP@human_GAPDH_TAA_len41_fa0_ta20_fm6_tm14*127*a,1187,0,23,0,1210,0.019,127,2676@TOP@human_GAPDH_TAA_len41_fa0_ta20_fm6_tm14,a
2676@TOP@human_GAPDH_TAA_len41_fa0_ta20_fm6_tm14*128*c,0,1217,0,0,1217,0.0,128,2676@TOP@human_GAPDH_TAA_len41_fa0_ta20_fm6_tm14,c
2676@TOP@human_GAPDH_TAA_len41_fa0_ta20_fm6_tm14*129*c,0,1210,0,0,1210,0.0,129,2676@TOP@human_GAPDH_TAA_len41_fa0_ta20_fm6_tm14,c
2676@TOP@human_GAPDH_TAA_len41_fa0_ta20_fm6_tm14*130*c,1,1218,0,0,1219,0.0,130,2676@TOP@human_GAPDH_TAA_len41_fa0_ta20_fm6_tm14,c
2676@TOP@human_GAPDH_TAA_len41_fa0_ta20_fm6_tm14*131*c,0,1216,0,0,1216,0.0,131,2676@TOP@human_GAPDH_TAA_len41_fa0_ta20_fm6_tm14,c
2676@TOP@human_GAPDH_TAA_len41_fa0_ta20_fm6_tm14*132*t,0,0,0,1207,1207,0.0,132,2676@TOP@human_GAPDH_TAA_len41_fa0_ta20_fm6_tm14,t
2676@TOP@human_GAPDH_TAA_len41_fa0_ta20_fm6_tm14*133*g,0,0,1197,0,1197,1.0,133,2676@TOP@human_GAPDH_TAA_len41_fa0_ta20_fm6_tm14,g
2676@TOP@human_GAPDH_TAA_len41_fa0_ta20_fm6_tm14*134*g,0,0,1212,0,1212,1.0,134,2676@TOP@human_GAPDH_TAA_len41_fa0_ta20_fm6_tm14,g
2677@TOP@human_GAPDH_TAA_len41_fa0_ta20_fm6_tm14*114*t,0,0,0,738,738,0.0,114,2677@TOP@human_GAPDH_TAA_len41_fa0_ta20_fm6_tm14,t
2677@TOP@human_GAPDH_TAA_len41_fa0_ta20_fm6_tm14*115*c,0,746,0,0,746,0.0,115,2677@TOP@human_GAPDH_TAA_len41_fa0_ta20_fm6_tm14,c
2677@TOP@human_GAPDH_TAA_len41_fa0_ta20_fm6_tm14*116*c,0,743,0,0,743,0.0,116,2677@TOP@human_GAPDH_TAA_len41_fa0_ta20_fm6_tm14,c
2677@TOP@human_GAPDH_TAA_len41_fa0_ta20_fm6_tm14*117*a,732,0,7,0,739,0.009,117,2677@TOP@human_GAPDH_TAA_len41_fa0_ta20_fm6_tm14,a
2677@TOP@human_GAPDH_TAA_len41_fa0_ta20_fm6_tm14*118*a,703,0,34,0,737,0.046,118,2677@TOP@human_GAPDH_TAA_len41_fa0_ta20_fm6_tm14,a
2677@TOP@human_GAPDH_TAA_len41_fa0_ta20_fm6_tm14*119*g,0,0,733,0,733,1.0,119,2677@TOP@human_GAPDH_TAA_len41_fa0_ta20_fm6_tm14,g
2677@TOP@human_GAPDH_TAA_len41_fa0_ta20_fm6_tm14*120*g,0,0,731,0,731,1.0,120,2677@TOP@human_GAPDH_TAA_len41_fa0_ta20_fm6_tm14,g
2677@TOP@human_GAPDH_TAA_len41_fa0_ta20_fm6_tm14*121*a,742,0,1,0,743,0.001,121,2677@TOP@human_GAPDH_TAA_len41_fa0_ta20_fm6_tm14,a
2677@TOP@human_GAPDH_TAA_len41_fa0_ta20_fm6_tm14*122*g,0,0,741,1,742,0.999,122,2677@TOP@human_GAPDH_TAA_len41_fa0_ta20_fm6_tm14,g
2677@TOP@human_GAPDH_TAA_len41_fa0_ta20_fm6_tm14*123*t,0,0,0,723,723,0.0,123,2677@TOP@human_GAPDH_TAA_len41_fa0_ta20_fm6_tm14,t
2677@TOP@human_GAPDH_TAA_len41_fa0_ta20_fm6_tm14*124*a,600,0,137,0,737,0.186,124,2677@TOP@human_GAPDH_TAA_len41_fa0_ta20_fm6_tm14,a
2677@TOP@human_GAPDH_TAA_len41_fa0_ta20_fm6_tm14*125*a,685,0,49,0,734,0.067,125,2677@TOP@human_GAPDH_TAA_len41_fa0_ta20_fm6_tm14,a
2677@TOP@human_GAPDH_TAA_len41_fa0_ta20_fm6_tm14*126*g,0,0,729,0,729,1.0,126,2677@TOP@human_GAPDH_TAA_len41_fa0_ta20_fm6_tm14,g
2677@TOP@human_GAPDH_TAA_len41_fa0_ta20_fm6_tm14*127*a,732,0,6,0,738,0.008,127,2677@TOP@human_GAPDH_TAA_len41_fa0_ta20_fm6_tm14,a
2677@TOP@human_GAPDH_TAA_len41_fa0_ta20_fm6_tm14*128*c,0,744,0,0,744,0.0,128,2677@TOP@human_GAPDH_TAA_len41_fa0_ta20_fm6_tm14,c
2677@TOP@human_GAPDH_TAA_len41_fa0_ta20_fm6_tm14*129*c,0,739,0,0,739,0.0,129,2677@TOP@human_GAPDH_TAA_len41_fa0_ta20_fm6_tm14,c
2677@TOP@human_GAPDH_TAA_len41_fa0_ta20_fm6_tm14*130*c,0,742,0,0,742,0.0,130,2677@TOP@human_GAPDH_TAA_len41_fa0_ta20_fm6_tm14,c
2677@TOP@human_GAPDH_TAA_len41_fa0_ta20_fm6_tm14*131*c,1,744,0,0,745,0.0,131,2677@TOP@human_GAPDH_TAA_len41_fa0_ta20_fm6_tm14,c
2677@TOP@human_GAPDH_TAA_len41_fa0_ta20_fm6_tm14*132*t,0,0,0,739,739,0.0,132,2677@TOP@human_GAPDH_TAA_len41_fa0_ta20_fm6_tm14,t
2677@TOP@human_GAPDH_TAA_len41_fa0_ta20_fm6_tm14*133*g,0,0,735,0,735,1.0,133,2677@TOP@human_GAPDH_TAA_len41_fa0_ta20_fm6_tm14,g
2677@TOP@human_GAPDH_TAA_len41_fa0_ta20_fm6_tm14*134*g,0,1,734,0,735,0.999,134,2677@TOP@human_GAPDH_TAA_len41_fa0_ta20_fm6_tm14,g
2678@TOP@human_GAPDH_TAA_len41_fa0_ta20_fm6_tm14*114*t,0,0,0,332,332,0.0,114,2678@TOP@human_GAPDH_TAA_len41_fa0_ta20_fm6_tm14,t
2678@TOP@human_GAPDH_TAA_len41_fa0_ta20_fm6_tm14*115*c,0,336,0,0,336,0.0,115,2678@TOP@human_GAPDH_TAA_len41_fa0_ta20_fm6_tm14,c
2678@TOP@human_GAPDH_TAA_len41_fa0_ta20_fm6_tm14*116*c,0,333,0,0,333,0.0,116,2678@TOP@human_GAPDH_TAA_len41_fa0_ta20_fm6_tm14,c
2678@TOP@human_GAPDH_TAA_len41_fa0_ta20_fm6_tm14*117*a,336,0,0,0,336,0.0,117,2678@TOP@human_GAPDH_TAA_len41_fa0_ta20_fm6_tm14,a
2678@TOP@human_GAPDH_TAA_len41_fa0_ta20_fm6_tm14*118*a,320,0,8,0,328,0.024,118,2678@TOP@human_GAPDH_TAA_len41_fa0_ta20_fm6_tm14,a
2678@TOP@human_GAPDH_TAA_len41_fa0_ta20_fm6_tm14*119*g,2,0,326,0,328,0.994,119,2678@TOP@human_GAPDH_TAA_len41_fa0_ta20_fm6_tm14,g
2678@TOP@human_GAPDH_TAA_len41_fa0_ta20_fm6_tm14*120*g,0,0,327,0,327,1.0,120,2678@TOP@human_GAPDH_TAA_len41_fa0_ta20_fm6_tm14,g
2678@TOP@human_GAPDH_TAA_len41_fa0_ta20_fm6_tm14*121*a,333,0,0,0,333,0.0,121,2678@TOP@human_GAPDH_TAA_len41_fa0_ta20_fm6_tm14,a
2678@TOP@human_GAPDH_TAA_len41_fa0_ta20_fm6_tm14*122*g,0,0,332,0,332,1.0,122,2678@TOP@human_GAPDH_TAA_len41_fa0_ta20_fm6_tm14,g
2678@TOP@human_GAPDH_TAA_len41_fa0_ta20_fm6_tm14*123*t,0,0,0,323,323,0.0,123,2678@TOP@human_GAPDH_TAA_len41_fa0_ta20_fm6_tm14,t
2678@TOP@human_GAPDH_TAA_len41_fa0_ta20_fm6_tm14*124*a,292,0,38,0,330,0.115,124,2678@TOP@human_GAPDH_TAA_len41_fa0_ta20_fm6_tm14,a
2678@TOP@human_GAPDH_TAA_len41_fa0_ta20_fm6_tm14*125*a,314,0,13,0,327,0.04,125,2678@TOP@human_GAPDH_TAA_len41_fa0_ta20_fm6_tm14,a
2678@TOP@human_GAPDH_TAA_len41_fa0_ta20_fm6_tm14*126*g,0,0,332,0,332,1.0,126,2678@TOP@human_GAPDH_TAA_len41_fa0_ta20_fm6_tm14,g
2678@TOP@human_GAPDH_TAA_len41_fa0_ta20_fm6_tm14*127*a,334,0,1,0,335,0.003,127,2678@TOP@human_GAPDH_TAA_len41_fa0_ta20_fm6_tm14,a
2678@TOP@human_GAPDH_TAA_len41_fa0_ta20_fm6_tm14*128*c,0,335,0,0,335,0.0,128,2678@TOP@human_GAPDH_TAA_len41_fa0_ta20_fm6_tm14,c
2678@TOP@human_GAPDH_TAA_len41_fa0_ta20_fm6_tm14*129*c,0,330,0,0,330,0.0,129,2678@TOP@human_GAPDH_TAA_len41_fa0_ta20_fm6_tm14,c
2678@TOP@human_GAPDH_TAA_len41_fa0_ta20_fm6_tm14*130*c,0,333,0,0,333,0.0,130,2678@TOP@human_GAPDH_TAA_len41_fa0_ta20_fm6_tm14,c
2678@TOP@human_GAPDH_TAA_len41_fa0_ta20_fm6_tm14*131*c,0,334,0,0,334,0.0,131,2678@TOP@human_GAPDH_TAA_len41_fa0_ta20_fm6_tm14,c
2678@TOP@human_GAPDH_TAA_len41_fa0_ta20_fm6_tm14*132*t,0,5,0,314,319,0.0,132,2678@TOP@human_GAPDH_TAA_len41_fa0_ta20_fm6_tm14,t
2678@TOP@human_GAPDH_TAA_len41_fa0_ta20_fm6_tm14*133*g,0,0,329,0,329,1.0,133,2678@TOP@human_GAPDH_TAA_len41_fa0_ta20_fm6_tm14,g
2678@TOP@human_GAPDH_TAA_len41_fa0_ta20_fm6_tm14*134*g,0,0,327,0,327,1.0,134,2678@TOP@human_GAPDH_TAA_len41_fa0_ta20_fm6_tm14,g
2679@TOP@human_GAPDH_TAA_len41_fa0_ta20_fm6_tm14*114*t,0,1,0,527,528,0.0,114,2679@TOP@human_GAPDH_TAA_len41_fa0_ta20_fm6_tm14,t
2679@TOP@human_GAPDH_TAA_len41_fa0_ta20_fm6_tm14*115*c,0,534,0,0,534,0.0,115,2679@TOP@human_GAPDH_TAA_len41_fa0_ta20_fm6_tm14,c
2679@TOP@human_GAPDH_TAA_len41_fa0_ta20_fm6_tm14*116*c,0,524,0,0,524,0.0,116,2679@TOP@human_GAPDH_TAA_len41_fa0_ta20_fm6_tm14,c
2679@TOP@human_GAPDH_TAA_len41_fa0_ta20_fm6_tm14*117*a,530,0,0,0,530,0.0,117,2679@TOP@human_GAPDH_TAA_len41_fa0_ta20_fm6_tm14,a
2679@TOP@human_GAPDH_TAA_len41_fa0_ta20_fm6_tm14*118*a,509,0,17,0,526,0.032,118,2679@TOP@human_GAPDH_TAA_len41_fa0_ta20_fm6_tm14,a
2679@TOP@human_GAPDH_TAA_len41_fa0_ta20_fm6_tm14*119*g,0,0,525,0,525,1.0,119,2679@TOP@human_GAPDH_TAA_len41_fa0_ta20_fm6_tm14,g
2679@TOP@human_GAPDH_TAA_len41_fa0_ta20_fm6_tm14*120*g,0,0,507,0,507,1.0,120,2679@TOP@human_GAPDH_TAA_len41_fa0_ta20_fm6_tm14,g
2679@TOP@human_GAPDH_TAA_len41_fa0_ta20_fm6_tm14*121*a,527,0,0,0,527,0.0,121,2679@TOP@human_GAPDH_TAA_len41_fa0_ta20_fm6_tm14,a
2679@TOP@human_GAPDH_TAA_len41_fa0_ta20_fm6_tm14*122*g,0,0,527,0,527,1.0,122,2679@TOP@human_GAPDH_TAA_len41_fa0_ta20_fm6_tm14,g
2679@TOP@human_GAPDH_TAA_len41_fa0_ta20_fm6_tm14*123*t,0,0,0,509,509,0.0,123,2679@TOP@human_GAPDH_TAA_len41_fa0_ta20_fm6_tm14,t
2679@TOP@human_GAPDH_TAA_len41_fa0_ta20_fm6_tm14*124*a,438,0,82,0,520,0.158,124,2679@TOP@human_GAPDH_TAA_len41_fa0_ta20_fm6_tm14,a
2679@TOP@human_GAPDH_TAA_len41_fa0_ta20_fm6_tm14*125*a,456,0,59,0,515,0.115,125,2679@TOP@human_GAPDH_TAA_len41_fa0_ta20_fm6_tm14,a
2679@TOP@human_GAPDH_TAA_len41_fa0_ta20_fm6_tm14*126*g,0,0,513,0,513,1.0,126,2679@TOP@human_GAPDH_TAA_len41_fa0_ta20_fm6_tm14,g
2679@TOP@human_GAPDH_TAA_len41_fa0_ta20_fm6_tm14*127*a,529,0,0,0,529,0.0,127,2679@TOP@human_GAPDH_TAA_len41_fa0_ta20_fm6_tm14,a
2679@TOP@human_GAPDH_TAA_len41_fa0_ta20_fm6_tm14*128*c,0,531,0,0,531,0.0,128,2679@TOP@human_GAPDH_TAA_len41_fa0_ta20_fm6_tm14,c
2679@TOP@human_GAPDH_TAA_len41_fa0_ta20_fm6_tm14*129*c,0,517,0,0,517,0.0,129,2679@TOP@human_GAPDH_TAA_len41_fa0_ta20_fm6_tm14,c
2679@TOP@human_GAPDH_TAA_len41_fa0_ta20_fm6_tm14*130*c,0,528,0,0,528,0.0,130,2679@TOP@human_GAPDH_TAA_len41_fa0_ta20_fm6_tm14,c
2679@TOP@human_GAPDH_TAA_len41_fa0_ta20_fm6_tm14*131*c,0,531,0,0,531,0.0,131,2679@TOP@human_GAPDH_TAA_len41_fa0_ta20_fm6_tm14,c
2679@TOP@human_GAPDH_TAA_len41_fa0_ta20_fm6_tm14*132*t,0,1,0,506,507,0.0,132,2679@TOP@human_GAPDH_TAA_len41_fa0_ta20_fm6_tm14,t
2679@TOP@human_GAPDH_TAA_len41_fa0_ta20_fm6_tm14*133*g,0,0,513,0,513,1.0,133,2679@TOP@human_GAPDH_TAA_len41_fa0_ta20_fm6_tm14,g
2679@TOP@human_GAPDH_TAA_len41_fa0_ta20_fm6_tm14*134*g,0,0,516,0,516,1.0,134,2679@TOP@human_GAPDH_TAA_len41_fa0_ta20_fm6_tm14,g
2680@TOP@human_GAPDH_TAA_len41_fa0_ta20_fm6_tm14*114*t,0,0,0,750,750,0.0,114,2680@TOP@human_GAPDH_TAA_len41_fa0_ta20_fm6_tm14,t
2680@TOP@human_GAPDH_TAA_len41_fa0_ta20_fm6_tm14*115*c,0,760,0,1,761,0.0,115,2680@TOP@human_GAPDH_TAA_len41_fa0_ta20_fm6_tm14,c
2680@TOP@human_GAPDH_TAA_len41_fa0_ta20_fm6_tm14*116*c,0,756,0,0,756,0.0,116,2680@TOP@human_GAPDH_TAA_len41_fa0_ta20_fm6_tm14,c
2680@TOP@human_GAPDH_TAA_len41_fa0_ta20_fm6_tm14*117*a,755,0,2,0,757,0.003,117,2680@TOP@human_GAPDH_TAA_len41_fa0_ta20_fm6_tm14,a
2680@TOP@human_GAPDH_TAA_len41_fa0_ta20_fm6_tm14*118*a,709,0,40,0,749,0.053,118,2680@TOP@human_GAPDH_TAA_len41_fa0_ta20_fm6_tm14,a
2680@TOP@human_GAPDH_TAA_len41_fa0_ta20_fm6_tm14*119*g,0,0,753,0,753,1.0,119,2680@TOP@human_GAPDH_TAA_len41_fa0_ta20_fm6_tm14,g
2680@TOP@human_GAPDH_TAA_len41_fa0_ta20_fm6_tm14*120*g,0,0,742,0,742,1.0,120,2680@TOP@human_GAPDH_TAA_len41_fa0_ta20_fm6_tm14,g
2680@TOP@human_GAPDH_TAA_len41_fa0_ta20_fm6_tm14*121*a,754,0,0,0,754,0.0,121,2680@TOP@human_GAPDH_TAA_len41_fa0_ta20_fm6_tm14,a
2680@TOP@human_GAPDH_TAA_len41_fa0_ta20_fm6_tm14*122*g,0,0,757,0,757,1.0,122,2680@TOP@human_GAPDH_TAA_len41_fa0_ta20_fm6_tm14,g
2680@TOP@human_GAPDH_TAA_len41_fa0_ta20_fm6_tm14*123*t,0,0,0,746,746,0.0,123,2680@TOP@human_GAPDH_TAA_len41_fa0_ta20_fm6_tm14,t
2680@TOP@human_GAPDH_TAA_len41_fa0_ta20_fm6_tm14*124*a,679,0,67,0,746,0.09,124,2680@TOP@human_GAPDH_TAA_len41_fa0_ta20_fm6_tm14,a
2680@TOP@human_GAPDH_TAA_len41_fa0_ta20_fm6_tm14*125*a,685,0,62,0,747,0.083,125,2680@TOP@human_GAPDH_TAA_len41_fa0_ta20_fm6_tm14,a
2680@TOP@human_GAPDH_TAA_len41_fa0_ta20_fm6_tm14*126*g,0,0,747,0,747,1.0,126,2680@TOP@human_GAPDH_TAA_len41_fa0_ta20_fm6_tm14,g
2680@TOP@human_GAPDH_TAA_len41_fa0_ta20_fm6_tm14*127*a,747,0,4,0,751,0.005,127,2680@TOP@human_GAPDH_TAA_len41_fa0_ta20_fm6_tm14,a
2680@TOP@human_GAPDH_TAA_len41_fa0_ta20_fm6_tm14*128*c,0,757,0,0,757,0.0,128,2680@TOP@human_GAPDH_TAA_len41_fa0_ta20_fm6_tm14,c
2680@TOP@human_GAPDH_TAA_len41_fa0_ta20_fm6_tm14*129*c,0,756,0,0,756,0.0,129,2680@TOP@human_GAPDH_TAA_len41_fa0_ta20_fm6_tm14,c
2680@TOP@human_GAPDH_TAA_len41_fa0_ta20_fm6_tm14*130*c,0,755,0,0,755,0.0,130,2680@TOP@human_GAPDH_TAA_len41_fa0_ta20_fm6_tm14,c
2680@TOP@human_GAPDH_TAA_len41_fa0_ta20_fm6_tm14*131*c,0,758,0,0,758,0.0,131,2680@TOP@human_GAPDH_TAA_len41_fa0_ta20_fm6_tm14,c
2680@TOP@human_GAPDH_TAA_len41_fa0_ta20_fm6_tm14*132*t,0,0,0,745,745,0.0,132,2680@TOP@human_GAPDH_TAA_len41_fa0_ta20_fm6_tm14,t
2680@TOP@human_GAPDH_TAA_len41_fa0_ta20_fm6_tm14*133*g,0,1,750,0,751,0.999,133,2680@TOP@human_GAPDH_TAA_len41_fa0_ta20_fm6_tm14,g
2680@TOP@human_GAPDH_TAA_len41_fa0_ta20_fm6_tm14*134*g,2,0,748,0,750,0.997,134,2680@TOP@human_GAPDH_TAA_len41_fa0_ta20_fm6_tm14,g
2681@TOP@human_GAPDH_TAA_len41_fa0_ta20_fm6_tm14*114*t,0,0,1,646,647,0.002,114,2681@TOP@human_GAPDH_TAA_len41_fa0_ta20_fm6_tm14,t
2681@TOP@human_GAPDH_TAA_len41_fa0_ta20_fm6_tm14*115*c,0,649,0,0,649,0.0,115,2681@TOP@human_GAPDH_TAA_len41_fa0_ta20_fm6_tm14,c
2681@TOP@human_GAPDH_TAA_len41_fa0_ta20_fm6_tm14*116*c,0,648,0,0,648,0.0,116,2681@TOP@human_GAPDH_TAA_len41_fa0_ta20_fm6_tm14,c
2681@TOP@human_GAPDH_TAA_len41_fa0_ta20_fm6_tm14*117*a,644,0,0,0,644,0.0,117,2681@TOP@human_GAPDH_TAA_len41_fa0_ta20_fm6_tm14,a
2681@TOP@human_GAPDH_TAA_len41_fa0_ta20_fm6_tm14*118*a,630,0,12,0,642,0.019,118,2681@TOP@human_GAPDH_TAA_len41_fa0_ta20_fm6_tm14,a
2681@TOP@human_GAPDH_TAA_len41_fa0_ta20_fm6_tm14*119*g,0,0,632,0,632,1.0,119,2681@TOP@human_GAPDH_TAA_len41_fa0_ta20_fm6_tm14,g
2681@TOP@human_GAPDH_TAA_len41_fa0_ta20_fm6_tm14*120*g,0,0,633,0,633,1.0,120,2681@TOP@human_GAPDH_TAA_len41_fa0_ta20_fm6_tm14,g
2681@TOP@human_GAPDH_TAA_len41_fa0_ta20_fm6_tm14*121*a,645,0,0,0,645,0.0,121,2681@TOP@human_GAPDH_TAA_len41_fa0_ta20_fm6_tm14,a
2681@TOP@human_GAPDH_TAA_len41_fa0_ta20_fm6_tm14*122*g,0,0,645,0,645,1.0,122,2681@TOP@human_GAPDH_TAA_len41_fa0_ta20_fm6_tm14,g
2681@TOP@human_GAPDH_TAA_len41_fa0_ta20_fm6_tm14*123*t,0,0,0,641,641,0.0,123,2681@TOP@human_GAPDH_TAA_len41_fa0_ta20_fm6_tm14,t
2681@TOP@human_GAPDH_TAA_len41_fa0_ta20_fm6_tm14*124*a,492,0,146,0,638,0.229,124,2681@TOP@human_GAPDH_TAA_len41_fa0_ta20_fm6_tm14,a
2681@TOP@human_GAPDH_TAA_len41_fa0_ta20_fm6_tm14*125*a,565,0,68,0,633,0.107,125,2681@TOP@human_GAPDH_TAA_len41_fa0_ta20_fm6_tm14,a
2681@TOP@human_GAPDH_TAA_len41_fa0_ta20_fm6_tm14*126*g,0,0,639,0,639,1.0,126,2681@TOP@human_GAPDH_TAA_len41_fa0_ta20_fm6_tm14,g
2681@TOP@human_GAPDH_TAA_len41_fa0_ta20_fm6_tm14*127*a,641,0,3,0,644,0.005,127,2681@TOP@human_GAPDH_TAA_len41_fa0_ta20_fm6_tm14,a
2681@TOP@human_GAPDH_TAA_len41_fa0_ta20_fm6_tm14*128*c,0,642,0,3,645,0.0,128,2681@TOP@human_GAPDH_TAA_len41_fa0_ta20_fm6_tm14,c
2681@TOP@human_GAPDH_TAA_len41_fa0_ta20_fm6_tm14*129*c,0,633,0,0,633,0.0,129,2681@TOP@human_GAPDH_TAA_len41_fa0_ta20_fm6_tm14,c
2681@TOP@human_GAPDH_TAA_len41_fa0_ta20_fm6_tm14*130*c,0,647,0,0,647,0.0,130,2681@TOP@human_GAPDH_TAA_len41_fa0_ta20_fm6_tm14,c
2681@TOP@human_GAPDH_TAA_len41_fa0_ta20_fm6_tm14*131*c,0,644,0,0,644,0.0,131,2681@TOP@human_GAPDH_TAA_len41_fa0_ta20_fm6_tm14,c
2681@TOP@human_GAPDH_TAA_len41_fa0_ta20_fm6_tm14*132*t,0,0,0,638,638,0.0,132,2681@TOP@human_GAPDH_TAA_len41_fa0_ta20_fm6_tm14,t
2681@TOP@human_GAPDH_TAA_len41_fa0_ta20_fm6_tm14*133*g,0,0,624,0,624,1.0,133,2681@TOP@human_GAPDH_TAA_len41_fa0_ta20_fm6_tm14,g
2681@TOP@human_GAPDH_TAA_len41_fa0_ta20_fm6_tm14*134*g,0,0,637,0,637,1.0,134,2681@TOP@human_GAPDH_TAA_len41_fa0_ta20_fm6_tm14,g
2682@TOP@human_GAPDH_TAA_len41_fa0_ta20_fm6_tm14*114*t,0,0,1,1466,1467,0.001,114,2682@TOP@human_GAPDH_TAA_len41_fa0_ta20_fm6_tm14,t
2682@TOP@human_GAPDH_TAA_len41_fa0_ta20_fm6_tm14*115*c,1,1470,0,0,1471,0.0,115,2682@TOP@human_GAPDH_TAA_len41_fa0_ta20_fm6_tm14,c
2682@TOP@human_GAPDH_TAA_len41_fa0_ta20_fm6_tm14*116*c,0,1466,0,0,1466,0.0,116,2682@TOP@human_GAPDH_TAA_len41_fa0_ta20_fm6_tm14,c
2682@TOP@human_GAPDH_TAA_len41_fa0_ta20_fm6_tm14*117*a,1458,0,3,0,1461,0.002,117,2682@TOP@human_GAPDH_TAA_len41_fa0_ta20_fm6_tm14,a
2682@TOP@human_GAPDH_TAA_len41_fa0_ta20_fm6_tm14*118*a,1399,0,59,0,1458,0.04,118,2682@TOP@human_GAPDH_TAA_len41_fa0_ta20_fm6_tm14,a
2682@TOP@human_GAPDH_TAA_len41_fa0_ta20_fm6_tm14*119*g,0,0,1453,0,1453,1.0,119,2682@TOP@human_GAPDH_TAA_len41_fa0_ta20_fm6_tm14,g
2682@TOP@human_GAPDH_TAA_len41_fa0_ta20_fm6_tm14*120*g,0,0,1443,0,1443,1.0,120,2682@TOP@human_GAPDH_TAA_len41_fa0_ta20_fm6_tm14,g
2682@TOP@human_GAPDH_TAA_len41_fa0_ta20_fm6_tm14*121*a,1461,0,2,0,1463,0.001,121,2682@TOP@human_GAPDH_TAA_len41_fa0_ta20_fm6_tm14,a
2682@TOP@human_GAPDH_TAA_len41_fa0_ta20_fm6_tm14*122*g,1,0,1463,0,1464,0.999,122,2682@TOP@human_GAPDH_TAA_len41_fa0_ta20_fm6_tm14,g
2682@TOP@human_GAPDH_TAA_len41_fa0_ta20_fm6_tm14*123*t,0,0,0,1444,1444,0.0,123,2682@TOP@human_GAPDH_TAA_len41_fa0_ta20_fm6_tm14,t
2682@TOP@human_GAPDH_TAA_len41_fa0_ta20_fm6_tm14*124*a,1000,0,449,0,1449,0.31,124,2682@TOP@human_GAPDH_TAA_len41_fa0_ta20_fm6_tm14,a
2682@TOP@human_GAPDH_TAA_len41_fa0_ta20_fm6_tm14*125*a,1344,0,96,0,1440,0.067,125,2682@TOP@human_GAPDH_TAA_len41_fa0_ta20_fm6_tm14,a
2682@TOP@human_GAPDH_TAA_len41_fa0_ta20_fm6_tm14*126*g,0,0,1447,0,1447,1.0,126,2682@TOP@human_GAPDH_TAA_len41_fa0_ta20_fm6_tm14,g
2682@TOP@human_GAPDH_TAA_len41_fa0_ta20_fm6_tm14*127*a,1454,0,4,0,1458,0.003,127,2682@TOP@human_GAPDH_TAA_len41_fa0_ta20_fm6_tm14,a
2682@TOP@human_GAPDH_TAA_len41_fa0_ta20_fm6_tm14*128*c,0,1472,0,0,1472,0.0,128,2682@TOP@human_GAPDH_TAA_len41_fa0_ta20_fm6_tm14,c
2682@TOP@human_GAPDH_TAA_len41_fa0_ta20_fm6_tm14*129*c,0,1455,0,0,1455,0.0,129,2682@TOP@human_GAPDH_TAA_len41_fa0_ta20_fm6_tm14,c
2682@TOP@human_GAPDH_TAA_len41_fa0_ta20_fm6_tm14*130*c,0,1467,0,0,1467,0.0,130,2682@TOP@human_GAPDH_TAA_len41_fa0_ta20_fm6_tm14,c
2682@TOP@human_GAPDH_TAA_len41_fa0_ta20_fm6_tm14*131*c,0,1470,0,0,1470,0.0,131,2682@TOP@human_GAPDH_TAA_len41_fa0_ta20_fm6_tm14,c
2682@TOP@human_GAPDH_TAA_len41_fa0_ta20_fm6_tm14*132*t,0,1,0,1445,1446,0.0,132,2682@TOP@human_GAPDH_TAA_len41_fa0_ta20_fm6_tm14,t
2682@TOP@human_GAPDH_TAA_len41_fa0_ta20_fm6_tm14*133*g,2,0,1438,0,1440,0.999,133,2682@TOP@human_GAPDH_TAA_len41_fa0_ta20_fm6_tm14,g
2682@TOP@human_GAPDH_TAA_len41_fa0_ta20_fm6_tm14*134*g,0,0,1443,0,1443,1.0,134,2682@TOP@human_GAPDH_TAA_len41_fa0_ta20_fm6_tm14,g
2683@TOP@human_GAPDH_TAA_len41_fa0_ta20_fm6_tm14*114*t,0,0,0,529,529,0.0,114,2683@TOP@human_GAPDH_TAA_len41_fa0_ta20_fm6_tm14,t
2683@TOP@human_GAPDH_TAA_len41_fa0_ta20_fm6_tm14*115*c,0,537,0,0,537,0.0,115,2683@TOP@human_GAPDH_TAA_len41_fa0_ta20_fm6_tm14,c
2683@TOP@human_GAPDH_TAA_len41_fa0_ta20_fm6_tm14*116*c,0,530,0,0,530,0.0,116,2683@TOP@human_GAPDH_TAA_len41_fa0_ta20_fm6_tm14,c
2683@TOP@human_GAPDH_TAA_len41_fa0_ta20_fm6_tm14*117*a,531,0,0,0,531,0.0,117,2683@TOP@human_GAPDH_TAA_len41_fa0_ta20_fm6_tm14,a
2683@TOP@human_GAPDH_TAA_len41_fa0_ta20_fm6_tm14*118*a,523,0,7,0,530,0.013,118,2683@TOP@human_GAPDH_TAA_len41_fa0_ta20_fm6_tm14,a
2683@TOP@human_GAPDH_TAA_len41_fa0_ta20_fm6_tm14*119*g,0,0,527,0,527,1.0,119,2683@TOP@human_GAPDH_TAA_len41_fa0_ta20_fm6_tm14,g
2683@TOP@human_GAPDH_TAA_len41_fa0_ta20_fm6_tm14*120*g,0,0,524,0,524,1.0,120,2683@TOP@human_GAPDH_TAA_len41_fa0_ta20_fm6_tm14,g
2683@TOP@human_GAPDH_TAA_len41_fa0_ta20_fm6_tm14*121*a,528,0,0,0,528,0.0,121,2683@TOP@human_GAPDH_TAA_len41_fa0_ta20_fm6_tm14,a
2683@TOP@human_GAPDH_TAA_len41_fa0_ta20_fm6_tm14*122*g,0,0,532,0,532,1.0,122,2683@TOP@human_GAPDH_TAA_len41_fa0_ta20_fm6_tm14,g
2683@TOP@human_GAPDH_TAA_len41_fa0_ta20_fm6_tm14*123*t,0,0,0,520,520,0.0,123,2683@TOP@human_GAPDH_TAA_len41_fa0_ta20_fm6_tm14,t
2683@TOP@human_GAPDH_TAA_len41_fa0_ta20_fm6_tm14*124*a,493,0,30,0,523,0.057,124,2683@TOP@human_GAPDH_TAA_len41_fa0_ta20_fm6_tm14,a
2683@TOP@human_GAPDH_TAA_len41_fa0_ta20_fm6_tm14*125*a,499,0,24,0,523,0.046,125,2683@TOP@human_GAPDH_TAA_len41_fa0_ta20_fm6_tm14,a
2683@TOP@human_GAPDH_TAA_len41_fa0_ta20_fm6_tm14*126*g,0,0,525,0,525,1.0,126,2683@TOP@human_GAPDH_TAA_len41_fa0_ta20_fm6_tm14,g
2683@TOP@human_GAPDH_TAA_len41_fa0_ta20_fm6_tm14*127*a,530,0,0,1,531,0.0,127,2683@TOP@human_GAPDH_TAA_len41_fa0_ta20_fm6_tm14,a
2683@TOP@human_GAPDH_TAA_len41_fa0_ta20_fm6_tm14*128*c,0,535,0,0,535,0.0,128,2683@TOP@human_GAPDH_TAA_len41_fa0_ta20_fm6_tm14,c
2683@TOP@human_GAPDH_TAA_len41_fa0_ta20_fm6_tm14*129*c,0,530,0,0,530,0.0,129,2683@TOP@human_GAPDH_TAA_len41_fa0_ta20_fm6_tm14,c
2683@TOP@human_GAPDH_TAA_len41_fa0_ta20_fm6_tm14*130*c,0,532,0,0,532,0.0,130,2683@TOP@human_GAPDH_TAA_len41_fa0_ta20_fm6_tm14,c
2683@TOP@human_GAPDH_TAA_len41_fa0_ta20_fm6_tm14*131*c,0,535,0,0,535,0.0,131,2683@TOP@human_GAPDH_TAA_len41_fa0_ta20_fm6_tm14,c
2683@TOP@human_GAPDH_TAA_len41_fa0_ta20_fm6_tm14*132*t,0,0,0,521,521,0.0,132,2683@TOP@human_GAPDH_TAA_len41_fa0_ta20_fm6_tm14,t
2683@TOP@human_GAPDH_TAA_len41_fa0_ta20_fm6_tm14*133*g,0,0,523,0,523,1.0,133,2683@TOP@human_GAPDH_TAA_len41_fa0_ta20_fm6_tm14,g
2683@TOP@human_GAPDH_TAA_len41_fa0_ta20_fm6_tm14*134*g,0,0,528,0,528,1.0,134,2683@TOP@human_GAPDH_TAA_len41_fa0_ta20_fm6_tm14,g
2684@TOP@human_GAPDH_TAA_len41_fa0_ta20_fm6_tm14*114*t,0,1,0,557,558,0.0,114,2684@TOP@human_GAPDH_TAA_len41_fa0_ta20_fm6_tm14,t
2684@TOP@human_GAPDH_TAA_len41_fa0_ta20_fm6_tm14*115*c,0,559,0,1,560,0.0,115,2684@TOP@human_GAPDH_TAA_len41_fa0_ta20_fm6_tm14,c
2684@TOP@human_GAPDH_TAA_len41_fa0_ta20_fm6_tm14*116*c,0,557,0,0,557,0.0,116,2684@TOP@human_GAPDH_TAA_len41_fa0_ta20_fm6_tm14,c
2684@TOP@human_GAPDH_TAA_len41_fa0_ta20_fm6_tm14*117*a,545,0,7,0,552,0.013,117,2684@TOP@human_GAPDH_TAA_len41_fa0_ta20_fm6_tm14,a
2684@TOP@human_GAPDH_TAA_len41_fa0_ta20_fm6_tm14*118*a,534,0,16,0,550,0.029,118,2684@TOP@human_GAPDH_TAA_len41_fa0_ta20_fm6_tm14,a
2684@TOP@human_GAPDH_TAA_len41_fa0_ta20_fm6_tm14*119*g,0,0,552,0,552,1.0,119,2684@TOP@human_GAPDH_TAA_len41_fa0_ta20_fm6_tm14,g
2684@TOP@human_GAPDH_TAA_len41_fa0_ta20_fm6_tm14*120*g,1,0,549,0,550,0.998,120,2684@TOP@human_GAPDH_TAA_len41_fa0_ta20_fm6_tm14,g
2684@TOP@human_GAPDH_TAA_len41_fa0_ta20_fm6_tm14*121*a,553,0,0,0,553,0.0,121,2684@TOP@human_GAPDH_TAA_len41_fa0_ta20_fm6_tm14,a
2684@TOP@human_GAPDH_TAA_len41_fa0_ta20_fm6_tm14*122*g,0,0,553,0,553,1.0,122,2684@TOP@human_GAPDH_TAA_len41_fa0_ta20_fm6_tm14,g
2684@TOP@human_GAPDH_TAA_len41_fa0_ta20_fm6_tm14*123*t,0,0,0,543,543,0.0,123,2684@TOP@human_GAPDH_TAA_len41_fa0_ta20_fm6_tm14,t
2684@TOP@human_GAPDH_TAA_len41_fa0_ta20_fm6_tm14*124*a,480,0,56,0,536,0.104,124,2684@TOP@human_GAPDH_TAA_len41_fa0_ta20_fm6_tm14,a
2684@TOP@human_GAPDH_TAA_len41_fa0_ta20_fm6_tm14*125*a,514,0,25,0,539,0.046,125,2684@TOP@human_GAPDH_TAA_len41_fa0_ta20_fm6_tm14,a
2684@TOP@human_GAPDH_TAA_len41_fa0_ta20_fm6_tm14*126*g,0,0,544,0,544,1.0,126,2684@TOP@human_GAPDH_TAA_len41_fa0_ta20_fm6_tm14,g
2684@TOP@human_GAPDH_TAA_len41_fa0_ta20_fm6_tm14*127*a,559,0,0,0,559,0.0,127,2684@TOP@human_GAPDH_TAA_len41_fa0_ta20_fm6_tm14,a
2684@TOP@human_GAPDH_TAA_len41_fa0_ta20_fm6_tm14*128*c,0,557,0,0,557,0.0,128,2684@TOP@human_GAPDH_TAA_len41_fa0_ta20_fm6_tm14,c
2684@TOP@human_GAPDH_TAA_len41_fa0_ta20_fm6_tm14*129*c,0,555,0,0,555,0.0,129,2684@TOP@human_GAPDH_TAA_len41_fa0_ta20_fm6_tm14,c
2684@TOP@human_GAPDH_TAA_len41_fa0_ta20_fm6_tm14*130*c,0,554,0,0,554,0.0,130,2684@TOP@human_GAPDH_TAA_len41_fa0_ta20_fm6_tm14,c
2684@TOP@human_GAPDH_TAA_len41_fa0_ta20_fm6_tm14*131*c,0,559,0,0,559,0.0,131,2684@TOP@human_GAPDH_TAA_len41_fa0_ta20_fm6_tm14,c
2684@TOP@human_GAPDH_TAA_len41_fa0_ta20_fm6_tm14*132*t,0,0,0,549,549,0.0,132,2684@TOP@human_GAPDH_TAA_len41_fa0_ta20_fm6_tm14,t
2684@TOP@human_GAPDH_TAA_len41_fa0_ta20_fm6_tm14*133*g,0,0,552,0,552,1.0,133,2684@TOP@human_GAPDH_TAA_len41_fa0_ta20_fm6_tm14,g
2684@TOP@human_GAPDH_TAA_len41_fa0_ta20_fm6_tm14*134*g,2,1,548,0,551,0.995,134,2684@TOP@human_GAPDH_TAA_len41_fa0_ta20_fm6_tm14,g
2685@TOP@human_GAPDH_TAA_len41_fa0_ta20_fm6_tm14*114*t,0,0,0,957,957,0.0,114,2685@TOP@human_GAPDH_TAA_len41_fa0_ta20_fm6_tm14,t
2685@TOP@human_GAPDH_TAA_len41_fa0_ta20_fm6_tm14*115*c,0,965,0,0,965,0.0,115,2685@TOP@human_GAPDH_TAA_len41_fa0_ta20_fm6_tm14,c
2685@TOP@human_GAPDH_TAA_len41_fa0_ta20_fm6_tm14*116*c,0,960,0,0,960,0.0,116,2685@TOP@human_GAPDH_TAA_len41_fa0_ta20_fm6_tm14,c
2685@TOP@human_GAPDH_TAA_len41_fa0_ta20_fm6_tm14*117*a,958,0,6,0,964,0.006,117,2685@TOP@human_GAPDH_TAA_len41_fa0_ta20_fm6_tm14,a
2685@TOP@human_GAPDH_TAA_len41_fa0_ta20_fm6_tm14*118*a,925,0,28,0,953,0.029,118,2685@TOP@human_GAPDH_TAA_len41_fa0_ta20_fm6_tm14,a
2685@TOP@human_GAPDH_TAA_len41_fa0_ta20_fm6_tm14*119*g,0,1,949,0,950,0.999,119,2685@TOP@human_GAPDH_TAA_len41_fa0_ta20_fm6_tm14,g
2685@TOP@human_GAPDH_TAA_len41_fa0_ta20_fm6_tm14*120*g,0,0,946,0,946,1.0,120,2685@TOP@human_GAPDH_TAA_len41_fa0_ta20_fm6_tm14,g
2685@TOP@human_GAPDH_TAA_len41_fa0_ta20_fm6_tm14*121*a,957,0,2,0,959,0.002,121,2685@TOP@human_GAPDH_TAA_len41_fa0_ta20_fm6_tm14,a
2685@TOP@human_GAPDH_TAA_len41_fa0_ta20_fm6_tm14*122*g,0,0,958,0,958,1.0,122,2685@TOP@human_GAPDH_TAA_len41_fa0_ta20_fm6_tm14,g
2685@TOP@human_GAPDH_TAA_len41_fa0_ta20_fm6_tm14*123*t,0,0,0,944,944,0.0,123,2685@TOP@human_GAPDH_TAA_len41_fa0_ta20_fm6_tm14,t
2685@TOP@human_GAPDH_TAA_len41_fa0_ta20_fm6_tm14*124*a,701,0,246,0,947,0.26,124,2685@TOP@human_GAPDH_TAA_len41_fa0_ta20_fm6_tm14,a
2685@TOP@human_GAPDH_TAA_len41_fa0_ta20_fm6_tm14*125*a,830,0,126,0,956,0.132,125,2685@TOP@human_GAPDH_TAA_len41_fa0_ta20_fm6_tm14,a
2685@TOP@human_GAPDH_TAA_len41_fa0_ta20_fm6_tm14*126*g,0,0,946,0,946,1.0,126,2685@TOP@human_GAPDH_TAA_len41_fa0_ta20_fm6_tm14,g
2685@TOP@human_GAPDH_TAA_len41_fa0_ta20_fm6_tm14*127*a,950,0,8,0,958,0.008,127,2685@TOP@human_GAPDH_TAA_len41_fa0_ta20_fm6_tm14,a
2685@TOP@human_GAPDH_TAA_len41_fa0_ta20_fm6_tm14*128*c,0,960,0,0,960,0.0,128,2685@TOP@human_GAPDH_TAA_len41_fa0_ta20_fm6_tm14,c
2685@TOP@human_GAPDH_TAA_len41_fa0_ta20_fm6_tm14*129*c,0,950,0,0,950,0.0,129,2685@TOP@human_GAPDH_TAA_len41_fa0_ta20_fm6_tm14,c
2685@TOP@human_GAPDH_TAA_len41_fa0_ta20_fm6_tm14*130*c,0,962,0,0,962,0.0,130,2685@TOP@human_GAPDH_TAA_len41_fa0_ta20_fm6_tm14,c
2685@TOP@human_GAPDH_TAA_len41_fa0_ta20_fm6_tm14*131*c,0,961,0,0,961,0.0,131,2685@TOP@human_GAPDH_TAA_len41_fa0_ta20_fm6_tm14,c
2685@TOP@human_GAPDH_TAA_len41_fa0_ta20_fm6_tm14*132*t,0,0,0,948,948,0.0,132,2685@TOP@human_GAPDH_TAA_len41_fa0_ta20_fm6_tm14,t
2685@TOP@human_GAPDH_TAA_len41_fa0_ta20_fm6_tm14*133*g,0,0,945,0,945,1.0,133,2685@TOP@human_GAPDH_TAA_len41_fa0_ta20_fm6_tm14,g
2685@TOP@human_GAPDH_TAA_len41_fa0_ta20_fm6_tm14*134*g,0,0,951,0,951,1.0,134,2685@TOP@human_GAPDH_TAA_len41_fa0_ta20_fm6_tm14,g
2686@TOP@human_GAPDH_TAA_len41_fa0_ta20_fm6_tm14*114*t,0,0,0,593,593,0.0,114,2686@TOP@human_GAPDH_TAA_len41_fa0_ta20_fm6_tm14,t
2686@TOP@human_GAPDH_TAA_len41_fa0_ta20_fm6_tm14*115*c,0,598,0,0,598,0.0,115,2686@TOP@human_GAPDH_TAA_len41_fa0_ta20_fm6_tm14,c
2686@TOP@human_GAPDH_TAA_len41_fa0_ta20_fm6_tm14*116*c,0,594,0,0,594,0.0,116,2686@TOP@human_GAPDH_TAA_len41_fa0_ta20_fm6_tm14,c
2686@TOP@human_GAPDH_TAA_len41_fa0_ta20_fm6_tm14*117*a,587,0,4,0,591,0.007,117,2686@TOP@human_GAPDH_TAA_len41_fa0_ta20_fm6_tm14,a
2686@TOP@human_GAPDH_TAA_len41_fa0_ta20_fm6_tm14*118*a,550,0,41,0,591,0.069,118,2686@TOP@human_GAPDH_TAA_len41_fa0_ta20_fm6_tm14,a
2686@TOP@human_GAPDH_TAA_len41_fa0_ta20_fm6_tm14*119*g,0,0,587,0,587,1.0,119,2686@TOP@human_GAPDH_TAA_len41_fa0_ta20_fm6_tm14,g
2686@TOP@human_GAPDH_TAA_len41_fa0_ta20_fm6_tm14*120*g,0,0,587,0,587,1.0,120,2686@TOP@human_GAPDH_TAA_len41_fa0_ta20_fm6_tm14,g
2686@TOP@human_GAPDH_TAA_len41_fa0_ta20_fm6_tm14*121*a,595,0,0,0,595,0.0,121,2686@TOP@human_GAPDH_TAA_len41_fa0_ta20_fm6_tm14,a
2686@TOP@human_GAPDH_TAA_len41_fa0_ta20_fm6_tm14*122*g,0,0,597,0,597,1.0,122,2686@TOP@human_GAPDH_TAA_len41_fa0_ta20_fm6_tm14,g
2686@TOP@human_GAPDH_TAA_len41_fa0_ta20_fm6_tm14*123*t,0,0,0,585,585,0.0,123,2686@TOP@human_GAPDH_TAA_len41_fa0_ta20_fm6_tm14,t
2686@TOP@human_GAPDH_TAA_len41_fa0_ta20_fm6_tm14*124*a,464,0,119,0,583,0.204,124,2686@TOP@human_GAPDH_TAA_len41_fa0_ta20_fm6_tm14,a
2686@TOP@human_GAPDH_TAA_len41_fa0_ta20_fm6_tm14*125*a,531,0,59,0,590,0.1,125,2686@TOP@human_GAPDH_TAA_len41_fa0_ta20_fm6_tm14,a
2686@TOP@human_GAPDH_TAA_len41_fa0_ta20_fm6_tm14*126*g,0,0,584,1,585,0.998,126,2686@TOP@human_GAPDH_TAA_len41_fa0_ta20_fm6_tm14,g
2686@TOP@human_GAPDH_TAA_len41_fa0_ta20_fm6_tm14*127*a,583,1,7,0,591,0.012,127,2686@TOP@human_GAPDH_TAA_len41_fa0_ta20_fm6_tm14,a
2686@TOP@human_GAPDH_TAA_len41_fa0_ta20_fm6_tm14*128*c,0,597,0,0,597,0.0,128,2686@TOP@human_GAPDH_TAA_len41_fa0_ta20_fm6_tm14,c
2686@TOP@human_GAPDH_TAA_len41_fa0_ta20_fm6_tm14*129*c,0,590,0,0,590,0.0,129,2686@TOP@human_GAPDH_TAA_len41_fa0_ta20_fm6_tm14,c
2686@TOP@human_GAPDH_TAA_len41_fa0_ta20_fm6_tm14*130*c,0,597,0,0,597,0.0,130,2686@TOP@human_GAPDH_TAA_len41_fa0_ta20_fm6_tm14,c
2686@TOP@human_GAPDH_TAA_len41_fa0_ta20_fm6_tm14*131*c,0,595,0,0,595,0.0,131,2686@TOP@human_GAPDH_TAA_len41_fa0_ta20_fm6_tm14,c
2686@TOP@human_GAPDH_TAA_len41_fa0_ta20_fm6_tm14*132*t,0,0,0,580,580,0.0,132,2686@TOP@human_GAPDH_TAA_len41_fa0_ta20_fm6_tm14,t
2686@TOP@human_GAPDH_TAA_len41_fa0_ta20_fm6_tm14*133*g,0,0,586,0,586,1.0,133,2686@TOP@human_GAPDH_TAA_len41_fa0_ta20_fm6_tm14,g
2686@TOP@human_GAPDH_TAA_len41_fa0_ta20_fm6_tm14*134*g,0,0,586,0,586,1.0,134,2686@TOP@human_GAPDH_TAA_len41_fa0_ta20_fm6_tm14,g
2687@TOP@human_GAPDH_TAA_len41_fa0_ta20_fm6_tm14*114*t,0,0,0,1220,1220,0.0,114,2687@TOP@human_GAPDH_TAA_len41_fa0_ta20_fm6_tm14,t
2687@TOP@human_GAPDH_TAA_len41_fa0_ta20_fm6_tm14*115*c,0,1231,0,0,1231,0.0,115,2687@TOP@human_GAPDH_TAA_len41_fa0_ta20_fm6_tm14,c
2687@TOP@human_GAPDH_TAA_len41_fa0_ta20_fm6_tm14*116*c,0,1230,0,0,1230,0.0,116,2687@TOP@human_GAPDH_TAA_len41_fa0_ta20_fm6_tm14,c
2687@TOP@human_GAPDH_TAA_len41_fa0_ta20_fm6_tm14*117*a,1228,0,0,0,1228,0.0,117,2687@TOP@human_GAPDH_TAA_len41_fa0_ta20_fm6_tm14,a
2687@TOP@human_GAPDH_TAA_len41_fa0_ta20_fm6_tm14*118*a,1184,0,26,0,1210,0.021,118,2687@TOP@human_GAPDH_TAA_len41_fa0_ta20_fm6_tm14,a
2687@TOP@human_GAPDH_TAA_len41_fa0_ta20_fm6_tm14*119*g,0,0,1217,0,1217,1.0,119,2687@TOP@human_GAPDH_TAA_len41_fa0_ta20_fm6_tm14,g
2687@TOP@human_GAPDH_TAA_len41_fa0_ta20_fm6_tm14*120*g,0,0,1215,0,1215,1.0,120,2687@TOP@human_GAPDH_TAA_len41_fa0_ta20_fm6_tm14,g
2687@TOP@human_GAPDH_TAA_len41_fa0_ta20_fm6_tm14*121*a,1215,0,1,0,1216,0.001,121,2687@TOP@human_GAPDH_TAA_len41_fa0_ta20_fm6_tm14,a
2687@TOP@human_GAPDH_TAA_len41_fa0_ta20_fm6_tm14*122*g,0,0,1225,0,1225,1.0,122,2687@TOP@human_GAPDH_TAA_len41_fa0_ta20_fm6_tm14,g
2687@TOP@human_GAPDH_TAA_len41_fa0_ta20_fm6_tm14*123*t,0,2,0,1193,1195,0.0,123,2687@TOP@human_GAPDH_TAA_len41_fa0_ta20_fm6_tm14,t
2687@TOP@human_GAPDH_TAA_len41_fa0_ta20_fm6_tm14*124*a,1153,0,48,0,1201,0.04,124,2687@TOP@human_GAPDH_TAA_len41_fa0_ta20_fm6_tm14,a
2687@TOP@human_GAPDH_TAA_len41_fa0_ta20_fm6_tm14*125*a,1097,0,104,0,1201,0.087,125,2687@TOP@human_GAPDH_TAA_len41_fa0_ta20_fm6_tm14,a
2687@TOP@human_GAPDH_TAA_len41_fa0_ta20_fm6_tm14*126*g,0,0,1210,2,1212,0.998,126,2687@TOP@human_GAPDH_TAA_len41_fa0_ta20_fm6_tm14,g
2687@TOP@human_GAPDH_TAA_len41_fa0_ta20_fm6_tm14*127*a,1220,0,0,0,1220,0.0,127,2687@TOP@human_GAPDH_TAA_len41_fa0_ta20_fm6_tm14,a
2687@TOP@human_GAPDH_TAA_len41_fa0_ta20_fm6_tm14*128*c,0,1231,0,0,1231,0.0,128,2687@TOP@human_GAPDH_TAA_len41_fa0_ta20_fm6_tm14,c
2687@TOP@human_GAPDH_TAA_len41_fa0_ta20_fm6_tm14*129*c,0,1218,0,0,1218,0.0,129,2687@TOP@human_GAPDH_TAA_len41_fa0_ta20_fm6_tm14,c
2687@TOP@human_GAPDH_TAA_len41_fa0_ta20_fm6_tm14*130*c,0,1223,0,2,1225,0.0,130,2687@TOP@human_GAPDH_TAA_len41_fa0_ta20_fm6_tm14,c
2687@TOP@human_GAPDH_TAA_len41_fa0_ta20_fm6_tm14*131*c,0,1228,0,0,1228,0.0,131,2687@TOP@human_GAPDH_TAA_len41_fa0_ta20_fm6_tm14,c
2687@TOP@human_GAPDH_TAA_len41_fa0_ta20_fm6_tm14*132*t,0,2,0,1211,1213,0.0,132,2687@TOP@human_GAPDH_TAA_len41_fa0_ta20_fm6_tm14,t
2687@TOP@human_GAPDH_TAA_len41_fa0_ta20_fm6_tm14*133*g,0,0,1205,0,1205,1.0,133,2687@TOP@human_GAPDH_TAA_len41_fa0_ta20_fm6_tm14,g
2687@TOP@human_GAPDH_TAA_len41_fa0_ta20_fm6_tm14*134*g,0,0,1210,0,1210,1.0,134,2687@TOP@human_GAPDH_TAA_len41_fa0_ta20_fm6_tm14,g
2688@TOP@human_GAPDH_TAA_len41_fa0_ta20_fm6_tm14*114*t,0,1,0,983,984,0.0,114,2688@TOP@human_GAPDH_TAA_len41_fa0_ta20_fm6_tm14,t
2688@TOP@human_GAPDH_TAA_len41_fa0_ta20_fm6_tm14*115*c,0,992,0,0,992,0.0,115,2688@TOP@human_GAPDH_TAA_len41_fa0_ta20_fm6_tm14,c
2688@TOP@human_GAPDH_TAA_len41_fa0_ta20_fm6_tm14*116*c,0,983,0,0,983,0.0,116,2688@TOP@human_GAPDH_TAA_len41_fa0_ta20_fm6_tm14,c
2688@TOP@human_GAPDH_TAA_len41_fa0_ta20_fm6_tm14*117*a,981,0,7,0,988,0.007,117,2688@TOP@human_GAPDH_TAA_len41_fa0_ta20_fm6_tm14,a
2688@TOP@human_GAPDH_TAA_len41_fa0_ta20_fm6_tm14*118*a,947,0,25,0,972,0.026,118,2688@TOP@human_GAPDH_TAA_len41_fa0_ta20_fm6_tm14,a
2688@TOP@human_GAPDH_TAA_len41_fa0_ta20_fm6_tm14*119*g,0,0,971,0,971,1.0,119,2688@TOP@human_GAPDH_TAA_len41_fa0_ta20_fm6_tm14,g
2688@TOP@human_GAPDH_TAA_len41_fa0_ta20_fm6_tm14*120*g,0,0,977,0,977,1.0,120,2688@TOP@human_GAPDH_TAA_len41_fa0_ta20_fm6_tm14,g
2688@TOP@human_GAPDH_TAA_len41_fa0_ta20_fm6_tm14*121*a,977,0,0,0,977,0.0,121,2688@TOP@human_GAPDH_TAA_len41_fa0_ta20_fm6_tm14,a
2688@TOP@human_GAPDH_TAA_len41_fa0_ta20_fm6_tm14*122*g,0,0,985,0,985,1.0,122,2688@TOP@human_GAPDH_TAA_len41_fa0_ta20_fm6_tm14,g
2688@TOP@human_GAPDH_TAA_len41_fa0_ta20_fm6_tm14*123*t,0,0,0,966,966,0.0,123,2688@TOP@human_GAPDH_TAA_len41_fa0_ta20_fm6_tm14,t
2688@TOP@human_GAPDH_TAA_len41_fa0_ta20_fm6_tm14*124*a,881,0,84,0,965,0.087,124,2688@TOP@human_GAPDH_TAA_len41_fa0_ta20_fm6_tm14,a
2688@TOP@human_GAPDH_TAA_len41_fa0_ta20_fm6_tm14*125*a,826,0,141,0,967,0.146,125,2688@TOP@human_GAPDH_TAA_len41_fa0_ta20_fm6_tm14,a
2688@TOP@human_GAPDH_TAA_len41_fa0_ta20_fm6_tm14*126*g,0,0,972,0,972,1.0,126,2688@TOP@human_GAPDH_TAA_len41_fa0_ta20_fm6_tm14,g
2688@TOP@human_GAPDH_TAA_len41_fa0_ta20_fm6_tm14*127*a,989,0,1,0,990,0.001,127,2688@TOP@human_GAPDH_TAA_len41_fa0_ta20_fm6_tm14,a
2688@TOP@human_GAPDH_TAA_len41_fa0_ta20_fm6_tm14*128*c,0,985,0,0,985,0.0,128,2688@TOP@human_GAPDH_TAA_len41_fa0_ta20_fm6_tm14,c
2688@TOP@human_GAPDH_TAA_len41_fa0_ta20_fm6_tm14*129*c,0,984,0,0,984,0.0,129,2688@TOP@human_GAPDH_TAA_len41_fa0_ta20_fm6_tm14,c
2688@TOP@human_GAPDH_TAA_len41_fa0_ta20_fm6_tm14*130*c,0,981,0,0,981,0.0,130,2688@TOP@human_GAPDH_TAA_len41_fa0_ta20_fm6_tm14,c
2688@TOP@human_GAPDH_TAA_len41_fa0_ta20_fm6_tm14*131*c,0,990,0,0,990,0.0,131,2688@TOP@human_GAPDH_TAA_len41_fa0_ta20_fm6_tm14,c
2688@TOP@human_GAPDH_TAA_len41_fa0_ta20_fm6_tm14*132*t,0,1,0,967,968,0.0,132,2688@TOP@human_GAPDH_TAA_len41_fa0_ta20_fm6_tm14,t
2688@TOP@human_GAPDH_TAA_len41_fa0_ta20_fm6_tm14*133*g,0,0,977,0,977,1.0,133,2688@TOP@human_GAPDH_TAA_len41_fa0_ta20_fm6_tm14,g
2688@TOP@human_GAPDH_TAA_len41_fa0_ta20_fm6_tm14*134*g,0,0,976,0,976,1.0,134,2688@TOP@human_GAPDH_TAA_len41_fa0_ta20_fm6_tm14,g
2689@TOP@human_GAPDH_TAA_len41_fa0_ta20_fm6_tm14*114*t,0,0,0,809,809,0.0,114,2689@TOP@human_GAPDH_TAA_len41_fa0_ta20_fm6_tm14,t
2689@TOP@human_GAPDH_TAA_len41_fa0_ta20_fm6_tm14*115*c,0,816,0,0,816,0.0,115,2689@TOP@human_GAPDH_TAA_len41_fa0_ta20_fm6_tm14,c
2689@TOP@human_GAPDH_TAA_len41_fa0_ta20_fm6_tm14*116*c,0,814,0,0,814,0.0,116,2689@TOP@human_GAPDH_TAA_len41_fa0_ta20_fm6_tm14,c
2689@TOP@human_GAPDH_TAA_len41_fa0_ta20_fm6_tm14*117*a,815,0,0,0,815,0.0,117,2689@TOP@human_GAPDH_TAA_len41_fa0_ta20_fm6_tm14,a
2689@TOP@human_GAPDH_TAA_len41_fa0_ta20_fm6_tm14*118*a,794,0,11,0,805,0.014,118,2689@TOP@human_GAPDH_TAA_len41_fa0_ta20_fm6_tm14,a
2689@TOP@human_GAPDH_TAA_len41_fa0_ta20_fm6_tm14*119*g,0,0,801,0,801,1.0,119,2689@TOP@human_GAPDH_TAA_len41_fa0_ta20_fm6_tm14,g
2689@TOP@human_GAPDH_TAA_len41_fa0_ta20_fm6_tm14*120*g,2,0,801,0,803,0.998,120,2689@TOP@human_GAPDH_TAA_len41_fa0_ta20_fm6_tm14,g
2689@TOP@human_GAPDH_TAA_len41_fa0_ta20_fm6_tm14*121*a,808,0,1,0,809,0.001,121,2689@TOP@human_GAPDH_TAA_len41_fa0_ta20_fm6_tm14,a
2689@TOP@human_GAPDH_TAA_len41_fa0_ta20_fm6_tm14*122*g,0,0,812,0,812,1.0,122,2689@TOP@human_GAPDH_TAA_len41_fa0_ta20_fm6_tm14,g
2689@TOP@human_GAPDH_TAA_len41_fa0_ta20_fm6_tm14*123*t,0,0,0,799,799,0.0,123,2689@TOP@human_GAPDH_TAA_len41_fa0_ta20_fm6_tm14,t
2689@TOP@human_GAPDH_TAA_len41_fa0_ta20_fm6_tm14*124*a,602,0,192,0,794,0.242,124,2689@TOP@human_GAPDH_TAA_len41_fa0_ta20_fm6_tm14,a
2689@TOP@human_GAPDH_TAA_len41_fa0_ta20_fm6_tm14*125*a,671,0,130,0,801,0.162,125,2689@TOP@human_GAPDH_TAA_len41_fa0_ta20_fm6_tm14,a
2689@TOP@human_GAPDH_TAA_len41_fa0_ta20_fm6_tm14*126*g,0,0,796,0,796,1.0,126,2689@TOP@human_GAPDH_TAA_len41_fa0_ta20_fm6_tm14,g
2689@TOP@human_GAPDH_TAA_len41_fa0_ta20_fm6_tm14*127*a,808,1,1,0,810,0.001,127,2689@TOP@human_GAPDH_TAA_len41_fa0_ta20_fm6_tm14,a
2689@TOP@human_GAPDH_TAA_len41_fa0_ta20_fm6_tm14*128*c,0,812,0,0,812,0.0,128,2689@TOP@human_GAPDH_TAA_len41_fa0_ta20_fm6_tm14,c
2689@TOP@human_GAPDH_TAA_len41_fa0_ta20_fm6_tm14*129*c,0,808,0,0,808,0.0,129,2689@TOP@human_GAPDH_TAA_len41_fa0_ta20_fm6_tm14,c
2689@TOP@human_GAPDH_TAA_len41_fa0_ta20_fm6_tm14*130*c,0,816,0,0,816,0.0,130,2689@TOP@human_GAPDH_TAA_len41_fa0_ta20_fm6_tm14,c
2689@TOP@human_GAPDH_TAA_len41_fa0_ta20_fm6_tm14*131*c,0,816,0,0,816,0.0,131,2689@TOP@human_GAPDH_TAA_len41_fa0_ta20_fm6_tm14,c
2689@TOP@human_GAPDH_TAA_len41_fa0_ta20_fm6_tm14*132*t,0,0,0,805,805,0.0,132,2689@TOP@human_GAPDH_TAA_len41_fa0_ta20_fm6_tm14,t
2689@TOP@human_GAPDH_TAA_len41_fa0_ta20_fm6_tm14*133*g,0,0,807,0,807,1.0,133,2689@TOP@human_GAPDH_TAA_len41_fa0_ta20_fm6_tm14,g
2689@TOP@human_GAPDH_TAA_len41_fa0_ta20_fm6_tm14*134*g,0,0,810,0,810,1.0,134,2689@TOP@human_GAPDH_TAA_len41_fa0_ta20_fm6_tm14,g
2690@TOP@human_GAPDH_TAA_len41_fa0_ta20_fm6_tm14*114*t,0,0,0,582,582,0.0,114,2690@TOP@human_GAPDH_TAA_len41_fa0_ta20_fm6_tm14,t
2690@TOP@human_GAPDH_TAA_len41_fa0_ta20_fm6_tm14*115*c,0,592,0,0,592,0.0,115,2690@TOP@human_GAPDH_TAA_len41_fa0_ta20_fm6_tm14,c
2690@TOP@human_GAPDH_TAA_len41_fa0_ta20_fm6_tm14*116*c,0,586,0,0,586,0.0,116,2690@TOP@human_GAPDH_TAA_len41_fa0_ta20_fm6_tm14,c
2690@TOP@human_GAPDH_TAA_len41_fa0_ta20_fm6_tm14*117*a,588,0,0,0,588,0.0,117,2690@TOP@human_GAPDH_TAA_len41_fa0_ta20_fm6_tm14,a
2690@TOP@human_GAPDH_TAA_len41_fa0_ta20_fm6_tm14*118*a,561,0,20,0,581,0.034,118,2690@TOP@human_GAPDH_TAA_len41_fa0_ta20_fm6_tm14,a
2690@TOP@human_GAPDH_TAA_len41_fa0_ta20_fm6_tm14*119*g,0,0,578,0,578,1.0,119,2690@TOP@human_GAPDH_TAA_len41_fa0_ta20_fm6_tm14,g
2690@TOP@human_GAPDH_TAA_len41_fa0_ta20_fm6_tm14*120*g,0,0,573,0,573,1.0,120,2690@TOP@human_GAPDH_TAA_len41_fa0_ta20_fm6_tm14,g
2690@TOP@human_GAPDH_TAA_len41_fa0_ta20_fm6_tm14*121*a,587,1,0,0,588,0.0,121,2690@TOP@human_GAPDH_TAA_len41_fa0_ta20_fm6_tm14,a
2690@TOP@human_GAPDH_TAA_len41_fa0_ta20_fm6_tm14*122*g,0,0,587,0,587,1.0,122,2690@TOP@human_GAPDH_TAA_len41_fa0_ta20_fm6_tm14,g
2690@TOP@human_GAPDH_TAA_len41_fa0_ta20_fm6_tm14*123*t,0,0,0,572,572,0.0,123,2690@TOP@human_GAPDH_TAA_len41_fa0_ta20_fm6_tm14,t
2690@TOP@human_GAPDH_TAA_len41_fa0_ta20_fm6_tm14*124*a,421,0,160,0,581,0.275,124,2690@TOP@human_GAPDH_TAA_len41_fa0_ta20_fm6_tm14,a
2690@TOP@human_GAPDH_TAA_len41_fa0_ta20_fm6_tm14*125*a,485,0,91,0,576,0.158,125,2690@TOP@human_GAPDH_TAA_len41_fa0_ta20_fm6_tm14,a
2690@TOP@human_GAPDH_TAA_len41_fa0_ta20_fm6_tm14*126*g,0,0,574,0,574,1.0,126,2690@TOP@human_GAPDH_TAA_len41_fa0_ta20_fm6_tm14,g
2690@TOP@human_GAPDH_TAA_len41_fa0_ta20_fm6_tm14*127*a,586,0,3,0,589,0.005,127,2690@TOP@human_GAPDH_TAA_len41_fa0_ta20_fm6_tm14,a
2690@TOP@human_GAPDH_TAA_len41_fa0_ta20_fm6_tm14*128*c,0,589,0,0,589,0.0,128,2690@TOP@human_GAPDH_TAA_len41_fa0_ta20_fm6_tm14,c
2690@TOP@human_GAPDH_TAA_len41_fa0_ta20_fm6_tm14*129*c,0,585,0,0,585,0.0,129,2690@TOP@human_GAPDH_TAA_len41_fa0_ta20_fm6_tm14,c
2690@TOP@human_GAPDH_TAA_len41_fa0_ta20_fm6_tm14*130*c,0,587,0,0,587,0.0,130,2690@TOP@human_GAPDH_TAA_len41_fa0_ta20_fm6_tm14,c
2690@TOP@human_GAPDH_TAA_len41_fa0_ta20_fm6_tm14*131*c,0,589,0,0,589,0.0,131,2690@TOP@human_GAPDH_TAA_len41_fa0_ta20_fm6_tm14,c
2690@TOP@human_GAPDH_TAA_len41_fa0_ta20_fm6_tm14*132*t,1,0,0,577,578,0.0,132,2690@TOP@human_GAPDH_TAA_len41_fa0_ta20_fm6_tm14,t
2690@TOP@human_GAPDH_TAA_len41_fa0_ta20_fm6_tm14*133*g,0,0,568,0,568,1.0,133,2690@TOP@human_GAPDH_TAA_len41_fa0_ta20_fm6_tm14,g
2690@TOP@human_GAPDH_TAA_len41_fa0_ta20_fm6_tm14*134*g,0,0,570,0,570,1.0,134,2690@TOP@human_GAPDH_TAA_len41_fa0_ta20_fm6_tm14,g
2691@TOP@human_GAPDH_TAA_len41_fa0_ta20_fm6_tm14*114*t,1,0,0,2680,2681,0.0,114,2691@TOP@human_GAPDH_TAA_len41_fa0_ta20_fm6_tm14,t
2691@TOP@human_GAPDH_TAA_len41_fa0_ta20_fm6_tm14*115*c,0,2693,0,0,2693,0.0,115,2691@TOP@human_GAPDH_TAA_len41_fa0_ta20_fm6_tm14,c
2691@TOP@human_GAPDH_TAA_len41_fa0_ta20_fm6_tm14*116*c,0,2681,0,0,2681,0.0,116,2691@TOP@human_GAPDH_TAA_len41_fa0_ta20_fm6_tm14,c
2691@TOP@human_GAPDH_TAA_len41_fa0_ta20_fm6_tm14*117*a,2649,0,31,0,2680,0.012,117,2691@TOP@human_GAPDH_TAA_len41_fa0_ta20_fm6_tm14,a
2691@TOP@human_GAPDH_TAA_len41_fa0_ta20_fm6_tm14*118*a,2543,0,123,0,2666,0.046,118,2691@TOP@human_GAPDH_TAA_len41_fa0_ta20_fm6_tm14,a
2691@TOP@human_GAPDH_TAA_len41_fa0_ta20_fm6_tm14*119*g,0,0,2650,0,2650,1.0,119,2691@TOP@human_GAPDH_TAA_len41_fa0_ta20_fm6_tm14,g
2691@TOP@human_GAPDH_TAA_len41_fa0_ta20_fm6_tm14*120*g,1,0,2633,0,2634,1.0,120,2691@TOP@human_GAPDH_TAA_len41_fa0_ta20_fm6_tm14,g
2691@TOP@human_GAPDH_TAA_len41_fa0_ta20_fm6_tm14*121*a,2679,0,7,0,2686,0.003,121,2691@TOP@human_GAPDH_TAA_len41_fa0_ta20_fm6_tm14,a
2691@TOP@human_GAPDH_TAA_len41_fa0_ta20_fm6_tm14*122*g,0,0,2678,0,2678,1.0,122,2691@TOP@human_GAPDH_TAA_len41_fa0_ta20_fm6_tm14,g
2691@TOP@human_GAPDH_TAA_len41_fa0_ta20_fm6_tm14*123*t,1,0,0,2650,2651,0.0,123,2691@TOP@human_GAPDH_TAA_len41_fa0_ta20_fm6_tm14,t
2691@TOP@human_GAPDH_TAA_len41_fa0_ta20_fm6_tm14*124*a,2218,0,426,0,2644,0.161,124,2691@TOP@human_GAPDH_TAA_len41_fa0_ta20_fm6_tm14,a
2691@TOP@human_GAPDH_TAA_len41_fa0_ta20_fm6_tm14*125*a,2425,0,225,0,2650,0.085,125,2691@TOP@human_GAPDH_TAA_len41_fa0_ta20_fm6_tm14,a
2691@TOP@human_GAPDH_TAA_len41_fa0_ta20_fm6_tm14*126*g,1,0,2640,0,2641,1.0,126,2691@TOP@human_GAPDH_TAA_len41_fa0_ta20_fm6_tm14,g
2691@TOP@human_GAPDH_TAA_len41_fa0_ta20_fm6_tm14*127*a,2644,0,27,0,2671,0.01,127,2691@TOP@human_GAPDH_TAA_len41_fa0_ta20_fm6_tm14,a
2691@TOP@human_GAPDH_TAA_len41_fa0_ta20_fm6_tm14*128*c,0,2688,0,0,2688,0.0,128,2691@TOP@human_GAPDH_TAA_len41_fa0_ta20_fm6_tm14,c
2691@TOP@human_GAPDH_TAA_len41_fa0_ta20_fm6_tm14*129*c,0,2663,0,0,2663,0.0,129,2691@TOP@human_GAPDH_TAA_len41_fa0_ta20_fm6_tm14,c
2691@TOP@human_GAPDH_TAA_len41_fa0_ta20_fm6_tm14*130*c,0,2678,0,0,2678,0.0,130,2691@TOP@human_GAPDH_TAA_len41_fa0_ta20_fm6_tm14,c
2691@TOP@human_GAPDH_TAA_len41_fa0_ta20_fm6_tm14*131*c,0,2688,0,0,2688,0.0,131,2691@TOP@human_GAPDH_TAA_len41_fa0_ta20_fm6_tm14,c
2691@TOP@human_GAPDH_TAA_len41_fa0_ta20_fm6_tm14*132*t,0,3,0,2651,2654,0.0,132,2691@TOP@human_GAPDH_TAA_len41_fa0_ta20_fm6_tm14,t
2691@TOP@human_GAPDH_TAA_len41_fa0_ta20_fm6_tm14*133*g,0,0,2632,0,2632,1.0,133,2691@TOP@human_GAPDH_TAA_len41_fa0_ta20_fm6_tm14,g
2691@TOP@human_GAPDH_TAA_len41_fa0_ta20_fm6_tm14*134*g,0,2,2648,0,2650,0.999,134,2691@TOP@human_GAPDH_TAA_len41_fa0_ta20_fm6_tm14,g
2692@TOP@human_GAPDH_TAA_len41_fa0_ta20_fm6_tm14*114*t,0,0,0,453,453,0.0,114,2692@TOP@human_GAPDH_TAA_len41_fa0_ta20_fm6_tm14,t
2692@TOP@human_GAPDH_TAA_len41_fa0_ta20_fm6_tm14*115*c,0,459,0,0,459,0.0,115,2692@TOP@human_GAPDH_TAA_len41_fa0_ta20_fm6_tm14,c
2692@TOP@human_GAPDH_TAA_len41_fa0_ta20_fm6_tm14*116*c,0,453,0,0,453,0.0,116,2692@TOP@human_GAPDH_TAA_len41_fa0_ta20_fm6_tm14,c
2692@TOP@human_GAPDH_TAA_len41_fa0_ta20_fm6_tm14*117*a,451,0,4,0,455,0.009,117,2692@TOP@human_GAPDH_TAA_len41_fa0_ta20_fm6_tm14,a
2692@TOP@human_GAPDH_TAA_len41_fa0_ta20_fm6_tm14*118*a,434,0,16,0,450,0.036,118,2692@TOP@human_GAPDH_TAA_len41_fa0_ta20_fm6_tm14,a
2692@TOP@human_GAPDH_TAA_len41_fa0_ta20_fm6_tm14*119*g,0,0,454,0,454,1.0,119,2692@TOP@human_GAPDH_TAA_len41_fa0_ta20_fm6_tm14,g
2692@TOP@human_GAPDH_TAA_len41_fa0_ta20_fm6_tm14*120*g,0,0,452,0,452,1.0,120,2692@TOP@human_GAPDH_TAA_len41_fa0_ta20_fm6_tm14,g
2692@TOP@human_GAPDH_TAA_len41_fa0_ta20_fm6_tm14*121*a,455,0,0,0,455,0.0,121,2692@TOP@human_GAPDH_TAA_len41_fa0_ta20_fm6_tm14,a
2692@TOP@human_GAPDH_TAA_len41_fa0_ta20_fm6_tm14*122*g,0,0,456,0,456,1.0,122,2692@TOP@human_GAPDH_TAA_len41_fa0_ta20_fm6_tm14,g
2692@TOP@human_GAPDH_TAA_len41_fa0_ta20_fm6_tm14*123*t,1,0,0,449,450,0.0,123,2692@TOP@human_GAPDH_TAA_len41_fa0_ta20_fm6_tm14,t
2692@TOP@human_GAPDH_TAA_len41_fa0_ta20_fm6_tm14*124*a,374,0,72,0,446,0.161,124,2692@TOP@human_GAPDH_TAA_len41_fa0_ta20_fm6_tm14,a
2692@TOP@human_GAPDH_TAA_len41_fa0_ta20_fm6_tm14*125*a,377,0,69,0,446,0.155,125,2692@TOP@human_GAPDH_TAA_len41_fa0_ta20_fm6_tm14,a
2692@TOP@human_GAPDH_TAA_len41_fa0_ta20_fm6_tm14*126*g,0,0,446,0,446,1.0,126,2692@TOP@human_GAPDH_TAA_len41_fa0_ta20_fm6_tm14,g
2692@TOP@human_GAPDH_TAA_len41_fa0_ta20_fm6_tm14*127*a,447,0,8,0,455,0.018,127,2692@TOP@human_GAPDH_TAA_len41_fa0_ta20_fm6_tm14,a
2692@TOP@human_GAPDH_TAA_len41_fa0_ta20_fm6_tm14*128*c,0,456,0,0,456,0.0,128,2692@TOP@human_GAPDH_TAA_len41_fa0_ta20_fm6_tm14,c
2692@TOP@human_GAPDH_TAA_len41_fa0_ta20_fm6_tm14*129*c,1,451,0,0,452,0.0,129,2692@TOP@human_GAPDH_TAA_len41_fa0_ta20_fm6_tm14,c
2692@TOP@human_GAPDH_TAA_len41_fa0_ta20_fm6_tm14*130*c,0,455,0,0,455,0.0,130,2692@TOP@human_GAPDH_TAA_len41_fa0_ta20_fm6_tm14,c
2692@TOP@human_GAPDH_TAA_len41_fa0_ta20_fm6_tm14*131*c,0,460,0,0,460,0.0,131,2692@TOP@human_GAPDH_TAA_len41_fa0_ta20_fm6_tm14,c
2692@TOP@human_GAPDH_TAA_len41_fa0_ta20_fm6_tm14*132*t,1,0,0,448,449,0.0,132,2692@TOP@human_GAPDH_TAA_len41_fa0_ta20_fm6_tm14,t
2692@TOP@human_GAPDH_TAA_len41_fa0_ta20_fm6_tm14*133*g,0,0,446,0,446,1.0,133,2692@TOP@human_GAPDH_TAA_len41_fa0_ta20_fm6_tm14,g
2692@TOP@human_GAPDH_TAA_len41_fa0_ta20_fm6_tm14*134*g,0,0,450,1,451,0.998,134,2692@TOP@human_GAPDH_TAA_len41_fa0_ta20_fm6_tm14,g
2693@TOP@human_GAPDH_TAA_len41_fa0_ta20_fm6_tm14*114*t,2,5,0,23425,23432,0.0,114,2693@TOP@human_GAPDH_TAA_len41_fa0_ta20_fm6_tm14,t
2693@TOP@human_GAPDH_TAA_len41_fa0_ta20_fm6_tm14*115*c,0,23550,0,0,23550,0.0,115,2693@TOP@human_GAPDH_TAA_len41_fa0_ta20_fm6_tm14,c
2693@TOP@human_GAPDH_TAA_len41_fa0_ta20_fm6_tm14*116*c,2,23449,0,3,23454,0.0,116,2693@TOP@human_GAPDH_TAA_len41_fa0_ta20_fm6_tm14,c
2693@TOP@human_GAPDH_TAA_len41_fa0_ta20_fm6_tm14*117*a,23390,0,48,1,23439,0.002,117,2693@TOP@human_GAPDH_TAA_len41_fa0_ta20_fm6_tm14,a
2693@TOP@human_GAPDH_TAA_len41_fa0_ta20_fm6_tm14*118*a,22984,0,336,2,23322,0.014,118,2693@TOP@human_GAPDH_TAA_len41_fa0_ta20_fm6_tm14,a
2693@TOP@human_GAPDH_TAA_len41_fa0_ta20_fm6_tm14*119*g,0,0,23312,1,23313,1.0,119,2693@TOP@human_GAPDH_TAA_len41_fa0_ta20_fm6_tm14,g
2693@TOP@human_GAPDH_TAA_len41_fa0_ta20_fm6_tm14*120*g,2,0,23198,0,23200,1.0,120,2693@TOP@human_GAPDH_TAA_len41_fa0_ta20_fm6_tm14,g
2693@TOP@human_GAPDH_TAA_len41_fa0_ta20_fm6_tm14*121*a,23415,1,8,3,23427,0.0,121,2693@TOP@human_GAPDH_TAA_len41_fa0_ta20_fm6_tm14,a
2693@TOP@human_GAPDH_TAA_len41_fa0_ta20_fm6_tm14*122*g,1,1,23447,0,23449,1.0,122,2693@TOP@human_GAPDH_TAA_len41_fa0_ta20_fm6_tm14,g
2693@TOP@human_GAPDH_TAA_len41_fa0_ta20_fm6_tm14*123*t,6,4,4,23166,23180,0.0,123,2693@TOP@human_GAPDH_TAA_len41_fa0_ta20_fm6_tm14,t
2693@TOP@human_GAPDH_TAA_len41_fa0_ta20_fm6_tm14*124*a,15938,1,7223,0,23162,0.312,124,2693@TOP@human_GAPDH_TAA_len41_fa0_ta20_fm6_tm14,a
2693@TOP@human_GAPDH_TAA_len41_fa0_ta20_fm6_tm14*125*a,17855,1,5231,2,23089,0.227,125,2693@TOP@human_GAPDH_TAA_len41_fa0_ta20_fm6_tm14,a
2693@TOP@human_GAPDH_TAA_len41_fa0_ta20_fm6_tm14*126*g,0,1,23227,0,23228,1.0,126,2693@TOP@human_GAPDH_TAA_len41_fa0_ta20_fm6_tm14,g
2693@TOP@human_GAPDH_TAA_len41_fa0_ta20_fm6_tm14*127*a,23229,2,144,0,23375,0.006,127,2693@TOP@human_GAPDH_TAA_len41_fa0_ta20_fm6_tm14,a
2693@TOP@human_GAPDH_TAA_len41_fa0_ta20_fm6_tm14*128*c,0,23499,4,1,23504,0.0,128,2693@TOP@human_GAPDH_TAA_len41_fa0_ta20_fm6_tm14,c
2693@TOP@human_GAPDH_TAA_len41_fa0_ta20_fm6_tm14*129*c,0,23351,0,0,23351,0.0,129,2693@TOP@human_GAPDH_TAA_len41_fa0_ta20_fm6_tm14,c
2693@TOP@human_GAPDH_TAA_len41_fa0_ta20_fm6_tm14*130*c,1,23481,0,2,23484,0.0,130,2693@TOP@human_GAPDH_TAA_len41_fa0_ta20_fm6_tm14,c
2693@TOP@human_GAPDH_TAA_len41_fa0_ta20_fm6_tm14*131*c,5,23504,0,1,23510,0.0,131,2693@TOP@human_GAPDH_TAA_len41_fa0_ta20_fm6_tm14,c
2693@TOP@human_GAPDH_TAA_len41_fa0_ta20_fm6_tm14*132*t,6,4,4,23203,23217,0.0,132,2693@TOP@human_GAPDH_TAA_len41_fa0_ta20_fm6_tm14,t
2693@TOP@human_GAPDH_TAA_len41_fa0_ta20_fm6_tm14*133*g,0,0,23137,0,23137,1.0,133,2693@TOP@human_GAPDH_TAA_len41_fa0_ta20_fm6_tm14,g
2693@TOP@human_GAPDH_TAA_len41_fa0_ta20_fm6_tm14*134*g,0,2,23274,2,23278,1.0,134,2693@TOP@human_GAPDH_TAA_len41_fa0_ta20_fm6_tm14,g
2694@TOP@human_GAPDH_TAA_len41_fa0_ta20_fm6_tm14*114*t,0,0,0,2038,2038,0.0,114,2694@TOP@human_GAPDH_TAA_len41_fa0_ta20_fm6_tm14,t
2694@TOP@human_GAPDH_TAA_len41_fa0_ta20_fm6_tm14*115*c,0,2047,0,0,2047,0.0,115,2694@TOP@human_GAPDH_TAA_len41_fa0_ta20_fm6_tm14,c
2694@TOP@human_GAPDH_TAA_len41_fa0_ta20_fm6_tm14*116*c,0,2045,0,0,2045,0.0,116,2694@TOP@human_GAPDH_TAA_len41_fa0_ta20_fm6_tm14,c
2694@TOP@human_GAPDH_TAA_len41_fa0_ta20_fm6_tm14*117*a,2036,0,4,0,2040,0.002,117,2694@TOP@human_GAPDH_TAA_len41_fa0_ta20_fm6_tm14,a
2694@TOP@human_GAPDH_TAA_len41_fa0_ta20_fm6_tm14*118*a,1985,0,47,0,2032,0.023,118,2694@TOP@human_GAPDH_TAA_len41_fa0_ta20_fm6_tm14,a
2694@TOP@human_GAPDH_TAA_len41_fa0_ta20_fm6_tm14*119*g,0,0,2030,0,2030,1.0,119,2694@TOP@human_GAPDH_TAA_len41_fa0_ta20_fm6_tm14,g
2694@TOP@human_GAPDH_TAA_len41_fa0_ta20_fm6_tm14*120*g,0,0,2016,0,2016,1.0,120,2694@TOP@human_GAPDH_TAA_len41_fa0_ta20_fm6_tm14,g
2694@TOP@human_GAPDH_TAA_len41_fa0_ta20_fm6_tm14*121*a,2034,0,3,0,2037,0.001,121,2694@TOP@human_GAPDH_TAA_len41_fa0_ta20_fm6_tm14,a
2694@TOP@human_GAPDH_TAA_len41_fa0_ta20_fm6_tm14*122*g,0,1,2042,0,2043,1.0,122,2694@TOP@human_GAPDH_TAA_len41_fa0_ta20_fm6_tm14,g
2694@TOP@human_GAPDH_TAA_len41_fa0_ta20_fm6_tm14*123*t,0,0,0,2021,2021,0.0,123,2694@TOP@human_GAPDH_TAA_len41_fa0_ta20_fm6_tm14,t
2694@TOP@human_GAPDH_TAA_len41_fa0_ta20_fm6_tm14*124*a,1334,1,663,0,1998,0.332,124,2694@TOP@human_GAPDH_TAA_len41_fa0_ta20_fm6_tm14,a
2694@TOP@human_GAPDH_TAA_len41_fa0_ta20_fm6_tm14*125*a,1715,0,295,0,2010,0.147,125,2694@TOP@human_GAPDH_TAA_len41_fa0_ta20_fm6_tm14,a
2694@TOP@human_GAPDH_TAA_len41_fa0_ta20_fm6_tm14*126*g,0,0,2019,0,2019,1.0,126,2694@TOP@human_GAPDH_TAA_len41_fa0_ta20_fm6_tm14,g
2694@TOP@human_GAPDH_TAA_len41_fa0_ta20_fm6_tm14*127*a,2020,0,21,0,2041,0.01,127,2694@TOP@human_GAPDH_TAA_len41_fa0_ta20_fm6_tm14,a
2694@TOP@human_GAPDH_TAA_len41_fa0_ta20_fm6_tm14*128*c,0,2040,1,0,2041,0.0,128,2694@TOP@human_GAPDH_TAA_len41_fa0_ta20_fm6_tm14,c
2694@TOP@human_GAPDH_TAA_len41_fa0_ta20_fm6_tm14*129*c,0,2033,0,0,2033,0.0,129,2694@TOP@human_GAPDH_TAA_len41_fa0_ta20_fm6_tm14,c
2694@TOP@human_GAPDH_TAA_len41_fa0_ta20_fm6_tm14*130*c,0,2042,0,0,2042,0.0,130,2694@TOP@human_GAPDH_TAA_len41_fa0_ta20_fm6_tm14,c
2694@TOP@human_GAPDH_TAA_len41_fa0_ta20_fm6_tm14*131*c,0,2048,0,0,2048,0.0,131,2694@TOP@human_GAPDH_TAA_len41_fa0_ta20_fm6_tm14,c
2694@TOP@human_GAPDH_TAA_len41_fa0_ta20_fm6_tm14*132*t,0,3,0,2015,2018,0.0,132,2694@TOP@human_GAPDH_TAA_len41_fa0_ta20_fm6_tm14,t
2694@TOP@human_GAPDH_TAA_len41_fa0_ta20_fm6_tm14*133*g,0,0,2010,0,2010,1.0,133,2694@TOP@human_GAPDH_TAA_len41_fa0_ta20_fm6_tm14,g
2694@TOP@human_GAPDH_TAA_len41_fa0_ta20_fm6_tm14*134*g,1,1,2023,0,2025,0.999,134,2694@TOP@human_GAPDH_TAA_len41_fa0_ta20_fm6_tm14,g
2695@TOP@human_GAPDH_TAA_len41_fa0_ta20_fm6_tm14*114*t,0,0,0,728,728,0.0,114,2695@TOP@human_GAPDH_TAA_len41_fa0_ta20_fm6_tm14,t
2695@TOP@human_GAPDH_TAA_len41_fa0_ta20_fm6_tm14*115*c,0,742,0,0,742,0.0,115,2695@TOP@human_GAPDH_TAA_len41_fa0_ta20_fm6_tm14,c
2695@TOP@human_GAPDH_TAA_len41_fa0_ta20_fm6_tm14*116*c,0,737,0,0,737,0.0,116,2695@TOP@human_GAPDH_TAA_len41_fa0_ta20_fm6_tm14,c
2695@TOP@human_GAPDH_TAA_len41_fa0_ta20_fm6_tm14*117*a,731,0,6,0,737,0.008,117,2695@TOP@human_GAPDH_TAA_len41_fa0_ta20_fm6_tm14,a
2695@TOP@human_GAPDH_TAA_len41_fa0_ta20_fm6_tm14*118*a,718,0,17,0,735,0.023,118,2695@TOP@human_GAPDH_TAA_len41_fa0_ta20_fm6_tm14,a
2695@TOP@human_GAPDH_TAA_len41_fa0_ta20_fm6_tm14*119*g,0,0,731,0,731,1.0,119,2695@TOP@human_GAPDH_TAA_len41_fa0_ta20_fm6_tm14,g
2695@TOP@human_GAPDH_TAA_len41_fa0_ta20_fm6_tm14*120*g,0,0,730,0,730,1.0,120,2695@TOP@human_GAPDH_TAA_len41_fa0_ta20_fm6_tm14,g
2695@TOP@human_GAPDH_TAA_len41_fa0_ta20_fm6_tm14*121*a,736,0,0,0,736,0.0,121,2695@TOP@human_GAPDH_TAA_len41_fa0_ta20_fm6_tm14,a
2695@TOP@human_GAPDH_TAA_len41_fa0_ta20_fm6_tm14*122*g,0,0,739,0,739,1.0,122,2695@TOP@human_GAPDH_TAA_len41_fa0_ta20_fm6_tm14,g
2695@TOP@human_GAPDH_TAA_len41_fa0_ta20_fm6_tm14*123*t,0,0,0,724,724,0.0,123,2695@TOP@human_GAPDH_TAA_len41_fa0_ta20_fm6_tm14,t
2695@TOP@human_GAPDH_TAA_len41_fa0_ta20_fm6_tm14*124*a,527,0,203,0,730,0.278,124,2695@TOP@human_GAPDH_TAA_len41_fa0_ta20_fm6_tm14,a
2695@TOP@human_GAPDH_TAA_len41_fa0_ta20_fm6_tm14*125*a,619,0,113,0,732,0.154,125,2695@TOP@human_GAPDH_TAA_len41_fa0_ta20_fm6_tm14,a
2695@TOP@human_GAPDH_TAA_len41_fa0_ta20_fm6_tm14*126*g,0,0,727,0,727,1.0,126,2695@TOP@human_GAPDH_TAA_len41_fa0_ta20_fm6_tm14,g
2695@TOP@human_GAPDH_TAA_len41_fa0_ta20_fm6_tm14*127*a,731,0,5,0,736,0.007,127,2695@TOP@human_GAPDH_TAA_len41_fa0_ta20_fm6_tm14,a
2695@TOP@human_GAPDH_TAA_len41_fa0_ta20_fm6_tm14*128*c,0,739,0,0,739,0.0,128,2695@TOP@human_GAPDH_TAA_len41_fa0_ta20_fm6_tm14,c
2695@TOP@human_GAPDH_TAA_len41_fa0_ta20_fm6_tm14*129*c,0,737,0,0,737,0.0,129,2695@TOP@human_GAPDH_TAA_len41_fa0_ta20_fm6_tm14,c
2695@TOP@human_GAPDH_TAA_len41_fa0_ta20_fm6_tm14*130*c,0,736,0,0,736,0.0,130,2695@TOP@human_GAPDH_TAA_len41_fa0_ta20_fm6_tm14,c
2695@TOP@human_GAPDH_TAA_len41_fa0_ta20_fm6_tm14*131*c,0,743,0,0,743,0.0,131,2695@TOP@human_GAPDH_TAA_len41_fa0_ta20_fm6_tm14,c
2695@TOP@human_GAPDH_TAA_len41_fa0_ta20_fm6_tm14*132*t,0,0,0,726,726,0.0,132,2695@TOP@human_GAPDH_TAA_len41_fa0_ta20_fm6_tm14,t
2695@TOP@human_GAPDH_TAA_len41_fa0_ta20_fm6_tm14*133*g,0,0,732,0,732,1.0,133,2695@TOP@human_GAPDH_TAA_len41_fa0_ta20_fm6_tm14,g
2695@TOP@human_GAPDH_TAA_len41_fa0_ta20_fm6_tm14*134*g,0,1,731,0,732,0.999,134,2695@TOP@human_GAPDH_TAA_len41_fa0_ta20_fm6_tm14,g
2696@TOP@human_GAPDH_TAA_len41_fa0_ta20_fm6_tm14*114*t,0,0,0,2087,2087,0.0,114,2696@TOP@human_GAPDH_TAA_len41_fa0_ta20_fm6_tm14,t
2696@TOP@human_GAPDH_TAA_len41_fa0_ta20_fm6_tm14*115*c,0,2100,0,0,2100,0.0,115,2696@TOP@human_GAPDH_TAA_len41_fa0_ta20_fm6_tm14,c
2696@TOP@human_GAPDH_TAA_len41_fa0_ta20_fm6_tm14*116*c,0,2092,0,0,2092,0.0,116,2696@TOP@human_GAPDH_TAA_len41_fa0_ta20_fm6_tm14,c
2696@TOP@human_GAPDH_TAA_len41_fa0_ta20_fm6_tm14*117*a,2092,0,1,0,2093,0.0,117,2696@TOP@human_GAPDH_TAA_len41_fa0_ta20_fm6_tm14,a
2696@TOP@human_GAPDH_TAA_len41_fa0_ta20_fm6_tm14*118*a,2010,0,63,0,2073,0.03,118,2696@TOP@human_GAPDH_TAA_len41_fa0_ta20_fm6_tm14,a
2696@TOP@human_GAPDH_TAA_len41_fa0_ta20_fm6_tm14*119*g,1,0,2072,0,2073,1.0,119,2696@TOP@human_GAPDH_TAA_len41_fa0_ta20_fm6_tm14,g
2696@TOP@human_GAPDH_TAA_len41_fa0_ta20_fm6_tm14*120*g,0,0,2058,2,2060,0.999,120,2696@TOP@human_GAPDH_TAA_len41_fa0_ta20_fm6_tm14,g
2696@TOP@human_GAPDH_TAA_len41_fa0_ta20_fm6_tm14*121*a,2084,0,3,0,2087,0.001,121,2696@TOP@human_GAPDH_TAA_len41_fa0_ta20_fm6_tm14,a
2696@TOP@human_GAPDH_TAA_len41_fa0_ta20_fm6_tm14*122*g,0,0,2095,0,2095,1.0,122,2696@TOP@human_GAPDH_TAA_len41_fa0_ta20_fm6_tm14,g
2696@TOP@human_GAPDH_TAA_len41_fa0_ta20_fm6_tm14*123*t,1,0,0,2064,2065,0.0,123,2696@TOP@human_GAPDH_TAA_len41_fa0_ta20_fm6_tm14,t
2696@TOP@human_GAPDH_TAA_len41_fa0_ta20_fm6_tm14*124*a,1900,0,158,0,2058,0.077,124,2696@TOP@human_GAPDH_TAA_len41_fa0_ta20_fm6_tm14,a
2696@TOP@human_GAPDH_TAA_len41_fa0_ta20_fm6_tm14*125*a,1968,1,66,0,2035,0.032,125,2696@TOP@human_GAPDH_TAA_len41_fa0_ta20_fm6_tm14,a
2696@TOP@human_GAPDH_TAA_len41_fa0_ta20_fm6_tm14*126*g,0,0,2059,1,2060,1.0,126,2696@TOP@human_GAPDH_TAA_len41_fa0_ta20_fm6_tm14,g
2696@TOP@human_GAPDH_TAA_len41_fa0_ta20_fm6_tm14*127*a,2075,0,13,0,2088,0.006,127,2696@TOP@human_GAPDH_TAA_len41_fa0_ta20_fm6_tm14,a
2696@TOP@human_GAPDH_TAA_len41_fa0_ta20_fm6_tm14*128*c,0,2097,0,0,2097,0.0,128,2696@TOP@human_GAPDH_TAA_len41_fa0_ta20_fm6_tm14,c
2696@TOP@human_GAPDH_TAA_len41_fa0_ta20_fm6_tm14*129*c,0,2079,0,0,2079,0.0,129,2696@TOP@human_GAPDH_TAA_len41_fa0_ta20_fm6_tm14,c
2696@TOP@human_GAPDH_TAA_len41_fa0_ta20_fm6_tm14*130*c,1,2088,0,0,2089,0.0,130,2696@TOP@human_GAPDH_TAA_len41_fa0_ta20_fm6_tm14,c
2696@TOP@human_GAPDH_TAA_len41_fa0_ta20_fm6_tm14*131*c,0,2097,0,0,2097,0.0,131,2696@TOP@human_GAPDH_TAA_len41_fa0_ta20_fm6_tm14,c
2696@TOP@human_GAPDH_TAA_len41_fa0_ta20_fm6_tm14*132*t,0,0,0,2064,2064,0.0,132,2696@TOP@human_GAPDH_TAA_len41_fa0_ta20_fm6_tm14,t
2696@TOP@human_GAPDH_TAA_len41_fa0_ta20_fm6_tm14*133*g,0,0,2059,0,2059,1.0,133,2696@TOP@human_GAPDH_TAA_len41_fa0_ta20_fm6_tm14,g
2696@TOP@human_GAPDH_TAA_len41_fa0_ta20_fm6_tm14*134*g,0,1,2069,0,2070,1.0,134,2696@TOP@human_GAPDH_TAA_len41_fa0_ta20_fm6_tm14,g
2697@TOP@human_GAPDH_TAA_len41_fa0_ta20_fm6_tm14*114*t,0,0,0,1572,1572,0.0,114,2697@TOP@human_GAPDH_TAA_len41_fa0_ta20_fm6_tm14,t
2697@TOP@human_GAPDH_TAA_len41_fa0_ta20_fm6_tm14*115*c,0,1581,0,0,1581,0.0,115,2697@TOP@human_GAPDH_TAA_len41_fa0_ta20_fm6_tm14,c
2697@TOP@human_GAPDH_TAA_len41_fa0_ta20_fm6_tm14*116*c,0,1570,0,0,1570,0.0,116,2697@TOP@human_GAPDH_TAA_len41_fa0_ta20_fm6_tm14,c
2697@TOP@human_GAPDH_TAA_len41_fa0_ta20_fm6_tm14*117*a,1570,0,1,0,1571,0.001,117,2697@TOP@human_GAPDH_TAA_len41_fa0_ta20_fm6_tm14,a
2697@TOP@human_GAPDH_TAA_len41_fa0_ta20_fm6_tm14*118*a,1506,0,58,0,1564,0.037,118,2697@TOP@human_GAPDH_TAA_len41_fa0_ta20_fm6_tm14,a
2697@TOP@human_GAPDH_TAA_len41_fa0_ta20_fm6_tm14*119*g,0,0,1556,0,1556,1.0,119,2697@TOP@human_GAPDH_TAA_len41_fa0_ta20_fm6_tm14,g
2697@TOP@human_GAPDH_TAA_len41_fa0_ta20_fm6_tm14*120*g,0,0,1552,0,1552,1.0,120,2697@TOP@human_GAPDH_TAA_len41_fa0_ta20_fm6_tm14,g
2697@TOP@human_GAPDH_TAA_len41_fa0_ta20_fm6_tm14*121*a,1573,0,0,0,1573,0.0,121,2697@TOP@human_GAPDH_TAA_len41_fa0_ta20_fm6_tm14,a
2697@TOP@human_GAPDH_TAA_len41_fa0_ta20_fm6_tm14*122*g,0,0,1572,0,1572,1.0,122,2697@TOP@human_GAPDH_TAA_len41_fa0_ta20_fm6_tm14,g
2697@TOP@human_GAPDH_TAA_len41_fa0_ta20_fm6_tm14*123*t,0,2,0,1541,1543,0.0,123,2697@TOP@human_GAPDH_TAA_len41_fa0_ta20_fm6_tm14,t
2697@TOP@human_GAPDH_TAA_len41_fa0_ta20_fm6_tm14*124*a,1486,0,65,0,1551,0.042,124,2697@TOP@human_GAPDH_TAA_len41_fa0_ta20_fm6_tm14,a
2697@TOP@human_GAPDH_TAA_len41_fa0_ta20_fm6_tm14*125*a,1501,0,39,0,1540,0.025,125,2697@TOP@human_GAPDH_TAA_len41_fa0_ta20_fm6_tm14,a
2697@TOP@human_GAPDH_TAA_len41_fa0_ta20_fm6_tm14*126*g,0,1,1550,0,1551,0.999,126,2697@TOP@human_GAPDH_TAA_len41_fa0_ta20_fm6_tm14,g
2697@TOP@human_GAPDH_TAA_len41_fa0_ta20_fm6_tm14*127*a,1570,0,1,0,1571,0.001,127,2697@TOP@human_GAPDH_TAA_len41_fa0_ta20_fm6_tm14,a
2697@TOP@human_GAPDH_TAA_len41_fa0_ta20_fm6_tm14*128*c,0,1573,0,0,1573,0.0,128,2697@TOP@human_GAPDH_TAA_len41_fa0_ta20_fm6_tm14,c
2697@TOP@human_GAPDH_TAA_len41_fa0_ta20_fm6_tm14*129*c,0,1557,0,0,1557,0.0,129,2697@TOP@human_GAPDH_TAA_len41_fa0_ta20_fm6_tm14,c
2697@TOP@human_GAPDH_TAA_len41_fa0_ta20_fm6_tm14*130*c,0,1564,0,2,1566,0.0,130,2697@TOP@human_GAPDH_TAA_len41_fa0_ta20_fm6_tm14,c
2697@TOP@human_GAPDH_TAA_len41_fa0_ta20_fm6_tm14*131*c,0,1573,0,0,1573,0.0,131,2697@TOP@human_GAPDH_TAA_len41_fa0_ta20_fm6_tm14,c
2697@TOP@human_GAPDH_TAA_len41_fa0_ta20_fm6_tm14*132*t,0,0,0,1547,1547,0.0,132,2697@TOP@human_GAPDH_TAA_len41_fa0_ta20_fm6_tm14,t
2697@TOP@human_GAPDH_TAA_len41_fa0_ta20_fm6_tm14*133*g,0,0,1543,0,1543,1.0,133,2697@TOP@human_GAPDH_TAA_len41_fa0_ta20_fm6_tm14,g
2697@TOP@human_GAPDH_TAA_len41_fa0_ta20_fm6_tm14*134*g,0,0,1559,0,1559,1.0,134,2697@TOP@human_GAPDH_TAA_len41_fa0_ta20_fm6_tm14,g
2698@TOP@human_GAPDH_TAA_len41_fa0_ta20_fm6_tm14*114*t,0,0,0,1550,1550,0.0,114,2698@TOP@human_GAPDH_TAA_len41_fa0_ta20_fm6_tm14,t
2698@TOP@human_GAPDH_TAA_len41_fa0_ta20_fm6_tm14*115*c,0,1562,0,0,1562,0.0,115,2698@TOP@human_GAPDH_TAA_len41_fa0_ta20_fm6_tm14,c
2698@TOP@human_GAPDH_TAA_len41_fa0_ta20_fm6_tm14*116*c,0,1553,0,0,1553,0.0,116,2698@TOP@human_GAPDH_TAA_len41_fa0_ta20_fm6_tm14,c
2698@TOP@human_GAPDH_TAA_len41_fa0_ta20_fm6_tm14*117*a,1544,0,4,0,1548,0.003,117,2698@TOP@human_GAPDH_TAA_len41_fa0_ta20_fm6_tm14,a
2698@TOP@human_GAPDH_TAA_len41_fa0_ta20_fm6_tm14*118*a,1430,0,111,1,1542,0.072,118,2698@TOP@human_GAPDH_TAA_len41_fa0_ta20_fm6_tm14,a
2698@TOP@human_GAPDH_TAA_len41_fa0_ta20_fm6_tm14*119*g,0,0,1543,0,1543,1.0,119,2698@TOP@human_GAPDH_TAA_len41_fa0_ta20_fm6_tm14,g
2698@TOP@human_GAPDH_TAA_len41_fa0_ta20_fm6_tm14*120*g,0,0,1531,1,1532,0.999,120,2698@TOP@human_GAPDH_TAA_len41_fa0_ta20_fm6_tm14,g
2698@TOP@human_GAPDH_TAA_len41_fa0_ta20_fm6_tm14*121*a,1551,0,4,0,1555,0.003,121,2698@TOP@human_GAPDH_TAA_len41_fa0_ta20_fm6_tm14,a
2698@TOP@human_GAPDH_TAA_len41_fa0_ta20_fm6_tm14*122*g,0,0,1555,0,1555,1.0,122,2698@TOP@human_GAPDH_TAA_len41_fa0_ta20_fm6_tm14,g
2698@TOP@human_GAPDH_TAA_len41_fa0_ta20_fm6_tm14*123*t,0,0,0,1536,1536,0.0,123,2698@TOP@human_GAPDH_TAA_len41_fa0_ta20_fm6_tm14,t
2698@TOP@human_GAPDH_TAA_len41_fa0_ta20_fm6_tm14*124*a,1278,0,252,0,1530,0.165,124,2698@TOP@human_GAPDH_TAA_len41_fa0_ta20_fm6_tm14,a
2698@TOP@human_GAPDH_TAA_len41_fa0_ta20_fm6_tm14*125*a,1394,0,125,0,1519,0.082,125,2698@TOP@human_GAPDH_TAA_len41_fa0_ta20_fm6_tm14,a
2698@TOP@human_GAPDH_TAA_len41_fa0_ta20_fm6_tm14*126*g,0,0,1532,1,1533,0.999,126,2698@TOP@human_GAPDH_TAA_len41_fa0_ta20_fm6_tm14,g
2698@TOP@human_GAPDH_TAA_len41_fa0_ta20_fm6_tm14*127*a,1542,0,6,0,1548,0.004,127,2698@TOP@human_GAPDH_TAA_len41_fa0_ta20_fm6_tm14,a
2698@TOP@human_GAPDH_TAA_len41_fa0_ta20_fm6_tm14*128*c,0,1556,0,0,1556,0.0,128,2698@TOP@human_GAPDH_TAA_len41_fa0_ta20_fm6_tm14,c
2698@TOP@human_GAPDH_TAA_len41_fa0_ta20_fm6_tm14*129*c,1,1540,0,0,1541,0.0,129,2698@TOP@human_GAPDH_TAA_len41_fa0_ta20_fm6_tm14,c
2698@TOP@human_GAPDH_TAA_len41_fa0_ta20_fm6_tm14*130*c,0,1554,0,0,1554,0.0,130,2698@TOP@human_GAPDH_TAA_len41_fa0_ta20_fm6_tm14,c
2698@TOP@human_GAPDH_TAA_len41_fa0_ta20_fm6_tm14*131*c,0,1558,0,0,1558,0.0,131,2698@TOP@human_GAPDH_TAA_len41_fa0_ta20_fm6_tm14,c
2698@TOP@human_GAPDH_TAA_len41_fa0_ta20_fm6_tm14*132*t,0,0,0,1528,1528,0.0,132,2698@TOP@human_GAPDH_TAA_len41_fa0_ta20_fm6_tm14,t
2698@TOP@human_GAPDH_TAA_len41_fa0_ta20_fm6_tm14*133*g,0,0,1533,0,1533,1.0,133,2698@TOP@human_GAPDH_TAA_len41_fa0_ta20_fm6_tm14,g
2698@TOP@human_GAPDH_TAA_len41_fa0_ta20_fm6_tm14*134*g,0,0,1538,0,1538,1.0,134,2698@TOP@human_GAPDH_TAA_len41_fa0_ta20_fm6_tm14,g
2699@TOP@human_GAPDH_TAA_len41_fa0_ta20_fm6_tm14*114*t,0,0,0,1016,1016,0.0,114,2699@TOP@human_GAPDH_TAA_len41_fa0_ta20_fm6_tm14,t
2699@TOP@human_GAPDH_TAA_len41_fa0_ta20_fm6_tm14*115*c,0,1022,0,0,1022,0.0,115,2699@TOP@human_GAPDH_TAA_len41_fa0_ta20_fm6_tm14,c
2699@TOP@human_GAPDH_TAA_len41_fa0_ta20_fm6_tm14*116*c,0,1016,0,0,1016,0.0,116,2699@TOP@human_GAPDH_TAA_len41_fa0_ta20_fm6_tm14,c
2699@TOP@human_GAPDH_TAA_len41_fa0_ta20_fm6_tm14*117*a,1010,0,7,0,1017,0.007,117,2699@TOP@human_GAPDH_TAA_len41_fa0_ta20_fm6_tm14,a
2699@TOP@human_GAPDH_TAA_len41_fa0_ta20_fm6_tm14*118*a,950,0,63,0,1013,0.062,118,2699@TOP@human_GAPDH_TAA_len41_fa0_ta20_fm6_tm14,a
2699@TOP@human_GAPDH_TAA_len41_fa0_ta20_fm6_tm14*119*g,0,0,1007,1,1008,0.999,119,2699@TOP@human_GAPDH_TAA_len41_fa0_ta20_fm6_tm14,g
2699@TOP@human_GAPDH_TAA_len41_fa0_ta20_fm6_tm14*120*g,0,0,1001,0,1001,1.0,120,2699@TOP@human_GAPDH_TAA_len41_fa0_ta20_fm6_tm14,g
2699@TOP@human_GAPDH_TAA_len41_fa0_ta20_fm6_tm14*121*a,1017,0,0,0,1017,0.0,121,2699@TOP@human_GAPDH_TAA_len41_fa0_ta20_fm6_tm14,a
2699@TOP@human_GAPDH_TAA_len41_fa0_ta20_fm6_tm14*122*g,0,0,1015,0,1015,1.0,122,2699@TOP@human_GAPDH_TAA_len41_fa0_ta20_fm6_tm14,g
2699@TOP@human_GAPDH_TAA_len41_fa0_ta20_fm6_tm14*123*t,0,0,0,1002,1002,0.0,123,2699@TOP@human_GAPDH_TAA_len41_fa0_ta20_fm6_tm14,t
2699@TOP@human_GAPDH_TAA_len41_fa0_ta20_fm6_tm14*124*a,706,0,291,0,997,0.292,124,2699@TOP@human_GAPDH_TAA_len41_fa0_ta20_fm6_tm14,a
2699@TOP@human_GAPDH_TAA_len41_fa0_ta20_fm6_tm14*125*a,915,0,80,0,995,0.08,125,2699@TOP@human_GAPDH_TAA_len41_fa0_ta20_fm6_tm14,a
2699@TOP@human_GAPDH_TAA_len41_fa0_ta20_fm6_tm14*126*g,0,0,1003,0,1003,1.0,126,2699@TOP@human_GAPDH_TAA_len41_fa0_ta20_fm6_tm14,g
2699@TOP@human_GAPDH_TAA_len41_fa0_ta20_fm6_tm14*127*a,1018,0,1,0,1019,0.001,127,2699@TOP@human_GAPDH_TAA_len41_fa0_ta20_fm6_tm14,a
2699@TOP@human_GAPDH_TAA_len41_fa0_ta20_fm6_tm14*128*c,0,1019,0,1,1020,0.0,128,2699@TOP@human_GAPDH_TAA_len41_fa0_ta20_fm6_tm14,c
2699@TOP@human_GAPDH_TAA_len41_fa0_ta20_fm6_tm14*129*c,0,1008,0,0,1008,0.0,129,2699@TOP@human_GAPDH_TAA_len41_fa0_ta20_fm6_tm14,c
2699@TOP@human_GAPDH_TAA_len41_fa0_ta20_fm6_tm14*130*c,0,1018,0,0,1018,0.0,130,2699@TOP@human_GAPDH_TAA_len41_fa0_ta20_fm6_tm14,c
2699@TOP@human_GAPDH_TAA_len41_fa0_ta20_fm6_tm14*131*c,0,1023,0,0,1023,0.0,131,2699@TOP@human_GAPDH_TAA_len41_fa0_ta20_fm6_tm14,c
2699@TOP@human_GAPDH_TAA_len41_fa0_ta20_fm6_tm14*132*t,0,1,0,996,997,0.0,132,2699@TOP@human_GAPDH_TAA_len41_fa0_ta20_fm6_tm14,t
2699@TOP@human_GAPDH_TAA_len41_fa0_ta20_fm6_tm14*133*g,0,0,1002,1,1003,0.999,133,2699@TOP@human_GAPDH_TAA_len41_fa0_ta20_fm6_tm14,g
2699@TOP@human_GAPDH_TAA_len41_fa0_ta20_fm6_tm14*134*g,0,1,1009,0,1010,0.999,134,2699@TOP@human_GAPDH_TAA_len41_fa0_ta20_fm6_tm14,g
2700@TOP@human_GAPDH_TAA_len41_fa0_ta20_fm6_tm14*114*t,0,1,0,1371,1372,0.0,114,2700@TOP@human_GAPDH_TAA_len41_fa0_ta20_fm6_tm14,t
2700@TOP@human_GAPDH_TAA_len41_fa0_ta20_fm6_tm14*115*c,0,1385,0,0,1385,0.0,115,2700@TOP@human_GAPDH_TAA_len41_fa0_ta20_fm6_tm14,c
2700@TOP@human_GAPDH_TAA_len41_fa0_ta20_fm6_tm14*116*c,0,1375,0,0,1375,0.0,116,2700@TOP@human_GAPDH_TAA_len41_fa0_ta20_fm6_tm14,c
2700@TOP@human_GAPDH_TAA_len41_fa0_ta20_fm6_tm14*117*a,1383,0,1,0,1384,0.001,117,2700@TOP@human_GAPDH_TAA_len41_fa0_ta20_fm6_tm14,a
2700@TOP@human_GAPDH_TAA_len41_fa0_ta20_fm6_tm14*118*a,1345,0,24,0,1369,0.018,118,2700@TOP@human_GAPDH_TAA_len41_fa0_ta20_fm6_tm14,a
2700@TOP@human_GAPDH_TAA_len41_fa0_ta20_fm6_tm14*119*g,1,0,1353,0,1354,0.999,119,2700@TOP@human_GAPDH_TAA_len41_fa0_ta20_fm6_tm14,g
2700@TOP@human_GAPDH_TAA_len41_fa0_ta20_fm6_tm14*120*g,0,0,1347,1,1348,0.999,120,2700@TOP@human_GAPDH_TAA_len41_fa0_ta20_fm6_tm14,g
2700@TOP@human_GAPDH_TAA_len41_fa0_ta20_fm6_tm14*121*a,1376,0,0,0,1376,0.0,121,2700@TOP@human_GAPDH_TAA_len41_fa0_ta20_fm6_tm14,a
2700@TOP@human_GAPDH_TAA_len41_fa0_ta20_fm6_tm14*122*g,0,0,1379,0,1379,1.0,122,2700@TOP@human_GAPDH_TAA_len41_fa0_ta20_fm6_tm14,g
2700@TOP@human_GAPDH_TAA_len41_fa0_ta20_fm6_tm14*123*t,1,0,0,1353,1354,0.0,123,2700@TOP@human_GAPDH_TAA_len41_fa0_ta20_fm6_tm14,t
2700@TOP@human_GAPDH_TAA_len41_fa0_ta20_fm6_tm14*124*a,1109,0,240,0,1349,0.178,124,2700@TOP@human_GAPDH_TAA_len41_fa0_ta20_fm6_tm14,a
2700@TOP@human_GAPDH_TAA_len41_fa0_ta20_fm6_tm14*125*a,1237,0,108,0,1345,0.08,125,2700@TOP@human_GAPDH_TAA_len41_fa0_ta20_fm6_tm14,a
2700@TOP@human_GAPDH_TAA_len41_fa0_ta20_fm6_tm14*126*g,0,0,1359,0,1359,1.0,126,2700@TOP@human_GAPDH_TAA_len41_fa0_ta20_fm6_tm14,g
2700@TOP@human_GAPDH_TAA_len41_fa0_ta20_fm6_tm14*127*a,1360,0,16,0,1376,0.012,127,2700@TOP@human_GAPDH_TAA_len41_fa0_ta20_fm6_tm14,a
2700@TOP@human_GAPDH_TAA_len41_fa0_ta20_fm6_tm14*128*c,0,1380,0,0,1380,0.0,128,2700@TOP@human_GAPDH_TAA_len41_fa0_ta20_fm6_tm14,c
2700@TOP@human_GAPDH_TAA_len41_fa0_ta20_fm6_tm14*129*c,0,1373,0,0,1373,0.0,129,2700@TOP@human_GAPDH_TAA_len41_fa0_ta20_fm6_tm14,c
2700@TOP@human_GAPDH_TAA_len41_fa0_ta20_fm6_tm14*130*c,0,1380,0,1,1381,0.0,130,2700@TOP@human_GAPDH_TAA_len41_fa0_ta20_fm6_tm14,c
2700@TOP@human_GAPDH_TAA_len41_fa0_ta20_fm6_tm14*131*c,0,1382,0,0,1382,0.0,131,2700@TOP@human_GAPDH_TAA_len41_fa0_ta20_fm6_tm14,c
2700@TOP@human_GAPDH_TAA_len41_fa0_ta20_fm6_tm14*132*t,0,0,0,1362,1362,0.0,132,2700@TOP@human_GAPDH_TAA_len41_fa0_ta20_fm6_tm14,t
2700@TOP@human_GAPDH_TAA_len41_fa0_ta20_fm6_tm14*133*g,0,1,1359,0,1360,0.999,133,2700@TOP@human_GAPDH_TAA_len41_fa0_ta20_fm6_tm14,g
2700@TOP@human_GAPDH_TAA_len41_fa0_ta20_fm6_tm14*134*g,0,0,1361,0,1361,1.0,134,2700@TOP@human_GAPDH_TAA_len41_fa0_ta20_fm6_tm14,g
2701@TOP@human_GAPDH_TAA_len41_fa0_ta20_fm6_tm14*114*t,0,1,0,1870,1871,0.0,114,2701@TOP@human_GAPDH_TAA_len41_fa0_ta20_fm6_tm14,t
2701@TOP@human_GAPDH_TAA_len41_fa0_ta20_fm6_tm14*115*c,0,1882,0,0,1882,0.0,115,2701@TOP@human_GAPDH_TAA_len41_fa0_ta20_fm6_tm14,c
2701@TOP@human_GAPDH_TAA_len41_fa0_ta20_fm6_tm14*116*c,0,1876,0,0,1876,0.0,116,2701@TOP@human_GAPDH_TAA_len41_fa0_ta20_fm6_tm14,c
2701@TOP@human_GAPDH_TAA_len41_fa0_ta20_fm6_tm14*117*a,1866,0,5,0,1871,0.003,117,2701@TOP@human_GAPDH_TAA_len41_fa0_ta20_fm6_tm14,a
2701@TOP@human_GAPDH_TAA_len41_fa0_ta20_fm6_tm14*118*a,1823,0,44,0,1867,0.024,118,2701@TOP@human_GAPDH_TAA_len41_fa0_ta20_fm6_tm14,a
2701@TOP@human_GAPDH_TAA_len41_fa0_ta20_fm6_tm14*119*g,0,0,1857,0,1857,1.0,119,2701@TOP@human_GAPDH_TAA_len41_fa0_ta20_fm6_tm14,g
2701@TOP@human_GAPDH_TAA_len41_fa0_ta20_fm6_tm14*120*g,0,0,1855,0,1855,1.0,120,2701@TOP@human_GAPDH_TAA_len41_fa0_ta20_fm6_tm14,g
2701@TOP@human_GAPDH_TAA_len41_fa0_ta20_fm6_tm14*121*a,1869,0,1,0,1870,0.001,121,2701@TOP@human_GAPDH_TAA_len41_fa0_ta20_fm6_tm14,a
2701@TOP@human_GAPDH_TAA_len41_fa0_ta20_fm6_tm14*122*g,0,0,1873,0,1873,1.0,122,2701@TOP@human_GAPDH_TAA_len41_fa0_ta20_fm6_tm14,g
2701@TOP@human_GAPDH_TAA_len41_fa0_ta20_fm6_tm14*123*t,1,0,1,1858,1860,0.001,123,2701@TOP@human_GAPDH_TAA_len41_fa0_ta20_fm6_tm14,t
2701@TOP@human_GAPDH_TAA_len41_fa0_ta20_fm6_tm14*124*a,1385,0,456,0,1841,0.248,124,2701@TOP@human_GAPDH_TAA_len41_fa0_ta20_fm6_tm14,a
2701@TOP@human_GAPDH_TAA_len41_fa0_ta20_fm6_tm14*125*a,1439,0,411,0,1850,0.222,125,2701@TOP@human_GAPDH_TAA_len41_fa0_ta20_fm6_tm14,a
2701@TOP@human_GAPDH_TAA_len41_fa0_ta20_fm6_tm14*126*g,0,0,1846,0,1846,1.0,126,2701@TOP@human_GAPDH_TAA_len41_fa0_ta20_fm6_tm14,g
2701@TOP@human_GAPDH_TAA_len41_fa0_ta20_fm6_tm14*127*a,1835,0,31,0,1866,0.017,127,2701@TOP@human_GAPDH_TAA_len41_fa0_ta20_fm6_tm14,a
2701@TOP@human_GAPDH_TAA_len41_fa0_ta20_fm6_tm14*128*c,0,1873,0,0,1873,0.0,128,2701@TOP@human_GAPDH_TAA_len41_fa0_ta20_fm6_tm14,c
2701@TOP@human_GAPDH_TAA_len41_fa0_ta20_fm6_tm14*129*c,0,1865,0,0,1865,0.0,129,2701@TOP@human_GAPDH_TAA_len41_fa0_ta20_fm6_tm14,c
2701@TOP@human_GAPDH_TAA_len41_fa0_ta20_fm6_tm14*130*c,0,1876,0,0,1876,0.0,130,2701@TOP@human_GAPDH_TAA_len41_fa0_ta20_fm6_tm14,c
2701@TOP@human_GAPDH_TAA_len41_fa0_ta20_fm6_tm14*131*c,0,1880,0,0,1880,0.0,131,2701@TOP@human_GAPDH_TAA_len41_fa0_ta20_fm6_tm14,c
2701@TOP@human_GAPDH_TAA_len41_fa0_ta20_fm6_tm14*132*t,0,0,0,1846,1846,0.0,132,2701@TOP@human_GAPDH_TAA_len41_fa0_ta20_fm6_tm14,t
2701@TOP@human_GAPDH_TAA_len41_fa0_ta20_fm6_tm14*133*g,0,0,1841,0,1841,1.0,133,2701@TOP@human_GAPDH_TAA_len41_fa0_ta20_fm6_tm14,g
2701@TOP@human_GAPDH_TAA_len41_fa0_ta20_fm6_tm14*134*g,0,0,1843,0,1843,1.0,134,2701@TOP@human_GAPDH_TAA_len41_fa0_ta20_fm6_tm14,g
2702@TOP@human_GAPDH_TAA_len41_fa0_ta20_fm6_tm14*114*t,0,0,1,1915,1916,0.001,114,2702@TOP@human_GAPDH_TAA_len41_fa0_ta20_fm6_tm14,t
2702@TOP@human_GAPDH_TAA_len41_fa0_ta20_fm6_tm14*115*c,0,1936,0,0,1936,0.0,115,2702@TOP@human_GAPDH_TAA_len41_fa0_ta20_fm6_tm14,c
2702@TOP@human_GAPDH_TAA_len41_fa0_ta20_fm6_tm14*116*c,0,1915,0,0,1915,0.0,116,2702@TOP@human_GAPDH_TAA_len41_fa0_ta20_fm6_tm14,c
2702@TOP@human_GAPDH_TAA_len41_fa0_ta20_fm6_tm14*117*a,1912,0,9,0,1921,0.005,117,2702@TOP@human_GAPDH_TAA_len41_fa0_ta20_fm6_tm14,a
2702@TOP@human_GAPDH_TAA_len41_fa0_ta20_fm6_tm14*118*a,1854,0,40,0,1894,0.021,118,2702@TOP@human_GAPDH_TAA_len41_fa0_ta20_fm6_tm14,a
2702@TOP@human_GAPDH_TAA_len41_fa0_ta20_fm6_tm14*119*g,0,0,1904,0,1904,1.0,119,2702@TOP@human_GAPDH_TAA_len41_fa0_ta20_fm6_tm14,g
2702@TOP@human_GAPDH_TAA_len41_fa0_ta20_fm6_tm14*120*g,0,0,1889,0,1889,1.0,120,2702@TOP@human_GAPDH_TAA_len41_fa0_ta20_fm6_tm14,g
2702@TOP@human_GAPDH_TAA_len41_fa0_ta20_fm6_tm14*121*a,1921,0,0,0,1921,0.0,121,2702@TOP@human_GAPDH_TAA_len41_fa0_ta20_fm6_tm14,a
2702@TOP@human_GAPDH_TAA_len41_fa0_ta20_fm6_tm14*122*g,0,0,1925,0,1925,1.0,122,2702@TOP@human_GAPDH_TAA_len41_fa0_ta20_fm6_tm14,g
2702@TOP@human_GAPDH_TAA_len41_fa0_ta20_fm6_tm14*123*t,0,0,1,1878,1879,0.001,123,2702@TOP@human_GAPDH_TAA_len41_fa0_ta20_fm6_tm14,t
2702@TOP@human_GAPDH_TAA_len41_fa0_ta20_fm6_tm14*124*a,1205,0,676,0,1881,0.359,124,2702@TOP@human_GAPDH_TAA_len41_fa0_ta20_fm6_tm14,a
2702@TOP@human_GAPDH_TAA_len41_fa0_ta20_fm6_tm14*125*a,1415,1,462,0,1878,0.246,125,2702@TOP@human_GAPDH_TAA_len41_fa0_ta20_fm6_tm14,a
2702@TOP@human_GAPDH_TAA_len41_fa0_ta20_fm6_tm14*126*g,0,0,1903,0,1903,1.0,126,2702@TOP@human_GAPDH_TAA_len41_fa0_ta20_fm6_tm14,g
2702@TOP@human_GAPDH_TAA_len41_fa0_ta20_fm6_tm14*127*a,1865,0,49,0,1914,0.026,127,2702@TOP@human_GAPDH_TAA_len41_fa0_ta20_fm6_tm14,a
2702@TOP@human_GAPDH_TAA_len41_fa0_ta20_fm6_tm14*128*c,1,1925,0,0,1926,0.0,128,2702@TOP@human_GAPDH_TAA_len41_fa0_ta20_fm6_tm14,c
2702@TOP@human_GAPDH_TAA_len41_fa0_ta20_fm6_tm14*129*c,0,1909,0,0,1909,0.0,129,2702@TOP@human_GAPDH_TAA_len41_fa0_ta20_fm6_tm14,c
2702@TOP@human_GAPDH_TAA_len41_fa0_ta20_fm6_tm14*130*c,0,1919,0,0,1919,0.0,130,2702@TOP@human_GAPDH_TAA_len41_fa0_ta20_fm6_tm14,c
2702@TOP@human_GAPDH_TAA_len41_fa0_ta20_fm6_tm14*131*c,0,1923,0,0,1923,0.0,131,2702@TOP@human_GAPDH_TAA_len41_fa0_ta20_fm6_tm14,c
2702@TOP@human_GAPDH_TAA_len41_fa0_ta20_fm6_tm14*132*t,1,0,0,1877,1878,0.0,132,2702@TOP@human_GAPDH_TAA_len41_fa0_ta20_fm6_tm14,t
2702@TOP@human_GAPDH_TAA_len41_fa0_ta20_fm6_tm14*133*g,0,0,1902,0,1902,1.0,133,2702@TOP@human_GAPDH_TAA_len41_fa0_ta20_fm6_tm14,g
2702@TOP@human_GAPDH_TAA_len41_fa0_ta20_fm6_tm14*134*g,2,0,1907,0,1909,0.999,134,2702@TOP@human_GAPDH_TAA_len41_fa0_ta20_fm6_tm14,g
2703@TOP@human_GAPDH_TAA_len41_fa0_ta20_fm6_tm14*114*t,10,9,1,35269,35289,0.0,114,2703@TOP@human_GAPDH_TAA_len41_fa0_ta20_fm6_tm14,t
2703@TOP@human_GAPDH_TAA_len41_fa0_ta20_fm6_tm14*115*c,2,35476,0,6,35484,0.0,115,2703@TOP@human_GAPDH_TAA_len41_fa0_ta20_fm6_tm14,c
2703@TOP@human_GAPDH_TAA_len41_fa0_ta20_fm6_tm14*116*c,0,35335,0,0,35335,0.0,116,2703@TOP@human_GAPDH_TAA_len41_fa0_ta20_fm6_tm14,c
2703@TOP@human_GAPDH_TAA_len41_fa0_ta20_fm6_tm14*117*a,35297,0,37,0,35334,0.001,117,2703@TOP@human_GAPDH_TAA_len41_fa0_ta20_fm6_tm14,a
2703@TOP@human_GAPDH_TAA_len41_fa0_ta20_fm6_tm14*118*a,34753,2,361,1,35117,0.01,118,2703@TOP@human_GAPDH_TAA_len41_fa0_ta20_fm6_tm14,a
2703@TOP@human_GAPDH_TAA_len41_fa0_ta20_fm6_tm14*119*g,3,2,35079,1,35085,1.0,119,2703@TOP@human_GAPDH_TAA_len41_fa0_ta20_fm6_tm14,g
2703@TOP@human_GAPDH_TAA_len41_fa0_ta20_fm6_tm14*120*g,5,0,34959,1,34965,1.0,120,2703@TOP@human_GAPDH_TAA_len41_fa0_ta20_fm6_tm14,g
2703@TOP@human_GAPDH_TAA_len41_fa0_ta20_fm6_tm14*121*a,35305,0,10,1,35316,0.0,121,2703@TOP@human_GAPDH_TAA_len41_fa0_ta20_fm6_tm14,a
2703@TOP@human_GAPDH_TAA_len41_fa0_ta20_fm6_tm14*122*g,1,2,35360,0,35363,1.0,122,2703@TOP@human_GAPDH_TAA_len41_fa0_ta20_fm6_tm14,g
2703@TOP@human_GAPDH_TAA_len41_fa0_ta20_fm6_tm14*123*t,3,3,6,34870,34882,0.0,123,2703@TOP@human_GAPDH_TAA_len41_fa0_ta20_fm6_tm14,t
2703@TOP@human_GAPDH_TAA_len41_fa0_ta20_fm6_tm14*124*a,33679,3,943,0,34625,0.027,124,2703@TOP@human_GAPDH_TAA_len41_fa0_ta20_fm6_tm14,a
2703@TOP@human_GAPDH_TAA_len41_fa0_ta20_fm6_tm14*125*a,31207,1,3481,2,34691,0.1,125,2703@TOP@human_GAPDH_TAA_len41_fa0_ta20_fm6_tm14,a
2703@TOP@human_GAPDH_TAA_len41_fa0_ta20_fm6_tm14*126*g,2,0,34840,0,34842,1.0,126,2703@TOP@human_GAPDH_TAA_len41_fa0_ta20_fm6_tm14,g
2703@TOP@human_GAPDH_TAA_len41_fa0_ta20_fm6_tm14*127*a,33617,1,1596,0,35214,0.045,127,2703@TOP@human_GAPDH_TAA_len41_fa0_ta20_fm6_tm14,a
2703@TOP@human_GAPDH_TAA_len41_fa0_ta20_fm6_tm14*128*c,0,35394,2,0,35396,0.0,128,2703@TOP@human_GAPDH_TAA_len41_fa0_ta20_fm6_tm14,c
2703@TOP@human_GAPDH_TAA_len41_fa0_ta20_fm6_tm14*129*c,2,35152,0,3,35157,0.0,129,2703@TOP@human_GAPDH_TAA_len41_fa0_ta20_fm6_tm14,c
2703@TOP@human_GAPDH_TAA_len41_fa0_ta20_fm6_tm14*130*c,2,35340,0,5,35347,0.0,130,2703@TOP@human_GAPDH_TAA_len41_fa0_ta20_fm6_tm14,c
2703@TOP@human_GAPDH_TAA_len41_fa0_ta20_fm6_tm14*131*c,0,35416,0,6,35422,0.0,131,2703@TOP@human_GAPDH_TAA_len41_fa0_ta20_fm6_tm14,c
2703@TOP@human_GAPDH_TAA_len41_fa0_ta20_fm6_tm14*132*t,5,5,3,34955,34968,0.0,132,2703@TOP@human_GAPDH_TAA_len41_fa0_ta20_fm6_tm14,t
2703@TOP@human_GAPDH_TAA_len41_fa0_ta20_fm6_tm14*133*g,0,0,34855,4,34859,1.0,133,2703@TOP@human_GAPDH_TAA_len41_fa0_ta20_fm6_tm14,g
2703@TOP@human_GAPDH_TAA_len41_fa0_ta20_fm6_tm14*134*g,1,3,35008,5,35017,1.0,134,2703@TOP@human_GAPDH_TAA_len41_fa0_ta20_fm6_tm14,g
2704@TOP@human_GAPDH_TAA_len41_fa0_ta20_fm6_tm14*114*t,2,5,0,34719,34726,0.0,114,2704@TOP@human_GAPDH_TAA_len41_fa0_ta20_fm6_tm14,t
2704@TOP@human_GAPDH_TAA_len41_fa0_ta20_fm6_tm14*115*c,0,34883,0,3,34886,0.0,115,2704@TOP@human_GAPDH_TAA_len41_fa0_ta20_fm6_tm14,c
2704@TOP@human_GAPDH_TAA_len41_fa0_ta20_fm6_tm14*116*c,4,34740,0,9,34753,0.0,116,2704@TOP@human_GAPDH_TAA_len41_fa0_ta20_fm6_tm14,c
2704@TOP@human_GAPDH_TAA_len41_fa0_ta20_fm6_tm14*117*a,34675,0,64,0,34739,0.002,117,2704@TOP@human_GAPDH_TAA_len41_fa0_ta20_fm6_tm14,a
2704@TOP@human_GAPDH_TAA_len41_fa0_ta20_fm6_tm14*118*a,34143,0,400,0,34543,0.012,118,2704@TOP@human_GAPDH_TAA_len41_fa0_ta20_fm6_tm14,a
2704@TOP@human_GAPDH_TAA_len41_fa0_ta20_fm6_tm14*119*g,0,2,34488,0,34490,1.0,119,2704@TOP@human_GAPDH_TAA_len41_fa0_ta20_fm6_tm14,g
2704@TOP@human_GAPDH_TAA_len41_fa0_ta20_fm6_tm14*120*g,3,1,34345,1,34350,1.0,120,2704@TOP@human_GAPDH_TAA_len41_fa0_ta20_fm6_tm14,g
2704@TOP@human_GAPDH_TAA_len41_fa0_ta20_fm6_tm14*121*a,34710,0,13,0,34723,0.0,121,2704@TOP@human_GAPDH_TAA_len41_fa0_ta20_fm6_tm14,a
2704@TOP@human_GAPDH_TAA_len41_fa0_ta20_fm6_tm14*122*g,1,0,34742,0,34743,1.0,122,2704@TOP@human_GAPDH_TAA_len41_fa0_ta20_fm6_tm14,g
2704@TOP@human_GAPDH_TAA_len41_fa0_ta20_fm6_tm14*123*t,6,3,1,34352,34362,0.0,123,2704@TOP@human_GAPDH_TAA_len41_fa0_ta20_fm6_tm14,t
2704@TOP@human_GAPDH_TAA_len41_fa0_ta20_fm6_tm14*124*a,33252,1,973,2,34228,0.028,124,2704@TOP@human_GAPDH_TAA_len41_fa0_ta20_fm6_tm14,a
2704@TOP@human_GAPDH_TAA_len41_fa0_ta20_fm6_tm14*125*a,32203,1,1917,0,34121,0.056,125,2704@TOP@human_GAPDH_TAA_len41_fa0_ta20_fm6_tm14,a
2704@TOP@human_GAPDH_TAA_len41_fa0_ta20_fm6_tm14*126*g,2,0,34329,3,34334,1.0,126,2704@TOP@human_GAPDH_TAA_len41_fa0_ta20_fm6_tm14,g
2704@TOP@human_GAPDH_TAA_len41_fa0_ta20_fm6_tm14*127*a,34187,7,436,1,34631,0.013,127,2704@TOP@human_GAPDH_TAA_len41_fa0_ta20_fm6_tm14,a
2704@TOP@human_GAPDH_TAA_len41_fa0_ta20_fm6_tm14*128*c,1,34817,5,1,34824,0.0,128,2704@TOP@human_GAPDH_TAA_len41_fa0_ta20_fm6_tm14,c
2704@TOP@human_GAPDH_TAA_len41_fa0_ta20_fm6_tm14*129*c,3,34560,0,3,34566,0.0,129,2704@TOP@human_GAPDH_TAA_len41_fa0_ta20_fm6_tm14,c
2704@TOP@human_GAPDH_TAA_len41_fa0_ta20_fm6_tm14*130*c,5,34762,2,4,34773,0.0,130,2704@TOP@human_GAPDH_TAA_len41_fa0_ta20_fm6_tm14,c
2704@TOP@human_GAPDH_TAA_len41_fa0_ta20_fm6_tm14*131*c,6,34806,0,2,34814,0.0,131,2704@TOP@human_GAPDH_TAA_len41_fa0_ta20_fm6_tm14,c
2704@TOP@human_GAPDH_TAA_len41_fa0_ta20_fm6_tm14*132*t,0,5,3,34344,34352,0.0,132,2704@TOP@human_GAPDH_TAA_len41_fa0_ta20_fm6_tm14,t
2704@TOP@human_GAPDH_TAA_len41_fa0_ta20_fm6_tm14*133*g,6,3,34243,1,34253,1.0,133,2704@TOP@human_GAPDH_TAA_len41_fa0_ta20_fm6_tm14,g
2704@TOP@human_GAPDH_TAA_len41_fa0_ta20_fm6_tm14*134*g,1,0,34472,2,34475,1.0,134,2704@TOP@human_GAPDH_TAA_len41_fa0_ta20_fm6_tm14,g
2705@TOP@human_GAPDH_TAA_len41_fa0_ta20_fm6_tm14*114*t,0,0,0,301,301,0.0,114,2705@TOP@human_GAPDH_TAA_len41_fa0_ta20_fm6_tm14,t
2705@TOP@human_GAPDH_TAA_len41_fa0_ta20_fm6_tm14*115*c,0,300,0,0,300,0.0,115,2705@TOP@human_GAPDH_TAA_len41_fa0_ta20_fm6_tm14,c
2705@TOP@human_GAPDH_TAA_len41_fa0_ta20_fm6_tm14*116*c,0,298,0,0,298,0.0,116,2705@TOP@human_GAPDH_TAA_len41_fa0_ta20_fm6_tm14,c
2705@TOP@human_GAPDH_TAA_len41_fa0_ta20_fm6_tm14*117*a,301,0,0,0,301,0.0,117,2705@TOP@human_GAPDH_TAA_len41_fa0_ta20_fm6_tm14,a
2705@TOP@human_GAPDH_TAA_len41_fa0_ta20_fm6_tm14*118*a,281,0,14,1,296,0.047,118,2705@TOP@human_GAPDH_TAA_len41_fa0_ta20_fm6_tm14,a
2705@TOP@human_GAPDH_TAA_len41_fa0_ta20_fm6_tm14*119*g,0,0,293,0,293,1.0,119,2705@TOP@human_GAPDH_TAA_len41_fa0_ta20_fm6_tm14,g
2705@TOP@human_GAPDH_TAA_len41_fa0_ta20_fm6_tm14*120*g,0,0,292,0,292,1.0,120,2705@TOP@human_GAPDH_TAA_len41_fa0_ta20_fm6_tm14,g
2705@TOP@human_GAPDH_TAA_len41_fa0_ta20_fm6_tm14*121*a,299,0,0,0,299,0.0,121,2705@TOP@human_GAPDH_TAA_len41_fa0_ta20_fm6_tm14,a
2705@TOP@human_GAPDH_TAA_len41_fa0_ta20_fm6_tm14*122*g,0,0,299,0,299,1.0,122,2705@TOP@human_GAPDH_TAA_len41_fa0_ta20_fm6_tm14,g
2705@TOP@human_GAPDH_TAA_len41_fa0_ta20_fm6_tm14*123*t,0,0,0,293,293,0.0,123,2705@TOP@human_GAPDH_TAA_len41_fa0_ta20_fm6_tm14,t
2705@TOP@human_GAPDH_TAA_len41_fa0_ta20_fm6_tm14*124*a,250,0,39,0,289,0.135,124,2705@TOP@human_GAPDH_TAA_len41_fa0_ta20_fm6_tm14,a
2705@TOP@human_GAPDH_TAA_len41_fa0_ta20_fm6_tm14*125*a,260,0,35,0,295,0.119,125,2705@TOP@human_GAPDH_TAA_len41_fa0_ta20_fm6_tm14,a
2705@TOP@human_GAPDH_TAA_len41_fa0_ta20_fm6_tm14*126*g,0,0,292,0,292,1.0,126,2705@TOP@human_GAPDH_TAA_len41_fa0_ta20_fm6_tm14,g
2705@TOP@human_GAPDH_TAA_len41_fa0_ta20_fm6_tm14*127*a,295,0,3,0,298,0.01,127,2705@TOP@human_GAPDH_TAA_len41_fa0_ta20_fm6_tm14,a
2705@TOP@human_GAPDH_TAA_len41_fa0_ta20_fm6_tm14*128*c,0,300,0,0,300,0.0,128,2705@TOP@human_GAPDH_TAA_len41_fa0_ta20_fm6_tm14,c
2705@TOP@human_GAPDH_TAA_len41_fa0_ta20_fm6_tm14*129*c,0,294,0,0,294,0.0,129,2705@TOP@human_GAPDH_TAA_len41_fa0_ta20_fm6_tm14,c
2705@TOP@human_GAPDH_TAA_len41_fa0_ta20_fm6_tm14*130*c,0,298,0,0,298,0.0,130,2705@TOP@human_GAPDH_TAA_len41_fa0_ta20_fm6_tm14,c
2705@TOP@human_GAPDH_TAA_len41_fa0_ta20_fm6_tm14*131*c,0,300,0,0,300,0.0,131,2705@TOP@human_GAPDH_TAA_len41_fa0_ta20_fm6_tm14,c
2705@TOP@human_GAPDH_TAA_len41_fa0_ta20_fm6_tm14*132*t,0,0,0,290,290,0.0,132,2705@TOP@human_GAPDH_TAA_len41_fa0_ta20_fm6_tm14,t
2705@TOP@human_GAPDH_TAA_len41_fa0_ta20_fm6_tm14*133*g,0,0,298,0,298,1.0,133,2705@TOP@human_GAPDH_TAA_len41_fa0_ta20_fm6_tm14,g
2705@TOP@human_GAPDH_TAA_len41_fa0_ta20_fm6_tm14*134*g,0,0,296,0,296,1.0,134,2705@TOP@human_GAPDH_TAA_len41_fa0_ta20_fm6_tm14,g
2706@TOP@human_GAPDH_TAA_len41_fa0_ta20_fm6_tm14*114*t,0,0,0,2445,2445,0.0,114,2706@TOP@human_GAPDH_TAA_len41_fa0_ta20_fm6_tm14,t
2706@TOP@human_GAPDH_TAA_len41_fa0_ta20_fm6_tm14*115*c,0,2456,0,0,2456,0.0,115,2706@TOP@human_GAPDH_TAA_len41_fa0_ta20_fm6_tm14,c
2706@TOP@human_GAPDH_TAA_len41_fa0_ta20_fm6_tm14*116*c,0,2447,0,0,2447,0.0,116,2706@TOP@human_GAPDH_TAA_len41_fa0_ta20_fm6_tm14,c
2706@TOP@human_GAPDH_TAA_len41_fa0_ta20_fm6_tm14*117*a,2414,0,33,0,2447,0.013,117,2706@TOP@human_GAPDH_TAA_len41_fa0_ta20_fm6_tm14,a
2706@TOP@human_GAPDH_TAA_len41_fa0_ta20_fm6_tm14*118*a,2310,0,126,0,2436,0.052,118,2706@TOP@human_GAPDH_TAA_len41_fa0_ta20_fm6_tm14,a
2706@TOP@human_GAPDH_TAA_len41_fa0_ta20_fm6_tm14*119*g,0,0,2414,0,2414,1.0,119,2706@TOP@human_GAPDH_TAA_len41_fa0_ta20_fm6_tm14,g
2706@TOP@human_GAPDH_TAA_len41_fa0_ta20_fm6_tm14*120*g,1,0,2411,0,2412,1.0,120,2706@TOP@human_GAPDH_TAA_len41_fa0_ta20_fm6_tm14,g
2706@TOP@human_GAPDH_TAA_len41_fa0_ta20_fm6_tm14*121*a,2440,0,5,0,2445,0.002,121,2706@TOP@human_GAPDH_TAA_len41_fa0_ta20_fm6_tm14,a
2706@TOP@human_GAPDH_TAA_len41_fa0_ta20_fm6_tm14*122*g,1,0,2443,0,2444,1.0,122,2706@TOP@human_GAPDH_TAA_len41_fa0_ta20_fm6_tm14,g
2706@TOP@human_GAPDH_TAA_len41_fa0_ta20_fm6_tm14*123*t,0,1,0,2405,2406,0.0,123,2706@TOP@human_GAPDH_TAA_len41_fa0_ta20_fm6_tm14,t
2706@TOP@human_GAPDH_TAA_len41_fa0_ta20_fm6_tm14*124*a,2034,0,382,0,2416,0.158,124,2706@TOP@human_GAPDH_TAA_len41_fa0_ta20_fm6_tm14,a
2706@TOP@human_GAPDH_TAA_len41_fa0_ta20_fm6_tm14*125*a,2148,0,253,0,2401,0.105,125,2706@TOP@human_GAPDH_TAA_len41_fa0_ta20_fm6_tm14,a
2706@TOP@human_GAPDH_TAA_len41_fa0_ta20_fm6_tm14*126*g,0,0,2415,0,2415,1.0,126,2706@TOP@human_GAPDH_TAA_len41_fa0_ta20_fm6_tm14,g
2706@TOP@human_GAPDH_TAA_len41_fa0_ta20_fm6_tm14*127*a,2430,0,7,0,2437,0.003,127,2706@TOP@human_GAPDH_TAA_len41_fa0_ta20_fm6_tm14,a
2706@TOP@human_GAPDH_TAA_len41_fa0_ta20_fm6_tm14*128*c,0,2447,0,0,2447,0.0,128,2706@TOP@human_GAPDH_TAA_len41_fa0_ta20_fm6_tm14,c
2706@TOP@human_GAPDH_TAA_len41_fa0_ta20_fm6_tm14*129*c,0,2432,0,0,2432,0.0,129,2706@TOP@human_GAPDH_TAA_len41_fa0_ta20_fm6_tm14,c
2706@TOP@human_GAPDH_TAA_len41_fa0_ta20_fm6_tm14*130*c,0,2445,0,0,2445,0.0,130,2706@TOP@human_GAPDH_TAA_len41_fa0_ta20_fm6_tm14,c
2706@TOP@human_GAPDH_TAA_len41_fa0_ta20_fm6_tm14*131*c,0,2453,0,0,2453,0.0,131,2706@TOP@human_GAPDH_TAA_len41_fa0_ta20_fm6_tm14,c
2706@TOP@human_GAPDH_TAA_len41_fa0_ta20_fm6_tm14*132*t,0,3,0,2417,2420,0.0,132,2706@TOP@human_GAPDH_TAA_len41_fa0_ta20_fm6_tm14,t
2706@TOP@human_GAPDH_TAA_len41_fa0_ta20_fm6_tm14*133*g,0,0,2412,0,2412,1.0,133,2706@TOP@human_GAPDH_TAA_len41_fa0_ta20_fm6_tm14,g
2706@TOP@human_GAPDH_TAA_len41_fa0_ta20_fm6_tm14*134*g,1,2,2413,0,2416,0.999,134,2706@TOP@human_GAPDH_TAA_len41_fa0_ta20_fm6_tm14,g
2707@TOP@human_GAPDH_TAA_len41_fa0_ta20_fm6_tm14*114*t,0,0,0,1341,1341,0.0,114,2707@TOP@human_GAPDH_TAA_len41_fa0_ta20_fm6_tm14,t
2707@TOP@human_GAPDH_TAA_len41_fa0_ta20_fm6_tm14*115*c,0,1346,0,0,1346,0.0,115,2707@TOP@human_GAPDH_TAA_len41_fa0_ta20_fm6_tm14,c
2707@TOP@human_GAPDH_TAA_len41_fa0_ta20_fm6_tm14*116*c,0,1339,0,0,1339,0.0,116,2707@TOP@human_GAPDH_TAA_len41_fa0_ta20_fm6_tm14,c
2707@TOP@human_GAPDH_TAA_len41_fa0_ta20_fm6_tm14*117*a,1337,0,3,0,1340,0.002,117,2707@TOP@human_GAPDH_TAA_len41_fa0_ta20_fm6_tm14,a
2707@TOP@human_GAPDH_TAA_len41_fa0_ta20_fm6_tm14*118*a,1278,0,59,0,1337,0.044,118,2707@TOP@human_GAPDH_TAA_len41_fa0_ta20_fm6_tm14,a
2707@TOP@human_GAPDH_TAA_len41_fa0_ta20_fm6_tm14*119*g,0,0,1329,0,1329,1.0,119,2707@TOP@human_GAPDH_TAA_len41_fa0_ta20_fm6_tm14,g
2707@TOP@human_GAPDH_TAA_len41_fa0_ta20_fm6_tm14*120*g,0,0,1325,0,1325,1.0,120,2707@TOP@human_GAPDH_TAA_len41_fa0_ta20_fm6_tm14,g
2707@TOP@human_GAPDH_TAA_len41_fa0_ta20_fm6_tm14*121*a,1338,0,4,0,1342,0.003,121,2707@TOP@human_GAPDH_TAA_len41_fa0_ta20_fm6_tm14,a
2707@TOP@human_GAPDH_TAA_len41_fa0_ta20_fm6_tm14*122*g,0,0,1341,0,1341,1.0,122,2707@TOP@human_GAPDH_TAA_len41_fa0_ta20_fm6_tm14,g
2707@TOP@human_GAPDH_TAA_len41_fa0_ta20_fm6_tm14*123*t,0,0,0,1322,1322,0.0,123,2707@TOP@human_GAPDH_TAA_len41_fa0_ta20_fm6_tm14,t
2707@TOP@human_GAPDH_TAA_len41_fa0_ta20_fm6_tm14*124*a,1156,0,161,0,1317,0.122,124,2707@TOP@human_GAPDH_TAA_len41_fa0_ta20_fm6_tm14,a
2707@TOP@human_GAPDH_TAA_len41_fa0_ta20_fm6_tm14*125*a,1123,0,200,0,1323,0.151,125,2707@TOP@human_GAPDH_TAA_len41_fa0_ta20_fm6_tm14,a
2707@TOP@human_GAPDH_TAA_len41_fa0_ta20_fm6_tm14*126*g,0,0,1327,0,1327,1.0,126,2707@TOP@human_GAPDH_TAA_len41_fa0_ta20_fm6_tm14,g
2707@TOP@human_GAPDH_TAA_len41_fa0_ta20_fm6_tm14*127*a,1339,0,1,0,1340,0.001,127,2707@TOP@human_GAPDH_TAA_len41_fa0_ta20_fm6_tm14,a
2707@TOP@human_GAPDH_TAA_len41_fa0_ta20_fm6_tm14*128*c,0,1341,0,3,1344,0.0,128,2707@TOP@human_GAPDH_TAA_len41_fa0_ta20_fm6_tm14,c
2707@TOP@human_GAPDH_TAA_len41_fa0_ta20_fm6_tm14*129*c,0,1333,0,0,1333,0.0,129,2707@TOP@human_GAPDH_TAA_len41_fa0_ta20_fm6_tm14,c
2707@TOP@human_GAPDH_TAA_len41_fa0_ta20_fm6_tm14*130*c,0,1344,0,0,1344,0.0,130,2707@TOP@human_GAPDH_TAA_len41_fa0_ta20_fm6_tm14,c
2707@TOP@human_GAPDH_TAA_len41_fa0_ta20_fm6_tm14*131*c,0,1343,0,0,1343,0.0,131,2707@TOP@human_GAPDH_TAA_len41_fa0_ta20_fm6_tm14,c
2707@TOP@human_GAPDH_TAA_len41_fa0_ta20_fm6_tm14*132*t,0,0,0,1329,1329,0.0,132,2707@TOP@human_GAPDH_TAA_len41_fa0_ta20_fm6_tm14,t
2707@TOP@human_GAPDH_TAA_len41_fa0_ta20_fm6_tm14*133*g,0,0,1323,0,1323,1.0,133,2707@TOP@human_GAPDH_TAA_len41_fa0_ta20_fm6_tm14,g
2707@TOP@human_GAPDH_TAA_len41_fa0_ta20_fm6_tm14*134*g,0,0,1339,0,1339,1.0,134,2707@TOP@human_GAPDH_TAA_len41_fa0_ta20_fm6_tm14,g
2708@TOP@human_GAPDH_TAA_len41_fa0_ta20_fm6_tm14*114*t,0,0,0,576,576,0.0,114,2708@TOP@human_GAPDH_TAA_len41_fa0_ta20_fm6_tm14,t
2708@TOP@human_GAPDH_TAA_len41_fa0_ta20_fm6_tm14*115*c,0,580,0,0,580,0.0,115,2708@TOP@human_GAPDH_TAA_len41_fa0_ta20_fm6_tm14,c
2708@TOP@human_GAPDH_TAA_len41_fa0_ta20_fm6_tm14*116*c,0,573,0,0,573,0.0,116,2708@TOP@human_GAPDH_TAA_len41_fa0_ta20_fm6_tm14,c
2708@TOP@human_GAPDH_TAA_len41_fa0_ta20_fm6_tm14*117*a,569,0,3,0,572,0.005,117,2708@TOP@human_GAPDH_TAA_len41_fa0_ta20_fm6_tm14,a
2708@TOP@human_GAPDH_TAA_len41_fa0_ta20_fm6_tm14*118*a,568,0,5,0,573,0.009,118,2708@TOP@human_GAPDH_TAA_len41_fa0_ta20_fm6_tm14,a
2708@TOP@human_GAPDH_TAA_len41_fa0_ta20_fm6_tm14*119*g,0,0,566,0,566,1.0,119,2708@TOP@human_GAPDH_TAA_len41_fa0_ta20_fm6_tm14,g
2708@TOP@human_GAPDH_TAA_len41_fa0_ta20_fm6_tm14*120*g,0,0,556,0,556,1.0,120,2708@TOP@human_GAPDH_TAA_len41_fa0_ta20_fm6_tm14,g
2708@TOP@human_GAPDH_TAA_len41_fa0_ta20_fm6_tm14*121*a,576,0,0,0,576,0.0,121,2708@TOP@human_GAPDH_TAA_len41_fa0_ta20_fm6_tm14,a
2708@TOP@human_GAPDH_TAA_len41_fa0_ta20_fm6_tm14*122*g,0,0,578,0,578,1.0,122,2708@TOP@human_GAPDH_TAA_len41_fa0_ta20_fm6_tm14,g
2708@TOP@human_GAPDH_TAA_len41_fa0_ta20_fm6_tm14*123*t,0,0,0,569,569,0.0,123,2708@TOP@human_GAPDH_TAA_len41_fa0_ta20_fm6_tm14,t
2708@TOP@human_GAPDH_TAA_len41_fa0_ta20_fm6_tm14*124*a,411,0,158,0,569,0.278,124,2708@TOP@human_GAPDH_TAA_len41_fa0_ta20_fm6_tm14,a
2708@TOP@human_GAPDH_TAA_len41_fa0_ta20_fm6_tm14*125*a,478,0,94,0,572,0.164,125,2708@TOP@human_GAPDH_TAA_len41_fa0_ta20_fm6_tm14,a
2708@TOP@human_GAPDH_TAA_len41_fa0_ta20_fm6_tm14*126*g,1,0,564,0,565,0.998,126,2708@TOP@human_GAPDH_TAA_len41_fa0_ta20_fm6_tm14,g
2708@TOP@human_GAPDH_TAA_len41_fa0_ta20_fm6_tm14*127*a,563,0,13,1,577,0.023,127,2708@TOP@human_GAPDH_TAA_len41_fa0_ta20_fm6_tm14,a
2708@TOP@human_GAPDH_TAA_len41_fa0_ta20_fm6_tm14*128*c,0,578,0,0,578,0.0,128,2708@TOP@human_GAPDH_TAA_len41_fa0_ta20_fm6_tm14,c
2708@TOP@human_GAPDH_TAA_len41_fa0_ta20_fm6_tm14*129*c,0,571,0,0,571,0.0,129,2708@TOP@human_GAPDH_TAA_len41_fa0_ta20_fm6_tm14,c
2708@TOP@human_GAPDH_TAA_len41_fa0_ta20_fm6_tm14*130*c,0,571,0,0,571,0.0,130,2708@TOP@human_GAPDH_TAA_len41_fa0_ta20_fm6_tm14,c
2708@TOP@human_GAPDH_TAA_len41_fa0_ta20_fm6_tm14*131*c,0,580,0,0,580,0.0,131,2708@TOP@human_GAPDH_TAA_len41_fa0_ta20_fm6_tm14,c
2708@TOP@human_GAPDH_TAA_len41_fa0_ta20_fm6_tm14*132*t,0,0,0,565,565,0.0,132,2708@TOP@human_GAPDH_TAA_len41_fa0_ta20_fm6_tm14,t
2708@TOP@human_GAPDH_TAA_len41_fa0_ta20_fm6_tm14*133*g,0,0,567,0,567,1.0,133,2708@TOP@human_GAPDH_TAA_len41_fa0_ta20_fm6_tm14,g
2708@TOP@human_GAPDH_TAA_len41_fa0_ta20_fm6_tm14*134*g,0,0,569,0,569,1.0,134,2708@TOP@human_GAPDH_TAA_len41_fa0_ta20_fm6_tm14,g
2709@TOP@human_GAPDH_TAA_len41_fa0_ta20_fm6_tm14*114*t,1,3,0,18100,18104,0.0,114,2709@TOP@human_GAPDH_TAA_len41_fa0_ta20_fm6_tm14,t
2709@TOP@human_GAPDH_TAA_len41_fa0_ta20_fm6_tm14*115*c,0,18218,0,0,18218,0.0,115,2709@TOP@human_GAPDH_TAA_len41_fa0_ta20_fm6_tm14,c
2709@TOP@human_GAPDH_TAA_len41_fa0_ta20_fm6_tm14*116*c,0,18129,0,2,18131,0.0,116,2709@TOP@human_GAPDH_TAA_len41_fa0_ta20_fm6_tm14,c
2709@TOP@human_GAPDH_TAA_len41_fa0_ta20_fm6_tm14*117*a,18111,0,20,0,18131,0.001,117,2709@TOP@human_GAPDH_TAA_len41_fa0_ta20_fm6_tm14,a
2709@TOP@human_GAPDH_TAA_len41_fa0_ta20_fm6_tm14*118*a,17774,0,250,2,18026,0.014,118,2709@TOP@human_GAPDH_TAA_len41_fa0_ta20_fm6_tm14,a
2709@TOP@human_GAPDH_TAA_len41_fa0_ta20_fm6_tm14*119*g,0,1,17999,0,18000,1.0,119,2709@TOP@human_GAPDH_TAA_len41_fa0_ta20_fm6_tm14,g
2709@TOP@human_GAPDH_TAA_len41_fa0_ta20_fm6_tm14*120*g,7,0,17895,1,17903,1.0,120,2709@TOP@human_GAPDH_TAA_len41_fa0_ta20_fm6_tm14,g
2709@TOP@human_GAPDH_TAA_len41_fa0_ta20_fm6_tm14*121*a,18119,0,3,0,18122,0.0,121,2709@TOP@human_GAPDH_TAA_len41_fa0_ta20_fm6_tm14,a
2709@TOP@human_GAPDH_TAA_len41_fa0_ta20_fm6_tm14*122*g,0,0,18121,0,18121,1.0,122,2709@TOP@human_GAPDH_TAA_len41_fa0_ta20_fm6_tm14,g
2709@TOP@human_GAPDH_TAA_len41_fa0_ta20_fm6_tm14*123*t,1,0,6,17943,17950,0.0,123,2709@TOP@human_GAPDH_TAA_len41_fa0_ta20_fm6_tm14,t
2709@TOP@human_GAPDH_TAA_len41_fa0_ta20_fm6_tm14*124*a,12314,1,5563,2,17880,0.311,124,2709@TOP@human_GAPDH_TAA_len41_fa0_ta20_fm6_tm14,a
2709@TOP@human_GAPDH_TAA_len41_fa0_ta20_fm6_tm14*125*a,15662,1,2192,1,17856,0.123,125,2709@TOP@human_GAPDH_TAA_len41_fa0_ta20_fm6_tm14,a
2709@TOP@human_GAPDH_TAA_len41_fa0_ta20_fm6_tm14*126*g,0,0,17922,2,17924,1.0,126,2709@TOP@human_GAPDH_TAA_len41_fa0_ta20_fm6_tm14,g
2709@TOP@human_GAPDH_TAA_len41_fa0_ta20_fm6_tm14*127*a,18023,1,64,0,18088,0.004,127,2709@TOP@human_GAPDH_TAA_len41_fa0_ta20_fm6_tm14,a
2709@TOP@human_GAPDH_TAA_len41_fa0_ta20_fm6_tm14*128*c,0,18167,0,1,18168,0.0,128,2709@TOP@human_GAPDH_TAA_len41_fa0_ta20_fm6_tm14,c
2709@TOP@human_GAPDH_TAA_len41_fa0_ta20_fm6_tm14*129*c,0,18032,1,2,18035,0.0,129,2709@TOP@human_GAPDH_TAA_len41_fa0_ta20_fm6_tm14,c
2709@TOP@human_GAPDH_TAA_len41_fa0_ta20_fm6_tm14*130*c,0,18119,0,3,18122,0.0,130,2709@TOP@human_GAPDH_TAA_len41_fa0_ta20_fm6_tm14,c
2709@TOP@human_GAPDH_TAA_len41_fa0_ta20_fm6_tm14*131*c,2,18173,1,4,18180,0.0,131,2709@TOP@human_GAPDH_TAA_len41_fa0_ta20_fm6_tm14,c
2709@TOP@human_GAPDH_TAA_len41_fa0_ta20_fm6_tm14*132*t,2,8,0,17944,17954,0.0,132,2709@TOP@human_GAPDH_TAA_len41_fa0_ta20_fm6_tm14,t
2709@TOP@human_GAPDH_TAA_len41_fa0_ta20_fm6_tm14*133*g,0,0,17911,0,17911,1.0,133,2709@TOP@human_GAPDH_TAA_len41_fa0_ta20_fm6_tm14,g
2709@TOP@human_GAPDH_TAA_len41_fa0_ta20_fm6_tm14*134*g,1,3,17968,1,17973,1.0,134,2709@TOP@human_GAPDH_TAA_len41_fa0_ta20_fm6_tm14,g
2710@TOP@human_GAPDH_TAA_len41_fa0_ta20_fm6_tm14*114*t,0,0,0,10123,10123,0.0,114,2710@TOP@human_GAPDH_TAA_len41_fa0_ta20_fm6_tm14,t
2710@TOP@human_GAPDH_TAA_len41_fa0_ta20_fm6_tm14*115*c,1,10183,0,0,10184,0.0,115,2710@TOP@human_GAPDH_TAA_len41_fa0_ta20_fm6_tm14,c
2710@TOP@human_GAPDH_TAA_len41_fa0_ta20_fm6_tm14*116*c,0,10158,0,1,10159,0.0,116,2710@TOP@human_GAPDH_TAA_len41_fa0_ta20_fm6_tm14,c
2710@TOP@human_GAPDH_TAA_len41_fa0_ta20_fm6_tm14*117*a,10095,0,32,0,10127,0.003,117,2710@TOP@human_GAPDH_TAA_len41_fa0_ta20_fm6_tm14,a
2710@TOP@human_GAPDH_TAA_len41_fa0_ta20_fm6_tm14*118*a,9826,1,255,1,10083,0.025,118,2710@TOP@human_GAPDH_TAA_len41_fa0_ta20_fm6_tm14,a
2710@TOP@human_GAPDH_TAA_len41_fa0_ta20_fm6_tm14*119*g,0,0,10075,0,10075,1.0,119,2710@TOP@human_GAPDH_TAA_len41_fa0_ta20_fm6_tm14,g
2710@TOP@human_GAPDH_TAA_len41_fa0_ta20_fm6_tm14*120*g,0,1,10018,0,10019,1.0,120,2710@TOP@human_GAPDH_TAA_len41_fa0_ta20_fm6_tm14,g
2710@TOP@human_GAPDH_TAA_len41_fa0_ta20_fm6_tm14*121*a,10095,0,8,0,10103,0.001,121,2710@TOP@human_GAPDH_TAA_len41_fa0_ta20_fm6_tm14,a
2710@TOP@human_GAPDH_TAA_len41_fa0_ta20_fm6_tm14*122*g,1,0,10149,0,10150,1.0,122,2710@TOP@human_GAPDH_TAA_len41_fa0_ta20_fm6_tm14,g
2710@TOP@human_GAPDH_TAA_len41_fa0_ta20_fm6_tm14*123*t,1,1,3,10008,10013,0.0,123,2710@TOP@human_GAPDH_TAA_len41_fa0_ta20_fm6_tm14,t
2710@TOP@human_GAPDH_TAA_len41_fa0_ta20_fm6_tm14*124*a,8960,0,983,2,9945,0.099,124,2710@TOP@human_GAPDH_TAA_len41_fa0_ta20_fm6_tm14,a
2710@TOP@human_GAPDH_TAA_len41_fa0_ta20_fm6_tm14*125*a,8857,0,1087,1,9945,0.109,125,2710@TOP@human_GAPDH_TAA_len41_fa0_ta20_fm6_tm14,a
2710@TOP@human_GAPDH_TAA_len41_fa0_ta20_fm6_tm14*126*g,0,0,10015,0,10015,1.0,126,2710@TOP@human_GAPDH_TAA_len41_fa0_ta20_fm6_tm14,g
2710@TOP@human_GAPDH_TAA_len41_fa0_ta20_fm6_tm14*127*a,10072,3,22,0,10097,0.002,127,2710@TOP@human_GAPDH_TAA_len41_fa0_ta20_fm6_tm14,a
2710@TOP@human_GAPDH_TAA_len41_fa0_ta20_fm6_tm14*128*c,2,10153,0,0,10155,0.0,128,2710@TOP@human_GAPDH_TAA_len41_fa0_ta20_fm6_tm14,c
2710@TOP@human_GAPDH_TAA_len41_fa0_ta20_fm6_tm14*129*c,0,10084,0,1,10085,0.0,129,2710@TOP@human_GAPDH_TAA_len41_fa0_ta20_fm6_tm14,c
2710@TOP@human_GAPDH_TAA_len41_fa0_ta20_fm6_tm14*130*c,1,10149,0,0,10150,0.0,130,2710@TOP@human_GAPDH_TAA_len41_fa0_ta20_fm6_tm14,c
2710@TOP@human_GAPDH_TAA_len41_fa0_ta20_fm6_tm14*131*c,0,10173,0,1,10174,0.0,131,2710@TOP@human_GAPDH_TAA_len41_fa0_ta20_fm6_tm14,c
2710@TOP@human_GAPDH_TAA_len41_fa0_ta20_fm6_tm14*132*t,0,2,0,10021,10023,0.0,132,2710@TOP@human_GAPDH_TAA_len41_fa0_ta20_fm6_tm14,t
2710@TOP@human_GAPDH_TAA_len41_fa0_ta20_fm6_tm14*133*g,0,1,10014,0,10015,1.0,133,2710@TOP@human_GAPDH_TAA_len41_fa0_ta20_fm6_tm14,g
2710@TOP@human_GAPDH_TAA_len41_fa0_ta20_fm6_tm14*134*g,0,0,10062,0,10062,1.0,134,2710@TOP@human_GAPDH_TAA_len41_fa0_ta20_fm6_tm14,g
2711@TOP@human_GAPDH_TAA_len41_fa0_ta20_fm6_tm14*114*t,0,2,0,6515,6517,0.0,114,2711@TOP@human_GAPDH_TAA_len41_fa0_ta20_fm6_tm14,t
2711@TOP@human_GAPDH_TAA_len41_fa0_ta20_fm6_tm14*115*c,0,6560,0,0,6560,0.0,115,2711@TOP@human_GAPDH_TAA_len41_fa0_ta20_fm6_tm14,c
2711@TOP@human_GAPDH_TAA_len41_fa0_ta20_fm6_tm14*116*c,0,6519,0,0,6519,0.0,116,2711@TOP@human_GAPDH_TAA_len41_fa0_ta20_fm6_tm14,c
2711@TOP@human_GAPDH_TAA_len41_fa0_ta20_fm6_tm14*117*a,6507,0,12,0,6519,0.002,117,2711@TOP@human_GAPDH_TAA_len41_fa0_ta20_fm6_tm14,a
2711@TOP@human_GAPDH_TAA_len41_fa0_ta20_fm6_tm14*118*a,6396,0,99,0,6495,0.015,118,2711@TOP@human_GAPDH_TAA_len41_fa0_ta20_fm6_tm14,a
2711@TOP@human_GAPDH_TAA_len41_fa0_ta20_fm6_tm14*119*g,1,0,6488,0,6489,1.0,119,2711@TOP@human_GAPDH_TAA_len41_fa0_ta20_fm6_tm14,g
2711@TOP@human_GAPDH_TAA_len41_fa0_ta20_fm6_tm14*120*g,0,0,6453,1,6454,1.0,120,2711@TOP@human_GAPDH_TAA_len41_fa0_ta20_fm6_tm14,g
2711@TOP@human_GAPDH_TAA_len41_fa0_ta20_fm6_tm14*121*a,6523,1,2,1,6527,0.0,121,2711@TOP@human_GAPDH_TAA_len41_fa0_ta20_fm6_tm14,a
2711@TOP@human_GAPDH_TAA_len41_fa0_ta20_fm6_tm14*122*g,0,0,6541,0,6541,1.0,122,2711@TOP@human_GAPDH_TAA_len41_fa0_ta20_fm6_tm14,g
2711@TOP@human_GAPDH_TAA_len41_fa0_ta20_fm6_tm14*123*t,0,0,4,6455,6459,0.001,123,2711@TOP@human_GAPDH_TAA_len41_fa0_ta20_fm6_tm14,t
2711@TOP@human_GAPDH_TAA_len41_fa0_ta20_fm6_tm14*124*a,3106,1,3366,0,6473,0.52,124,2711@TOP@human_GAPDH_TAA_len41_fa0_ta20_fm6_tm14,a
2711@TOP@human_GAPDH_TAA_len41_fa0_ta20_fm6_tm14*125*a,3616,1,2825,0,6442,0.439,125,2711@TOP@human_GAPDH_TAA_len41_fa0_ta20_fm6_tm14,a
2711@TOP@human_GAPDH_TAA_len41_fa0_ta20_fm6_tm14*126*g,1,0,6467,0,6468,1.0,126,2711@TOP@human_GAPDH_TAA_len41_fa0_ta20_fm6_tm14,g
2711@TOP@human_GAPDH_TAA_len41_fa0_ta20_fm6_tm14*127*a,6489,0,18,0,6507,0.003,127,2711@TOP@human_GAPDH_TAA_len41_fa0_ta20_fm6_tm14,a
2711@TOP@human_GAPDH_TAA_len41_fa0_ta20_fm6_tm14*128*c,0,6547,1,1,6549,0.0,128,2711@TOP@human_GAPDH_TAA_len41_fa0_ta20_fm6_tm14,c
2711@TOP@human_GAPDH_TAA_len41_fa0_ta20_fm6_tm14*129*c,0,6497,0,0,6497,0.0,129,2711@TOP@human_GAPDH_TAA_len41_fa0_ta20_fm6_tm14,c
2711@TOP@human_GAPDH_TAA_len41_fa0_ta20_fm6_tm14*130*c,0,6535,0,0,6535,0.0,130,2711@TOP@human_GAPDH_TAA_len41_fa0_ta20_fm6_tm14,c
2711@TOP@human_GAPDH_TAA_len41_fa0_ta20_fm6_tm14*131*c,0,6546,0,0,6546,0.0,131,2711@TOP@human_GAPDH_TAA_len41_fa0_ta20_fm6_tm14,c
2711@TOP@human_GAPDH_TAA_len41_fa0_ta20_fm6_tm14*132*t,0,4,0,6487,6491,0.0,132,2711@TOP@human_GAPDH_TAA_len41_fa0_ta20_fm6_tm14,t
2711@TOP@human_GAPDH_TAA_len41_fa0_ta20_fm6_tm14*133*g,0,0,6448,0,6448,1.0,133,2711@TOP@human_GAPDH_TAA_len41_fa0_ta20_fm6_tm14,g
2711@TOP@human_GAPDH_TAA_len41_fa0_ta20_fm6_tm14*134*g,0,0,6498,0,6498,1.0,134,2711@TOP@human_GAPDH_TAA_len41_fa0_ta20_fm6_tm14,g
2712@TOP@human_GAPDH_TAA_len41_fa0_ta20_fm6_tm14*114*t,0,0,0,1068,1068,0.0,114,2712@TOP@human_GAPDH_TAA_len41_fa0_ta20_fm6_tm14,t
2712@TOP@human_GAPDH_TAA_len41_fa0_ta20_fm6_tm14*115*c,0,1075,0,0,1075,0.0,115,2712@TOP@human_GAPDH_TAA_len41_fa0_ta20_fm6_tm14,c
2712@TOP@human_GAPDH_TAA_len41_fa0_ta20_fm6_tm14*116*c,0,1068,0,0,1068,0.0,116,2712@TOP@human_GAPDH_TAA_len41_fa0_ta20_fm6_tm14,c
2712@TOP@human_GAPDH_TAA_len41_fa0_ta20_fm6_tm14*117*a,1071,0,0,0,1071,0.0,117,2712@TOP@human_GAPDH_TAA_len41_fa0_ta20_fm6_tm14,a
2712@TOP@human_GAPDH_TAA_len41_fa0_ta20_fm6_tm14*118*a,1011,0,52,0,1063,0.049,118,2712@TOP@human_GAPDH_TAA_len41_fa0_ta20_fm6_tm14,a
2712@TOP@human_GAPDH_TAA_len41_fa0_ta20_fm6_tm14*119*g,0,0,1062,0,1062,1.0,119,2712@TOP@human_GAPDH_TAA_len41_fa0_ta20_fm6_tm14,g
2712@TOP@human_GAPDH_TAA_len41_fa0_ta20_fm6_tm14*120*g,0,0,1061,0,1061,1.0,120,2712@TOP@human_GAPDH_TAA_len41_fa0_ta20_fm6_tm14,g
2712@TOP@human_GAPDH_TAA_len41_fa0_ta20_fm6_tm14*121*a,1067,0,2,0,1069,0.002,121,2712@TOP@human_GAPDH_TAA_len41_fa0_ta20_fm6_tm14,a
2712@TOP@human_GAPDH_TAA_len41_fa0_ta20_fm6_tm14*122*g,0,0,1071,0,1071,1.0,122,2712@TOP@human_GAPDH_TAA_len41_fa0_ta20_fm6_tm14,g
2712@TOP@human_GAPDH_TAA_len41_fa0_ta20_fm6_tm14*123*t,0,0,0,1050,1050,0.0,123,2712@TOP@human_GAPDH_TAA_len41_fa0_ta20_fm6_tm14,t
2712@TOP@human_GAPDH_TAA_len41_fa0_ta20_fm6_tm14*124*a,971,0,76,0,1047,0.073,124,2712@TOP@human_GAPDH_TAA_len41_fa0_ta20_fm6_tm14,a
2712@TOP@human_GAPDH_TAA_len41_fa0_ta20_fm6_tm14*125*a,1009,0,40,0,1049,0.038,125,2712@TOP@human_GAPDH_TAA_len41_fa0_ta20_fm6_tm14,a
2712@TOP@human_GAPDH_TAA_len41_fa0_ta20_fm6_tm14*126*g,0,0,1050,0,1050,1.0,126,2712@TOP@human_GAPDH_TAA_len41_fa0_ta20_fm6_tm14,g
2712@TOP@human_GAPDH_TAA_len41_fa0_ta20_fm6_tm14*127*a,1059,0,6,0,1065,0.006,127,2712@TOP@human_GAPDH_TAA_len41_fa0_ta20_fm6_tm14,a
2712@TOP@human_GAPDH_TAA_len41_fa0_ta20_fm6_tm14*128*c,0,1072,1,0,1073,0.001,128,2712@TOP@human_GAPDH_TAA_len41_fa0_ta20_fm6_tm14,c
2712@TOP@human_GAPDH_TAA_len41_fa0_ta20_fm6_tm14*129*c,0,1066,0,0,1066,0.0,129,2712@TOP@human_GAPDH_TAA_len41_fa0_ta20_fm6_tm14,c
2712@TOP@human_GAPDH_TAA_len41_fa0_ta20_fm6_tm14*130*c,0,1069,0,0,1069,0.0,130,2712@TOP@human_GAPDH_TAA_len41_fa0_ta20_fm6_tm14,c
2712@TOP@human_GAPDH_TAA_len41_fa0_ta20_fm6_tm14*131*c,0,1077,0,0,1077,0.0,131,2712@TOP@human_GAPDH_TAA_len41_fa0_ta20_fm6_tm14,c
2712@TOP@human_GAPDH_TAA_len41_fa0_ta20_fm6_tm14*132*t,0,0,0,1050,1050,0.0,132,2712@TOP@human_GAPDH_TAA_len41_fa0_ta20_fm6_tm14,t
2712@TOP@human_GAPDH_TAA_len41_fa0_ta20_fm6_tm14*133*g,0,0,1048,0,1048,1.0,133,2712@TOP@human_GAPDH_TAA_len41_fa0_ta20_fm6_tm14,g
2712@TOP@human_GAPDH_TAA_len41_fa0_ta20_fm6_tm14*134*g,0,0,1061,0,1061,1.0,134,2712@TOP@human_GAPDH_TAA_len41_fa0_ta20_fm6_tm14,g
2713@TOP@human_GAPDH_TAA_len41_fa0_ta20_fm6_tm14*114*t,0,0,0,1849,1849,0.0,114,2713@TOP@human_GAPDH_TAA_len41_fa0_ta20_fm6_tm14,t
2713@TOP@human_GAPDH_TAA_len41_fa0_ta20_fm6_tm14*115*c,0,1863,0,0,1863,0.0,115,2713@TOP@human_GAPDH_TAA_len41_fa0_ta20_fm6_tm14,c
2713@TOP@human_GAPDH_TAA_len41_fa0_ta20_fm6_tm14*116*c,0,1856,0,1,1857,0.0,116,2713@TOP@human_GAPDH_TAA_len41_fa0_ta20_fm6_tm14,c
2713@TOP@human_GAPDH_TAA_len41_fa0_ta20_fm6_tm14*117*a,1848,0,4,0,1852,0.002,117,2713@TOP@human_GAPDH_TAA_len41_fa0_ta20_fm6_tm14,a
2713@TOP@human_GAPDH_TAA_len41_fa0_ta20_fm6_tm14*118*a,1817,0,21,0,1838,0.011,118,2713@TOP@human_GAPDH_TAA_len41_fa0_ta20_fm6_tm14,a
2713@TOP@human_GAPDH_TAA_len41_fa0_ta20_fm6_tm14*119*g,0,0,1825,0,1825,1.0,119,2713@TOP@human_GAPDH_TAA_len41_fa0_ta20_fm6_tm14,g
2713@TOP@human_GAPDH_TAA_len41_fa0_ta20_fm6_tm14*120*g,0,0,1830,0,1830,1.0,120,2713@TOP@human_GAPDH_TAA_len41_fa0_ta20_fm6_tm14,g
2713@TOP@human_GAPDH_TAA_len41_fa0_ta20_fm6_tm14*121*a,1853,0,0,0,1853,0.0,121,2713@TOP@human_GAPDH_TAA_len41_fa0_ta20_fm6_tm14,a
2713@TOP@human_GAPDH_TAA_len41_fa0_ta20_fm6_tm14*122*g,0,0,1854,0,1854,1.0,122,2713@TOP@human_GAPDH_TAA_len41_fa0_ta20_fm6_tm14,g
2713@TOP@human_GAPDH_TAA_len41_fa0_ta20_fm6_tm14*123*t,0,0,1,1828,1829,0.001,123,2713@TOP@human_GAPDH_TAA_len41_fa0_ta20_fm6_tm14,t
2713@TOP@human_GAPDH_TAA_len41_fa0_ta20_fm6_tm14*124*a,1698,0,128,0,1826,0.07,124,2713@TOP@human_GAPDH_TAA_len41_fa0_ta20_fm6_tm14,a
2713@TOP@human_GAPDH_TAA_len41_fa0_ta20_fm6_tm14*125*a,1717,0,88,0,1805,0.049,125,2713@TOP@human_GAPDH_TAA_len41_fa0_ta20_fm6_tm14,a
2713@TOP@human_GAPDH_TAA_len41_fa0_ta20_fm6_tm14*126*g,1,0,1817,0,1818,0.999,126,2713@TOP@human_GAPDH_TAA_len41_fa0_ta20_fm6_tm14,g
2713@TOP@human_GAPDH_TAA_len41_fa0_ta20_fm6_tm14*127*a,1798,0,49,0,1847,0.027,127,2713@TOP@human_GAPDH_TAA_len41_fa0_ta20_fm6_tm14,a
2713@TOP@human_GAPDH_TAA_len41_fa0_ta20_fm6_tm14*128*c,0,1859,0,0,1859,0.0,128,2713@TOP@human_GAPDH_TAA_len41_fa0_ta20_fm6_tm14,c
2713@TOP@human_GAPDH_TAA_len41_fa0_ta20_fm6_tm14*129*c,0,1840,0,0,1840,0.0,129,2713@TOP@human_GAPDH_TAA_len41_fa0_ta20_fm6_tm14,c
2713@TOP@human_GAPDH_TAA_len41_fa0_ta20_fm6_tm14*130*c,0,1852,0,0,1852,0.0,130,2713@TOP@human_GAPDH_TAA_len41_fa0_ta20_fm6_tm14,c
2713@TOP@human_GAPDH_TAA_len41_fa0_ta20_fm6_tm14*131*c,1,1859,0,0,1860,0.0,131,2713@TOP@human_GAPDH_TAA_len41_fa0_ta20_fm6_tm14,c
2713@TOP@human_GAPDH_TAA_len41_fa0_ta20_fm6_tm14*132*t,0,0,0,1829,1829,0.0,132,2713@TOP@human_GAPDH_TAA_len41_fa0_ta20_fm6_tm14,t
2713@TOP@human_GAPDH_TAA_len41_fa0_ta20_fm6_tm14*133*g,0,0,1826,0,1826,1.0,133,2713@TOP@human_GAPDH_TAA_len41_fa0_ta20_fm6_tm14,g
2713@TOP@human_GAPDH_TAA_len41_fa0_ta20_fm6_tm14*134*g,0,0,1833,0,1833,1.0,134,2713@TOP@human_GAPDH_TAA_len41_fa0_ta20_fm6_tm14,g
2714@TOP@human_GAPDH_TAA_len41_fa0_ta20_fm6_tm14*114*t,0,0,0,789,789,0.0,114,2714@TOP@human_GAPDH_TAA_len41_fa0_ta20_fm6_tm14,t
2714@TOP@human_GAPDH_TAA_len41_fa0_ta20_fm6_tm14*115*c,0,797,0,0,797,0.0,115,2714@TOP@human_GAPDH_TAA_len41_fa0_ta20_fm6_tm14,c
2714@TOP@human_GAPDH_TAA_len41_fa0_ta20_fm6_tm14*116*c,0,796,0,0,796,0.0,116,2714@TOP@human_GAPDH_TAA_len41_fa0_ta20_fm6_tm14,c
2714@TOP@human_GAPDH_TAA_len41_fa0_ta20_fm6_tm14*117*a,781,0,11,0,792,0.014,117,2714@TOP@human_GAPDH_TAA_len41_fa0_ta20_fm6_tm14,a
2714@TOP@human_GAPDH_TAA_len41_fa0_ta20_fm6_tm14*118*a,706,0,75,0,781,0.096,118,2714@TOP@human_GAPDH_TAA_len41_fa0_ta20_fm6_tm14,a
2714@TOP@human_GAPDH_TAA_len41_fa0_ta20_fm6_tm14*119*g,0,0,783,0,783,1.0,119,2714@TOP@human_GAPDH_TAA_len41_fa0_ta20_fm6_tm14,g
2714@TOP@human_GAPDH_TAA_len41_fa0_ta20_fm6_tm14*120*g,0,0,788,0,788,1.0,120,2714@TOP@human_GAPDH_TAA_len41_fa0_ta20_fm6_tm14,g
2714@TOP@human_GAPDH_TAA_len41_fa0_ta20_fm6_tm14*121*a,788,0,2,0,790,0.003,121,2714@TOP@human_GAPDH_TAA_len41_fa0_ta20_fm6_tm14,a
2714@TOP@human_GAPDH_TAA_len41_fa0_ta20_fm6_tm14*122*g,2,0,792,0,794,0.997,122,2714@TOP@human_GAPDH_TAA_len41_fa0_ta20_fm6_tm14,g
2714@TOP@human_GAPDH_TAA_len41_fa0_ta20_fm6_tm14*123*t,0,0,0,769,769,0.0,123,2714@TOP@human_GAPDH_TAA_len41_fa0_ta20_fm6_tm14,t
2714@TOP@human_GAPDH_TAA_len41_fa0_ta20_fm6_tm14*124*a,660,0,122,0,782,0.156,124,2714@TOP@human_GAPDH_TAA_len41_fa0_ta20_fm6_tm14,a
2714@TOP@human_GAPDH_TAA_len41_fa0_ta20_fm6_tm14*125*a,667,1,109,0,777,0.14,125,2714@TOP@human_GAPDH_TAA_len41_fa0_ta20_fm6_tm14,a
2714@TOP@human_GAPDH_TAA_len41_fa0_ta20_fm6_tm14*126*g,0,0,778,0,778,1.0,126,2714@TOP@human_GAPDH_TAA_len41_fa0_ta20_fm6_tm14,g
2714@TOP@human_GAPDH_TAA_len41_fa0_ta20_fm6_tm14*127*a,785,0,6,0,791,0.008,127,2714@TOP@human_GAPDH_TAA_len41_fa0_ta20_fm6_tm14,a
2714@TOP@human_GAPDH_TAA_len41_fa0_ta20_fm6_tm14*128*c,1,795,0,0,796,0.0,128,2714@TOP@human_GAPDH_TAA_len41_fa0_ta20_fm6_tm14,c
2714@TOP@human_GAPDH_TAA_len41_fa0_ta20_fm6_tm14*129*c,0,791,0,0,791,0.0,129,2714@TOP@human_GAPDH_TAA_len41_fa0_ta20_fm6_tm14,c
2714@TOP@human_GAPDH_TAA_len41_fa0_ta20_fm6_tm14*130*c,0,794,0,0,794,0.0,130,2714@TOP@human_GAPDH_TAA_len41_fa0_ta20_fm6_tm14,c
2714@TOP@human_GAPDH_TAA_len41_fa0_ta20_fm6_tm14*131*c,0,794,0,0,794,0.0,131,2714@TOP@human_GAPDH_TAA_len41_fa0_ta20_fm6_tm14,c
2714@TOP@human_GAPDH_TAA_len41_fa0_ta20_fm6_tm14*132*t,0,1,0,782,783,0.0,132,2714@TOP@human_GAPDH_TAA_len41_fa0_ta20_fm6_tm14,t
2714@TOP@human_GAPDH_TAA_len41_fa0_ta20_fm6_tm14*133*g,0,0,778,0,778,1.0,133,2714@TOP@human_GAPDH_TAA_len41_fa0_ta20_fm6_tm14,g
2714@TOP@human_GAPDH_TAA_len41_fa0_ta20_fm6_tm14*134*g,1,0,785,0,786,0.999,134,2714@TOP@human_GAPDH_TAA_len41_fa0_ta20_fm6_tm14,g
2715@TOP@human_GAPDH_TAA_len41_fa0_ta20_fm6_tm14*114*t,0,0,0,724,724,0.0,114,2715@TOP@human_GAPDH_TAA_len41_fa0_ta20_fm6_tm14,t
2715@TOP@human_GAPDH_TAA_len41_fa0_ta20_fm6_tm14*115*c,0,725,0,0,725,0.0,115,2715@TOP@human_GAPDH_TAA_len41_fa0_ta20_fm6_tm14,c
2715@TOP@human_GAPDH_TAA_len41_fa0_ta20_fm6_tm14*116*c,0,724,0,0,724,0.0,116,2715@TOP@human_GAPDH_TAA_len41_fa0_ta20_fm6_tm14,c
2715@TOP@human_GAPDH_TAA_len41_fa0_ta20_fm6_tm14*117*a,720,0,4,0,724,0.006,117,2715@TOP@human_GAPDH_TAA_len41_fa0_ta20_fm6_tm14,a
2715@TOP@human_GAPDH_TAA_len41_fa0_ta20_fm6_tm14*118*a,697,0,22,0,719,0.031,118,2715@TOP@human_GAPDH_TAA_len41_fa0_ta20_fm6_tm14,a
2715@TOP@human_GAPDH_TAA_len41_fa0_ta20_fm6_tm14*119*g,0,0,716,0,716,1.0,119,2715@TOP@human_GAPDH_TAA_len41_fa0_ta20_fm6_tm14,g
2715@TOP@human_GAPDH_TAA_len41_fa0_ta20_fm6_tm14*120*g,0,0,714,0,714,1.0,120,2715@TOP@human_GAPDH_TAA_len41_fa0_ta20_fm6_tm14,g
2715@TOP@human_GAPDH_TAA_len41_fa0_ta20_fm6_tm14*121*a,722,0,0,0,722,0.0,121,2715@TOP@human_GAPDH_TAA_len41_fa0_ta20_fm6_tm14,a
2715@TOP@human_GAPDH_TAA_len41_fa0_ta20_fm6_tm14*122*g,0,0,725,0,725,1.0,122,2715@TOP@human_GAPDH_TAA_len41_fa0_ta20_fm6_tm14,g
2715@TOP@human_GAPDH_TAA_len41_fa0_ta20_fm6_tm14*123*t,0,3,0,709,712,0.0,123,2715@TOP@human_GAPDH_TAA_len41_fa0_ta20_fm6_tm14,t
2715@TOP@human_GAPDH_TAA_len41_fa0_ta20_fm6_tm14*124*a,601,0,113,0,714,0.158,124,2715@TOP@human_GAPDH_TAA_len41_fa0_ta20_fm6_tm14,a
2715@TOP@human_GAPDH_TAA_len41_fa0_ta20_fm6_tm14*125*a,632,0,72,0,704,0.102,125,2715@TOP@human_GAPDH_TAA_len41_fa0_ta20_fm6_tm14,a
2715@TOP@human_GAPDH_TAA_len41_fa0_ta20_fm6_tm14*126*g,0,0,712,0,712,1.0,126,2715@TOP@human_GAPDH_TAA_len41_fa0_ta20_fm6_tm14,g
2715@TOP@human_GAPDH_TAA_len41_fa0_ta20_fm6_tm14*127*a,717,0,7,0,724,0.01,127,2715@TOP@human_GAPDH_TAA_len41_fa0_ta20_fm6_tm14,a
2715@TOP@human_GAPDH_TAA_len41_fa0_ta20_fm6_tm14*128*c,0,724,0,0,724,0.0,128,2715@TOP@human_GAPDH_TAA_len41_fa0_ta20_fm6_tm14,c
2715@TOP@human_GAPDH_TAA_len41_fa0_ta20_fm6_tm14*129*c,0,720,0,0,720,0.0,129,2715@TOP@human_GAPDH_TAA_len41_fa0_ta20_fm6_tm14,c
2715@TOP@human_GAPDH_TAA_len41_fa0_ta20_fm6_tm14*130*c,0,723,0,0,723,0.0,130,2715@TOP@human_GAPDH_TAA_len41_fa0_ta20_fm6_tm14,c
2715@TOP@human_GAPDH_TAA_len41_fa0_ta20_fm6_tm14*131*c,0,723,0,0,723,0.0,131,2715@TOP@human_GAPDH_TAA_len41_fa0_ta20_fm6_tm14,c
2715@TOP@human_GAPDH_TAA_len41_fa0_ta20_fm6_tm14*132*t,0,1,0,713,714,0.0,132,2715@TOP@human_GAPDH_TAA_len41_fa0_ta20_fm6_tm14,t
2715@TOP@human_GAPDH_TAA_len41_fa0_ta20_fm6_tm14*133*g,0,0,712,0,712,1.0,133,2715@TOP@human_GAPDH_TAA_len41_fa0_ta20_fm6_tm14,g
2715@TOP@human_GAPDH_TAA_len41_fa0_ta20_fm6_tm14*134*g,0,0,714,0,714,1.0,134,2715@TOP@human_GAPDH_TAA_len41_fa0_ta20_fm6_tm14,g
2716@TOP@human_GAPDH_TAA_len41_fa0_ta20_fm6_tm14*114*t,1,3,0,11928,11932,0.0,114,2716@TOP@human_GAPDH_TAA_len41_fa0_ta20_fm6_tm14,t
2716@TOP@human_GAPDH_TAA_len41_fa0_ta20_fm6_tm14*115*c,0,11998,0,0,11998,0.0,115,2716@TOP@human_GAPDH_TAA_len41_fa0_ta20_fm6_tm14,c
2716@TOP@human_GAPDH_TAA_len41_fa0_ta20_fm6_tm14*116*c,0,11948,0,0,11948,0.0,116,2716@TOP@human_GAPDH_TAA_len41_fa0_ta20_fm6_tm14,c
2716@TOP@human_GAPDH_TAA_len41_fa0_ta20_fm6_tm14*117*a,11926,2,12,1,11941,0.001,117,2716@TOP@human_GAPDH_TAA_len41_fa0_ta20_fm6_tm14,a
2716@TOP@human_GAPDH_TAA_len41_fa0_ta20_fm6_tm14*118*a,11741,0,112,0,11853,0.009,118,2716@TOP@human_GAPDH_TAA_len41_fa0_ta20_fm6_tm14,a
2716@TOP@human_GAPDH_TAA_len41_fa0_ta20_fm6_tm14*119*g,0,0,11835,0,11835,1.0,119,2716@TOP@human_GAPDH_TAA_len41_fa0_ta20_fm6_tm14,g
2716@TOP@human_GAPDH_TAA_len41_fa0_ta20_fm6_tm14*120*g,0,0,11789,3,11792,1.0,120,2716@TOP@human_GAPDH_TAA_len41_fa0_ta20_fm6_tm14,g
2716@TOP@human_GAPDH_TAA_len41_fa0_ta20_fm6_tm14*121*a,11932,0,3,0,11935,0.0,121,2716@TOP@human_GAPDH_TAA_len41_fa0_ta20_fm6_tm14,a
2716@TOP@human_GAPDH_TAA_len41_fa0_ta20_fm6_tm14*122*g,0,0,11952,0,11952,1.0,122,2716@TOP@human_GAPDH_TAA_len41_fa0_ta20_fm6_tm14,g
2716@TOP@human_GAPDH_TAA_len41_fa0_ta20_fm6_tm14*123*t,4,1,0,11744,11749,0.0,123,2716@TOP@human_GAPDH_TAA_len41_fa0_ta20_fm6_tm14,t
2716@TOP@human_GAPDH_TAA_len41_fa0_ta20_fm6_tm14*124*a,10177,0,1562,0,11739,0.133,124,2716@TOP@human_GAPDH_TAA_len41_fa0_ta20_fm6_tm14,a
2716@TOP@human_GAPDH_TAA_len41_fa0_ta20_fm6_tm14*125*a,11242,1,472,1,11716,0.04,125,2716@TOP@human_GAPDH_TAA_len41_fa0_ta20_fm6_tm14,a
2716@TOP@human_GAPDH_TAA_len41_fa0_ta20_fm6_tm14*126*g,0,0,11786,0,11786,1.0,126,2716@TOP@human_GAPDH_TAA_len41_fa0_ta20_fm6_tm14,g
2716@TOP@human_GAPDH_TAA_len41_fa0_ta20_fm6_tm14*127*a,11741,2,168,0,11911,0.014,127,2716@TOP@human_GAPDH_TAA_len41_fa0_ta20_fm6_tm14,a
2716@TOP@human_GAPDH_TAA_len41_fa0_ta20_fm6_tm14*128*c,1,11971,0,0,11972,0.0,128,2716@TOP@human_GAPDH_TAA_len41_fa0_ta20_fm6_tm14,c
2716@TOP@human_GAPDH_TAA_len41_fa0_ta20_fm6_tm14*129*c,1,11877,0,0,11878,0.0,129,2716@TOP@human_GAPDH_TAA_len41_fa0_ta20_fm6_tm14,c
2716@TOP@human_GAPDH_TAA_len41_fa0_ta20_fm6_tm14*130*c,0,11951,0,4,11955,0.0,130,2716@TOP@human_GAPDH_TAA_len41_fa0_ta20_fm6_tm14,c
2716@TOP@human_GAPDH_TAA_len41_fa0_ta20_fm6_tm14*131*c,1,11978,0,0,11979,0.0,131,2716@TOP@human_GAPDH_TAA_len41_fa0_ta20_fm6_tm14,c
2716@TOP@human_GAPDH_TAA_len41_fa0_ta20_fm6_tm14*132*t,0,2,0,11791,11793,0.0,132,2716@TOP@human_GAPDH_TAA_len41_fa0_ta20_fm6_tm14,t
2716@TOP@human_GAPDH_TAA_len41_fa0_ta20_fm6_tm14*133*g,2,0,11771,1,11774,1.0,133,2716@TOP@human_GAPDH_TAA_len41_fa0_ta20_fm6_tm14,g
2716@TOP@human_GAPDH_TAA_len41_fa0_ta20_fm6_tm14*134*g,1,1,11842,0,11844,1.0,134,2716@TOP@human_GAPDH_TAA_len41_fa0_ta20_fm6_tm14,g
2717@TOP@human_GAPDH_TAA_len41_fa0_ta20_fm6_tm14*114*t,0,0,0,4328,4328,0.0,114,2717@TOP@human_GAPDH_TAA_len41_fa0_ta20_fm6_tm14,t
2717@TOP@human_GAPDH_TAA_len41_fa0_ta20_fm6_tm14*115*c,0,4355,0,1,4356,0.0,115,2717@TOP@human_GAPDH_TAA_len41_fa0_ta20_fm6_tm14,c
2717@TOP@human_GAPDH_TAA_len41_fa0_ta20_fm6_tm14*116*c,0,4335,0,0,4335,0.0,116,2717@TOP@human_GAPDH_TAA_len41_fa0_ta20_fm6_tm14,c
2717@TOP@human_GAPDH_TAA_len41_fa0_ta20_fm6_tm14*117*a,4305,0,20,1,4326,0.005,117,2717@TOP@human_GAPDH_TAA_len41_fa0_ta20_fm6_tm14,a
2717@TOP@human_GAPDH_TAA_len41_fa0_ta20_fm6_tm14*118*a,4206,0,99,0,4305,0.023,118,2717@TOP@human_GAPDH_TAA_len41_fa0_ta20_fm6_tm14,a
2717@TOP@human_GAPDH_TAA_len41_fa0_ta20_fm6_tm14*119*g,0,0,4309,0,4309,1.0,119,2717@TOP@human_GAPDH_TAA_len41_fa0_ta20_fm6_tm14,g
2717@TOP@human_GAPDH_TAA_len41_fa0_ta20_fm6_tm14*120*g,0,0,4274,0,4274,1.0,120,2717@TOP@human_GAPDH_TAA_len41_fa0_ta20_fm6_tm14,g
2717@TOP@human_GAPDH_TAA_len41_fa0_ta20_fm6_tm14*121*a,4284,0,46,0,4330,0.011,121,2717@TOP@human_GAPDH_TAA_len41_fa0_ta20_fm6_tm14,a
2717@TOP@human_GAPDH_TAA_len41_fa0_ta20_fm6_tm14*122*g,1,0,4340,0,4341,1.0,122,2717@TOP@human_GAPDH_TAA_len41_fa0_ta20_fm6_tm14,g
2717@TOP@human_GAPDH_TAA_len41_fa0_ta20_fm6_tm14*123*t,0,0,2,4299,4301,0.0,123,2717@TOP@human_GAPDH_TAA_len41_fa0_ta20_fm6_tm14,t
2717@TOP@human_GAPDH_TAA_len41_fa0_ta20_fm6_tm14*124*a,3071,0,1196,0,4267,0.28,124,2717@TOP@human_GAPDH_TAA_len41_fa0_ta20_fm6_tm14,a
2717@TOP@human_GAPDH_TAA_len41_fa0_ta20_fm6_tm14*125*a,2912,0,1346,2,4260,0.316,125,2717@TOP@human_GAPDH_TAA_len41_fa0_ta20_fm6_tm14,a
2717@TOP@human_GAPDH_TAA_len41_fa0_ta20_fm6_tm14*126*g,0,0,4277,0,4277,1.0,126,2717@TOP@human_GAPDH_TAA_len41_fa0_ta20_fm6_tm14,g
2717@TOP@human_GAPDH_TAA_len41_fa0_ta20_fm6_tm14*127*a,4286,3,32,0,4321,0.007,127,2717@TOP@human_GAPDH_TAA_len41_fa0_ta20_fm6_tm14,a
2717@TOP@human_GAPDH_TAA_len41_fa0_ta20_fm6_tm14*128*c,0,4335,3,0,4338,0.001,128,2717@TOP@human_GAPDH_TAA_len41_fa0_ta20_fm6_tm14,c
2717@TOP@human_GAPDH_TAA_len41_fa0_ta20_fm6_tm14*129*c,0,4315,0,0,4315,0.0,129,2717@TOP@human_GAPDH_TAA_len41_fa0_ta20_fm6_tm14,c
2717@TOP@human_GAPDH_TAA_len41_fa0_ta20_fm6_tm14*130*c,0,4332,0,0,4332,0.0,130,2717@TOP@human_GAPDH_TAA_len41_fa0_ta20_fm6_tm14,c
2717@TOP@human_GAPDH_TAA_len41_fa0_ta20_fm6_tm14*131*c,1,4346,0,1,4348,0.0,131,2717@TOP@human_GAPDH_TAA_len41_fa0_ta20_fm6_tm14,c
2717@TOP@human_GAPDH_TAA_len41_fa0_ta20_fm6_tm14*132*t,0,1,1,4288,4290,0.0,132,2717@TOP@human_GAPDH_TAA_len41_fa0_ta20_fm6_tm14,t
2717@TOP@human_GAPDH_TAA_len41_fa0_ta20_fm6_tm14*133*g,0,1,4275,0,4276,1.0,133,2717@TOP@human_GAPDH_TAA_len41_fa0_ta20_fm6_tm14,g
2717@TOP@human_GAPDH_TAA_len41_fa0_ta20_fm6_tm14*134*g,0,0,4313,0,4313,1.0,134,2717@TOP@human_GAPDH_TAA_len41_fa0_ta20_fm6_tm14,g
2718@TOP@human_GAPDH_TAA_len41_fa0_ta20_fm6_tm14*114*t,3,1,0,6973,6977,0.0,114,2718@TOP@human_GAPDH_TAA_len41_fa0_ta20_fm6_tm14,t
2718@TOP@human_GAPDH_TAA_len41_fa0_ta20_fm6_tm14*115*c,0,7012,3,0,7015,0.0,115,2718@TOP@human_GAPDH_TAA_len41_fa0_ta20_fm6_tm14,c
2718@TOP@human_GAPDH_TAA_len41_fa0_ta20_fm6_tm14*116*c,0,6995,0,0,6995,0.0,116,2718@TOP@human_GAPDH_TAA_len41_fa0_ta20_fm6_tm14,c
2718@TOP@human_GAPDH_TAA_len41_fa0_ta20_fm6_tm14*117*a,6978,0,5,0,6983,0.001,117,2718@TOP@human_GAPDH_TAA_len41_fa0_ta20_fm6_tm14,a
2718@TOP@human_GAPDH_TAA_len41_fa0_ta20_fm6_tm14*118*a,6884,0,64,0,6948,0.009,118,2718@TOP@human_GAPDH_TAA_len41_fa0_ta20_fm6_tm14,a
2718@TOP@human_GAPDH_TAA_len41_fa0_ta20_fm6_tm14*119*g,0,0,6937,0,6937,1.0,119,2718@TOP@human_GAPDH_TAA_len41_fa0_ta20_fm6_tm14,g
2718@TOP@human_GAPDH_TAA_len41_fa0_ta20_fm6_tm14*120*g,0,0,6892,0,6892,1.0,120,2718@TOP@human_GAPDH_TAA_len41_fa0_ta20_fm6_tm14,g
2718@TOP@human_GAPDH_TAA_len41_fa0_ta20_fm6_tm14*121*a,6918,0,64,1,6983,0.009,121,2718@TOP@human_GAPDH_TAA_len41_fa0_ta20_fm6_tm14,a
2718@TOP@human_GAPDH_TAA_len41_fa0_ta20_fm6_tm14*122*g,0,0,6993,0,6993,1.0,122,2718@TOP@human_GAPDH_TAA_len41_fa0_ta20_fm6_tm14,g
2718@TOP@human_GAPDH_TAA_len41_fa0_ta20_fm6_tm14*123*t,0,0,0,6898,6898,0.0,123,2718@TOP@human_GAPDH_TAA_len41_fa0_ta20_fm6_tm14,t
2718@TOP@human_GAPDH_TAA_len41_fa0_ta20_fm6_tm14*124*a,4909,0,1970,0,6879,0.286,124,2718@TOP@human_GAPDH_TAA_len41_fa0_ta20_fm6_tm14,a
2718@TOP@human_GAPDH_TAA_len41_fa0_ta20_fm6_tm14*125*a,6162,0,728,0,6890,0.106,125,2718@TOP@human_GAPDH_TAA_len41_fa0_ta20_fm6_tm14,a
2718@TOP@human_GAPDH_TAA_len41_fa0_ta20_fm6_tm14*126*g,2,0,6923,0,6925,1.0,126,2718@TOP@human_GAPDH_TAA_len41_fa0_ta20_fm6_tm14,g
2718@TOP@human_GAPDH_TAA_len41_fa0_ta20_fm6_tm14*127*a,6950,0,13,0,6963,0.002,127,2718@TOP@human_GAPDH_TAA_len41_fa0_ta20_fm6_tm14,a
2718@TOP@human_GAPDH_TAA_len41_fa0_ta20_fm6_tm14*128*c,0,7008,0,0,7008,0.0,128,2718@TOP@human_GAPDH_TAA_len41_fa0_ta20_fm6_tm14,c
2718@TOP@human_GAPDH_TAA_len41_fa0_ta20_fm6_tm14*129*c,0,6949,0,0,6949,0.0,129,2718@TOP@human_GAPDH_TAA_len41_fa0_ta20_fm6_tm14,c
2718@TOP@human_GAPDH_TAA_len41_fa0_ta20_fm6_tm14*130*c,1,6990,0,0,6991,0.0,130,2718@TOP@human_GAPDH_TAA_len41_fa0_ta20_fm6_tm14,c
2718@TOP@human_GAPDH_TAA_len41_fa0_ta20_fm6_tm14*131*c,2,7005,0,0,7007,0.0,131,2718@TOP@human_GAPDH_TAA_len41_fa0_ta20_fm6_tm14,c
2718@TOP@human_GAPDH_TAA_len41_fa0_ta20_fm6_tm14*132*t,0,1,0,6890,6891,0.0,132,2718@TOP@human_GAPDH_TAA_len41_fa0_ta20_fm6_tm14,t
2718@TOP@human_GAPDH_TAA_len41_fa0_ta20_fm6_tm14*133*g,0,1,6904,0,6905,1.0,133,2718@TOP@human_GAPDH_TAA_len41_fa0_ta20_fm6_tm14,g
2718@TOP@human_GAPDH_TAA_len41_fa0_ta20_fm6_tm14*134*g,0,2,6931,0,6933,1.0,134,2718@TOP@human_GAPDH_TAA_len41_fa0_ta20_fm6_tm14,g
2719@TOP@human_GAPDH_TAA_len41_fa0_ta20_fm6_tm14*114*t,0,1,0,795,796,0.0,114,2719@TOP@human_GAPDH_TAA_len41_fa0_ta20_fm6_tm14,t
2719@TOP@human_GAPDH_TAA_len41_fa0_ta20_fm6_tm14*115*c,0,801,0,0,801,0.0,115,2719@TOP@human_GAPDH_TAA_len41_fa0_ta20_fm6_tm14,c
2719@TOP@human_GAPDH_TAA_len41_fa0_ta20_fm6_tm14*116*c,0,799,0,0,799,0.0,116,2719@TOP@human_GAPDH_TAA_len41_fa0_ta20_fm6_tm14,c
2719@TOP@human_GAPDH_TAA_len41_fa0_ta20_fm6_tm14*117*a,795,0,2,0,797,0.003,117,2719@TOP@human_GAPDH_TAA_len41_fa0_ta20_fm6_tm14,a
2719@TOP@human_GAPDH_TAA_len41_fa0_ta20_fm6_tm14*118*a,771,0,16,0,787,0.02,118,2719@TOP@human_GAPDH_TAA_len41_fa0_ta20_fm6_tm14,a
2719@TOP@human_GAPDH_TAA_len41_fa0_ta20_fm6_tm14*119*g,0,0,789,0,789,1.0,119,2719@TOP@human_GAPDH_TAA_len41_fa0_ta20_fm6_tm14,g
2719@TOP@human_GAPDH_TAA_len41_fa0_ta20_fm6_tm14*120*g,0,0,782,0,782,1.0,120,2719@TOP@human_GAPDH_TAA_len41_fa0_ta20_fm6_tm14,g
2719@TOP@human_GAPDH_TAA_len41_fa0_ta20_fm6_tm14*121*a,796,0,0,0,796,0.0,121,2719@TOP@human_GAPDH_TAA_len41_fa0_ta20_fm6_tm14,a
2719@TOP@human_GAPDH_TAA_len41_fa0_ta20_fm6_tm14*122*g,0,0,793,0,793,1.0,122,2719@TOP@human_GAPDH_TAA_len41_fa0_ta20_fm6_tm14,g
2719@TOP@human_GAPDH_TAA_len41_fa0_ta20_fm6_tm14*123*t,0,0,0,790,790,0.0,123,2719@TOP@human_GAPDH_TAA_len41_fa0_ta20_fm6_tm14,t
2719@TOP@human_GAPDH_TAA_len41_fa0_ta20_fm6_tm14*124*a,556,0,222,1,779,0.285,124,2719@TOP@human_GAPDH_TAA_len41_fa0_ta20_fm6_tm14,a
2719@TOP@human_GAPDH_TAA_len41_fa0_ta20_fm6_tm14*125*a,591,0,193,0,784,0.246,125,2719@TOP@human_GAPDH_TAA_len41_fa0_ta20_fm6_tm14,a
2719@TOP@human_GAPDH_TAA_len41_fa0_ta20_fm6_tm14*126*g,0,0,786,0,786,1.0,126,2719@TOP@human_GAPDH_TAA_len41_fa0_ta20_fm6_tm14,g
2719@TOP@human_GAPDH_TAA_len41_fa0_ta20_fm6_tm14*127*a,795,0,1,0,796,0.001,127,2719@TOP@human_GAPDH_TAA_len41_fa0_ta20_fm6_tm14,a
2719@TOP@human_GAPDH_TAA_len41_fa0_ta20_fm6_tm14*128*c,0,797,0,0,797,0.0,128,2719@TOP@human_GAPDH_TAA_len41_fa0_ta20_fm6_tm14,c
2719@TOP@human_GAPDH_TAA_len41_fa0_ta20_fm6_tm14*129*c,0,798,0,0,798,0.0,129,2719@TOP@human_GAPDH_TAA_len41_fa0_ta20_fm6_tm14,c
2719@TOP@human_GAPDH_TAA_len41_fa0_ta20_fm6_tm14*130*c,0,800,0,0,800,0.0,130,2719@TOP@human_GAPDH_TAA_len41_fa0_ta20_fm6_tm14,c
2719@TOP@human_GAPDH_TAA_len41_fa0_ta20_fm6_tm14*131*c,0,799,0,0,799,0.0,131,2719@TOP@human_GAPDH_TAA_len41_fa0_ta20_fm6_tm14,c
2719@TOP@human_GAPDH_TAA_len41_fa0_ta20_fm6_tm14*132*t,0,0,0,789,789,0.0,132,2719@TOP@human_GAPDH_TAA_len41_fa0_ta20_fm6_tm14,t
2719@TOP@human_GAPDH_TAA_len41_fa0_ta20_fm6_tm14*133*g,0,0,785,0,785,1.0,133,2719@TOP@human_GAPDH_TAA_len41_fa0_ta20_fm6_tm14,g
2719@TOP@human_GAPDH_TAA_len41_fa0_ta20_fm6_tm14*134*g,0,0,793,0,793,1.0,134,2719@TOP@human_GAPDH_TAA_len41_fa0_ta20_fm6_tm14,g
2720@TOP@human_GAPDH_TAA_len41_fa0_ta20_fm6_tm14*114*t,0,0,0,1411,1411,0.0,114,2720@TOP@human_GAPDH_TAA_len41_fa0_ta20_fm6_tm14,t
2720@TOP@human_GAPDH_TAA_len41_fa0_ta20_fm6_tm14*115*c,0,1418,0,0,1418,0.0,115,2720@TOP@human_GAPDH_TAA_len41_fa0_ta20_fm6_tm14,c
2720@TOP@human_GAPDH_TAA_len41_fa0_ta20_fm6_tm14*116*c,0,1410,0,0,1410,0.0,116,2720@TOP@human_GAPDH_TAA_len41_fa0_ta20_fm6_tm14,c
2720@TOP@human_GAPDH_TAA_len41_fa0_ta20_fm6_tm14*117*a,1412,0,0,0,1412,0.0,117,2720@TOP@human_GAPDH_TAA_len41_fa0_ta20_fm6_tm14,a
2720@TOP@human_GAPDH_TAA_len41_fa0_ta20_fm6_tm14*118*a,1353,0,51,0,1404,0.036,118,2720@TOP@human_GAPDH_TAA_len41_fa0_ta20_fm6_tm14,a
2720@TOP@human_GAPDH_TAA_len41_fa0_ta20_fm6_tm14*119*g,0,0,1392,0,1392,1.0,119,2720@TOP@human_GAPDH_TAA_len41_fa0_ta20_fm6_tm14,g
2720@TOP@human_GAPDH_TAA_len41_fa0_ta20_fm6_tm14*120*g,0,0,1393,0,1393,1.0,120,2720@TOP@human_GAPDH_TAA_len41_fa0_ta20_fm6_tm14,g
2720@TOP@human_GAPDH_TAA_len41_fa0_ta20_fm6_tm14*121*a,1409,0,1,0,1410,0.001,121,2720@TOP@human_GAPDH_TAA_len41_fa0_ta20_fm6_tm14,a
2720@TOP@human_GAPDH_TAA_len41_fa0_ta20_fm6_tm14*122*g,0,0,1415,0,1415,1.0,122,2720@TOP@human_GAPDH_TAA_len41_fa0_ta20_fm6_tm14,g
2720@TOP@human_GAPDH_TAA_len41_fa0_ta20_fm6_tm14*123*t,0,0,3,1383,1386,0.002,123,2720@TOP@human_GAPDH_TAA_len41_fa0_ta20_fm6_tm14,t
2720@TOP@human_GAPDH_TAA_len41_fa0_ta20_fm6_tm14*124*a,1002,0,385,1,1388,0.277,124,2720@TOP@human_GAPDH_TAA_len41_fa0_ta20_fm6_tm14,a
2720@TOP@human_GAPDH_TAA_len41_fa0_ta20_fm6_tm14*125*a,1199,0,193,0,1392,0.139,125,2720@TOP@human_GAPDH_TAA_len41_fa0_ta20_fm6_tm14,a
2720@TOP@human_GAPDH_TAA_len41_fa0_ta20_fm6_tm14*126*g,1,0,1392,0,1393,0.999,126,2720@TOP@human_GAPDH_TAA_len41_fa0_ta20_fm6_tm14,g
2720@TOP@human_GAPDH_TAA_len41_fa0_ta20_fm6_tm14*127*a,1397,0,14,0,1411,0.01,127,2720@TOP@human_GAPDH_TAA_len41_fa0_ta20_fm6_tm14,a
2720@TOP@human_GAPDH_TAA_len41_fa0_ta20_fm6_tm14*128*c,0,1413,1,0,1414,0.001,128,2720@TOP@human_GAPDH_TAA_len41_fa0_ta20_fm6_tm14,c
2720@TOP@human_GAPDH_TAA_len41_fa0_ta20_fm6_tm14*129*c,0,1402,0,0,1402,0.0,129,2720@TOP@human_GAPDH_TAA_len41_fa0_ta20_fm6_tm14,c
2720@TOP@human_GAPDH_TAA_len41_fa0_ta20_fm6_tm14*130*c,0,1412,0,0,1412,0.0,130,2720@TOP@human_GAPDH_TAA_len41_fa0_ta20_fm6_tm14,c
2720@TOP@human_GAPDH_TAA_len41_fa0_ta20_fm6_tm14*131*c,0,1419,0,0,1419,0.0,131,2720@TOP@human_GAPDH_TAA_len41_fa0_ta20_fm6_tm14,c
2720@TOP@human_GAPDH_TAA_len41_fa0_ta20_fm6_tm14*132*t,2,0,0,1381,1383,0.0,132,2720@TOP@human_GAPDH_TAA_len41_fa0_ta20_fm6_tm14,t
2720@TOP@human_GAPDH_TAA_len41_fa0_ta20_fm6_tm14*133*g,0,0,1381,0,1381,1.0,133,2720@TOP@human_GAPDH_TAA_len41_fa0_ta20_fm6_tm14,g
2720@TOP@human_GAPDH_TAA_len41_fa0_ta20_fm6_tm14*134*g,1,0,1391,0,1392,0.999,134,2720@TOP@human_GAPDH_TAA_len41_fa0_ta20_fm6_tm14,g
2721@TOP@human_GAPDH_TAA_len41_fa0_ta20_fm6_tm14*114*t,0,0,0,893,893,0.0,114,2721@TOP@human_GAPDH_TAA_len41_fa0_ta20_fm6_tm14,t
2721@TOP@human_GAPDH_TAA_len41_fa0_ta20_fm6_tm14*115*c,0,900,0,0,900,0.0,115,2721@TOP@human_GAPDH_TAA_len41_fa0_ta20_fm6_tm14,c
2721@TOP@human_GAPDH_TAA_len41_fa0_ta20_fm6_tm14*116*c,0,898,0,0,898,0.0,116,2721@TOP@human_GAPDH_TAA_len41_fa0_ta20_fm6_tm14,c
2721@TOP@human_GAPDH_TAA_len41_fa0_ta20_fm6_tm14*117*a,891,0,2,0,893,0.002,117,2721@TOP@human_GAPDH_TAA_len41_fa0_ta20_fm6_tm14,a
2721@TOP@human_GAPDH_TAA_len41_fa0_ta20_fm6_tm14*118*a,862,0,29,0,891,0.033,118,2721@TOP@human_GAPDH_TAA_len41_fa0_ta20_fm6_tm14,a
2721@TOP@human_GAPDH_TAA_len41_fa0_ta20_fm6_tm14*119*g,0,0,892,0,892,1.0,119,2721@TOP@human_GAPDH_TAA_len41_fa0_ta20_fm6_tm14,g
2721@TOP@human_GAPDH_TAA_len41_fa0_ta20_fm6_tm14*120*g,0,0,887,0,887,1.0,120,2721@TOP@human_GAPDH_TAA_len41_fa0_ta20_fm6_tm14,g
2721@TOP@human_GAPDH_TAA_len41_fa0_ta20_fm6_tm14*121*a,894,0,0,0,894,0.0,121,2721@TOP@human_GAPDH_TAA_len41_fa0_ta20_fm6_tm14,a
2721@TOP@human_GAPDH_TAA_len41_fa0_ta20_fm6_tm14*122*g,0,0,896,0,896,1.0,122,2721@TOP@human_GAPDH_TAA_len41_fa0_ta20_fm6_tm14,g
2721@TOP@human_GAPDH_TAA_len41_fa0_ta20_fm6_tm14*123*t,0,0,0,875,875,0.0,123,2721@TOP@human_GAPDH_TAA_len41_fa0_ta20_fm6_tm14,t
2721@TOP@human_GAPDH_TAA_len41_fa0_ta20_fm6_tm14*124*a,669,0,218,0,887,0.246,124,2721@TOP@human_GAPDH_TAA_len41_fa0_ta20_fm6_tm14,a
2721@TOP@human_GAPDH_TAA_len41_fa0_ta20_fm6_tm14*125*a,774,0,110,0,884,0.124,125,2721@TOP@human_GAPDH_TAA_len41_fa0_ta20_fm6_tm14,a
2721@TOP@human_GAPDH_TAA_len41_fa0_ta20_fm6_tm14*126*g,0,0,888,0,888,1.0,126,2721@TOP@human_GAPDH_TAA_len41_fa0_ta20_fm6_tm14,g
2721@TOP@human_GAPDH_TAA_len41_fa0_ta20_fm6_tm14*127*a,892,0,4,0,896,0.004,127,2721@TOP@human_GAPDH_TAA_len41_fa0_ta20_fm6_tm14,a
2721@TOP@human_GAPDH_TAA_len41_fa0_ta20_fm6_tm14*128*c,0,898,0,0,898,0.0,128,2721@TOP@human_GAPDH_TAA_len41_fa0_ta20_fm6_tm14,c
2721@TOP@human_GAPDH_TAA_len41_fa0_ta20_fm6_tm14*129*c,0,891,0,0,891,0.0,129,2721@TOP@human_GAPDH_TAA_len41_fa0_ta20_fm6_tm14,c
2721@TOP@human_GAPDH_TAA_len41_fa0_ta20_fm6_tm14*130*c,0,896,0,0,896,0.0,130,2721@TOP@human_GAPDH_TAA_len41_fa0_ta20_fm6_tm14,c
2721@TOP@human_GAPDH_TAA_len41_fa0_ta20_fm6_tm14*131*c,0,897,0,0,897,0.0,131,2721@TOP@human_GAPDH_TAA_len41_fa0_ta20_fm6_tm14,c
2721@TOP@human_GAPDH_TAA_len41_fa0_ta20_fm6_tm14*132*t,0,0,0,891,891,0.0,132,2721@TOP@human_GAPDH_TAA_len41_fa0_ta20_fm6_tm14,t
2721@TOP@human_GAPDH_TAA_len41_fa0_ta20_fm6_tm14*133*g,0,0,883,0,883,1.0,133,2721@TOP@human_GAPDH_TAA_len41_fa0_ta20_fm6_tm14,g
2721@TOP@human_GAPDH_TAA_len41_fa0_ta20_fm6_tm14*134*g,0,1,890,0,891,0.999,134,2721@TOP@human_GAPDH_TAA_len41_fa0_ta20_fm6_tm14,g
2722@TOP@human_GAPDH_TAA_len41_fa0_ta20_fm6_tm14*114*t,0,1,0,651,652,0.0,114,2722@TOP@human_GAPDH_TAA_len41_fa0_ta20_fm6_tm14,t
2722@TOP@human_GAPDH_TAA_len41_fa0_ta20_fm6_tm14*115*c,0,654,0,0,654,0.0,115,2722@TOP@human_GAPDH_TAA_len41_fa0_ta20_fm6_tm14,c
2722@TOP@human_GAPDH_TAA_len41_fa0_ta20_fm6_tm14*116*c,0,651,0,0,651,0.0,116,2722@TOP@human_GAPDH_TAA_len41_fa0_ta20_fm6_tm14,c
2722@TOP@human_GAPDH_TAA_len41_fa0_ta20_fm6_tm14*117*a,649,0,2,0,651,0.003,117,2722@TOP@human_GAPDH_TAA_len41_fa0_ta20_fm6_tm14,a
2722@TOP@human_GAPDH_TAA_len41_fa0_ta20_fm6_tm14*118*a,621,0,25,0,646,0.039,118,2722@TOP@human_GAPDH_TAA_len41_fa0_ta20_fm6_tm14,a
2722@TOP@human_GAPDH_TAA_len41_fa0_ta20_fm6_tm14*119*g,0,0,644,0,644,1.0,119,2722@TOP@human_GAPDH_TAA_len41_fa0_ta20_fm6_tm14,g
2722@TOP@human_GAPDH_TAA_len41_fa0_ta20_fm6_tm14*120*g,0,0,644,0,644,1.0,120,2722@TOP@human_GAPDH_TAA_len41_fa0_ta20_fm6_tm14,g
2722@TOP@human_GAPDH_TAA_len41_fa0_ta20_fm6_tm14*121*a,650,0,0,0,650,0.0,121,2722@TOP@human_GAPDH_TAA_len41_fa0_ta20_fm6_tm14,a
2722@TOP@human_GAPDH_TAA_len41_fa0_ta20_fm6_tm14*122*g,0,0,652,0,652,1.0,122,2722@TOP@human_GAPDH_TAA_len41_fa0_ta20_fm6_tm14,g
2722@TOP@human_GAPDH_TAA_len41_fa0_ta20_fm6_tm14*123*t,0,0,0,634,634,0.0,123,2722@TOP@human_GAPDH_TAA_len41_fa0_ta20_fm6_tm14,t
2722@TOP@human_GAPDH_TAA_len41_fa0_ta20_fm6_tm14*124*a,486,0,153,0,639,0.239,124,2722@TOP@human_GAPDH_TAA_len41_fa0_ta20_fm6_tm14,a
2722@TOP@human_GAPDH_TAA_len41_fa0_ta20_fm6_tm14*125*a,498,0,141,0,639,0.221,125,2722@TOP@human_GAPDH_TAA_len41_fa0_ta20_fm6_tm14,a
2722@TOP@human_GAPDH_TAA_len41_fa0_ta20_fm6_tm14*126*g,0,0,643,0,643,1.0,126,2722@TOP@human_GAPDH_TAA_len41_fa0_ta20_fm6_tm14,g
2722@TOP@human_GAPDH_TAA_len41_fa0_ta20_fm6_tm14*127*a,645,0,6,0,651,0.009,127,2722@TOP@human_GAPDH_TAA_len41_fa0_ta20_fm6_tm14,a
2722@TOP@human_GAPDH_TAA_len41_fa0_ta20_fm6_tm14*128*c,0,651,0,0,651,0.0,128,2722@TOP@human_GAPDH_TAA_len41_fa0_ta20_fm6_tm14,c
2722@TOP@human_GAPDH_TAA_len41_fa0_ta20_fm6_tm14*129*c,0,650,0,0,650,0.0,129,2722@TOP@human_GAPDH_TAA_len41_fa0_ta20_fm6_tm14,c
2722@TOP@human_GAPDH_TAA_len41_fa0_ta20_fm6_tm14*130*c,0,651,0,0,651,0.0,130,2722@TOP@human_GAPDH_TAA_len41_fa0_ta20_fm6_tm14,c
2722@TOP@human_GAPDH_TAA_len41_fa0_ta20_fm6_tm14*131*c,0,654,0,0,654,0.0,131,2722@TOP@human_GAPDH_TAA_len41_fa0_ta20_fm6_tm14,c
2722@TOP@human_GAPDH_TAA_len41_fa0_ta20_fm6_tm14*132*t,0,1,0,638,639,0.0,132,2722@TOP@human_GAPDH_TAA_len41_fa0_ta20_fm6_tm14,t
2722@TOP@human_GAPDH_TAA_len41_fa0_ta20_fm6_tm14*133*g,0,0,635,0,635,1.0,133,2722@TOP@human_GAPDH_TAA_len41_fa0_ta20_fm6_tm14,g
2722@TOP@human_GAPDH_TAA_len41_fa0_ta20_fm6_tm14*134*g,0,1,644,0,645,0.998,134,2722@TOP@human_GAPDH_TAA_len41_fa0_ta20_fm6_tm14,g
2723@TOP@human_GAPDH_TAA_len41_fa0_ta20_fm6_tm14*114*t,0,0,0,1305,1305,0.0,114,2723@TOP@human_GAPDH_TAA_len41_fa0_ta20_fm6_tm14,t
2723@TOP@human_GAPDH_TAA_len41_fa0_ta20_fm6_tm14*115*c,0,1317,0,0,1317,0.0,115,2723@TOP@human_GAPDH_TAA_len41_fa0_ta20_fm6_tm14,c
2723@TOP@human_GAPDH_TAA_len41_fa0_ta20_fm6_tm14*116*c,0,1305,0,0,1305,0.0,116,2723@TOP@human_GAPDH_TAA_len41_fa0_ta20_fm6_tm14,c
2723@TOP@human_GAPDH_TAA_len41_fa0_ta20_fm6_tm14*117*a,1304,0,9,0,1313,0.007,117,2723@TOP@human_GAPDH_TAA_len41_fa0_ta20_fm6_tm14,a
2723@TOP@human_GAPDH_TAA_len41_fa0_ta20_fm6_tm14*118*a,1265,0,41,1,1307,0.031,118,2723@TOP@human_GAPDH_TAA_len41_fa0_ta20_fm6_tm14,a
2723@TOP@human_GAPDH_TAA_len41_fa0_ta20_fm6_tm14*119*g,0,0,1301,0,1301,1.0,119,2723@TOP@human_GAPDH_TAA_len41_fa0_ta20_fm6_tm14,g
2723@TOP@human_GAPDH_TAA_len41_fa0_ta20_fm6_tm14*120*g,0,0,1286,0,1286,1.0,120,2723@TOP@human_GAPDH_TAA_len41_fa0_ta20_fm6_tm14,g
2723@TOP@human_GAPDH_TAA_len41_fa0_ta20_fm6_tm14*121*a,1300,0,4,0,1304,0.003,121,2723@TOP@human_GAPDH_TAA_len41_fa0_ta20_fm6_tm14,a
2723@TOP@human_GAPDH_TAA_len41_fa0_ta20_fm6_tm14*122*g,0,0,1309,0,1309,1.0,122,2723@TOP@human_GAPDH_TAA_len41_fa0_ta20_fm6_tm14,g
2723@TOP@human_GAPDH_TAA_len41_fa0_ta20_fm6_tm14*123*t,0,0,0,1296,1296,0.0,123,2723@TOP@human_GAPDH_TAA_len41_fa0_ta20_fm6_tm14,t
2723@TOP@human_GAPDH_TAA_len41_fa0_ta20_fm6_tm14*124*a,889,0,406,0,1295,0.314,124,2723@TOP@human_GAPDH_TAA_len41_fa0_ta20_fm6_tm14,a
2723@TOP@human_GAPDH_TAA_len41_fa0_ta20_fm6_tm14*125*a,1006,0,288,0,1294,0.223,125,2723@TOP@human_GAPDH_TAA_len41_fa0_ta20_fm6_tm14,a
2723@TOP@human_GAPDH_TAA_len41_fa0_ta20_fm6_tm14*126*g,0,0,1289,0,1289,1.0,126,2723@TOP@human_GAPDH_TAA_len41_fa0_ta20_fm6_tm14,g
2723@TOP@human_GAPDH_TAA_len41_fa0_ta20_fm6_tm14*127*a,1262,0,46,0,1308,0.035,127,2723@TOP@human_GAPDH_TAA_len41_fa0_ta20_fm6_tm14,a
2723@TOP@human_GAPDH_TAA_len41_fa0_ta20_fm6_tm14*128*c,0,1315,0,0,1315,0.0,128,2723@TOP@human_GAPDH_TAA_len41_fa0_ta20_fm6_tm14,c
2723@TOP@human_GAPDH_TAA_len41_fa0_ta20_fm6_tm14*129*c,0,1299,0,0,1299,0.0,129,2723@TOP@human_GAPDH_TAA_len41_fa0_ta20_fm6_tm14,c
2723@TOP@human_GAPDH_TAA_len41_fa0_ta20_fm6_tm14*130*c,0,1306,0,0,1306,0.0,130,2723@TOP@human_GAPDH_TAA_len41_fa0_ta20_fm6_tm14,c
2723@TOP@human_GAPDH_TAA_len41_fa0_ta20_fm6_tm14*131*c,0,1315,0,0,1315,0.0,131,2723@TOP@human_GAPDH_TAA_len41_fa0_ta20_fm6_tm14,c
2723@TOP@human_GAPDH_TAA_len41_fa0_ta20_fm6_tm14*132*t,1,0,0,1292,1293,0.0,132,2723@TOP@human_GAPDH_TAA_len41_fa0_ta20_fm6_tm14,t
2723@TOP@human_GAPDH_TAA_len41_fa0_ta20_fm6_tm14*133*g,0,0,1287,1,1288,0.999,133,2723@TOP@human_GAPDH_TAA_len41_fa0_ta20_fm6_tm14,g
2723@TOP@human_GAPDH_TAA_len41_fa0_ta20_fm6_tm14*134*g,0,0,1297,0,1297,1.0,134,2723@TOP@human_GAPDH_TAA_len41_fa0_ta20_fm6_tm14,g
2724@TOP@human_GAPDH_TAA_len41_fa0_ta20_fm6_tm14*114*t,0,2,0,4193,4195,0.0,114,2724@TOP@human_GAPDH_TAA_len41_fa0_ta20_fm6_tm14,t
2724@TOP@human_GAPDH_TAA_len41_fa0_ta20_fm6_tm14*115*c,0,4207,0,2,4209,0.0,115,2724@TOP@human_GAPDH_TAA_len41_fa0_ta20_fm6_tm14,c
2724@TOP@human_GAPDH_TAA_len41_fa0_ta20_fm6_tm14*116*c,1,4182,0,0,4183,0.0,116,2724@TOP@human_GAPDH_TAA_len41_fa0_ta20_fm6_tm14,c
2724@TOP@human_GAPDH_TAA_len41_fa0_ta20_fm6_tm14*117*a,4187,0,7,0,4194,0.002,117,2724@TOP@human_GAPDH_TAA_len41_fa0_ta20_fm6_tm14,a
2724@TOP@human_GAPDH_TAA_len41_fa0_ta20_fm6_tm14*118*a,4082,0,92,0,4174,0.022,118,2724@TOP@human_GAPDH_TAA_len41_fa0_ta20_fm6_tm14,a
2724@TOP@human_GAPDH_TAA_len41_fa0_ta20_fm6_tm14*119*g,0,0,4168,0,4168,1.0,119,2724@TOP@human_GAPDH_TAA_len41_fa0_ta20_fm6_tm14,g
2724@TOP@human_GAPDH_TAA_len41_fa0_ta20_fm6_tm14*120*g,2,0,4141,0,4143,1.0,120,2724@TOP@human_GAPDH_TAA_len41_fa0_ta20_fm6_tm14,g
2724@TOP@human_GAPDH_TAA_len41_fa0_ta20_fm6_tm14*121*a,4174,0,7,0,4181,0.002,121,2724@TOP@human_GAPDH_TAA_len41_fa0_ta20_fm6_tm14,a
2724@TOP@human_GAPDH_TAA_len41_fa0_ta20_fm6_tm14*122*g,0,0,4193,0,4193,1.0,122,2724@TOP@human_GAPDH_TAA_len41_fa0_ta20_fm6_tm14,g
2724@TOP@human_GAPDH_TAA_len41_fa0_ta20_fm6_tm14*123*t,2,0,0,4136,4138,0.0,123,2724@TOP@human_GAPDH_TAA_len41_fa0_ta20_fm6_tm14,t
2724@TOP@human_GAPDH_TAA_len41_fa0_ta20_fm6_tm14*124*a,1806,0,2338,0,4144,0.564,124,2724@TOP@human_GAPDH_TAA_len41_fa0_ta20_fm6_tm14,a
2724@TOP@human_GAPDH_TAA_len41_fa0_ta20_fm6_tm14*125*a,2534,1,1598,1,4134,0.387,125,2724@TOP@human_GAPDH_TAA_len41_fa0_ta20_fm6_tm14,a
2724@TOP@human_GAPDH_TAA_len41_fa0_ta20_fm6_tm14*126*g,0,0,4151,1,4152,1.0,126,2724@TOP@human_GAPDH_TAA_len41_fa0_ta20_fm6_tm14,g
2724@TOP@human_GAPDH_TAA_len41_fa0_ta20_fm6_tm14*127*a,4176,0,11,0,4187,0.003,127,2724@TOP@human_GAPDH_TAA_len41_fa0_ta20_fm6_tm14,a
2724@TOP@human_GAPDH_TAA_len41_fa0_ta20_fm6_tm14*128*c,0,4197,0,2,4199,0.0,128,2724@TOP@human_GAPDH_TAA_len41_fa0_ta20_fm6_tm14,c
2724@TOP@human_GAPDH_TAA_len41_fa0_ta20_fm6_tm14*129*c,2,4177,0,0,4179,0.0,129,2724@TOP@human_GAPDH_TAA_len41_fa0_ta20_fm6_tm14,c
2724@TOP@human_GAPDH_TAA_len41_fa0_ta20_fm6_tm14*130*c,0,4192,0,0,4192,0.0,130,2724@TOP@human_GAPDH_TAA_len41_fa0_ta20_fm6_tm14,c
2724@TOP@human_GAPDH_TAA_len41_fa0_ta20_fm6_tm14*131*c,0,4201,0,0,4201,0.0,131,2724@TOP@human_GAPDH_TAA_len41_fa0_ta20_fm6_tm14,c
2724@TOP@human_GAPDH_TAA_len41_fa0_ta20_fm6_tm14*132*t,0,3,0,4155,4158,0.0,132,2724@TOP@human_GAPDH_TAA_len41_fa0_ta20_fm6_tm14,t
2724@TOP@human_GAPDH_TAA_len41_fa0_ta20_fm6_tm14*133*g,0,0,4138,1,4139,1.0,133,2724@TOP@human_GAPDH_TAA_len41_fa0_ta20_fm6_tm14,g
2724@TOP@human_GAPDH_TAA_len41_fa0_ta20_fm6_tm14*134*g,0,0,4164,0,4164,1.0,134,2724@TOP@human_GAPDH_TAA_len41_fa0_ta20_fm6_tm14,g
2725@TOP@human_GAPDH_TAA_len41_fa0_ta20_fm6_tm14*114*t,0,0,0,326,326,0.0,114,2725@TOP@human_GAPDH_TAA_len41_fa0_ta20_fm6_tm14,t
2725@TOP@human_GAPDH_TAA_len41_fa0_ta20_fm6_tm14*115*c,0,330,0,0,330,0.0,115,2725@TOP@human_GAPDH_TAA_len41_fa0_ta20_fm6_tm14,c
2725@TOP@human_GAPDH_TAA_len41_fa0_ta20_fm6_tm14*116*c,0,329,0,0,329,0.0,116,2725@TOP@human_GAPDH_TAA_len41_fa0_ta20_fm6_tm14,c
2725@TOP@human_GAPDH_TAA_len41_fa0_ta20_fm6_tm14*117*a,326,0,3,0,329,0.009,117,2725@TOP@human_GAPDH_TAA_len41_fa0_ta20_fm6_tm14,a
2725@TOP@human_GAPDH_TAA_len41_fa0_ta20_fm6_tm14*118*a,316,0,10,0,326,0.031,118,2725@TOP@human_GAPDH_TAA_len41_fa0_ta20_fm6_tm14,a
2725@TOP@human_GAPDH_TAA_len41_fa0_ta20_fm6_tm14*119*g,0,0,328,0,328,1.0,119,2725@TOP@human_GAPDH_TAA_len41_fa0_ta20_fm6_tm14,g
2725@TOP@human_GAPDH_TAA_len41_fa0_ta20_fm6_tm14*120*g,0,0,324,0,324,1.0,120,2725@TOP@human_GAPDH_TAA_len41_fa0_ta20_fm6_tm14,g
2725@TOP@human_GAPDH_TAA_len41_fa0_ta20_fm6_tm14*121*a,329,0,0,0,329,0.0,121,2725@TOP@human_GAPDH_TAA_len41_fa0_ta20_fm6_tm14,a
2725@TOP@human_GAPDH_TAA_len41_fa0_ta20_fm6_tm14*122*g,0,0,328,0,328,1.0,122,2725@TOP@human_GAPDH_TAA_len41_fa0_ta20_fm6_tm14,g
2725@TOP@human_GAPDH_TAA_len41_fa0_ta20_fm6_tm14*123*t,0,0,0,318,318,0.0,123,2725@TOP@human_GAPDH_TAA_len41_fa0_ta20_fm6_tm14,t
2725@TOP@human_GAPDH_TAA_len41_fa0_ta20_fm6_tm14*124*a,256,0,65,0,321,0.202,124,2725@TOP@human_GAPDH_TAA_len41_fa0_ta20_fm6_tm14,a
2725@TOP@human_GAPDH_TAA_len41_fa0_ta20_fm6_tm14*125*a,260,0,63,0,323,0.195,125,2725@TOP@human_GAPDH_TAA_len41_fa0_ta20_fm6_tm14,a
2725@TOP@human_GAPDH_TAA_len41_fa0_ta20_fm6_tm14*126*g,0,0,323,0,323,1.0,126,2725@TOP@human_GAPDH_TAA_len41_fa0_ta20_fm6_tm14,g
2725@TOP@human_GAPDH_TAA_len41_fa0_ta20_fm6_tm14*127*a,323,0,2,0,325,0.006,127,2725@TOP@human_GAPDH_TAA_len41_fa0_ta20_fm6_tm14,a
2725@TOP@human_GAPDH_TAA_len41_fa0_ta20_fm6_tm14*128*c,0,330,0,0,330,0.0,128,2725@TOP@human_GAPDH_TAA_len41_fa0_ta20_fm6_tm14,c
2725@TOP@human_GAPDH_TAA_len41_fa0_ta20_fm6_tm14*129*c,0,327,0,0,327,0.0,129,2725@TOP@human_GAPDH_TAA_len41_fa0_ta20_fm6_tm14,c
2725@TOP@human_GAPDH_TAA_len41_fa0_ta20_fm6_tm14*130*c,0,325,0,0,325,0.0,130,2725@TOP@human_GAPDH_TAA_len41_fa0_ta20_fm6_tm14,c
2725@TOP@human_GAPDH_TAA_len41_fa0_ta20_fm6_tm14*131*c,0,329,0,0,329,0.0,131,2725@TOP@human_GAPDH_TAA_len41_fa0_ta20_fm6_tm14,c
2725@TOP@human_GAPDH_TAA_len41_fa0_ta20_fm6_tm14*132*t,0,0,0,322,322,0.0,132,2725@TOP@human_GAPDH_TAA_len41_fa0_ta20_fm6_tm14,t
2725@TOP@human_GAPDH_TAA_len41_fa0_ta20_fm6_tm14*133*g,0,0,324,0,324,1.0,133,2725@TOP@human_GAPDH_TAA_len41_fa0_ta20_fm6_tm14,g
2725@TOP@human_GAPDH_TAA_len41_fa0_ta20_fm6_tm14*134*g,0,0,324,0,324,1.0,134,2725@TOP@human_GAPDH_TAA_len41_fa0_ta20_fm6_tm14,g
2726@TOP@human_GAPDH_TAA_len41_fa0_ta20_fm6_tm14*114*t,0,1,0,1378,1379,0.0,114,2726@TOP@human_GAPDH_TAA_len41_fa0_ta20_fm6_tm14,t
2726@TOP@human_GAPDH_TAA_len41_fa0_ta20_fm6_tm14*115*c,0,1384,0,0,1384,0.0,115,2726@TOP@human_GAPDH_TAA_len41_fa0_ta20_fm6_tm14,c
2726@TOP@human_GAPDH_TAA_len41_fa0_ta20_fm6_tm14*116*c,1,1381,0,0,1382,0.0,116,2726@TOP@human_GAPDH_TAA_len41_fa0_ta20_fm6_tm14,c
2726@TOP@human_GAPDH_TAA_len41_fa0_ta20_fm6_tm14*117*a,1379,0,3,0,1382,0.002,117,2726@TOP@human_GAPDH_TAA_len41_fa0_ta20_fm6_tm14,a
2726@TOP@human_GAPDH_TAA_len41_fa0_ta20_fm6_tm14*118*a,1315,0,41,0,1356,0.03,118,2726@TOP@human_GAPDH_TAA_len41_fa0_ta20_fm6_tm14,a
2726@TOP@human_GAPDH_TAA_len41_fa0_ta20_fm6_tm14*119*g,0,0,1365,0,1365,1.0,119,2726@TOP@human_GAPDH_TAA_len41_fa0_ta20_fm6_tm14,g
2726@TOP@human_GAPDH_TAA_len41_fa0_ta20_fm6_tm14*120*g,0,0,1354,0,1354,1.0,120,2726@TOP@human_GAPDH_TAA_len41_fa0_ta20_fm6_tm14,g
2726@TOP@human_GAPDH_TAA_len41_fa0_ta20_fm6_tm14*121*a,1381,0,2,0,1383,0.001,121,2726@TOP@human_GAPDH_TAA_len41_fa0_ta20_fm6_tm14,a
2726@TOP@human_GAPDH_TAA_len41_fa0_ta20_fm6_tm14*122*g,0,0,1380,0,1380,1.0,122,2726@TOP@human_GAPDH_TAA_len41_fa0_ta20_fm6_tm14,g
2726@TOP@human_GAPDH_TAA_len41_fa0_ta20_fm6_tm14*123*t,1,0,0,1355,1356,0.0,123,2726@TOP@human_GAPDH_TAA_len41_fa0_ta20_fm6_tm14,t
2726@TOP@human_GAPDH_TAA_len41_fa0_ta20_fm6_tm14*124*a,1109,0,252,0,1361,0.185,124,2726@TOP@human_GAPDH_TAA_len41_fa0_ta20_fm6_tm14,a
2726@TOP@human_GAPDH_TAA_len41_fa0_ta20_fm6_tm14*125*a,1103,0,248,0,1351,0.184,125,2726@TOP@human_GAPDH_TAA_len41_fa0_ta20_fm6_tm14,a
2726@TOP@human_GAPDH_TAA_len41_fa0_ta20_fm6_tm14*126*g,0,0,1362,0,1362,1.0,126,2726@TOP@human_GAPDH_TAA_len41_fa0_ta20_fm6_tm14,g
2726@TOP@human_GAPDH_TAA_len41_fa0_ta20_fm6_tm14*127*a,1364,0,13,0,1377,0.009,127,2726@TOP@human_GAPDH_TAA_len41_fa0_ta20_fm6_tm14,a
2726@TOP@human_GAPDH_TAA_len41_fa0_ta20_fm6_tm14*128*c,0,1378,0,0,1378,0.0,128,2726@TOP@human_GAPDH_TAA_len41_fa0_ta20_fm6_tm14,c
2726@TOP@human_GAPDH_TAA_len41_fa0_ta20_fm6_tm14*129*c,0,1374,0,0,1374,0.0,129,2726@TOP@human_GAPDH_TAA_len41_fa0_ta20_fm6_tm14,c
2726@TOP@human_GAPDH_TAA_len41_fa0_ta20_fm6_tm14*130*c,0,1383,0,0,1383,0.0,130,2726@TOP@human_GAPDH_TAA_len41_fa0_ta20_fm6_tm14,c
2726@TOP@human_GAPDH_TAA_len41_fa0_ta20_fm6_tm14*131*c,0,1383,0,0,1383,0.0,131,2726@TOP@human_GAPDH_TAA_len41_fa0_ta20_fm6_tm14,c
2726@TOP@human_GAPDH_TAA_len41_fa0_ta20_fm6_tm14*132*t,0,0,0,1367,1367,0.0,132,2726@TOP@human_GAPDH_TAA_len41_fa0_ta20_fm6_tm14,t
2726@TOP@human_GAPDH_TAA_len41_fa0_ta20_fm6_tm14*133*g,0,0,1362,0,1362,1.0,133,2726@TOP@human_GAPDH_TAA_len41_fa0_ta20_fm6_tm14,g
2726@TOP@human_GAPDH_TAA_len41_fa0_ta20_fm6_tm14*134*g,0,0,1371,0,1371,1.0,134,2726@TOP@human_GAPDH_TAA_len41_fa0_ta20_fm6_tm14,g
2727@TOP@human_GAPDH_TAA_len41_fa0_ta20_fm6_tm14*114*t,0,1,0,1089,1090,0.0,114,2727@TOP@human_GAPDH_TAA_len41_fa0_ta20_fm6_tm14,t
2727@TOP@human_GAPDH_TAA_len41_fa0_ta20_fm6_tm14*115*c,0,1098,0,0,1098,0.0,115,2727@TOP@human_GAPDH_TAA_len41_fa0_ta20_fm6_tm14,c
2727@TOP@human_GAPDH_TAA_len41_fa0_ta20_fm6_tm14*116*c,0,1090,0,0,1090,0.0,116,2727@TOP@human_GAPDH_TAA_len41_fa0_ta20_fm6_tm14,c
2727@TOP@human_GAPDH_TAA_len41_fa0_ta20_fm6_tm14*117*a,1083,0,1,0,1084,0.001,117,2727@TOP@human_GAPDH_TAA_len41_fa0_ta20_fm6_tm14,a
2727@TOP@human_GAPDH_TAA_len41_fa0_ta20_fm6_tm14*118*a,1070,0,15,0,1085,0.014,118,2727@TOP@human_GAPDH_TAA_len41_fa0_ta20_fm6_tm14,a
2727@TOP@human_GAPDH_TAA_len41_fa0_ta20_fm6_tm14*119*g,0,0,1077,0,1077,1.0,119,2727@TOP@human_GAPDH_TAA_len41_fa0_ta20_fm6_tm14,g
2727@TOP@human_GAPDH_TAA_len41_fa0_ta20_fm6_tm14*120*g,0,0,1073,0,1073,1.0,120,2727@TOP@human_GAPDH_TAA_len41_fa0_ta20_fm6_tm14,g
2727@TOP@human_GAPDH_TAA_len41_fa0_ta20_fm6_tm14*121*a,1093,0,0,0,1093,0.0,121,2727@TOP@human_GAPDH_TAA_len41_fa0_ta20_fm6_tm14,a
2727@TOP@human_GAPDH_TAA_len41_fa0_ta20_fm6_tm14*122*g,0,0,1089,0,1089,1.0,122,2727@TOP@human_GAPDH_TAA_len41_fa0_ta20_fm6_tm14,g
2727@TOP@human_GAPDH_TAA_len41_fa0_ta20_fm6_tm14*123*t,0,0,0,1080,1080,0.0,123,2727@TOP@human_GAPDH_TAA_len41_fa0_ta20_fm6_tm14,t
2727@TOP@human_GAPDH_TAA_len41_fa0_ta20_fm6_tm14*124*a,828,0,244,0,1072,0.228,124,2727@TOP@human_GAPDH_TAA_len41_fa0_ta20_fm6_tm14,a
2727@TOP@human_GAPDH_TAA_len41_fa0_ta20_fm6_tm14*125*a,925,0,153,0,1078,0.142,125,2727@TOP@human_GAPDH_TAA_len41_fa0_ta20_fm6_tm14,a
2727@TOP@human_GAPDH_TAA_len41_fa0_ta20_fm6_tm14*126*g,0,0,1073,0,1073,1.0,126,2727@TOP@human_GAPDH_TAA_len41_fa0_ta20_fm6_tm14,g
2727@TOP@human_GAPDH_TAA_len41_fa0_ta20_fm6_tm14*127*a,1084,0,2,0,1086,0.002,127,2727@TOP@human_GAPDH_TAA_len41_fa0_ta20_fm6_tm14,a
2727@TOP@human_GAPDH_TAA_len41_fa0_ta20_fm6_tm14*128*c,0,1091,0,0,1091,0.0,128,2727@TOP@human_GAPDH_TAA_len41_fa0_ta20_fm6_tm14,c
2727@TOP@human_GAPDH_TAA_len41_fa0_ta20_fm6_tm14*129*c,0,1083,0,0,1083,0.0,129,2727@TOP@human_GAPDH_TAA_len41_fa0_ta20_fm6_tm14,c
2727@TOP@human_GAPDH_TAA_len41_fa0_ta20_fm6_tm14*130*c,0,1089,0,0,1089,0.0,130,2727@TOP@human_GAPDH_TAA_len41_fa0_ta20_fm6_tm14,c
2727@TOP@human_GAPDH_TAA_len41_fa0_ta20_fm6_tm14*131*c,0,1094,0,0,1094,0.0,131,2727@TOP@human_GAPDH_TAA_len41_fa0_ta20_fm6_tm14,c
2727@TOP@human_GAPDH_TAA_len41_fa0_ta20_fm6_tm14*132*t,0,0,0,1084,1084,0.0,132,2727@TOP@human_GAPDH_TAA_len41_fa0_ta20_fm6_tm14,t
2727@TOP@human_GAPDH_TAA_len41_fa0_ta20_fm6_tm14*133*g,0,0,1075,0,1075,1.0,133,2727@TOP@human_GAPDH_TAA_len41_fa0_ta20_fm6_tm14,g
2727@TOP@human_GAPDH_TAA_len41_fa0_ta20_fm6_tm14*134*g,0,0,1078,0,1078,1.0,134,2727@TOP@human_GAPDH_TAA_len41_fa0_ta20_fm6_tm14,g
2728@TOP@human_GAPDH_TAA_len41_fa0_ta20_fm6_tm14*114*t,0,0,0,1326,1326,0.0,114,2728@TOP@human_GAPDH_TAA_len41_fa0_ta20_fm6_tm14,t
2728@TOP@human_GAPDH_TAA_len41_fa0_ta20_fm6_tm14*115*c,0,1331,0,0,1331,0.0,115,2728@TOP@human_GAPDH_TAA_len41_fa0_ta20_fm6_tm14,c
2728@TOP@human_GAPDH_TAA_len41_fa0_ta20_fm6_tm14*116*c,0,1324,0,0,1324,0.0,116,2728@TOP@human_GAPDH_TAA_len41_fa0_ta20_fm6_tm14,c
2728@TOP@human_GAPDH_TAA_len41_fa0_ta20_fm6_tm14*117*a,1322,0,5,0,1327,0.004,117,2728@TOP@human_GAPDH_TAA_len41_fa0_ta20_fm6_tm14,a
2728@TOP@human_GAPDH_TAA_len41_fa0_ta20_fm6_tm14*118*a,1229,0,89,0,1318,0.068,118,2728@TOP@human_GAPDH_TAA_len41_fa0_ta20_fm6_tm14,a
2728@TOP@human_GAPDH_TAA_len41_fa0_ta20_fm6_tm14*119*g,0,0,1315,0,1315,1.0,119,2728@TOP@human_GAPDH_TAA_len41_fa0_ta20_fm6_tm14,g
2728@TOP@human_GAPDH_TAA_len41_fa0_ta20_fm6_tm14*120*g,0,0,1306,0,1306,1.0,120,2728@TOP@human_GAPDH_TAA_len41_fa0_ta20_fm6_tm14,g
2728@TOP@human_GAPDH_TAA_len41_fa0_ta20_fm6_tm14*121*a,1325,0,3,0,1328,0.002,121,2728@TOP@human_GAPDH_TAA_len41_fa0_ta20_fm6_tm14,a
2728@TOP@human_GAPDH_TAA_len41_fa0_ta20_fm6_tm14*122*g,0,0,1326,0,1326,1.0,122,2728@TOP@human_GAPDH_TAA_len41_fa0_ta20_fm6_tm14,g
2728@TOP@human_GAPDH_TAA_len41_fa0_ta20_fm6_tm14*123*t,0,0,0,1307,1307,0.0,123,2728@TOP@human_GAPDH_TAA_len41_fa0_ta20_fm6_tm14,t
2728@TOP@human_GAPDH_TAA_len41_fa0_ta20_fm6_tm14*124*a,987,0,325,0,1312,0.248,124,2728@TOP@human_GAPDH_TAA_len41_fa0_ta20_fm6_tm14,a
2728@TOP@human_GAPDH_TAA_len41_fa0_ta20_fm6_tm14*125*a,1088,0,207,0,1295,0.16,125,2728@TOP@human_GAPDH_TAA_len41_fa0_ta20_fm6_tm14,a
2728@TOP@human_GAPDH_TAA_len41_fa0_ta20_fm6_tm14*126*g,0,0,1311,0,1311,1.0,126,2728@TOP@human_GAPDH_TAA_len41_fa0_ta20_fm6_tm14,g
2728@TOP@human_GAPDH_TAA_len41_fa0_ta20_fm6_tm14*127*a,1305,0,12,0,1317,0.009,127,2728@TOP@human_GAPDH_TAA_len41_fa0_ta20_fm6_tm14,a
2728@TOP@human_GAPDH_TAA_len41_fa0_ta20_fm6_tm14*128*c,0,1330,0,0,1330,0.0,128,2728@TOP@human_GAPDH_TAA_len41_fa0_ta20_fm6_tm14,c
2728@TOP@human_GAPDH_TAA_len41_fa0_ta20_fm6_tm14*129*c,0,1314,0,0,1314,0.0,129,2728@TOP@human_GAPDH_TAA_len41_fa0_ta20_fm6_tm14,c
2728@TOP@human_GAPDH_TAA_len41_fa0_ta20_fm6_tm14*130*c,0,1330,0,0,1330,0.0,130,2728@TOP@human_GAPDH_TAA_len41_fa0_ta20_fm6_tm14,c
2728@TOP@human_GAPDH_TAA_len41_fa0_ta20_fm6_tm14*131*c,0,1325,0,0,1325,0.0,131,2728@TOP@human_GAPDH_TAA_len41_fa0_ta20_fm6_tm14,c
2728@TOP@human_GAPDH_TAA_len41_fa0_ta20_fm6_tm14*132*t,1,0,2,1307,1310,0.002,132,2728@TOP@human_GAPDH_TAA_len41_fa0_ta20_fm6_tm14,t
2728@TOP@human_GAPDH_TAA_len41_fa0_ta20_fm6_tm14*133*g,0,0,1308,0,1308,1.0,133,2728@TOP@human_GAPDH_TAA_len41_fa0_ta20_fm6_tm14,g
2728@TOP@human_GAPDH_TAA_len41_fa0_ta20_fm6_tm14*134*g,0,1,1305,0,1306,0.999,134,2728@TOP@human_GAPDH_TAA_len41_fa0_ta20_fm6_tm14,g
2729@TOP@human_GAPDH_TAA_len41_fa0_ta20_fm6_tm14*114*t,0,7,0,6383,6390,0.0,114,2729@TOP@human_GAPDH_TAA_len41_fa0_ta20_fm6_tm14,t
2729@TOP@human_GAPDH_TAA_len41_fa0_ta20_fm6_tm14*115*c,0,6428,0,1,6429,0.0,115,2729@TOP@human_GAPDH_TAA_len41_fa0_ta20_fm6_tm14,c
2729@TOP@human_GAPDH_TAA_len41_fa0_ta20_fm6_tm14*116*c,0,6397,0,1,6398,0.0,116,2729@TOP@human_GAPDH_TAA_len41_fa0_ta20_fm6_tm14,c
2729@TOP@human_GAPDH_TAA_len41_fa0_ta20_fm6_tm14*117*a,6376,0,14,0,6390,0.002,117,2729@TOP@human_GAPDH_TAA_len41_fa0_ta20_fm6_tm14,a
2729@TOP@human_GAPDH_TAA_len41_fa0_ta20_fm6_tm14*118*a,6251,0,105,0,6356,0.017,118,2729@TOP@human_GAPDH_TAA_len41_fa0_ta20_fm6_tm14,a
2729@TOP@human_GAPDH_TAA_len41_fa0_ta20_fm6_tm14*119*g,0,0,6358,0,6358,1.0,119,2729@TOP@human_GAPDH_TAA_len41_fa0_ta20_fm6_tm14,g
2729@TOP@human_GAPDH_TAA_len41_fa0_ta20_fm6_tm14*120*g,0,0,6308,1,6309,1.0,120,2729@TOP@human_GAPDH_TAA_len41_fa0_ta20_fm6_tm14,g
2729@TOP@human_GAPDH_TAA_len41_fa0_ta20_fm6_tm14*121*a,6387,0,1,0,6388,0.0,121,2729@TOP@human_GAPDH_TAA_len41_fa0_ta20_fm6_tm14,a
2729@TOP@human_GAPDH_TAA_len41_fa0_ta20_fm6_tm14*122*g,0,1,6399,0,6400,1.0,122,2729@TOP@human_GAPDH_TAA_len41_fa0_ta20_fm6_tm14,g
2729@TOP@human_GAPDH_TAA_len41_fa0_ta20_fm6_tm14*123*t,0,0,0,6319,6319,0.0,123,2729@TOP@human_GAPDH_TAA_len41_fa0_ta20_fm6_tm14,t
2729@TOP@human_GAPDH_TAA_len41_fa0_ta20_fm6_tm14*124*a,4203,0,2087,1,6291,0.332,124,2729@TOP@human_GAPDH_TAA_len41_fa0_ta20_fm6_tm14,a
2729@TOP@human_GAPDH_TAA_len41_fa0_ta20_fm6_tm14*125*a,2802,1,3518,0,6321,0.557,125,2729@TOP@human_GAPDH_TAA_len41_fa0_ta20_fm6_tm14,a
2729@TOP@human_GAPDH_TAA_len41_fa0_ta20_fm6_tm14*126*g,0,0,6343,0,6343,1.0,126,2729@TOP@human_GAPDH_TAA_len41_fa0_ta20_fm6_tm14,g
2729@TOP@human_GAPDH_TAA_len41_fa0_ta20_fm6_tm14*127*a,6331,1,64,0,6396,0.01,127,2729@TOP@human_GAPDH_TAA_len41_fa0_ta20_fm6_tm14,a
2729@TOP@human_GAPDH_TAA_len41_fa0_ta20_fm6_tm14*128*c,0,6410,0,0,6410,0.0,128,2729@TOP@human_GAPDH_TAA_len41_fa0_ta20_fm6_tm14,c
2729@TOP@human_GAPDH_TAA_len41_fa0_ta20_fm6_tm14*129*c,0,6382,0,0,6382,0.0,129,2729@TOP@human_GAPDH_TAA_len41_fa0_ta20_fm6_tm14,c
2729@TOP@human_GAPDH_TAA_len41_fa0_ta20_fm6_tm14*130*c,0,6409,0,0,6409,0.0,130,2729@TOP@human_GAPDH_TAA_len41_fa0_ta20_fm6_tm14,c
2729@TOP@human_GAPDH_TAA_len41_fa0_ta20_fm6_tm14*131*c,0,6421,0,0,6421,0.0,131,2729@TOP@human_GAPDH_TAA_len41_fa0_ta20_fm6_tm14,c
2729@TOP@human_GAPDH_TAA_len41_fa0_ta20_fm6_tm14*132*t,0,0,0,6344,6344,0.0,132,2729@TOP@human_GAPDH_TAA_len41_fa0_ta20_fm6_tm14,t
2729@TOP@human_GAPDH_TAA_len41_fa0_ta20_fm6_tm14*133*g,0,0,6317,0,6317,1.0,133,2729@TOP@human_GAPDH_TAA_len41_fa0_ta20_fm6_tm14,g
2729@TOP@human_GAPDH_TAA_len41_fa0_ta20_fm6_tm14*134*g,2,0,6358,0,6360,1.0,134,2729@TOP@human_GAPDH_TAA_len41_fa0_ta20_fm6_tm14,g
2730@TOP@human_GAPDH_TAA_len41_fa0_ta20_fm6_tm14*114*t,0,2,0,11080,11082,0.0,114,2730@TOP@human_GAPDH_TAA_len41_fa0_ta20_fm6_tm14,t
2730@TOP@human_GAPDH_TAA_len41_fa0_ta20_fm6_tm14*115*c,0,11142,0,0,11142,0.0,115,2730@TOP@human_GAPDH_TAA_len41_fa0_ta20_fm6_tm14,c
2730@TOP@human_GAPDH_TAA_len41_fa0_ta20_fm6_tm14*116*c,0,11107,0,1,11108,0.0,116,2730@TOP@human_GAPDH_TAA_len41_fa0_ta20_fm6_tm14,c
2730@TOP@human_GAPDH_TAA_len41_fa0_ta20_fm6_tm14*117*a,11051,0,28,0,11079,0.003,117,2730@TOP@human_GAPDH_TAA_len41_fa0_ta20_fm6_tm14,a
2730@TOP@human_GAPDH_TAA_len41_fa0_ta20_fm6_tm14*118*a,10872,0,171,0,11043,0.015,118,2730@TOP@human_GAPDH_TAA_len41_fa0_ta20_fm6_tm14,a
2730@TOP@human_GAPDH_TAA_len41_fa0_ta20_fm6_tm14*119*g,0,0,11021,0,11021,1.0,119,2730@TOP@human_GAPDH_TAA_len41_fa0_ta20_fm6_tm14,g
2730@TOP@human_GAPDH_TAA_len41_fa0_ta20_fm6_tm14*120*g,0,0,10975,2,10977,1.0,120,2730@TOP@human_GAPDH_TAA_len41_fa0_ta20_fm6_tm14,g
2730@TOP@human_GAPDH_TAA_len41_fa0_ta20_fm6_tm14*121*a,11083,0,3,0,11086,0.0,121,2730@TOP@human_GAPDH_TAA_len41_fa0_ta20_fm6_tm14,a
2730@TOP@human_GAPDH_TAA_len41_fa0_ta20_fm6_tm14*122*g,0,0,11103,0,11103,1.0,122,2730@TOP@human_GAPDH_TAA_len41_fa0_ta20_fm6_tm14,g
2730@TOP@human_GAPDH_TAA_len41_fa0_ta20_fm6_tm14*123*t,0,1,1,10982,10984,0.0,123,2730@TOP@human_GAPDH_TAA_len41_fa0_ta20_fm6_tm14,t
2730@TOP@human_GAPDH_TAA_len41_fa0_ta20_fm6_tm14*124*a,6727,0,4247,0,10974,0.387,124,2730@TOP@human_GAPDH_TAA_len41_fa0_ta20_fm6_tm14,a
2730@TOP@human_GAPDH_TAA_len41_fa0_ta20_fm6_tm14*125*a,7907,1,3010,1,10919,0.276,125,2730@TOP@human_GAPDH_TAA_len41_fa0_ta20_fm6_tm14,a
2730@TOP@human_GAPDH_TAA_len41_fa0_ta20_fm6_tm14*126*g,1,0,10994,1,10996,1.0,126,2730@TOP@human_GAPDH_TAA_len41_fa0_ta20_fm6_tm14,g
2730@TOP@human_GAPDH_TAA_len41_fa0_ta20_fm6_tm14*127*a,10991,0,84,0,11075,0.008,127,2730@TOP@human_GAPDH_TAA_len41_fa0_ta20_fm6_tm14,a
2730@TOP@human_GAPDH_TAA_len41_fa0_ta20_fm6_tm14*128*c,0,11113,0,0,11113,0.0,128,2730@TOP@human_GAPDH_TAA_len41_fa0_ta20_fm6_tm14,c
2730@TOP@human_GAPDH_TAA_len41_fa0_ta20_fm6_tm14*129*c,0,11037,1,0,11038,0.0,129,2730@TOP@human_GAPDH_TAA_len41_fa0_ta20_fm6_tm14,c
2730@TOP@human_GAPDH_TAA_len41_fa0_ta20_fm6_tm14*130*c,0,11107,0,0,11107,0.0,130,2730@TOP@human_GAPDH_TAA_len41_fa0_ta20_fm6_tm14,c
2730@TOP@human_GAPDH_TAA_len41_fa0_ta20_fm6_tm14*131*c,0,11130,0,0,11130,0.0,131,2730@TOP@human_GAPDH_TAA_len41_fa0_ta20_fm6_tm14,c
2730@TOP@human_GAPDH_TAA_len41_fa0_ta20_fm6_tm14*132*t,0,2,1,11000,11003,0.0,132,2730@TOP@human_GAPDH_TAA_len41_fa0_ta20_fm6_tm14,t
2730@TOP@human_GAPDH_TAA_len41_fa0_ta20_fm6_tm14*133*g,0,0,10956,2,10958,1.0,133,2730@TOP@human_GAPDH_TAA_len41_fa0_ta20_fm6_tm14,g
2730@TOP@human_GAPDH_TAA_len41_fa0_ta20_fm6_tm14*134*g,1,0,11022,0,11023,1.0,134,2730@TOP@human_GAPDH_TAA_len41_fa0_ta20_fm6_tm14,g
2731@TOP@human_GAPDH_TAA_len41_fa0_ta20_fm6_tm14*114*t,0,0,0,392,392,0.0,114,2731@TOP@human_GAPDH_TAA_len41_fa0_ta20_fm6_tm14,t
2731@TOP@human_GAPDH_TAA_len41_fa0_ta20_fm6_tm14*115*c,0,393,0,0,393,0.0,115,2731@TOP@human_GAPDH_TAA_len41_fa0_ta20_fm6_tm14,c
2731@TOP@human_GAPDH_TAA_len41_fa0_ta20_fm6_tm14*116*c,0,393,0,0,393,0.0,116,2731@TOP@human_GAPDH_TAA_len41_fa0_ta20_fm6_tm14,c
2731@TOP@human_GAPDH_TAA_len41_fa0_ta20_fm6_tm14*117*a,389,0,3,0,392,0.008,117,2731@TOP@human_GAPDH_TAA_len41_fa0_ta20_fm6_tm14,a
2731@TOP@human_GAPDH_TAA_len41_fa0_ta20_fm6_tm14*118*a,382,0,7,0,389,0.018,118,2731@TOP@human_GAPDH_TAA_len41_fa0_ta20_fm6_tm14,a
2731@TOP@human_GAPDH_TAA_len41_fa0_ta20_fm6_tm14*119*g,0,0,383,0,383,1.0,119,2731@TOP@human_GAPDH_TAA_len41_fa0_ta20_fm6_tm14,g
2731@TOP@human_GAPDH_TAA_len41_fa0_ta20_fm6_tm14*120*g,0,0,383,0,383,1.0,120,2731@TOP@human_GAPDH_TAA_len41_fa0_ta20_fm6_tm14,g
2731@TOP@human_GAPDH_TAA_len41_fa0_ta20_fm6_tm14*121*a,388,0,0,0,388,0.0,121,2731@TOP@human_GAPDH_TAA_len41_fa0_ta20_fm6_tm14,a
2731@TOP@human_GAPDH_TAA_len41_fa0_ta20_fm6_tm14*122*g,0,0,391,0,391,1.0,122,2731@TOP@human_GAPDH_TAA_len41_fa0_ta20_fm6_tm14,g
2731@TOP@human_GAPDH_TAA_len41_fa0_ta20_fm6_tm14*123*t,0,0,0,387,387,0.0,123,2731@TOP@human_GAPDH_TAA_len41_fa0_ta20_fm6_tm14,t
2731@TOP@human_GAPDH_TAA_len41_fa0_ta20_fm6_tm14*124*a,314,0,76,0,390,0.195,124,2731@TOP@human_GAPDH_TAA_len41_fa0_ta20_fm6_tm14,a
2731@TOP@human_GAPDH_TAA_len41_fa0_ta20_fm6_tm14*125*a,298,0,88,0,386,0.228,125,2731@TOP@human_GAPDH_TAA_len41_fa0_ta20_fm6_tm14,a
2731@TOP@human_GAPDH_TAA_len41_fa0_ta20_fm6_tm14*126*g,0,0,384,0,384,1.0,126,2731@TOP@human_GAPDH_TAA_len41_fa0_ta20_fm6_tm14,g
2731@TOP@human_GAPDH_TAA_len41_fa0_ta20_fm6_tm14*127*a,380,0,8,0,388,0.021,127,2731@TOP@human_GAPDH_TAA_len41_fa0_ta20_fm6_tm14,a
2731@TOP@human_GAPDH_TAA_len41_fa0_ta20_fm6_tm14*128*c,0,392,0,0,392,0.0,128,2731@TOP@human_GAPDH_TAA_len41_fa0_ta20_fm6_tm14,c
2731@TOP@human_GAPDH_TAA_len41_fa0_ta20_fm6_tm14*129*c,0,384,0,0,384,0.0,129,2731@TOP@human_GAPDH_TAA_len41_fa0_ta20_fm6_tm14,c
2731@TOP@human_GAPDH_TAA_len41_fa0_ta20_fm6_tm14*130*c,0,391,0,0,391,0.0,130,2731@TOP@human_GAPDH_TAA_len41_fa0_ta20_fm6_tm14,c
2731@TOP@human_GAPDH_TAA_len41_fa0_ta20_fm6_tm14*131*c,0,390,0,0,390,0.0,131,2731@TOP@human_GAPDH_TAA_len41_fa0_ta20_fm6_tm14,c
2731@TOP@human_GAPDH_TAA_len41_fa0_ta20_fm6_tm14*132*t,0,0,0,388,388,0.0,132,2731@TOP@human_GAPDH_TAA_len41_fa0_ta20_fm6_tm14,t
2731@TOP@human_GAPDH_TAA_len41_fa0_ta20_fm6_tm14*133*g,0,0,385,0,385,1.0,133,2731@TOP@human_GAPDH_TAA_len41_fa0_ta20_fm6_tm14,g
2731@TOP@human_GAPDH_TAA_len41_fa0_ta20_fm6_tm14*134*g,0,0,383,0,383,1.0,134,2731@TOP@human_GAPDH_TAA_len41_fa0_ta20_fm6_tm14,g
2732@TOP@human_GAPDH_TAA_len41_fa0_ta20_fm6_tm14*114*t,0,0,0,523,523,0.0,114,2732@TOP@human_GAPDH_TAA_len41_fa0_ta20_fm6_tm14,t
2732@TOP@human_GAPDH_TAA_len41_fa0_ta20_fm6_tm14*115*c,0,535,0,0,535,0.0,115,2732@TOP@human_GAPDH_TAA_len41_fa0_ta20_fm6_tm14,c
2732@TOP@human_GAPDH_TAA_len41_fa0_ta20_fm6_tm14*116*c,0,522,0,0,522,0.0,116,2732@TOP@human_GAPDH_TAA_len41_fa0_ta20_fm6_tm14,c
2732@TOP@human_GAPDH_TAA_len41_fa0_ta20_fm6_tm14*117*a,533,1,0,0,534,0.0,117,2732@TOP@human_GAPDH_TAA_len41_fa0_ta20_fm6_tm14,a
2732@TOP@human_GAPDH_TAA_len41_fa0_ta20_fm6_tm14*118*a,509,0,19,0,528,0.036,118,2732@TOP@human_GAPDH_TAA_len41_fa0_ta20_fm6_tm14,a
2732@TOP@human_GAPDH_TAA_len41_fa0_ta20_fm6_tm14*119*g,0,0,515,0,515,1.0,119,2732@TOP@human_GAPDH_TAA_len41_fa0_ta20_fm6_tm14,g
2732@TOP@human_GAPDH_TAA_len41_fa0_ta20_fm6_tm14*120*g,0,0,516,0,516,1.0,120,2732@TOP@human_GAPDH_TAA_len41_fa0_ta20_fm6_tm14,g
2732@TOP@human_GAPDH_TAA_len41_fa0_ta20_fm6_tm14*121*a,531,0,1,0,532,0.002,121,2732@TOP@human_GAPDH_TAA_len41_fa0_ta20_fm6_tm14,a
2732@TOP@human_GAPDH_TAA_len41_fa0_ta20_fm6_tm14*122*g,0,0,530,0,530,1.0,122,2732@TOP@human_GAPDH_TAA_len41_fa0_ta20_fm6_tm14,g
2732@TOP@human_GAPDH_TAA_len41_fa0_ta20_fm6_tm14*123*t,0,0,0,512,512,0.0,123,2732@TOP@human_GAPDH_TAA_len41_fa0_ta20_fm6_tm14,t
2732@TOP@human_GAPDH_TAA_len41_fa0_ta20_fm6_tm14*124*a,414,0,100,0,514,0.195,124,2732@TOP@human_GAPDH_TAA_len41_fa0_ta20_fm6_tm14,a
2732@TOP@human_GAPDH_TAA_len41_fa0_ta20_fm6_tm14*125*a,471,0,48,0,519,0.092,125,2732@TOP@human_GAPDH_TAA_len41_fa0_ta20_fm6_tm14,a
2732@TOP@human_GAPDH_TAA_len41_fa0_ta20_fm6_tm14*126*g,0,0,517,0,517,1.0,126,2732@TOP@human_GAPDH_TAA_len41_fa0_ta20_fm6_tm14,g
2732@TOP@human_GAPDH_TAA_len41_fa0_ta20_fm6_tm14*127*a,525,0,3,0,528,0.006,127,2732@TOP@human_GAPDH_TAA_len41_fa0_ta20_fm6_tm14,a
2732@TOP@human_GAPDH_TAA_len41_fa0_ta20_fm6_tm14*128*c,0,532,0,0,532,0.0,128,2732@TOP@human_GAPDH_TAA_len41_fa0_ta20_fm6_tm14,c
2732@TOP@human_GAPDH_TAA_len41_fa0_ta20_fm6_tm14*129*c,0,517,0,0,517,0.0,129,2732@TOP@human_GAPDH_TAA_len41_fa0_ta20_fm6_tm14,c
2732@TOP@human_GAPDH_TAA_len41_fa0_ta20_fm6_tm14*130*c,0,526,0,0,526,0.0,130,2732@TOP@human_GAPDH_TAA_len41_fa0_ta20_fm6_tm14,c
2732@TOP@human_GAPDH_TAA_len41_fa0_ta20_fm6_tm14*131*c,0,533,0,1,534,0.0,131,2732@TOP@human_GAPDH_TAA_len41_fa0_ta20_fm6_tm14,c
2732@TOP@human_GAPDH_TAA_len41_fa0_ta20_fm6_tm14*132*t,0,0,0,512,512,0.0,132,2732@TOP@human_GAPDH_TAA_len41_fa0_ta20_fm6_tm14,t
2732@TOP@human_GAPDH_TAA_len41_fa0_ta20_fm6_tm14*133*g,0,0,509,0,509,1.0,133,2732@TOP@human_GAPDH_TAA_len41_fa0_ta20_fm6_tm14,g
2732@TOP@human_GAPDH_TAA_len41_fa0_ta20_fm6_tm14*134*g,0,0,513,0,513,1.0,134,2732@TOP@human_GAPDH_TAA_len41_fa0_ta20_fm6_tm14,g
2733@TOP@human_GAPDH_TAA_len41_fa0_ta20_fm6_tm14*114*t,1,1,0,1615,1617,0.0,114,2733@TOP@human_GAPDH_TAA_len41_fa0_ta20_fm6_tm14,t
2733@TOP@human_GAPDH_TAA_len41_fa0_ta20_fm6_tm14*115*c,0,1640,0,0,1640,0.0,115,2733@TOP@human_GAPDH_TAA_len41_fa0_ta20_fm6_tm14,c
2733@TOP@human_GAPDH_TAA_len41_fa0_ta20_fm6_tm14*116*c,0,1627,1,0,1628,0.001,116,2733@TOP@human_GAPDH_TAA_len41_fa0_ta20_fm6_tm14,c
2733@TOP@human_GAPDH_TAA_len41_fa0_ta20_fm6_tm14*117*a,1626,0,5,0,1631,0.003,117,2733@TOP@human_GAPDH_TAA_len41_fa0_ta20_fm6_tm14,a
2733@TOP@human_GAPDH_TAA_len41_fa0_ta20_fm6_tm14*118*a,1572,0,46,0,1618,0.028,118,2733@TOP@human_GAPDH_TAA_len41_fa0_ta20_fm6_tm14,a
2733@TOP@human_GAPDH_TAA_len41_fa0_ta20_fm6_tm14*119*g,0,0,1600,0,1600,1.0,119,2733@TOP@human_GAPDH_TAA_len41_fa0_ta20_fm6_tm14,g
2733@TOP@human_GAPDH_TAA_len41_fa0_ta20_fm6_tm14*120*g,0,0,1602,1,1603,0.999,120,2733@TOP@human_GAPDH_TAA_len41_fa0_ta20_fm6_tm14,g
2733@TOP@human_GAPDH_TAA_len41_fa0_ta20_fm6_tm14*121*a,1631,0,0,0,1631,0.0,121,2733@TOP@human_GAPDH_TAA_len41_fa0_ta20_fm6_tm14,a
2733@TOP@human_GAPDH_TAA_len41_fa0_ta20_fm6_tm14*122*g,0,0,1625,0,1625,1.0,122,2733@TOP@human_GAPDH_TAA_len41_fa0_ta20_fm6_tm14,g
2733@TOP@human_GAPDH_TAA_len41_fa0_ta20_fm6_tm14*123*t,0,0,0,1594,1594,0.0,123,2733@TOP@human_GAPDH_TAA_len41_fa0_ta20_fm6_tm14,t
2733@TOP@human_GAPDH_TAA_len41_fa0_ta20_fm6_tm14*124*a,1133,0,460,0,1593,0.289,124,2733@TOP@human_GAPDH_TAA_len41_fa0_ta20_fm6_tm14,a
2733@TOP@human_GAPDH_TAA_len41_fa0_ta20_fm6_tm14*125*a,1095,0,507,0,1602,0.316,125,2733@TOP@human_GAPDH_TAA_len41_fa0_ta20_fm6_tm14,a
2733@TOP@human_GAPDH_TAA_len41_fa0_ta20_fm6_tm14*126*g,1,0,1606,0,1607,0.999,126,2733@TOP@human_GAPDH_TAA_len41_fa0_ta20_fm6_tm14,g
2733@TOP@human_GAPDH_TAA_len41_fa0_ta20_fm6_tm14*127*a,1572,0,45,0,1617,0.028,127,2733@TOP@human_GAPDH_TAA_len41_fa0_ta20_fm6_tm14,a
2733@TOP@human_GAPDH_TAA_len41_fa0_ta20_fm6_tm14*128*c,0,1638,1,0,1639,0.001,128,2733@TOP@human_GAPDH_TAA_len41_fa0_ta20_fm6_tm14,c
2733@TOP@human_GAPDH_TAA_len41_fa0_ta20_fm6_tm14*129*c,0,1624,0,0,1624,0.0,129,2733@TOP@human_GAPDH_TAA_len41_fa0_ta20_fm6_tm14,c
2733@TOP@human_GAPDH_TAA_len41_fa0_ta20_fm6_tm14*130*c,0,1628,0,1,1629,0.0,130,2733@TOP@human_GAPDH_TAA_len41_fa0_ta20_fm6_tm14,c
2733@TOP@human_GAPDH_TAA_len41_fa0_ta20_fm6_tm14*131*c,0,1639,0,0,1639,0.0,131,2733@TOP@human_GAPDH_TAA_len41_fa0_ta20_fm6_tm14,c
2733@TOP@human_GAPDH_TAA_len41_fa0_ta20_fm6_tm14*132*t,0,0,0,1603,1603,0.0,132,2733@TOP@human_GAPDH_TAA_len41_fa0_ta20_fm6_tm14,t
2733@TOP@human_GAPDH_TAA_len41_fa0_ta20_fm6_tm14*133*g,0,0,1589,0,1589,1.0,133,2733@TOP@human_GAPDH_TAA_len41_fa0_ta20_fm6_tm14,g
2733@TOP@human_GAPDH_TAA_len41_fa0_ta20_fm6_tm14*134*g,0,0,1609,0,1609,1.0,134,2733@TOP@human_GAPDH_TAA_len41_fa0_ta20_fm6_tm14,g
2734@TOP@human_GAPDH_TAA_len41_fa0_ta20_fm6_tm14*114*t,0,0,0,2314,2314,0.0,114,2734@TOP@human_GAPDH_TAA_len41_fa0_ta20_fm6_tm14,t
2734@TOP@human_GAPDH_TAA_len41_fa0_ta20_fm6_tm14*115*c,0,2333,0,1,2334,0.0,115,2734@TOP@human_GAPDH_TAA_len41_fa0_ta20_fm6_tm14,c
2734@TOP@human_GAPDH_TAA_len41_fa0_ta20_fm6_tm14*116*c,2,2318,0,0,2320,0.0,116,2734@TOP@human_GAPDH_TAA_len41_fa0_ta20_fm6_tm14,c
2734@TOP@human_GAPDH_TAA_len41_fa0_ta20_fm6_tm14*117*a,2306,0,16,0,2322,0.007,117,2734@TOP@human_GAPDH_TAA_len41_fa0_ta20_fm6_tm14,a
2734@TOP@human_GAPDH_TAA_len41_fa0_ta20_fm6_tm14*118*a,2250,0,59,0,2309,0.026,118,2734@TOP@human_GAPDH_TAA_len41_fa0_ta20_fm6_tm14,a
2734@TOP@human_GAPDH_TAA_len41_fa0_ta20_fm6_tm14*119*g,0,0,2286,0,2286,1.0,119,2734@TOP@human_GAPDH_TAA_len41_fa0_ta20_fm6_tm14,g
2734@TOP@human_GAPDH_TAA_len41_fa0_ta20_fm6_tm14*120*g,0,0,2287,0,2287,1.0,120,2734@TOP@human_GAPDH_TAA_len41_fa0_ta20_fm6_tm14,g
2734@TOP@human_GAPDH_TAA_len41_fa0_ta20_fm6_tm14*121*a,2323,0,1,0,2324,0.0,121,2734@TOP@human_GAPDH_TAA_len41_fa0_ta20_fm6_tm14,a
2734@TOP@human_GAPDH_TAA_len41_fa0_ta20_fm6_tm14*122*g,0,0,2317,0,2317,1.0,122,2734@TOP@human_GAPDH_TAA_len41_fa0_ta20_fm6_tm14,g
2734@TOP@human_GAPDH_TAA_len41_fa0_ta20_fm6_tm14*123*t,0,0,0,2293,2293,0.0,123,2734@TOP@human_GAPDH_TAA_len41_fa0_ta20_fm6_tm14,t
2734@TOP@human_GAPDH_TAA_len41_fa0_ta20_fm6_tm14*124*a,1370,0,929,0,2299,0.404,124,2734@TOP@human_GAPDH_TAA_len41_fa0_ta20_fm6_tm14,a
2734@TOP@human_GAPDH_TAA_len41_fa0_ta20_fm6_tm14*125*a,2024,0,270,0,2294,0.118,125,2734@TOP@human_GAPDH_TAA_len41_fa0_ta20_fm6_tm14,a
2734@TOP@human_GAPDH_TAA_len41_fa0_ta20_fm6_tm14*126*g,0,0,2288,0,2288,1.0,126,2734@TOP@human_GAPDH_TAA_len41_fa0_ta20_fm6_tm14,g
2734@TOP@human_GAPDH_TAA_len41_fa0_ta20_fm6_tm14*127*a,2307,0,7,0,2314,0.003,127,2734@TOP@human_GAPDH_TAA_len41_fa0_ta20_fm6_tm14,a
2734@TOP@human_GAPDH_TAA_len41_fa0_ta20_fm6_tm14*128*c,0,2327,0,0,2327,0.0,128,2734@TOP@human_GAPDH_TAA_len41_fa0_ta20_fm6_tm14,c
2734@TOP@human_GAPDH_TAA_len41_fa0_ta20_fm6_tm14*129*c,0,2304,0,0,2304,0.0,129,2734@TOP@human_GAPDH_TAA_len41_fa0_ta20_fm6_tm14,c
2734@TOP@human_GAPDH_TAA_len41_fa0_ta20_fm6_tm14*130*c,0,2330,0,0,2330,0.0,130,2734@TOP@human_GAPDH_TAA_len41_fa0_ta20_fm6_tm14,c
2734@TOP@human_GAPDH_TAA_len41_fa0_ta20_fm6_tm14*131*c,1,2329,0,0,2330,0.0,131,2734@TOP@human_GAPDH_TAA_len41_fa0_ta20_fm6_tm14,c
2734@TOP@human_GAPDH_TAA_len41_fa0_ta20_fm6_tm14*132*t,0,0,0,2286,2286,0.0,132,2734@TOP@human_GAPDH_TAA_len41_fa0_ta20_fm6_tm14,t
2734@TOP@human_GAPDH_TAA_len41_fa0_ta20_fm6_tm14*133*g,0,0,2283,0,2283,1.0,133,2734@TOP@human_GAPDH_TAA_len41_fa0_ta20_fm6_tm14,g
2734@TOP@human_GAPDH_TAA_len41_fa0_ta20_fm6_tm14*134*g,1,0,2297,0,2298,1.0,134,2734@TOP@human_GAPDH_TAA_len41_fa0_ta20_fm6_tm14,g
2735@TOP@human_GAPDH_TAA_len41_fa0_ta20_fm6_tm14*114*t,0,1,0,2446,2447,0.0,114,2735@TOP@human_GAPDH_TAA_len41_fa0_ta20_fm6_tm14,t
2735@TOP@human_GAPDH_TAA_len41_fa0_ta20_fm6_tm14*115*c,0,2459,0,0,2459,0.0,115,2735@TOP@human_GAPDH_TAA_len41_fa0_ta20_fm6_tm14,c
2735@TOP@human_GAPDH_TAA_len41_fa0_ta20_fm6_tm14*116*c,0,2449,0,0,2449,0.0,116,2735@TOP@human_GAPDH_TAA_len41_fa0_ta20_fm6_tm14,c
2735@TOP@human_GAPDH_TAA_len41_fa0_ta20_fm6_tm14*117*a,2448,0,5,0,2453,0.002,117,2735@TOP@human_GAPDH_TAA_len41_fa0_ta20_fm6_tm14,a
2735@TOP@human_GAPDH_TAA_len41_fa0_ta20_fm6_tm14*118*a,2375,0,62,0,2437,0.025,118,2735@TOP@human_GAPDH_TAA_len41_fa0_ta20_fm6_tm14,a
2735@TOP@human_GAPDH_TAA_len41_fa0_ta20_fm6_tm14*119*g,0,0,2434,0,2434,1.0,119,2735@TOP@human_GAPDH_TAA_len41_fa0_ta20_fm6_tm14,g
2735@TOP@human_GAPDH_TAA_len41_fa0_ta20_fm6_tm14*120*g,0,0,2425,0,2425,1.0,120,2735@TOP@human_GAPDH_TAA_len41_fa0_ta20_fm6_tm14,g
2735@TOP@human_GAPDH_TAA_len41_fa0_ta20_fm6_tm14*121*a,2446,0,1,0,2447,0.0,121,2735@TOP@human_GAPDH_TAA_len41_fa0_ta20_fm6_tm14,a
2735@TOP@human_GAPDH_TAA_len41_fa0_ta20_fm6_tm14*122*g,0,0,2452,0,2452,1.0,122,2735@TOP@human_GAPDH_TAA_len41_fa0_ta20_fm6_tm14,g
2735@TOP@human_GAPDH_TAA_len41_fa0_ta20_fm6_tm14*123*t,0,0,1,2423,2424,0.0,123,2735@TOP@human_GAPDH_TAA_len41_fa0_ta20_fm6_tm14,t
2735@TOP@human_GAPDH_TAA_len41_fa0_ta20_fm6_tm14*124*a,1470,0,954,0,2424,0.394,124,2735@TOP@human_GAPDH_TAA_len41_fa0_ta20_fm6_tm14,a
2735@TOP@human_GAPDH_TAA_len41_fa0_ta20_fm6_tm14*125*a,1404,1,1007,0,2412,0.417,125,2735@TOP@human_GAPDH_TAA_len41_fa0_ta20_fm6_tm14,a
2735@TOP@human_GAPDH_TAA_len41_fa0_ta20_fm6_tm14*126*g,0,0,2434,1,2435,1.0,126,2735@TOP@human_GAPDH_TAA_len41_fa0_ta20_fm6_tm14,g
2735@TOP@human_GAPDH_TAA_len41_fa0_ta20_fm6_tm14*127*a,2429,0,14,0,2443,0.006,127,2735@TOP@human_GAPDH_TAA_len41_fa0_ta20_fm6_tm14,a
2735@TOP@human_GAPDH_TAA_len41_fa0_ta20_fm6_tm14*128*c,0,2449,0,0,2449,0.0,128,2735@TOP@human_GAPDH_TAA_len41_fa0_ta20_fm6_tm14,c
2735@TOP@human_GAPDH_TAA_len41_fa0_ta20_fm6_tm14*129*c,0,2442,0,0,2442,0.0,129,2735@TOP@human_GAPDH_TAA_len41_fa0_ta20_fm6_tm14,c
2735@TOP@human_GAPDH_TAA_len41_fa0_ta20_fm6_tm14*130*c,0,2455,0,0,2455,0.0,130,2735@TOP@human_GAPDH_TAA_len41_fa0_ta20_fm6_tm14,c
2735@TOP@human_GAPDH_TAA_len41_fa0_ta20_fm6_tm14*131*c,0,2460,0,0,2460,0.0,131,2735@TOP@human_GAPDH_TAA_len41_fa0_ta20_fm6_tm14,c
2735@TOP@human_GAPDH_TAA_len41_fa0_ta20_fm6_tm14*132*t,0,0,0,2432,2432,0.0,132,2735@TOP@human_GAPDH_TAA_len41_fa0_ta20_fm6_tm14,t
2735@TOP@human_GAPDH_TAA_len41_fa0_ta20_fm6_tm14*133*g,0,0,2428,0,2428,1.0,133,2735@TOP@human_GAPDH_TAA_len41_fa0_ta20_fm6_tm14,g
2735@TOP@human_GAPDH_TAA_len41_fa0_ta20_fm6_tm14*134*g,0,0,2427,0,2427,1.0,134,2735@TOP@human_GAPDH_TAA_len41_fa0_ta20_fm6_tm14,g
2736@TOP@human_GAPDH_TAA_len41_fa0_ta20_fm6_tm14*114*t,0,2,0,2643,2645,0.0,114,2736@TOP@human_GAPDH_TAA_len41_fa0_ta20_fm6_tm14,t
2736@TOP@human_GAPDH_TAA_len41_fa0_ta20_fm6_tm14*115*c,0,2654,0,0,2654,0.0,115,2736@TOP@human_GAPDH_TAA_len41_fa0_ta20_fm6_tm14,c
2736@TOP@human_GAPDH_TAA_len41_fa0_ta20_fm6_tm14*116*c,0,2639,0,1,2640,0.0,116,2736@TOP@human_GAPDH_TAA_len41_fa0_ta20_fm6_tm14,c
2736@TOP@human_GAPDH_TAA_len41_fa0_ta20_fm6_tm14*117*a,2639,0,1,0,2640,0.0,117,2736@TOP@human_GAPDH_TAA_len41_fa0_ta20_fm6_tm14,a
2736@TOP@human_GAPDH_TAA_len41_fa0_ta20_fm6_tm14*118*a,2573,0,50,0,2623,0.019,118,2736@TOP@human_GAPDH_TAA_len41_fa0_ta20_fm6_tm14,a
2736@TOP@human_GAPDH_TAA_len41_fa0_ta20_fm6_tm14*119*g,0,0,2621,1,2622,1.0,119,2736@TOP@human_GAPDH_TAA_len41_fa0_ta20_fm6_tm14,g
2736@TOP@human_GAPDH_TAA_len41_fa0_ta20_fm6_tm14*120*g,1,0,2621,0,2622,1.0,120,2736@TOP@human_GAPDH_TAA_len41_fa0_ta20_fm6_tm14,g
2736@TOP@human_GAPDH_TAA_len41_fa0_ta20_fm6_tm14*121*a,2637,0,3,0,2640,0.001,121,2736@TOP@human_GAPDH_TAA_len41_fa0_ta20_fm6_tm14,a
2736@TOP@human_GAPDH_TAA_len41_fa0_ta20_fm6_tm14*122*g,0,0,2646,0,2646,1.0,122,2736@TOP@human_GAPDH_TAA_len41_fa0_ta20_fm6_tm14,g
2736@TOP@human_GAPDH_TAA_len41_fa0_ta20_fm6_tm14*123*t,0,0,1,2600,2601,0.0,123,2736@TOP@human_GAPDH_TAA_len41_fa0_ta20_fm6_tm14,t
2736@TOP@human_GAPDH_TAA_len41_fa0_ta20_fm6_tm14*124*a,1558,0,1053,0,2611,0.403,124,2736@TOP@human_GAPDH_TAA_len41_fa0_ta20_fm6_tm14,a
2736@TOP@human_GAPDH_TAA_len41_fa0_ta20_fm6_tm14*125*a,1996,1,604,0,2601,0.232,125,2736@TOP@human_GAPDH_TAA_len41_fa0_ta20_fm6_tm14,a
2736@TOP@human_GAPDH_TAA_len41_fa0_ta20_fm6_tm14*126*g,0,0,2615,0,2615,1.0,126,2736@TOP@human_GAPDH_TAA_len41_fa0_ta20_fm6_tm14,g
2736@TOP@human_GAPDH_TAA_len41_fa0_ta20_fm6_tm14*127*a,2630,0,6,0,2636,0.002,127,2736@TOP@human_GAPDH_TAA_len41_fa0_ta20_fm6_tm14,a
2736@TOP@human_GAPDH_TAA_len41_fa0_ta20_fm6_tm14*128*c,0,2642,0,0,2642,0.0,128,2736@TOP@human_GAPDH_TAA_len41_fa0_ta20_fm6_tm14,c
2736@TOP@human_GAPDH_TAA_len41_fa0_ta20_fm6_tm14*129*c,0,2631,0,0,2631,0.0,129,2736@TOP@human_GAPDH_TAA_len41_fa0_ta20_fm6_tm14,c
2736@TOP@human_GAPDH_TAA_len41_fa0_ta20_fm6_tm14*130*c,0,2645,0,0,2645,0.0,130,2736@TOP@human_GAPDH_TAA_len41_fa0_ta20_fm6_tm14,c
2736@TOP@human_GAPDH_TAA_len41_fa0_ta20_fm6_tm14*131*c,0,2649,0,0,2649,0.0,131,2736@TOP@human_GAPDH_TAA_len41_fa0_ta20_fm6_tm14,c
2736@TOP@human_GAPDH_TAA_len41_fa0_ta20_fm6_tm14*132*t,0,0,0,2620,2620,0.0,132,2736@TOP@human_GAPDH_TAA_len41_fa0_ta20_fm6_tm14,t
2736@TOP@human_GAPDH_TAA_len41_fa0_ta20_fm6_tm14*133*g,0,0,2605,0,2605,1.0,133,2736@TOP@human_GAPDH_TAA_len41_fa0_ta20_fm6_tm14,g
2736@TOP@human_GAPDH_TAA_len41_fa0_ta20_fm6_tm14*134*g,0,0,2624,0,2624,1.0,134,2736@TOP@human_GAPDH_TAA_len41_fa0_ta20_fm6_tm14,g
2737@TOP@human_GAPDH_TAA_len41_fa0_ta20_fm6_tm14*114*t,0,0,0,1088,1088,0.0,114,2737@TOP@human_GAPDH_TAA_len41_fa0_ta20_fm6_tm14,t
2737@TOP@human_GAPDH_TAA_len41_fa0_ta20_fm6_tm14*115*c,0,1089,0,0,1089,0.0,115,2737@TOP@human_GAPDH_TAA_len41_fa0_ta20_fm6_tm14,c
2737@TOP@human_GAPDH_TAA_len41_fa0_ta20_fm6_tm14*116*c,0,1087,0,0,1087,0.0,116,2737@TOP@human_GAPDH_TAA_len41_fa0_ta20_fm6_tm14,c
2737@TOP@human_GAPDH_TAA_len41_fa0_ta20_fm6_tm14*117*a,1083,0,4,0,1087,0.004,117,2737@TOP@human_GAPDH_TAA_len41_fa0_ta20_fm6_tm14,a
2737@TOP@human_GAPDH_TAA_len41_fa0_ta20_fm6_tm14*118*a,1069,0,14,0,1083,0.013,118,2737@TOP@human_GAPDH_TAA_len41_fa0_ta20_fm6_tm14,a
2737@TOP@human_GAPDH_TAA_len41_fa0_ta20_fm6_tm14*119*g,0,0,1081,0,1081,1.0,119,2737@TOP@human_GAPDH_TAA_len41_fa0_ta20_fm6_tm14,g
2737@TOP@human_GAPDH_TAA_len41_fa0_ta20_fm6_tm14*120*g,0,0,1078,0,1078,1.0,120,2737@TOP@human_GAPDH_TAA_len41_fa0_ta20_fm6_tm14,g
2737@TOP@human_GAPDH_TAA_len41_fa0_ta20_fm6_tm14*121*a,1086,0,0,0,1086,0.0,121,2737@TOP@human_GAPDH_TAA_len41_fa0_ta20_fm6_tm14,a
2737@TOP@human_GAPDH_TAA_len41_fa0_ta20_fm6_tm14*122*g,0,0,1086,0,1086,1.0,122,2737@TOP@human_GAPDH_TAA_len41_fa0_ta20_fm6_tm14,g
2737@TOP@human_GAPDH_TAA_len41_fa0_ta20_fm6_tm14*123*t,0,0,0,1071,1071,0.0,123,2737@TOP@human_GAPDH_TAA_len41_fa0_ta20_fm6_tm14,t
2737@TOP@human_GAPDH_TAA_len41_fa0_ta20_fm6_tm14*124*a,694,0,384,0,1078,0.356,124,2737@TOP@human_GAPDH_TAA_len41_fa0_ta20_fm6_tm14,a
2737@TOP@human_GAPDH_TAA_len41_fa0_ta20_fm6_tm14*125*a,709,0,356,0,1065,0.334,125,2737@TOP@human_GAPDH_TAA_len41_fa0_ta20_fm6_tm14,a
2737@TOP@human_GAPDH_TAA_len41_fa0_ta20_fm6_tm14*126*g,0,2,1073,0,1075,0.998,126,2737@TOP@human_GAPDH_TAA_len41_fa0_ta20_fm6_tm14,g
2737@TOP@human_GAPDH_TAA_len41_fa0_ta20_fm6_tm14*127*a,1073,0,10,0,1083,0.009,127,2737@TOP@human_GAPDH_TAA_len41_fa0_ta20_fm6_tm14,a
2737@TOP@human_GAPDH_TAA_len41_fa0_ta20_fm6_tm14*128*c,0,1089,0,0,1089,0.0,128,2737@TOP@human_GAPDH_TAA_len41_fa0_ta20_fm6_tm14,c
2737@TOP@human_GAPDH_TAA_len41_fa0_ta20_fm6_tm14*129*c,0,1083,0,0,1083,0.0,129,2737@TOP@human_GAPDH_TAA_len41_fa0_ta20_fm6_tm14,c
2737@TOP@human_GAPDH_TAA_len41_fa0_ta20_fm6_tm14*130*c,0,1089,0,0,1089,0.0,130,2737@TOP@human_GAPDH_TAA_len41_fa0_ta20_fm6_tm14,c
2737@TOP@human_GAPDH_TAA_len41_fa0_ta20_fm6_tm14*131*c,0,1088,0,0,1088,0.0,131,2737@TOP@human_GAPDH_TAA_len41_fa0_ta20_fm6_tm14,c
2737@TOP@human_GAPDH_TAA_len41_fa0_ta20_fm6_tm14*132*t,0,0,0,1076,1076,0.0,132,2737@TOP@human_GAPDH_TAA_len41_fa0_ta20_fm6_tm14,t
2737@TOP@human_GAPDH_TAA_len41_fa0_ta20_fm6_tm14*133*g,0,0,1075,0,1075,1.0,133,2737@TOP@human_GAPDH_TAA_len41_fa0_ta20_fm6_tm14,g
2737@TOP@human_GAPDH_TAA_len41_fa0_ta20_fm6_tm14*134*g,0,0,1079,0,1079,1.0,134,2737@TOP@human_GAPDH_TAA_len41_fa0_ta20_fm6_tm14,g
2738@TOP@human_GAPDH_TAA_len41_fa0_ta20_fm6_tm14*114*t,0,0,0,1075,1075,0.0,114,2738@TOP@human_GAPDH_TAA_len41_fa0_ta20_fm6_tm14,t
2738@TOP@human_GAPDH_TAA_len41_fa0_ta20_fm6_tm14*115*c,0,1081,0,0,1081,0.0,115,2738@TOP@human_GAPDH_TAA_len41_fa0_ta20_fm6_tm14,c
2738@TOP@human_GAPDH_TAA_len41_fa0_ta20_fm6_tm14*116*c,0,1078,0,0,1078,0.0,116,2738@TOP@human_GAPDH_TAA_len41_fa0_ta20_fm6_tm14,c
2738@TOP@human_GAPDH_TAA_len41_fa0_ta20_fm6_tm14*117*a,1073,0,1,0,1074,0.001,117,2738@TOP@human_GAPDH_TAA_len41_fa0_ta20_fm6_tm14,a
2738@TOP@human_GAPDH_TAA_len41_fa0_ta20_fm6_tm14*118*a,1050,0,16,0,1066,0.015,118,2738@TOP@human_GAPDH_TAA_len41_fa0_ta20_fm6_tm14,a
2738@TOP@human_GAPDH_TAA_len41_fa0_ta20_fm6_tm14*119*g,0,0,1066,0,1066,1.0,119,2738@TOP@human_GAPDH_TAA_len41_fa0_ta20_fm6_tm14,g
2738@TOP@human_GAPDH_TAA_len41_fa0_ta20_fm6_tm14*120*g,0,0,1064,0,1064,1.0,120,2738@TOP@human_GAPDH_TAA_len41_fa0_ta20_fm6_tm14,g
2738@TOP@human_GAPDH_TAA_len41_fa0_ta20_fm6_tm14*121*a,1079,0,0,0,1079,0.0,121,2738@TOP@human_GAPDH_TAA_len41_fa0_ta20_fm6_tm14,a
2738@TOP@human_GAPDH_TAA_len41_fa0_ta20_fm6_tm14*122*g,0,0,1077,0,1077,1.0,122,2738@TOP@human_GAPDH_TAA_len41_fa0_ta20_fm6_tm14,g
2738@TOP@human_GAPDH_TAA_len41_fa0_ta20_fm6_tm14*123*t,0,0,0,1065,1065,0.0,123,2738@TOP@human_GAPDH_TAA_len41_fa0_ta20_fm6_tm14,t
2738@TOP@human_GAPDH_TAA_len41_fa0_ta20_fm6_tm14*124*a,897,0,162,0,1059,0.153,124,2738@TOP@human_GAPDH_TAA_len41_fa0_ta20_fm6_tm14,a
2738@TOP@human_GAPDH_TAA_len41_fa0_ta20_fm6_tm14*125*a,930,0,127,0,1057,0.12,125,2738@TOP@human_GAPDH_TAA_len41_fa0_ta20_fm6_tm14,a
2738@TOP@human_GAPDH_TAA_len41_fa0_ta20_fm6_tm14*126*g,0,0,1063,0,1063,1.0,126,2738@TOP@human_GAPDH_TAA_len41_fa0_ta20_fm6_tm14,g
2738@TOP@human_GAPDH_TAA_len41_fa0_ta20_fm6_tm14*127*a,1070,0,2,0,1072,0.002,127,2738@TOP@human_GAPDH_TAA_len41_fa0_ta20_fm6_tm14,a
2738@TOP@human_GAPDH_TAA_len41_fa0_ta20_fm6_tm14*128*c,0,1080,0,0,1080,0.0,128,2738@TOP@human_GAPDH_TAA_len41_fa0_ta20_fm6_tm14,c
2738@TOP@human_GAPDH_TAA_len41_fa0_ta20_fm6_tm14*129*c,0,1072,0,0,1072,0.0,129,2738@TOP@human_GAPDH_TAA_len41_fa0_ta20_fm6_tm14,c
2738@TOP@human_GAPDH_TAA_len41_fa0_ta20_fm6_tm14*130*c,0,1079,0,0,1079,0.0,130,2738@TOP@human_GAPDH_TAA_len41_fa0_ta20_fm6_tm14,c
2738@TOP@human_GAPDH_TAA_len41_fa0_ta20_fm6_tm14*131*c,0,1079,0,0,1079,0.0,131,2738@TOP@human_GAPDH_TAA_len41_fa0_ta20_fm6_tm14,c
2738@TOP@human_GAPDH_TAA_len41_fa0_ta20_fm6_tm14*132*t,0,0,0,1060,1060,0.0,132,2738@TOP@human_GAPDH_TAA_len41_fa0_ta20_fm6_tm14,t
2738@TOP@human_GAPDH_TAA_len41_fa0_ta20_fm6_tm14*133*g,0,0,1053,0,1053,1.0,133,2738@TOP@human_GAPDH_TAA_len41_fa0_ta20_fm6_tm14,g
2738@TOP@human_GAPDH_TAA_len41_fa0_ta20_fm6_tm14*134*g,0,0,1064,0,1064,1.0,134,2738@TOP@human_GAPDH_TAA_len41_fa0_ta20_fm6_tm14,g
2739@TOP@human_GAPDH_TAA_len41_fa0_ta20_fm6_tm14*114*t,0,1,0,8904,8905,0.0,114,2739@TOP@human_GAPDH_TAA_len41_fa0_ta20_fm6_tm14,t
2739@TOP@human_GAPDH_TAA_len41_fa0_ta20_fm6_tm14*115*c,0,8956,0,0,8956,0.0,115,2739@TOP@human_GAPDH_TAA_len41_fa0_ta20_fm6_tm14,c
2739@TOP@human_GAPDH_TAA_len41_fa0_ta20_fm6_tm14*116*c,0,8915,1,0,8916,0.0,116,2739@TOP@human_GAPDH_TAA_len41_fa0_ta20_fm6_tm14,c
2739@TOP@human_GAPDH_TAA_len41_fa0_ta20_fm6_tm14*117*a,8906,0,7,0,8913,0.001,117,2739@TOP@human_GAPDH_TAA_len41_fa0_ta20_fm6_tm14,a
2739@TOP@human_GAPDH_TAA_len41_fa0_ta20_fm6_tm14*118*a,8767,1,101,0,8869,0.011,118,2739@TOP@human_GAPDH_TAA_len41_fa0_ta20_fm6_tm14,a
2739@TOP@human_GAPDH_TAA_len41_fa0_ta20_fm6_tm14*119*g,0,1,8858,0,8859,1.0,119,2739@TOP@human_GAPDH_TAA_len41_fa0_ta20_fm6_tm14,g
2739@TOP@human_GAPDH_TAA_len41_fa0_ta20_fm6_tm14*120*g,0,0,8818,0,8818,1.0,120,2739@TOP@human_GAPDH_TAA_len41_fa0_ta20_fm6_tm14,g
2739@TOP@human_GAPDH_TAA_len41_fa0_ta20_fm6_tm14*121*a,8911,0,2,0,8913,0.0,121,2739@TOP@human_GAPDH_TAA_len41_fa0_ta20_fm6_tm14,a
2739@TOP@human_GAPDH_TAA_len41_fa0_ta20_fm6_tm14*122*g,1,0,8924,0,8925,1.0,122,2739@TOP@human_GAPDH_TAA_len41_fa0_ta20_fm6_tm14,g
2739@TOP@human_GAPDH_TAA_len41_fa0_ta20_fm6_tm14*123*t,2,1,0,8829,8832,0.0,123,2739@TOP@human_GAPDH_TAA_len41_fa0_ta20_fm6_tm14,t
2739@TOP@human_GAPDH_TAA_len41_fa0_ta20_fm6_tm14*124*a,8538,1,248,0,8787,0.028,124,2739@TOP@human_GAPDH_TAA_len41_fa0_ta20_fm6_tm14,a
2739@TOP@human_GAPDH_TAA_len41_fa0_ta20_fm6_tm14*125*a,8635,0,124,1,8760,0.014,125,2739@TOP@human_GAPDH_TAA_len41_fa0_ta20_fm6_tm14,a
2739@TOP@human_GAPDH_TAA_len41_fa0_ta20_fm6_tm14*126*g,0,0,8822,1,8823,1.0,126,2739@TOP@human_GAPDH_TAA_len41_fa0_ta20_fm6_tm14,g
2739@TOP@human_GAPDH_TAA_len41_fa0_ta20_fm6_tm14*127*a,8876,0,9,0,8885,0.001,127,2739@TOP@human_GAPDH_TAA_len41_fa0_ta20_fm6_tm14,a
2739@TOP@human_GAPDH_TAA_len41_fa0_ta20_fm6_tm14*128*c,0,8938,0,1,8939,0.0,128,2739@TOP@human_GAPDH_TAA_len41_fa0_ta20_fm6_tm14,c
2739@TOP@human_GAPDH_TAA_len41_fa0_ta20_fm6_tm14*129*c,1,8892,0,2,8895,0.0,129,2739@TOP@human_GAPDH_TAA_len41_fa0_ta20_fm6_tm14,c
2739@TOP@human_GAPDH_TAA_len41_fa0_ta20_fm6_tm14*130*c,0,8922,0,2,8924,0.0,130,2739@TOP@human_GAPDH_TAA_len41_fa0_ta20_fm6_tm14,c
2739@TOP@human_GAPDH_TAA_len41_fa0_ta20_fm6_tm14*131*c,0,8932,0,0,8932,0.0,131,2739@TOP@human_GAPDH_TAA_len41_fa0_ta20_fm6_tm14,c
2739@TOP@human_GAPDH_TAA_len41_fa0_ta20_fm6_tm14*132*t,0,1,0,8818,8819,0.0,132,2739@TOP@human_GAPDH_TAA_len41_fa0_ta20_fm6_tm14,t
2739@TOP@human_GAPDH_TAA_len41_fa0_ta20_fm6_tm14*133*g,1,0,8792,1,8794,1.0,133,2739@TOP@human_GAPDH_TAA_len41_fa0_ta20_fm6_tm14,g
2739@TOP@human_GAPDH_TAA_len41_fa0_ta20_fm6_tm14*134*g,1,0,8850,1,8852,1.0,134,2739@TOP@human_GAPDH_TAA_len41_fa0_ta20_fm6_tm14,g
2740@TOP@human_GAPDH_TAA_len41_fa0_ta20_fm6_tm14*114*t,2,2,0,9260,9264,0.0,114,2740@TOP@human_GAPDH_TAA_len41_fa0_ta20_fm6_tm14,t
2740@TOP@human_GAPDH_TAA_len41_fa0_ta20_fm6_tm14*115*c,0,9326,0,1,9327,0.0,115,2740@TOP@human_GAPDH_TAA_len41_fa0_ta20_fm6_tm14,c
2740@TOP@human_GAPDH_TAA_len41_fa0_ta20_fm6_tm14*116*c,0,9289,0,1,9290,0.0,116,2740@TOP@human_GAPDH_TAA_len41_fa0_ta20_fm6_tm14,c
2740@TOP@human_GAPDH_TAA_len41_fa0_ta20_fm6_tm14*117*a,9285,0,15,0,9300,0.002,117,2740@TOP@human_GAPDH_TAA_len41_fa0_ta20_fm6_tm14,a
2740@TOP@human_GAPDH_TAA_len41_fa0_ta20_fm6_tm14*118*a,9119,1,96,1,9217,0.01,118,2740@TOP@human_GAPDH_TAA_len41_fa0_ta20_fm6_tm14,a
2740@TOP@human_GAPDH_TAA_len41_fa0_ta20_fm6_tm14*119*g,1,0,9191,0,9192,1.0,119,2740@TOP@human_GAPDH_TAA_len41_fa0_ta20_fm6_tm14,g
2740@TOP@human_GAPDH_TAA_len41_fa0_ta20_fm6_tm14*120*g,0,0,9171,0,9171,1.0,120,2740@TOP@human_GAPDH_TAA_len41_fa0_ta20_fm6_tm14,g
2740@TOP@human_GAPDH_TAA_len41_fa0_ta20_fm6_tm14*121*a,9280,0,2,0,9282,0.0,121,2740@TOP@human_GAPDH_TAA_len41_fa0_ta20_fm6_tm14,a
2740@TOP@human_GAPDH_TAA_len41_fa0_ta20_fm6_tm14*122*g,3,0,9283,0,9286,1.0,122,2740@TOP@human_GAPDH_TAA_len41_fa0_ta20_fm6_tm14,g
2740@TOP@human_GAPDH_TAA_len41_fa0_ta20_fm6_tm14*123*t,4,2,2,9141,9149,0.0,123,2740@TOP@human_GAPDH_TAA_len41_fa0_ta20_fm6_tm14,t
2740@TOP@human_GAPDH_TAA_len41_fa0_ta20_fm6_tm14*124*a,8860,1,300,0,9161,0.033,124,2740@TOP@human_GAPDH_TAA_len41_fa0_ta20_fm6_tm14,a
2740@TOP@human_GAPDH_TAA_len41_fa0_ta20_fm6_tm14*125*a,8947,1,175,0,9123,0.019,125,2740@TOP@human_GAPDH_TAA_len41_fa0_ta20_fm6_tm14,a
2740@TOP@human_GAPDH_TAA_len41_fa0_ta20_fm6_tm14*126*g,0,0,9157,0,9157,1.0,126,2740@TOP@human_GAPDH_TAA_len41_fa0_ta20_fm6_tm14,g
2740@TOP@human_GAPDH_TAA_len41_fa0_ta20_fm6_tm14*127*a,9246,0,16,0,9262,0.002,127,2740@TOP@human_GAPDH_TAA_len41_fa0_ta20_fm6_tm14,a
2740@TOP@human_GAPDH_TAA_len41_fa0_ta20_fm6_tm14*128*c,0,9307,0,1,9308,0.0,128,2740@TOP@human_GAPDH_TAA_len41_fa0_ta20_fm6_tm14,c
2740@TOP@human_GAPDH_TAA_len41_fa0_ta20_fm6_tm14*129*c,1,9234,0,0,9235,0.0,129,2740@TOP@human_GAPDH_TAA_len41_fa0_ta20_fm6_tm14,c
2740@TOP@human_GAPDH_TAA_len41_fa0_ta20_fm6_tm14*130*c,0,9285,0,3,9288,0.0,130,2740@TOP@human_GAPDH_TAA_len41_fa0_ta20_fm6_tm14,c
2740@TOP@human_GAPDH_TAA_len41_fa0_ta20_fm6_tm14*131*c,3,9307,0,0,9310,0.0,131,2740@TOP@human_GAPDH_TAA_len41_fa0_ta20_fm6_tm14,c
2740@TOP@human_GAPDH_TAA_len41_fa0_ta20_fm6_tm14*132*t,1,1,0,9174,9176,0.0,132,2740@TOP@human_GAPDH_TAA_len41_fa0_ta20_fm6_tm14,t
2740@TOP@human_GAPDH_TAA_len41_fa0_ta20_fm6_tm14*133*g,0,0,9148,0,9148,1.0,133,2740@TOP@human_GAPDH_TAA_len41_fa0_ta20_fm6_tm14,g
2740@TOP@human_GAPDH_TAA_len41_fa0_ta20_fm6_tm14*134*g,1,5,9205,0,9211,0.999,134,2740@TOP@human_GAPDH_TAA_len41_fa0_ta20_fm6_tm14,g
2741@TOP@human_GAPDH_TAA_len41_fa0_ta20_fm6_tm14*114*t,0,0,0,3085,3085,0.0,114,2741@TOP@human_GAPDH_TAA_len41_fa0_ta20_fm6_tm14,t
2741@TOP@human_GAPDH_TAA_len41_fa0_ta20_fm6_tm14*115*c,0,3099,0,0,3099,0.0,115,2741@TOP@human_GAPDH_TAA_len41_fa0_ta20_fm6_tm14,c
2741@TOP@human_GAPDH_TAA_len41_fa0_ta20_fm6_tm14*116*c,1,3092,0,0,3093,0.0,116,2741@TOP@human_GAPDH_TAA_len41_fa0_ta20_fm6_tm14,c
2741@TOP@human_GAPDH_TAA_len41_fa0_ta20_fm6_tm14*117*a,3063,0,13,0,3076,0.004,117,2741@TOP@human_GAPDH_TAA_len41_fa0_ta20_fm6_tm14,a
2741@TOP@human_GAPDH_TAA_len41_fa0_ta20_fm6_tm14*118*a,2984,0,70,0,3054,0.023,118,2741@TOP@human_GAPDH_TAA_len41_fa0_ta20_fm6_tm14,a
2741@TOP@human_GAPDH_TAA_len41_fa0_ta20_fm6_tm14*119*g,0,0,3064,0,3064,1.0,119,2741@TOP@human_GAPDH_TAA_len41_fa0_ta20_fm6_tm14,g
2741@TOP@human_GAPDH_TAA_len41_fa0_ta20_fm6_tm14*120*g,0,0,3052,0,3052,1.0,120,2741@TOP@human_GAPDH_TAA_len41_fa0_ta20_fm6_tm14,g
2741@TOP@human_GAPDH_TAA_len41_fa0_ta20_fm6_tm14*121*a,3079,0,6,0,3085,0.002,121,2741@TOP@human_GAPDH_TAA_len41_fa0_ta20_fm6_tm14,a
2741@TOP@human_GAPDH_TAA_len41_fa0_ta20_fm6_tm14*122*g,0,0,3087,0,3087,1.0,122,2741@TOP@human_GAPDH_TAA_len41_fa0_ta20_fm6_tm14,g
2741@TOP@human_GAPDH_TAA_len41_fa0_ta20_fm6_tm14*123*t,0,0,1,3047,3048,0.0,123,2741@TOP@human_GAPDH_TAA_len41_fa0_ta20_fm6_tm14,t
2741@TOP@human_GAPDH_TAA_len41_fa0_ta20_fm6_tm14*124*a,1645,0,1405,0,3050,0.461,124,2741@TOP@human_GAPDH_TAA_len41_fa0_ta20_fm6_tm14,a
2741@TOP@human_GAPDH_TAA_len41_fa0_ta20_fm6_tm14*125*a,1520,0,1520,0,3040,0.5,125,2741@TOP@human_GAPDH_TAA_len41_fa0_ta20_fm6_tm14,a
2741@TOP@human_GAPDH_TAA_len41_fa0_ta20_fm6_tm14*126*g,0,0,3053,1,3054,1.0,126,2741@TOP@human_GAPDH_TAA_len41_fa0_ta20_fm6_tm14,g
2741@TOP@human_GAPDH_TAA_len41_fa0_ta20_fm6_tm14*127*a,3049,0,32,0,3081,0.01,127,2741@TOP@human_GAPDH_TAA_len41_fa0_ta20_fm6_tm14,a
2741@TOP@human_GAPDH_TAA_len41_fa0_ta20_fm6_tm14*128*c,0,3094,0,0,3094,0.0,128,2741@TOP@human_GAPDH_TAA_len41_fa0_ta20_fm6_tm14,c
2741@TOP@human_GAPDH_TAA_len41_fa0_ta20_fm6_tm14*129*c,0,3072,0,0,3072,0.0,129,2741@TOP@human_GAPDH_TAA_len41_fa0_ta20_fm6_tm14,c
2741@TOP@human_GAPDH_TAA_len41_fa0_ta20_fm6_tm14*130*c,0,3087,0,1,3088,0.0,130,2741@TOP@human_GAPDH_TAA_len41_fa0_ta20_fm6_tm14,c
2741@TOP@human_GAPDH_TAA_len41_fa0_ta20_fm6_tm14*131*c,1,3098,0,0,3099,0.0,131,2741@TOP@human_GAPDH_TAA_len41_fa0_ta20_fm6_tm14,c
2741@TOP@human_GAPDH_TAA_len41_fa0_ta20_fm6_tm14*132*t,1,3,2,3047,3053,0.001,132,2741@TOP@human_GAPDH_TAA_len41_fa0_ta20_fm6_tm14,t
2741@TOP@human_GAPDH_TAA_len41_fa0_ta20_fm6_tm14*133*g,0,0,3052,0,3052,1.0,133,2741@TOP@human_GAPDH_TAA_len41_fa0_ta20_fm6_tm14,g
2741@TOP@human_GAPDH_TAA_len41_fa0_ta20_fm6_tm14*134*g,0,0,3052,2,3054,0.999,134,2741@TOP@human_GAPDH_TAA_len41_fa0_ta20_fm6_tm14,g
2742@TOP@human_GAPDH_TAA_len41_fa0_ta20_fm6_tm14*114*t,0,3,0,8465,8468,0.0,114,2742@TOP@human_GAPDH_TAA_len41_fa0_ta20_fm6_tm14,t
2742@TOP@human_GAPDH_TAA_len41_fa0_ta20_fm6_tm14*115*c,0,8513,0,0,8513,0.0,115,2742@TOP@human_GAPDH_TAA_len41_fa0_ta20_fm6_tm14,c
2742@TOP@human_GAPDH_TAA_len41_fa0_ta20_fm6_tm14*116*c,0,8478,0,0,8478,0.0,116,2742@TOP@human_GAPDH_TAA_len41_fa0_ta20_fm6_tm14,c
2742@TOP@human_GAPDH_TAA_len41_fa0_ta20_fm6_tm14*117*a,8450,0,10,0,8460,0.001,117,2742@TOP@human_GAPDH_TAA_len41_fa0_ta20_fm6_tm14,a
2742@TOP@human_GAPDH_TAA_len41_fa0_ta20_fm6_tm14*118*a,8305,1,112,0,8418,0.013,118,2742@TOP@human_GAPDH_TAA_len41_fa0_ta20_fm6_tm14,a
2742@TOP@human_GAPDH_TAA_len41_fa0_ta20_fm6_tm14*119*g,0,1,8401,0,8402,1.0,119,2742@TOP@human_GAPDH_TAA_len41_fa0_ta20_fm6_tm14,g
2742@TOP@human_GAPDH_TAA_len41_fa0_ta20_fm6_tm14*120*g,1,0,8359,0,8360,1.0,120,2742@TOP@human_GAPDH_TAA_len41_fa0_ta20_fm6_tm14,g
2742@TOP@human_GAPDH_TAA_len41_fa0_ta20_fm6_tm14*121*a,8477,0,0,0,8477,0.0,121,2742@TOP@human_GAPDH_TAA_len41_fa0_ta20_fm6_tm14,a
2742@TOP@human_GAPDH_TAA_len41_fa0_ta20_fm6_tm14*122*g,0,0,8478,0,8478,1.0,122,2742@TOP@human_GAPDH_TAA_len41_fa0_ta20_fm6_tm14,g
2742@TOP@human_GAPDH_TAA_len41_fa0_ta20_fm6_tm14*123*t,2,1,1,8375,8379,0.0,123,2742@TOP@human_GAPDH_TAA_len41_fa0_ta20_fm6_tm14,t
2742@TOP@human_GAPDH_TAA_len41_fa0_ta20_fm6_tm14*124*a,6382,0,1972,0,8354,0.236,124,2742@TOP@human_GAPDH_TAA_len41_fa0_ta20_fm6_tm14,a
2742@TOP@human_GAPDH_TAA_len41_fa0_ta20_fm6_tm14*125*a,7292,2,1047,0,8341,0.126,125,2742@TOP@human_GAPDH_TAA_len41_fa0_ta20_fm6_tm14,a
2742@TOP@human_GAPDH_TAA_len41_fa0_ta20_fm6_tm14*126*g,0,0,8378,0,8378,1.0,126,2742@TOP@human_GAPDH_TAA_len41_fa0_ta20_fm6_tm14,g
2742@TOP@human_GAPDH_TAA_len41_fa0_ta20_fm6_tm14*127*a,8426,0,16,0,8442,0.002,127,2742@TOP@human_GAPDH_TAA_len41_fa0_ta20_fm6_tm14,a
2742@TOP@human_GAPDH_TAA_len41_fa0_ta20_fm6_tm14*128*c,0,8488,0,2,8490,0.0,128,2742@TOP@human_GAPDH_TAA_len41_fa0_ta20_fm6_tm14,c
2742@TOP@human_GAPDH_TAA_len41_fa0_ta20_fm6_tm14*129*c,0,8421,0,1,8422,0.0,129,2742@TOP@human_GAPDH_TAA_len41_fa0_ta20_fm6_tm14,c
2742@TOP@human_GAPDH_TAA_len41_fa0_ta20_fm6_tm14*130*c,2,8466,0,1,8469,0.0,130,2742@TOP@human_GAPDH_TAA_len41_fa0_ta20_fm6_tm14,c
2742@TOP@human_GAPDH_TAA_len41_fa0_ta20_fm6_tm14*131*c,0,8502,0,1,8503,0.0,131,2742@TOP@human_GAPDH_TAA_len41_fa0_ta20_fm6_tm14,c
2742@TOP@human_GAPDH_TAA_len41_fa0_ta20_fm6_tm14*132*t,0,3,0,8395,8398,0.0,132,2742@TOP@human_GAPDH_TAA_len41_fa0_ta20_fm6_tm14,t
2742@TOP@human_GAPDH_TAA_len41_fa0_ta20_fm6_tm14*133*g,0,0,8357,0,8357,1.0,133,2742@TOP@human_GAPDH_TAA_len41_fa0_ta20_fm6_tm14,g
2742@TOP@human_GAPDH_TAA_len41_fa0_ta20_fm6_tm14*134*g,1,2,8397,0,8400,1.0,134,2742@TOP@human_GAPDH_TAA_len41_fa0_ta20_fm6_tm14,g
2743@TOP@human_GAPDH_TAA_len41_fa0_ta20_fm6_tm14*114*t,1,0,0,1755,1756,0.0,114,2743@TOP@human_GAPDH_TAA_len41_fa0_ta20_fm6_tm14,t
2743@TOP@human_GAPDH_TAA_len41_fa0_ta20_fm6_tm14*115*c,0,1768,0,0,1768,0.0,115,2743@TOP@human_GAPDH_TAA_len41_fa0_ta20_fm6_tm14,c
2743@TOP@human_GAPDH_TAA_len41_fa0_ta20_fm6_tm14*116*c,0,1759,0,0,1759,0.0,116,2743@TOP@human_GAPDH_TAA_len41_fa0_ta20_fm6_tm14,c
2743@TOP@human_GAPDH_TAA_len41_fa0_ta20_fm6_tm14*117*a,1753,0,9,0,1762,0.005,117,2743@TOP@human_GAPDH_TAA_len41_fa0_ta20_fm6_tm14,a
2743@TOP@human_GAPDH_TAA_len41_fa0_ta20_fm6_tm14*118*a,1562,0,180,0,1742,0.103,118,2743@TOP@human_GAPDH_TAA_len41_fa0_ta20_fm6_tm14,a
2743@TOP@human_GAPDH_TAA_len41_fa0_ta20_fm6_tm14*119*g,0,0,1745,0,1745,1.0,119,2743@TOP@human_GAPDH_TAA_len41_fa0_ta20_fm6_tm14,g
2743@TOP@human_GAPDH_TAA_len41_fa0_ta20_fm6_tm14*120*g,0,1,1732,0,1733,0.999,120,2743@TOP@human_GAPDH_TAA_len41_fa0_ta20_fm6_tm14,g
2743@TOP@human_GAPDH_TAA_len41_fa0_ta20_fm6_tm14*121*a,1755,0,0,0,1755,0.0,121,2743@TOP@human_GAPDH_TAA_len41_fa0_ta20_fm6_tm14,a
2743@TOP@human_GAPDH_TAA_len41_fa0_ta20_fm6_tm14*122*g,0,0,1759,0,1759,1.0,122,2743@TOP@human_GAPDH_TAA_len41_fa0_ta20_fm6_tm14,g
2743@TOP@human_GAPDH_TAA_len41_fa0_ta20_fm6_tm14*123*t,1,0,0,1728,1729,0.0,123,2743@TOP@human_GAPDH_TAA_len41_fa0_ta20_fm6_tm14,t
2743@TOP@human_GAPDH_TAA_len41_fa0_ta20_fm6_tm14*124*a,1145,0,584,0,1729,0.338,124,2743@TOP@human_GAPDH_TAA_len41_fa0_ta20_fm6_tm14,a
2743@TOP@human_GAPDH_TAA_len41_fa0_ta20_fm6_tm14*125*a,1494,0,238,0,1732,0.137,125,2743@TOP@human_GAPDH_TAA_len41_fa0_ta20_fm6_tm14,a
2743@TOP@human_GAPDH_TAA_len41_fa0_ta20_fm6_tm14*126*g,0,0,1733,0,1733,1.0,126,2743@TOP@human_GAPDH_TAA_len41_fa0_ta20_fm6_tm14,g
2743@TOP@human_GAPDH_TAA_len41_fa0_ta20_fm6_tm14*127*a,1753,0,4,0,1757,0.002,127,2743@TOP@human_GAPDH_TAA_len41_fa0_ta20_fm6_tm14,a
2743@TOP@human_GAPDH_TAA_len41_fa0_ta20_fm6_tm14*128*c,0,1761,1,1,1763,0.001,128,2743@TOP@human_GAPDH_TAA_len41_fa0_ta20_fm6_tm14,c
2743@TOP@human_GAPDH_TAA_len41_fa0_ta20_fm6_tm14*129*c,0,1749,0,3,1752,0.0,129,2743@TOP@human_GAPDH_TAA_len41_fa0_ta20_fm6_tm14,c
2743@TOP@human_GAPDH_TAA_len41_fa0_ta20_fm6_tm14*130*c,1,1754,0,0,1755,0.0,130,2743@TOP@human_GAPDH_TAA_len41_fa0_ta20_fm6_tm14,c
2743@TOP@human_GAPDH_TAA_len41_fa0_ta20_fm6_tm14*131*c,0,1764,0,0,1764,0.0,131,2743@TOP@human_GAPDH_TAA_len41_fa0_ta20_fm6_tm14,c
2743@TOP@human_GAPDH_TAA_len41_fa0_ta20_fm6_tm14*132*t,0,0,0,1741,1741,0.0,132,2743@TOP@human_GAPDH_TAA_len41_fa0_ta20_fm6_tm14,t
2743@TOP@human_GAPDH_TAA_len41_fa0_ta20_fm6_tm14*133*g,0,0,1729,0,1729,1.0,133,2743@TOP@human_GAPDH_TAA_len41_fa0_ta20_fm6_tm14,g
2743@TOP@human_GAPDH_TAA_len41_fa0_ta20_fm6_tm14*134*g,0,0,1739,0,1739,1.0,134,2743@TOP@human_GAPDH_TAA_len41_fa0_ta20_fm6_tm14,g
2744@TOP@human_GAPDH_TAA_len41_fa0_ta20_fm6_tm14*114*t,0,0,0,1052,1052,0.0,114,2744@TOP@human_GAPDH_TAA_len41_fa0_ta20_fm6_tm14,t
2744@TOP@human_GAPDH_TAA_len41_fa0_ta20_fm6_tm14*115*c,0,1055,0,0,1055,0.0,115,2744@TOP@human_GAPDH_TAA_len41_fa0_ta20_fm6_tm14,c
2744@TOP@human_GAPDH_TAA_len41_fa0_ta20_fm6_tm14*116*c,0,1048,0,0,1048,0.0,116,2744@TOP@human_GAPDH_TAA_len41_fa0_ta20_fm6_tm14,c
2744@TOP@human_GAPDH_TAA_len41_fa0_ta20_fm6_tm14*117*a,1042,0,7,0,1049,0.007,117,2744@TOP@human_GAPDH_TAA_len41_fa0_ta20_fm6_tm14,a
2744@TOP@human_GAPDH_TAA_len41_fa0_ta20_fm6_tm14*118*a,1008,0,33,1,1042,0.032,118,2744@TOP@human_GAPDH_TAA_len41_fa0_ta20_fm6_tm14,a
2744@TOP@human_GAPDH_TAA_len41_fa0_ta20_fm6_tm14*119*g,0,0,1045,0,1045,1.0,119,2744@TOP@human_GAPDH_TAA_len41_fa0_ta20_fm6_tm14,g
2744@TOP@human_GAPDH_TAA_len41_fa0_ta20_fm6_tm14*120*g,0,0,1038,0,1038,1.0,120,2744@TOP@human_GAPDH_TAA_len41_fa0_ta20_fm6_tm14,g
2744@TOP@human_GAPDH_TAA_len41_fa0_ta20_fm6_tm14*121*a,1043,1,4,0,1048,0.004,121,2744@TOP@human_GAPDH_TAA_len41_fa0_ta20_fm6_tm14,a
2744@TOP@human_GAPDH_TAA_len41_fa0_ta20_fm6_tm14*122*g,0,0,1053,0,1053,1.0,122,2744@TOP@human_GAPDH_TAA_len41_fa0_ta20_fm6_tm14,g
2744@TOP@human_GAPDH_TAA_len41_fa0_ta20_fm6_tm14*123*t,0,0,2,1039,1041,0.002,123,2744@TOP@human_GAPDH_TAA_len41_fa0_ta20_fm6_tm14,t
2744@TOP@human_GAPDH_TAA_len41_fa0_ta20_fm6_tm14*124*a,641,0,391,0,1032,0.379,124,2744@TOP@human_GAPDH_TAA_len41_fa0_ta20_fm6_tm14,a
2744@TOP@human_GAPDH_TAA_len41_fa0_ta20_fm6_tm14*125*a,788,0,248,0,1036,0.239,125,2744@TOP@human_GAPDH_TAA_len41_fa0_ta20_fm6_tm14,a
2744@TOP@human_GAPDH_TAA_len41_fa0_ta20_fm6_tm14*126*g,0,0,1036,0,1036,1.0,126,2744@TOP@human_GAPDH_TAA_len41_fa0_ta20_fm6_tm14,g
2744@TOP@human_GAPDH_TAA_len41_fa0_ta20_fm6_tm14*127*a,1010,0,37,1,1048,0.035,127,2744@TOP@human_GAPDH_TAA_len41_fa0_ta20_fm6_tm14,a
2744@TOP@human_GAPDH_TAA_len41_fa0_ta20_fm6_tm14*128*c,0,1049,0,0,1049,0.0,128,2744@TOP@human_GAPDH_TAA_len41_fa0_ta20_fm6_tm14,c
2744@TOP@human_GAPDH_TAA_len41_fa0_ta20_fm6_tm14*129*c,0,1044,0,0,1044,0.0,129,2744@TOP@human_GAPDH_TAA_len41_fa0_ta20_fm6_tm14,c
2744@TOP@human_GAPDH_TAA_len41_fa0_ta20_fm6_tm14*130*c,0,1051,0,0,1051,0.0,130,2744@TOP@human_GAPDH_TAA_len41_fa0_ta20_fm6_tm14,c
2744@TOP@human_GAPDH_TAA_len41_fa0_ta20_fm6_tm14*131*c,0,1055,0,0,1055,0.0,131,2744@TOP@human_GAPDH_TAA_len41_fa0_ta20_fm6_tm14,c
2744@TOP@human_GAPDH_TAA_len41_fa0_ta20_fm6_tm14*132*t,0,0,0,1037,1037,0.0,132,2744@TOP@human_GAPDH_TAA_len41_fa0_ta20_fm6_tm14,t
2744@TOP@human_GAPDH_TAA_len41_fa0_ta20_fm6_tm14*133*g,0,1,1039,0,1040,0.999,133,2744@TOP@human_GAPDH_TAA_len41_fa0_ta20_fm6_tm14,g
2744@TOP@human_GAPDH_TAA_len41_fa0_ta20_fm6_tm14*134*g,0,0,1041,0,1041,1.0,134,2744@TOP@human_GAPDH_TAA_len41_fa0_ta20_fm6_tm14,g
2745@TOP@human_GAPDH_TAA_len41_fa0_ta20_fm6_tm14*114*t,1,0,0,3885,3886,0.0,114,2745@TOP@human_GAPDH_TAA_len41_fa0_ta20_fm6_tm14,t
2745@TOP@human_GAPDH_TAA_len41_fa0_ta20_fm6_tm14*115*c,0,3910,0,0,3910,0.0,115,2745@TOP@human_GAPDH_TAA_len41_fa0_ta20_fm6_tm14,c
2745@TOP@human_GAPDH_TAA_len41_fa0_ta20_fm6_tm14*116*c,0,3899,0,0,3899,0.0,116,2745@TOP@human_GAPDH_TAA_len41_fa0_ta20_fm6_tm14,c
2745@TOP@human_GAPDH_TAA_len41_fa0_ta20_fm6_tm14*117*a,3885,0,4,0,3889,0.001,117,2745@TOP@human_GAPDH_TAA_len41_fa0_ta20_fm6_tm14,a
2745@TOP@human_GAPDH_TAA_len41_fa0_ta20_fm6_tm14*118*a,3777,0,84,0,3861,0.022,118,2745@TOP@human_GAPDH_TAA_len41_fa0_ta20_fm6_tm14,a
2745@TOP@human_GAPDH_TAA_len41_fa0_ta20_fm6_tm14*119*g,0,0,3861,0,3861,1.0,119,2745@TOP@human_GAPDH_TAA_len41_fa0_ta20_fm6_tm14,g
2745@TOP@human_GAPDH_TAA_len41_fa0_ta20_fm6_tm14*120*g,0,0,3863,0,3863,1.0,120,2745@TOP@human_GAPDH_TAA_len41_fa0_ta20_fm6_tm14,g
2745@TOP@human_GAPDH_TAA_len41_fa0_ta20_fm6_tm14*121*a,3875,1,6,0,3882,0.002,121,2745@TOP@human_GAPDH_TAA_len41_fa0_ta20_fm6_tm14,a
2745@TOP@human_GAPDH_TAA_len41_fa0_ta20_fm6_tm14*122*g,0,0,3892,0,3892,1.0,122,2745@TOP@human_GAPDH_TAA_len41_fa0_ta20_fm6_tm14,g
2745@TOP@human_GAPDH_TAA_len41_fa0_ta20_fm6_tm14*123*t,0,0,1,3841,3842,0.0,123,2745@TOP@human_GAPDH_TAA_len41_fa0_ta20_fm6_tm14,t
2745@TOP@human_GAPDH_TAA_len41_fa0_ta20_fm6_tm14*124*a,3583,0,229,0,3812,0.06,124,2745@TOP@human_GAPDH_TAA_len41_fa0_ta20_fm6_tm14,a
2745@TOP@human_GAPDH_TAA_len41_fa0_ta20_fm6_tm14*125*a,3054,0,754,0,3808,0.198,125,2745@TOP@human_GAPDH_TAA_len41_fa0_ta20_fm6_tm14,a
2745@TOP@human_GAPDH_TAA_len41_fa0_ta20_fm6_tm14*126*g,0,0,3854,0,3854,1.0,126,2745@TOP@human_GAPDH_TAA_len41_fa0_ta20_fm6_tm14,g
2745@TOP@human_GAPDH_TAA_len41_fa0_ta20_fm6_tm14*127*a,3865,1,11,0,3877,0.003,127,2745@TOP@human_GAPDH_TAA_len41_fa0_ta20_fm6_tm14,a
2745@TOP@human_GAPDH_TAA_len41_fa0_ta20_fm6_tm14*128*c,0,3904,1,0,3905,0.0,128,2745@TOP@human_GAPDH_TAA_len41_fa0_ta20_fm6_tm14,c
2745@TOP@human_GAPDH_TAA_len41_fa0_ta20_fm6_tm14*129*c,0,3874,0,0,3874,0.0,129,2745@TOP@human_GAPDH_TAA_len41_fa0_ta20_fm6_tm14,c
2745@TOP@human_GAPDH_TAA_len41_fa0_ta20_fm6_tm14*130*c,0,3895,0,0,3895,0.0,130,2745@TOP@human_GAPDH_TAA_len41_fa0_ta20_fm6_tm14,c
2745@TOP@human_GAPDH_TAA_len41_fa0_ta20_fm6_tm14*131*c,0,3901,0,0,3901,0.0,131,2745@TOP@human_GAPDH_TAA_len41_fa0_ta20_fm6_tm14,c
2745@TOP@human_GAPDH_TAA_len41_fa0_ta20_fm6_tm14*132*t,0,1,0,3857,3858,0.0,132,2745@TOP@human_GAPDH_TAA_len41_fa0_ta20_fm6_tm14,t
2745@TOP@human_GAPDH_TAA_len41_fa0_ta20_fm6_tm14*133*g,0,0,3841,0,3841,1.0,133,2745@TOP@human_GAPDH_TAA_len41_fa0_ta20_fm6_tm14,g
2745@TOP@human_GAPDH_TAA_len41_fa0_ta20_fm6_tm14*134*g,2,0,3865,0,3867,0.999,134,2745@TOP@human_GAPDH_TAA_len41_fa0_ta20_fm6_tm14,g
2746@TOP@human_GAPDH_TAA_len41_fa0_ta20_fm6_tm14*114*t,0,0,0,2033,2033,0.0,114,2746@TOP@human_GAPDH_TAA_len41_fa0_ta20_fm6_tm14,t
2746@TOP@human_GAPDH_TAA_len41_fa0_ta20_fm6_tm14*115*c,0,2048,0,0,2048,0.0,115,2746@TOP@human_GAPDH_TAA_len41_fa0_ta20_fm6_tm14,c
2746@TOP@human_GAPDH_TAA_len41_fa0_ta20_fm6_tm14*116*c,0,2044,0,0,2044,0.0,116,2746@TOP@human_GAPDH_TAA_len41_fa0_ta20_fm6_tm14,c
2746@TOP@human_GAPDH_TAA_len41_fa0_ta20_fm6_tm14*117*a,2042,0,4,0,2046,0.002,117,2746@TOP@human_GAPDH_TAA_len41_fa0_ta20_fm6_tm14,a
2746@TOP@human_GAPDH_TAA_len41_fa0_ta20_fm6_tm14*118*a,1951,0,73,0,2024,0.036,118,2746@TOP@human_GAPDH_TAA_len41_fa0_ta20_fm6_tm14,a
2746@TOP@human_GAPDH_TAA_len41_fa0_ta20_fm6_tm14*119*g,0,0,2035,0,2035,1.0,119,2746@TOP@human_GAPDH_TAA_len41_fa0_ta20_fm6_tm14,g
2746@TOP@human_GAPDH_TAA_len41_fa0_ta20_fm6_tm14*120*g,0,0,2027,0,2027,1.0,120,2746@TOP@human_GAPDH_TAA_len41_fa0_ta20_fm6_tm14,g
2746@TOP@human_GAPDH_TAA_len41_fa0_ta20_fm6_tm14*121*a,2038,0,5,0,2043,0.002,121,2746@TOP@human_GAPDH_TAA_len41_fa0_ta20_fm6_tm14,a
2746@TOP@human_GAPDH_TAA_len41_fa0_ta20_fm6_tm14*122*g,0,0,2044,0,2044,1.0,122,2746@TOP@human_GAPDH_TAA_len41_fa0_ta20_fm6_tm14,g
2746@TOP@human_GAPDH_TAA_len41_fa0_ta20_fm6_tm14*123*t,0,0,0,2021,2021,0.0,123,2746@TOP@human_GAPDH_TAA_len41_fa0_ta20_fm6_tm14,t
2746@TOP@human_GAPDH_TAA_len41_fa0_ta20_fm6_tm14*124*a,1420,0,596,0,2016,0.296,124,2746@TOP@human_GAPDH_TAA_len41_fa0_ta20_fm6_tm14,a
2746@TOP@human_GAPDH_TAA_len41_fa0_ta20_fm6_tm14*125*a,1555,0,460,0,2015,0.228,125,2746@TOP@human_GAPDH_TAA_len41_fa0_ta20_fm6_tm14,a
2746@TOP@human_GAPDH_TAA_len41_fa0_ta20_fm6_tm14*126*g,0,0,2023,0,2023,1.0,126,2746@TOP@human_GAPDH_TAA_len41_fa0_ta20_fm6_tm14,g
2746@TOP@human_GAPDH_TAA_len41_fa0_ta20_fm6_tm14*127*a,1978,0,60,0,2038,0.029,127,2746@TOP@human_GAPDH_TAA_len41_fa0_ta20_fm6_tm14,a
2746@TOP@human_GAPDH_TAA_len41_fa0_ta20_fm6_tm14*128*c,0,2047,0,0,2047,0.0,128,2746@TOP@human_GAPDH_TAA_len41_fa0_ta20_fm6_tm14,c
2746@TOP@human_GAPDH_TAA_len41_fa0_ta20_fm6_tm14*129*c,0,2034,0,0,2034,0.0,129,2746@TOP@human_GAPDH_TAA_len41_fa0_ta20_fm6_tm14,c
2746@TOP@human_GAPDH_TAA_len41_fa0_ta20_fm6_tm14*130*c,0,2047,0,0,2047,0.0,130,2746@TOP@human_GAPDH_TAA_len41_fa0_ta20_fm6_tm14,c
2746@TOP@human_GAPDH_TAA_len41_fa0_ta20_fm6_tm14*131*c,0,2050,0,0,2050,0.0,131,2746@TOP@human_GAPDH_TAA_len41_fa0_ta20_fm6_tm14,c
2746@TOP@human_GAPDH_TAA_len41_fa0_ta20_fm6_tm14*132*t,1,0,0,2029,2030,0.0,132,2746@TOP@human_GAPDH_TAA_len41_fa0_ta20_fm6_tm14,t
2746@TOP@human_GAPDH_TAA_len41_fa0_ta20_fm6_tm14*133*g,0,0,2018,0,2018,1.0,133,2746@TOP@human_GAPDH_TAA_len41_fa0_ta20_fm6_tm14,g
2746@TOP@human_GAPDH_TAA_len41_fa0_ta20_fm6_tm14*134*g,0,0,2031,0,2031,1.0,134,2746@TOP@human_GAPDH_TAA_len41_fa0_ta20_fm6_tm14,g
2747@TOP@human_GAPDH_TAA_len41_fa0_ta20_fm6_tm14*114*t,0,4,0,4054,4058,0.0,114,2747@TOP@human_GAPDH_TAA_len41_fa0_ta20_fm6_tm14,t
2747@TOP@human_GAPDH_TAA_len41_fa0_ta20_fm6_tm14*115*c,0,4086,0,0,4086,0.0,115,2747@TOP@human_GAPDH_TAA_len41_fa0_ta20_fm6_tm14,c
2747@TOP@human_GAPDH_TAA_len41_fa0_ta20_fm6_tm14*116*c,0,4060,0,0,4060,0.0,116,2747@TOP@human_GAPDH_TAA_len41_fa0_ta20_fm6_tm14,c
2747@TOP@human_GAPDH_TAA_len41_fa0_ta20_fm6_tm14*117*a,4064,0,2,0,4066,0.0,117,2747@TOP@human_GAPDH_TAA_len41_fa0_ta20_fm6_tm14,a
2747@TOP@human_GAPDH_TAA_len41_fa0_ta20_fm6_tm14*118*a,3962,0,80,0,4042,0.02,118,2747@TOP@human_GAPDH_TAA_len41_fa0_ta20_fm6_tm14,a
2747@TOP@human_GAPDH_TAA_len41_fa0_ta20_fm6_tm14*119*g,0,0,4043,0,4043,1.0,119,2747@TOP@human_GAPDH_TAA_len41_fa0_ta20_fm6_tm14,g
2747@TOP@human_GAPDH_TAA_len41_fa0_ta20_fm6_tm14*120*g,0,0,4030,0,4030,1.0,120,2747@TOP@human_GAPDH_TAA_len41_fa0_ta20_fm6_tm14,g
2747@TOP@human_GAPDH_TAA_len41_fa0_ta20_fm6_tm14*121*a,4062,0,0,0,4062,0.0,121,2747@TOP@human_GAPDH_TAA_len41_fa0_ta20_fm6_tm14,a
2747@TOP@human_GAPDH_TAA_len41_fa0_ta20_fm6_tm14*122*g,0,1,4067,0,4068,1.0,122,2747@TOP@human_GAPDH_TAA_len41_fa0_ta20_fm6_tm14,g
2747@TOP@human_GAPDH_TAA_len41_fa0_ta20_fm6_tm14*123*t,1,1,0,4008,4010,0.0,123,2747@TOP@human_GAPDH_TAA_len41_fa0_ta20_fm6_tm14,t
2747@TOP@human_GAPDH_TAA_len41_fa0_ta20_fm6_tm14*124*a,1945,0,2081,1,4027,0.517,124,2747@TOP@human_GAPDH_TAA_len41_fa0_ta20_fm6_tm14,a
2747@TOP@human_GAPDH_TAA_len41_fa0_ta20_fm6_tm14*125*a,1969,0,2042,0,4011,0.509,125,2747@TOP@human_GAPDH_TAA_len41_fa0_ta20_fm6_tm14,a
2747@TOP@human_GAPDH_TAA_len41_fa0_ta20_fm6_tm14*126*g,0,0,4045,0,4045,1.0,126,2747@TOP@human_GAPDH_TAA_len41_fa0_ta20_fm6_tm14,g
2747@TOP@human_GAPDH_TAA_len41_fa0_ta20_fm6_tm14*127*a,3916,0,148,0,4064,0.036,127,2747@TOP@human_GAPDH_TAA_len41_fa0_ta20_fm6_tm14,a
2747@TOP@human_GAPDH_TAA_len41_fa0_ta20_fm6_tm14*128*c,0,4084,0,0,4084,0.0,128,2747@TOP@human_GAPDH_TAA_len41_fa0_ta20_fm6_tm14,c
2747@TOP@human_GAPDH_TAA_len41_fa0_ta20_fm6_tm14*129*c,0,4060,0,0,4060,0.0,129,2747@TOP@human_GAPDH_TAA_len41_fa0_ta20_fm6_tm14,c
2747@TOP@human_GAPDH_TAA_len41_fa0_ta20_fm6_tm14*130*c,0,4068,0,0,4068,0.0,130,2747@TOP@human_GAPDH_TAA_len41_fa0_ta20_fm6_tm14,c
2747@TOP@human_GAPDH_TAA_len41_fa0_ta20_fm6_tm14*131*c,0,4075,0,0,4075,0.0,131,2747@TOP@human_GAPDH_TAA_len41_fa0_ta20_fm6_tm14,c
2747@TOP@human_GAPDH_TAA_len41_fa0_ta20_fm6_tm14*132*t,0,0,1,4035,4036,0.0,132,2747@TOP@human_GAPDH_TAA_len41_fa0_ta20_fm6_tm14,t
2747@TOP@human_GAPDH_TAA_len41_fa0_ta20_fm6_tm14*133*g,0,0,4017,0,4017,1.0,133,2747@TOP@human_GAPDH_TAA_len41_fa0_ta20_fm6_tm14,g
2747@TOP@human_GAPDH_TAA_len41_fa0_ta20_fm6_tm14*134*g,0,0,4043,0,4043,1.0,134,2747@TOP@human_GAPDH_TAA_len41_fa0_ta20_fm6_tm14,g
2748@TOP@human_GAPDH_TAA_len41_fa0_ta20_fm6_tm14*114*t,0,0,0,5444,5444,0.0,114,2748@TOP@human_GAPDH_TAA_len41_fa0_ta20_fm6_tm14,t
2748@TOP@human_GAPDH_TAA_len41_fa0_ta20_fm6_tm14*115*c,0,5487,0,0,5487,0.0,115,2748@TOP@human_GAPDH_TAA_len41_fa0_ta20_fm6_tm14,c
2748@TOP@human_GAPDH_TAA_len41_fa0_ta20_fm6_tm14*116*c,0,5471,0,0,5471,0.0,116,2748@TOP@human_GAPDH_TAA_len41_fa0_ta20_fm6_tm14,c
2748@TOP@human_GAPDH_TAA_len41_fa0_ta20_fm6_tm14*117*a,5438,0,11,0,5449,0.002,117,2748@TOP@human_GAPDH_TAA_len41_fa0_ta20_fm6_tm14,a
2748@TOP@human_GAPDH_TAA_len41_fa0_ta20_fm6_tm14*118*a,5364,0,63,0,5427,0.012,118,2748@TOP@human_GAPDH_TAA_len41_fa0_ta20_fm6_tm14,a
2748@TOP@human_GAPDH_TAA_len41_fa0_ta20_fm6_tm14*119*g,0,0,5429,1,5430,1.0,119,2748@TOP@human_GAPDH_TAA_len41_fa0_ta20_fm6_tm14,g
2748@TOP@human_GAPDH_TAA_len41_fa0_ta20_fm6_tm14*120*g,0,0,5399,0,5399,1.0,120,2748@TOP@human_GAPDH_TAA_len41_fa0_ta20_fm6_tm14,g
2748@TOP@human_GAPDH_TAA_len41_fa0_ta20_fm6_tm14*121*a,5459,0,2,0,5461,0.0,121,2748@TOP@human_GAPDH_TAA_len41_fa0_ta20_fm6_tm14,a
2748@TOP@human_GAPDH_TAA_len41_fa0_ta20_fm6_tm14*122*g,1,0,5464,0,5465,1.0,122,2748@TOP@human_GAPDH_TAA_len41_fa0_ta20_fm6_tm14,g
2748@TOP@human_GAPDH_TAA_len41_fa0_ta20_fm6_tm14*123*t,1,1,1,5396,5399,0.0,123,2748@TOP@human_GAPDH_TAA_len41_fa0_ta20_fm6_tm14,t
2748@TOP@human_GAPDH_TAA_len41_fa0_ta20_fm6_tm14*124*a,3083,0,2316,0,5399,0.429,124,2748@TOP@human_GAPDH_TAA_len41_fa0_ta20_fm6_tm14,a
2748@TOP@human_GAPDH_TAA_len41_fa0_ta20_fm6_tm14*125*a,4235,0,1162,0,5397,0.215,125,2748@TOP@human_GAPDH_TAA_len41_fa0_ta20_fm6_tm14,a
2748@TOP@human_GAPDH_TAA_len41_fa0_ta20_fm6_tm14*126*g,0,0,5405,0,5405,1.0,126,2748@TOP@human_GAPDH_TAA_len41_fa0_ta20_fm6_tm14,g
2748@TOP@human_GAPDH_TAA_len41_fa0_ta20_fm6_tm14*127*a,5341,0,109,0,5450,0.02,127,2748@TOP@human_GAPDH_TAA_len41_fa0_ta20_fm6_tm14,a
2748@TOP@human_GAPDH_TAA_len41_fa0_ta20_fm6_tm14*128*c,0,5471,1,0,5472,0.0,128,2748@TOP@human_GAPDH_TAA_len41_fa0_ta20_fm6_tm14,c
2748@TOP@human_GAPDH_TAA_len41_fa0_ta20_fm6_tm14*129*c,0,5445,0,0,5445,0.0,129,2748@TOP@human_GAPDH_TAA_len41_fa0_ta20_fm6_tm14,c
2748@TOP@human_GAPDH_TAA_len41_fa0_ta20_fm6_tm14*130*c,0,5473,0,0,5473,0.0,130,2748@TOP@human_GAPDH_TAA_len41_fa0_ta20_fm6_tm14,c
2748@TOP@human_GAPDH_TAA_len41_fa0_ta20_fm6_tm14*131*c,2,5476,0,0,5478,0.0,131,2748@TOP@human_GAPDH_TAA_len41_fa0_ta20_fm6_tm14,c
2748@TOP@human_GAPDH_TAA_len41_fa0_ta20_fm6_tm14*132*t,0,1,0,5400,5401,0.0,132,2748@TOP@human_GAPDH_TAA_len41_fa0_ta20_fm6_tm14,t
2748@TOP@human_GAPDH_TAA_len41_fa0_ta20_fm6_tm14*133*g,1,0,5380,0,5381,1.0,133,2748@TOP@human_GAPDH_TAA_len41_fa0_ta20_fm6_tm14,g
2748@TOP@human_GAPDH_TAA_len41_fa0_ta20_fm6_tm14*134*g,0,0,5426,0,5426,1.0,134,2748@TOP@human_GAPDH_TAA_len41_fa0_ta20_fm6_tm14,g
2749@TOP@human_GAPDH_TAA_len41_fa0_ta20_fm6_tm14*114*t,2,2,0,11461,11465,0.0,114,2749@TOP@human_GAPDH_TAA_len41_fa0_ta20_fm6_tm14,t
2749@TOP@human_GAPDH_TAA_len41_fa0_ta20_fm6_tm14*115*c,0,11522,0,0,11522,0.0,115,2749@TOP@human_GAPDH_TAA_len41_fa0_ta20_fm6_tm14,c
2749@TOP@human_GAPDH_TAA_len41_fa0_ta20_fm6_tm14*116*c,0,11487,0,1,11488,0.0,116,2749@TOP@human_GAPDH_TAA_len41_fa0_ta20_fm6_tm14,c
2749@TOP@human_GAPDH_TAA_len41_fa0_ta20_fm6_tm14*117*a,11441,0,22,0,11463,0.002,117,2749@TOP@human_GAPDH_TAA_len41_fa0_ta20_fm6_tm14,a
2749@TOP@human_GAPDH_TAA_len41_fa0_ta20_fm6_tm14*118*a,11258,1,142,1,11402,0.012,118,2749@TOP@human_GAPDH_TAA_len41_fa0_ta20_fm6_tm14,a
2749@TOP@human_GAPDH_TAA_len41_fa0_ta20_fm6_tm14*119*g,1,0,11387,0,11388,1.0,119,2749@TOP@human_GAPDH_TAA_len41_fa0_ta20_fm6_tm14,g
2749@TOP@human_GAPDH_TAA_len41_fa0_ta20_fm6_tm14*120*g,2,0,11348,0,11350,1.0,120,2749@TOP@human_GAPDH_TAA_len41_fa0_ta20_fm6_tm14,g
2749@TOP@human_GAPDH_TAA_len41_fa0_ta20_fm6_tm14*121*a,11462,0,7,0,11469,0.001,121,2749@TOP@human_GAPDH_TAA_len41_fa0_ta20_fm6_tm14,a
2749@TOP@human_GAPDH_TAA_len41_fa0_ta20_fm6_tm14*122*g,1,0,11471,0,11472,1.0,122,2749@TOP@human_GAPDH_TAA_len41_fa0_ta20_fm6_tm14,g
2749@TOP@human_GAPDH_TAA_len41_fa0_ta20_fm6_tm14*123*t,1,3,2,11317,11323,0.0,123,2749@TOP@human_GAPDH_TAA_len41_fa0_ta20_fm6_tm14,t
2749@TOP@human_GAPDH_TAA_len41_fa0_ta20_fm6_tm14*124*a,7783,1,3540,0,11324,0.313,124,2749@TOP@human_GAPDH_TAA_len41_fa0_ta20_fm6_tm14,a
2749@TOP@human_GAPDH_TAA_len41_fa0_ta20_fm6_tm14*125*a,7454,0,3860,1,11315,0.341,125,2749@TOP@human_GAPDH_TAA_len41_fa0_ta20_fm6_tm14,a
2749@TOP@human_GAPDH_TAA_len41_fa0_ta20_fm6_tm14*126*g,0,0,11373,1,11374,1.0,126,2749@TOP@human_GAPDH_TAA_len41_fa0_ta20_fm6_tm14,g
2749@TOP@human_GAPDH_TAA_len41_fa0_ta20_fm6_tm14*127*a,11440,1,9,0,11450,0.001,127,2749@TOP@human_GAPDH_TAA_len41_fa0_ta20_fm6_tm14,a
2749@TOP@human_GAPDH_TAA_len41_fa0_ta20_fm6_tm14*128*c,0,11494,0,0,11494,0.0,128,2749@TOP@human_GAPDH_TAA_len41_fa0_ta20_fm6_tm14,c
2749@TOP@human_GAPDH_TAA_len41_fa0_ta20_fm6_tm14*129*c,2,11455,0,1,11458,0.0,129,2749@TOP@human_GAPDH_TAA_len41_fa0_ta20_fm6_tm14,c
2749@TOP@human_GAPDH_TAA_len41_fa0_ta20_fm6_tm14*130*c,0,11478,0,0,11478,0.0,130,2749@TOP@human_GAPDH_TAA_len41_fa0_ta20_fm6_tm14,c
2749@TOP@human_GAPDH_TAA_len41_fa0_ta20_fm6_tm14*131*c,1,11507,0,0,11508,0.0,131,2749@TOP@human_GAPDH_TAA_len41_fa0_ta20_fm6_tm14,c
2749@TOP@human_GAPDH_TAA_len41_fa0_ta20_fm6_tm14*132*t,0,3,0,11368,11371,0.0,132,2749@TOP@human_GAPDH_TAA_len41_fa0_ta20_fm6_tm14,t
2749@TOP@human_GAPDH_TAA_len41_fa0_ta20_fm6_tm14*133*g,2,0,11345,0,11347,1.0,133,2749@TOP@human_GAPDH_TAA_len41_fa0_ta20_fm6_tm14,g
2749@TOP@human_GAPDH_TAA_len41_fa0_ta20_fm6_tm14*134*g,1,0,11380,1,11382,1.0,134,2749@TOP@human_GAPDH_TAA_len41_fa0_ta20_fm6_tm14,g
2750@TOP@human_GAPDH_TAA_len41_fa0_ta20_fm6_tm14*114*t,0,0,0,10613,10613,0.0,114,2750@TOP@human_GAPDH_TAA_len41_fa0_ta20_fm6_tm14,t
2750@TOP@human_GAPDH_TAA_len41_fa0_ta20_fm6_tm14*115*c,0,10666,0,1,10667,0.0,115,2750@TOP@human_GAPDH_TAA_len41_fa0_ta20_fm6_tm14,c
2750@TOP@human_GAPDH_TAA_len41_fa0_ta20_fm6_tm14*116*c,0,10630,0,1,10631,0.0,116,2750@TOP@human_GAPDH_TAA_len41_fa0_ta20_fm6_tm14,c
2750@TOP@human_GAPDH_TAA_len41_fa0_ta20_fm6_tm14*117*a,10602,0,19,1,10622,0.002,117,2750@TOP@human_GAPDH_TAA_len41_fa0_ta20_fm6_tm14,a
2750@TOP@human_GAPDH_TAA_len41_fa0_ta20_fm6_tm14*118*a,10382,0,162,0,10544,0.015,118,2750@TOP@human_GAPDH_TAA_len41_fa0_ta20_fm6_tm14,a
2750@TOP@human_GAPDH_TAA_len41_fa0_ta20_fm6_tm14*119*g,2,0,10530,1,10533,1.0,119,2750@TOP@human_GAPDH_TAA_len41_fa0_ta20_fm6_tm14,g
2750@TOP@human_GAPDH_TAA_len41_fa0_ta20_fm6_tm14*120*g,0,0,10499,0,10499,1.0,120,2750@TOP@human_GAPDH_TAA_len41_fa0_ta20_fm6_tm14,g
2750@TOP@human_GAPDH_TAA_len41_fa0_ta20_fm6_tm14*121*a,10619,1,1,1,10622,0.0,121,2750@TOP@human_GAPDH_TAA_len41_fa0_ta20_fm6_tm14,a
2750@TOP@human_GAPDH_TAA_len41_fa0_ta20_fm6_tm14*122*g,0,0,10631,1,10632,1.0,122,2750@TOP@human_GAPDH_TAA_len41_fa0_ta20_fm6_tm14,g
2750@TOP@human_GAPDH_TAA_len41_fa0_ta20_fm6_tm14*123*t,2,0,2,10493,10497,0.0,123,2750@TOP@human_GAPDH_TAA_len41_fa0_ta20_fm6_tm14,t
2750@TOP@human_GAPDH_TAA_len41_fa0_ta20_fm6_tm14*124*a,5354,0,5168,0,10522,0.491,124,2750@TOP@human_GAPDH_TAA_len41_fa0_ta20_fm6_tm14,a
2750@TOP@human_GAPDH_TAA_len41_fa0_ta20_fm6_tm14*125*a,8246,0,2249,0,10495,0.214,125,2750@TOP@human_GAPDH_TAA_len41_fa0_ta20_fm6_tm14,a
2750@TOP@human_GAPDH_TAA_len41_fa0_ta20_fm6_tm14*126*g,1,0,10525,0,10526,1.0,126,2750@TOP@human_GAPDH_TAA_len41_fa0_ta20_fm6_tm14,g
2750@TOP@human_GAPDH_TAA_len41_fa0_ta20_fm6_tm14*127*a,10594,2,8,0,10604,0.001,127,2750@TOP@human_GAPDH_TAA_len41_fa0_ta20_fm6_tm14,a
2750@TOP@human_GAPDH_TAA_len41_fa0_ta20_fm6_tm14*128*c,0,10639,2,0,10641,0.0,128,2750@TOP@human_GAPDH_TAA_len41_fa0_ta20_fm6_tm14,c
2750@TOP@human_GAPDH_TAA_len41_fa0_ta20_fm6_tm14*129*c,2,10579,0,1,10582,0.0,129,2750@TOP@human_GAPDH_TAA_len41_fa0_ta20_fm6_tm14,c
2750@TOP@human_GAPDH_TAA_len41_fa0_ta20_fm6_tm14*130*c,1,10629,0,2,10632,0.0,130,2750@TOP@human_GAPDH_TAA_len41_fa0_ta20_fm6_tm14,c
2750@TOP@human_GAPDH_TAA_len41_fa0_ta20_fm6_tm14*131*c,0,10658,0,1,10659,0.0,131,2750@TOP@human_GAPDH_TAA_len41_fa0_ta20_fm6_tm14,c
2750@TOP@human_GAPDH_TAA_len41_fa0_ta20_fm6_tm14*132*t,1,6,0,10519,10526,0.0,132,2750@TOP@human_GAPDH_TAA_len41_fa0_ta20_fm6_tm14,t
2750@TOP@human_GAPDH_TAA_len41_fa0_ta20_fm6_tm14*133*g,0,0,10480,1,10481,1.0,133,2750@TOP@human_GAPDH_TAA_len41_fa0_ta20_fm6_tm14,g
2750@TOP@human_GAPDH_TAA_len41_fa0_ta20_fm6_tm14*134*g,0,0,10533,0,10533,1.0,134,2750@TOP@human_GAPDH_TAA_len41_fa0_ta20_fm6_tm14,g
2751@TOP@human_GAPDH_TAA_len41_fa0_ta20_fm6_tm14*114*t,0,0,0,1291,1291,0.0,114,2751@TOP@human_GAPDH_TAA_len41_fa0_ta20_fm6_tm14,t
2751@TOP@human_GAPDH_TAA_len41_fa0_ta20_fm6_tm14*115*c,0,1305,0,0,1305,0.0,115,2751@TOP@human_GAPDH_TAA_len41_fa0_ta20_fm6_tm14,c
2751@TOP@human_GAPDH_TAA_len41_fa0_ta20_fm6_tm14*116*c,0,1298,0,0,1298,0.0,116,2751@TOP@human_GAPDH_TAA_len41_fa0_ta20_fm6_tm14,c
2751@TOP@human_GAPDH_TAA_len41_fa0_ta20_fm6_tm14*117*a,1299,0,1,0,1300,0.001,117,2751@TOP@human_GAPDH_TAA_len41_fa0_ta20_fm6_tm14,a
2751@TOP@human_GAPDH_TAA_len41_fa0_ta20_fm6_tm14*118*a,1269,0,23,0,1292,0.018,118,2751@TOP@human_GAPDH_TAA_len41_fa0_ta20_fm6_tm14,a
2751@TOP@human_GAPDH_TAA_len41_fa0_ta20_fm6_tm14*119*g,0,0,1287,0,1287,1.0,119,2751@TOP@human_GAPDH_TAA_len41_fa0_ta20_fm6_tm14,g
2751@TOP@human_GAPDH_TAA_len41_fa0_ta20_fm6_tm14*120*g,0,0,1287,0,1287,1.0,120,2751@TOP@human_GAPDH_TAA_len41_fa0_ta20_fm6_tm14,g
2751@TOP@human_GAPDH_TAA_len41_fa0_ta20_fm6_tm14*121*a,1295,0,0,0,1295,0.0,121,2751@TOP@human_GAPDH_TAA_len41_fa0_ta20_fm6_tm14,a
2751@TOP@human_GAPDH_TAA_len41_fa0_ta20_fm6_tm14*122*g,0,0,1296,0,1296,1.0,122,2751@TOP@human_GAPDH_TAA_len41_fa0_ta20_fm6_tm14,g
2751@TOP@human_GAPDH_TAA_len41_fa0_ta20_fm6_tm14*123*t,0,0,0,1278,1278,0.0,123,2751@TOP@human_GAPDH_TAA_len41_fa0_ta20_fm6_tm14,t
2751@TOP@human_GAPDH_TAA_len41_fa0_ta20_fm6_tm14*124*a,1027,0,257,0,1284,0.2,124,2751@TOP@human_GAPDH_TAA_len41_fa0_ta20_fm6_tm14,a
2751@TOP@human_GAPDH_TAA_len41_fa0_ta20_fm6_tm14*125*a,1132,0,144,1,1277,0.113,125,2751@TOP@human_GAPDH_TAA_len41_fa0_ta20_fm6_tm14,a
2751@TOP@human_GAPDH_TAA_len41_fa0_ta20_fm6_tm14*126*g,1,0,1285,0,1286,0.999,126,2751@TOP@human_GAPDH_TAA_len41_fa0_ta20_fm6_tm14,g
2751@TOP@human_GAPDH_TAA_len41_fa0_ta20_fm6_tm14*127*a,1238,0,53,0,1291,0.041,127,2751@TOP@human_GAPDH_TAA_len41_fa0_ta20_fm6_tm14,a
2751@TOP@human_GAPDH_TAA_len41_fa0_ta20_fm6_tm14*128*c,0,1299,0,0,1299,0.0,128,2751@TOP@human_GAPDH_TAA_len41_fa0_ta20_fm6_tm14,c
2751@TOP@human_GAPDH_TAA_len41_fa0_ta20_fm6_tm14*129*c,0,1289,0,1,1290,0.0,129,2751@TOP@human_GAPDH_TAA_len41_fa0_ta20_fm6_tm14,c
2751@TOP@human_GAPDH_TAA_len41_fa0_ta20_fm6_tm14*130*c,0,1295,0,0,1295,0.0,130,2751@TOP@human_GAPDH_TAA_len41_fa0_ta20_fm6_tm14,c
2751@TOP@human_GAPDH_TAA_len41_fa0_ta20_fm6_tm14*131*c,0,1301,0,0,1301,0.0,131,2751@TOP@human_GAPDH_TAA_len41_fa0_ta20_fm6_tm14,c
2751@TOP@human_GAPDH_TAA_len41_fa0_ta20_fm6_tm14*132*t,0,0,0,1279,1279,0.0,132,2751@TOP@human_GAPDH_TAA_len41_fa0_ta20_fm6_tm14,t
2751@TOP@human_GAPDH_TAA_len41_fa0_ta20_fm6_tm14*133*g,0,0,1284,0,1284,1.0,133,2751@TOP@human_GAPDH_TAA_len41_fa0_ta20_fm6_tm14,g
2751@TOP@human_GAPDH_TAA_len41_fa0_ta20_fm6_tm14*134*g,0,0,1285,0,1285,1.0,134,2751@TOP@human_GAPDH_TAA_len41_fa0_ta20_fm6_tm14,g
2752@TOP@human_GAPDH_TAA_len41_fa0_ta20_fm6_tm14*114*t,3,0,0,4567,4570,0.0,114,2752@TOP@human_GAPDH_TAA_len41_fa0_ta20_fm6_tm14,t
2752@TOP@human_GAPDH_TAA_len41_fa0_ta20_fm6_tm14*115*c,0,4596,0,0,4596,0.0,115,2752@TOP@human_GAPDH_TAA_len41_fa0_ta20_fm6_tm14,c
2752@TOP@human_GAPDH_TAA_len41_fa0_ta20_fm6_tm14*116*c,0,4579,0,1,4580,0.0,116,2752@TOP@human_GAPDH_TAA_len41_fa0_ta20_fm6_tm14,c
2752@TOP@human_GAPDH_TAA_len41_fa0_ta20_fm6_tm14*117*a,4568,0,7,0,4575,0.002,117,2752@TOP@human_GAPDH_TAA_len41_fa0_ta20_fm6_tm14,a
2752@TOP@human_GAPDH_TAA_len41_fa0_ta20_fm6_tm14*118*a,4487,0,48,0,4535,0.011,118,2752@TOP@human_GAPDH_TAA_len41_fa0_ta20_fm6_tm14,a
2752@TOP@human_GAPDH_TAA_len41_fa0_ta20_fm6_tm14*119*g,1,0,4551,0,4552,1.0,119,2752@TOP@human_GAPDH_TAA_len41_fa0_ta20_fm6_tm14,g
2752@TOP@human_GAPDH_TAA_len41_fa0_ta20_fm6_tm14*120*g,2,0,4512,0,4514,1.0,120,2752@TOP@human_GAPDH_TAA_len41_fa0_ta20_fm6_tm14,g
2752@TOP@human_GAPDH_TAA_len41_fa0_ta20_fm6_tm14*121*a,4551,0,3,0,4554,0.001,121,2752@TOP@human_GAPDH_TAA_len41_fa0_ta20_fm6_tm14,a
2752@TOP@human_GAPDH_TAA_len41_fa0_ta20_fm6_tm14*122*g,0,0,4576,0,4576,1.0,122,2752@TOP@human_GAPDH_TAA_len41_fa0_ta20_fm6_tm14,g
2752@TOP@human_GAPDH_TAA_len41_fa0_ta20_fm6_tm14*123*t,0,0,2,4523,4525,0.0,123,2752@TOP@human_GAPDH_TAA_len41_fa0_ta20_fm6_tm14,t
2752@TOP@human_GAPDH_TAA_len41_fa0_ta20_fm6_tm14*124*a,3006,0,1505,0,4511,0.334,124,2752@TOP@human_GAPDH_TAA_len41_fa0_ta20_fm6_tm14,a
2752@TOP@human_GAPDH_TAA_len41_fa0_ta20_fm6_tm14*125*a,3664,0,850,0,4514,0.188,125,2752@TOP@human_GAPDH_TAA_len41_fa0_ta20_fm6_tm14,a
2752@TOP@human_GAPDH_TAA_len41_fa0_ta20_fm6_tm14*126*g,0,0,4519,0,4519,1.0,126,2752@TOP@human_GAPDH_TAA_len41_fa0_ta20_fm6_tm14,g
2752@TOP@human_GAPDH_TAA_len41_fa0_ta20_fm6_tm14*127*a,4545,0,24,0,4569,0.005,127,2752@TOP@human_GAPDH_TAA_len41_fa0_ta20_fm6_tm14,a
2752@TOP@human_GAPDH_TAA_len41_fa0_ta20_fm6_tm14*128*c,0,4583,1,0,4584,0.0,128,2752@TOP@human_GAPDH_TAA_len41_fa0_ta20_fm6_tm14,c
2752@TOP@human_GAPDH_TAA_len41_fa0_ta20_fm6_tm14*129*c,2,4560,0,2,4564,0.0,129,2752@TOP@human_GAPDH_TAA_len41_fa0_ta20_fm6_tm14,c
2752@TOP@human_GAPDH_TAA_len41_fa0_ta20_fm6_tm14*130*c,1,4585,0,0,4586,0.0,130,2752@TOP@human_GAPDH_TAA_len41_fa0_ta20_fm6_tm14,c
2752@TOP@human_GAPDH_TAA_len41_fa0_ta20_fm6_tm14*131*c,0,4589,0,0,4589,0.0,131,2752@TOP@human_GAPDH_TAA_len41_fa0_ta20_fm6_tm14,c
2752@TOP@human_GAPDH_TAA_len41_fa0_ta20_fm6_tm14*132*t,0,1,0,4533,4534,0.0,132,2752@TOP@human_GAPDH_TAA_len41_fa0_ta20_fm6_tm14,t
2752@TOP@human_GAPDH_TAA_len41_fa0_ta20_fm6_tm14*133*g,0,0,4533,0,4533,1.0,133,2752@TOP@human_GAPDH_TAA_len41_fa0_ta20_fm6_tm14,g
2752@TOP@human_GAPDH_TAA_len41_fa0_ta20_fm6_tm14*134*g,0,4,4542,0,4546,0.999,134,2752@TOP@human_GAPDH_TAA_len41_fa0_ta20_fm6_tm14,g
2753@TOP@human_GAPDH_TAA_len41_fa0_ta20_fm6_tm14*114*t,1,8,0,22062,22071,0.0,114,2753@TOP@human_GAPDH_TAA_len41_fa0_ta20_fm6_tm14,t
2753@TOP@human_GAPDH_TAA_len41_fa0_ta20_fm6_tm14*115*c,0,22192,0,0,22192,0.0,115,2753@TOP@human_GAPDH_TAA_len41_fa0_ta20_fm6_tm14,c
2753@TOP@human_GAPDH_TAA_len41_fa0_ta20_fm6_tm14*116*c,0,22111,1,1,22113,0.0,116,2753@TOP@human_GAPDH_TAA_len41_fa0_ta20_fm6_tm14,c
2753@TOP@human_GAPDH_TAA_len41_fa0_ta20_fm6_tm14*117*a,22089,0,24,1,22114,0.001,117,2753@TOP@human_GAPDH_TAA_len41_fa0_ta20_fm6_tm14,a
2753@TOP@human_GAPDH_TAA_len41_fa0_ta20_fm6_tm14*118*a,21697,3,296,1,21997,0.013,118,2753@TOP@human_GAPDH_TAA_len41_fa0_ta20_fm6_tm14,a
2753@TOP@human_GAPDH_TAA_len41_fa0_ta20_fm6_tm14*119*g,1,0,21922,0,21923,1.0,119,2753@TOP@human_GAPDH_TAA_len41_fa0_ta20_fm6_tm14,g
2753@TOP@human_GAPDH_TAA_len41_fa0_ta20_fm6_tm14*120*g,2,0,21859,0,21861,1.0,120,2753@TOP@human_GAPDH_TAA_len41_fa0_ta20_fm6_tm14,g
2753@TOP@human_GAPDH_TAA_len41_fa0_ta20_fm6_tm14*121*a,22074,0,5,0,22079,0.0,121,2753@TOP@human_GAPDH_TAA_len41_fa0_ta20_fm6_tm14,a
2753@TOP@human_GAPDH_TAA_len41_fa0_ta20_fm6_tm14*122*g,0,0,22092,0,22092,1.0,122,2753@TOP@human_GAPDH_TAA_len41_fa0_ta20_fm6_tm14,g
2753@TOP@human_GAPDH_TAA_len41_fa0_ta20_fm6_tm14*123*t,3,4,4,21830,21841,0.0,123,2753@TOP@human_GAPDH_TAA_len41_fa0_ta20_fm6_tm14,t
2753@TOP@human_GAPDH_TAA_len41_fa0_ta20_fm6_tm14*124*a,12694,1,9168,2,21865,0.419,124,2753@TOP@human_GAPDH_TAA_len41_fa0_ta20_fm6_tm14,a
2753@TOP@human_GAPDH_TAA_len41_fa0_ta20_fm6_tm14*125*a,17063,1,4755,0,21819,0.218,125,2753@TOP@human_GAPDH_TAA_len41_fa0_ta20_fm6_tm14,a
2753@TOP@human_GAPDH_TAA_len41_fa0_ta20_fm6_tm14*126*g,1,2,21890,2,21895,1.0,126,2753@TOP@human_GAPDH_TAA_len41_fa0_ta20_fm6_tm14,g
2753@TOP@human_GAPDH_TAA_len41_fa0_ta20_fm6_tm14*127*a,22062,2,14,0,22078,0.001,127,2753@TOP@human_GAPDH_TAA_len41_fa0_ta20_fm6_tm14,a
2753@TOP@human_GAPDH_TAA_len41_fa0_ta20_fm6_tm14*128*c,0,22143,1,1,22145,0.0,128,2753@TOP@human_GAPDH_TAA_len41_fa0_ta20_fm6_tm14,c
2753@TOP@human_GAPDH_TAA_len41_fa0_ta20_fm6_tm14*129*c,2,21997,0,2,22001,0.0,129,2753@TOP@human_GAPDH_TAA_len41_fa0_ta20_fm6_tm14,c
2753@TOP@human_GAPDH_TAA_len41_fa0_ta20_fm6_tm14*130*c,0,22083,0,1,22084,0.0,130,2753@TOP@human_GAPDH_TAA_len41_fa0_ta20_fm6_tm14,c
2753@TOP@human_GAPDH_TAA_len41_fa0_ta20_fm6_tm14*131*c,2,22158,1,2,22163,0.0,131,2753@TOP@human_GAPDH_TAA_len41_fa0_ta20_fm6_tm14,c
2753@TOP@human_GAPDH_TAA_len41_fa0_ta20_fm6_tm14*132*t,6,2,1,21850,21859,0.0,132,2753@TOP@human_GAPDH_TAA_len41_fa0_ta20_fm6_tm14,t
2753@TOP@human_GAPDH_TAA_len41_fa0_ta20_fm6_tm14*133*g,0,2,21821,0,21823,1.0,133,2753@TOP@human_GAPDH_TAA_len41_fa0_ta20_fm6_tm14,g
2753@TOP@human_GAPDH_TAA_len41_fa0_ta20_fm6_tm14*134*g,0,0,21902,1,21903,1.0,134,2753@TOP@human_GAPDH_TAA_len41_fa0_ta20_fm6_tm14,g
2754@TOP@human_GAPDH_TAA_len41_fa0_ta20_fm6_tm14*114*t,7,1,0,20246,20254,0.0,114,2754@TOP@human_GAPDH_TAA_len41_fa0_ta20_fm6_tm14,t
2754@TOP@human_GAPDH_TAA_len41_fa0_ta20_fm6_tm14*115*c,0,20346,0,0,20346,0.0,115,2754@TOP@human_GAPDH_TAA_len41_fa0_ta20_fm6_tm14,c
2754@TOP@human_GAPDH_TAA_len41_fa0_ta20_fm6_tm14*116*c,1,20279,0,1,20281,0.0,116,2754@TOP@human_GAPDH_TAA_len41_fa0_ta20_fm6_tm14,c
2754@TOP@human_GAPDH_TAA_len41_fa0_ta20_fm6_tm14*117*a,20258,1,11,0,20270,0.001,117,2754@TOP@human_GAPDH_TAA_len41_fa0_ta20_fm6_tm14,a
2754@TOP@human_GAPDH_TAA_len41_fa0_ta20_fm6_tm14*118*a,19935,0,204,1,20140,0.01,118,2754@TOP@human_GAPDH_TAA_len41_fa0_ta20_fm6_tm14,a
2754@TOP@human_GAPDH_TAA_len41_fa0_ta20_fm6_tm14*119*g,4,0,20134,4,20142,1.0,119,2754@TOP@human_GAPDH_TAA_len41_fa0_ta20_fm6_tm14,g
2754@TOP@human_GAPDH_TAA_len41_fa0_ta20_fm6_tm14*120*g,2,0,20036,1,20039,1.0,120,2754@TOP@human_GAPDH_TAA_len41_fa0_ta20_fm6_tm14,g
2754@TOP@human_GAPDH_TAA_len41_fa0_ta20_fm6_tm14*121*a,20248,0,4,0,20252,0.0,121,2754@TOP@human_GAPDH_TAA_len41_fa0_ta20_fm6_tm14,a
2754@TOP@human_GAPDH_TAA_len41_fa0_ta20_fm6_tm14*122*g,0,0,20277,0,20277,1.0,122,2754@TOP@human_GAPDH_TAA_len41_fa0_ta20_fm6_tm14,g
2754@TOP@human_GAPDH_TAA_len41_fa0_ta20_fm6_tm14*123*t,5,0,4,20034,20043,0.0,123,2754@TOP@human_GAPDH_TAA_len41_fa0_ta20_fm6_tm14,t
2754@TOP@human_GAPDH_TAA_len41_fa0_ta20_fm6_tm14*124*a,9596,0,10448,0,20044,0.521,124,2754@TOP@human_GAPDH_TAA_len41_fa0_ta20_fm6_tm14,a
2754@TOP@human_GAPDH_TAA_len41_fa0_ta20_fm6_tm14*125*a,15202,2,4864,2,20070,0.242,125,2754@TOP@human_GAPDH_TAA_len41_fa0_ta20_fm6_tm14,a
2754@TOP@human_GAPDH_TAA_len41_fa0_ta20_fm6_tm14*126*g,4,0,20100,0,20104,1.0,126,2754@TOP@human_GAPDH_TAA_len41_fa0_ta20_fm6_tm14,g
2754@TOP@human_GAPDH_TAA_len41_fa0_ta20_fm6_tm14*127*a,19914,2,329,0,20245,0.016,127,2754@TOP@human_GAPDH_TAA_len41_fa0_ta20_fm6_tm14,a
2754@TOP@human_GAPDH_TAA_len41_fa0_ta20_fm6_tm14*128*c,0,20303,2,7,20312,0.0,128,2754@TOP@human_GAPDH_TAA_len41_fa0_ta20_fm6_tm14,c
2754@TOP@human_GAPDH_TAA_len41_fa0_ta20_fm6_tm14*129*c,0,20212,0,3,20215,0.0,129,2754@TOP@human_GAPDH_TAA_len41_fa0_ta20_fm6_tm14,c
2754@TOP@human_GAPDH_TAA_len41_fa0_ta20_fm6_tm14*130*c,0,20288,0,0,20288,0.0,130,2754@TOP@human_GAPDH_TAA_len41_fa0_ta20_fm6_tm14,c
2754@TOP@human_GAPDH_TAA_len41_fa0_ta20_fm6_tm14*131*c,1,20327,0,1,20329,0.0,131,2754@TOP@human_GAPDH_TAA_len41_fa0_ta20_fm6_tm14,c
2754@TOP@human_GAPDH_TAA_len41_fa0_ta20_fm6_tm14*132*t,3,5,2,20068,20078,0.0,132,2754@TOP@human_GAPDH_TAA_len41_fa0_ta20_fm6_tm14,t
2754@TOP@human_GAPDH_TAA_len41_fa0_ta20_fm6_tm14*133*g,3,1,20037,0,20041,1.0,133,2754@TOP@human_GAPDH_TAA_len41_fa0_ta20_fm6_tm14,g
2754@TOP@human_GAPDH_TAA_len41_fa0_ta20_fm6_tm14*134*g,0,1,20145,0,20146,1.0,134,2754@TOP@human_GAPDH_TAA_len41_fa0_ta20_fm6_tm14,g
2755@TOP@human_GAPDH_TAA_len41_fa0_ta20_fm6_tm14*114*t,2,3,0,19265,19270,0.0,114,2755@TOP@human_GAPDH_TAA_len41_fa0_ta20_fm6_tm14,t
2755@TOP@human_GAPDH_TAA_len41_fa0_ta20_fm6_tm14*115*c,0,19396,0,0,19396,0.0,115,2755@TOP@human_GAPDH_TAA_len41_fa0_ta20_fm6_tm14,c
2755@TOP@human_GAPDH_TAA_len41_fa0_ta20_fm6_tm14*116*c,0,19326,0,1,19327,0.0,116,2755@TOP@human_GAPDH_TAA_len41_fa0_ta20_fm6_tm14,c
2755@TOP@human_GAPDH_TAA_len41_fa0_ta20_fm6_tm14*117*a,19307,0,18,0,19325,0.001,117,2755@TOP@human_GAPDH_TAA_len41_fa0_ta20_fm6_tm14,a
2755@TOP@human_GAPDH_TAA_len41_fa0_ta20_fm6_tm14*118*a,18991,0,227,0,19218,0.012,118,2755@TOP@human_GAPDH_TAA_len41_fa0_ta20_fm6_tm14,a
2755@TOP@human_GAPDH_TAA_len41_fa0_ta20_fm6_tm14*119*g,4,0,19171,2,19177,1.0,119,2755@TOP@human_GAPDH_TAA_len41_fa0_ta20_fm6_tm14,g
2755@TOP@human_GAPDH_TAA_len41_fa0_ta20_fm6_tm14*120*g,1,0,19111,1,19113,1.0,120,2755@TOP@human_GAPDH_TAA_len41_fa0_ta20_fm6_tm14,g
2755@TOP@human_GAPDH_TAA_len41_fa0_ta20_fm6_tm14*121*a,19283,0,12,0,19295,0.001,121,2755@TOP@human_GAPDH_TAA_len41_fa0_ta20_fm6_tm14,a
2755@TOP@human_GAPDH_TAA_len41_fa0_ta20_fm6_tm14*122*g,0,0,19340,1,19341,1.0,122,2755@TOP@human_GAPDH_TAA_len41_fa0_ta20_fm6_tm14,g
2755@TOP@human_GAPDH_TAA_len41_fa0_ta20_fm6_tm14*123*t,3,1,2,19100,19106,0.0,123,2755@TOP@human_GAPDH_TAA_len41_fa0_ta20_fm6_tm14,t
2755@TOP@human_GAPDH_TAA_len41_fa0_ta20_fm6_tm14*124*a,8599,0,10504,0,19103,0.55,124,2755@TOP@human_GAPDH_TAA_len41_fa0_ta20_fm6_tm14,a
2755@TOP@human_GAPDH_TAA_len41_fa0_ta20_fm6_tm14*125*a,14213,0,4887,1,19101,0.256,125,2755@TOP@human_GAPDH_TAA_len41_fa0_ta20_fm6_tm14,a
2755@TOP@human_GAPDH_TAA_len41_fa0_ta20_fm6_tm14*126*g,0,0,19137,2,19139,1.0,126,2755@TOP@human_GAPDH_TAA_len41_fa0_ta20_fm6_tm14,g
2755@TOP@human_GAPDH_TAA_len41_fa0_ta20_fm6_tm14*127*a,19236,3,28,0,19267,0.001,127,2755@TOP@human_GAPDH_TAA_len41_fa0_ta20_fm6_tm14,a
2755@TOP@human_GAPDH_TAA_len41_fa0_ta20_fm6_tm14*128*c,0,19360,0,0,19360,0.0,128,2755@TOP@human_GAPDH_TAA_len41_fa0_ta20_fm6_tm14,c
2755@TOP@human_GAPDH_TAA_len41_fa0_ta20_fm6_tm14*129*c,2,19230,0,0,19232,0.0,129,2755@TOP@human_GAPDH_TAA_len41_fa0_ta20_fm6_tm14,c
2755@TOP@human_GAPDH_TAA_len41_fa0_ta20_fm6_tm14*130*c,0,19355,1,1,19357,0.0,130,2755@TOP@human_GAPDH_TAA_len41_fa0_ta20_fm6_tm14,c
2755@TOP@human_GAPDH_TAA_len41_fa0_ta20_fm6_tm14*131*c,0,19362,0,2,19364,0.0,131,2755@TOP@human_GAPDH_TAA_len41_fa0_ta20_fm6_tm14,c
2755@TOP@human_GAPDH_TAA_len41_fa0_ta20_fm6_tm14*132*t,2,7,1,19147,19157,0.0,132,2755@TOP@human_GAPDH_TAA_len41_fa0_ta20_fm6_tm14,t
2755@TOP@human_GAPDH_TAA_len41_fa0_ta20_fm6_tm14*133*g,2,1,19070,0,19073,1.0,133,2755@TOP@human_GAPDH_TAA_len41_fa0_ta20_fm6_tm14,g
2755@TOP@human_GAPDH_TAA_len41_fa0_ta20_fm6_tm14*134*g,6,0,19184,0,19190,1.0,134,2755@TOP@human_GAPDH_TAA_len41_fa0_ta20_fm6_tm14,g
2756@TOP@human_GAPDH_TAA_len41_fa0_ta20_fm6_tm14*114*t,1,0,0,1889,1890,0.0,114,2756@TOP@human_GAPDH_TAA_len41_fa0_ta20_fm6_tm14,t
2756@TOP@human_GAPDH_TAA_len41_fa0_ta20_fm6_tm14*115*c,0,1902,0,0,1902,0.0,115,2756@TOP@human_GAPDH_TAA_len41_fa0_ta20_fm6_tm14,c
2756@TOP@human_GAPDH_TAA_len41_fa0_ta20_fm6_tm14*116*c,0,1894,0,0,1894,0.0,116,2756@TOP@human_GAPDH_TAA_len41_fa0_ta20_fm6_tm14,c
2756@TOP@human_GAPDH_TAA_len41_fa0_ta20_fm6_tm14*117*a,1883,0,8,0,1891,0.004,117,2756@TOP@human_GAPDH_TAA_len41_fa0_ta20_fm6_tm14,a
2756@TOP@human_GAPDH_TAA_len41_fa0_ta20_fm6_tm14*118*a,1785,0,97,0,1882,0.052,118,2756@TOP@human_GAPDH_TAA_len41_fa0_ta20_fm6_tm14,a
2756@TOP@human_GAPDH_TAA_len41_fa0_ta20_fm6_tm14*119*g,0,0,1886,0,1886,1.0,119,2756@TOP@human_GAPDH_TAA_len41_fa0_ta20_fm6_tm14,g
2756@TOP@human_GAPDH_TAA_len41_fa0_ta20_fm6_tm14*120*g,0,0,1877,0,1877,1.0,120,2756@TOP@human_GAPDH_TAA_len41_fa0_ta20_fm6_tm14,g
2756@TOP@human_GAPDH_TAA_len41_fa0_ta20_fm6_tm14*121*a,1888,0,0,0,1888,0.0,121,2756@TOP@human_GAPDH_TAA_len41_fa0_ta20_fm6_tm14,a
2756@TOP@human_GAPDH_TAA_len41_fa0_ta20_fm6_tm14*122*g,0,0,1892,1,1893,0.999,122,2756@TOP@human_GAPDH_TAA_len41_fa0_ta20_fm6_tm14,g
2756@TOP@human_GAPDH_TAA_len41_fa0_ta20_fm6_tm14*123*t,0,0,0,1876,1876,0.0,123,2756@TOP@human_GAPDH_TAA_len41_fa0_ta20_fm6_tm14,t
2756@TOP@human_GAPDH_TAA_len41_fa0_ta20_fm6_tm14*124*a,1716,0,141,0,1857,0.076,124,2756@TOP@human_GAPDH_TAA_len41_fa0_ta20_fm6_tm14,a
2756@TOP@human_GAPDH_TAA_len41_fa0_ta20_fm6_tm14*125*a,1616,0,228,0,1844,0.124,125,2756@TOP@human_GAPDH_TAA_len41_fa0_ta20_fm6_tm14,a
2756@TOP@human_GAPDH_TAA_len41_fa0_ta20_fm6_tm14*126*g,0,0,1861,1,1862,0.999,126,2756@TOP@human_GAPDH_TAA_len41_fa0_ta20_fm6_tm14,g
2756@TOP@human_GAPDH_TAA_len41_fa0_ta20_fm6_tm14*127*a,1856,0,20,1,1877,0.011,127,2756@TOP@human_GAPDH_TAA_len41_fa0_ta20_fm6_tm14,a
2756@TOP@human_GAPDH_TAA_len41_fa0_ta20_fm6_tm14*128*c,0,1893,0,0,1893,0.0,128,2756@TOP@human_GAPDH_TAA_len41_fa0_ta20_fm6_tm14,c
2756@TOP@human_GAPDH_TAA_len41_fa0_ta20_fm6_tm14*129*c,0,1886,0,0,1886,0.0,129,2756@TOP@human_GAPDH_TAA_len41_fa0_ta20_fm6_tm14,c
2756@TOP@human_GAPDH_TAA_len41_fa0_ta20_fm6_tm14*130*c,0,1896,0,0,1896,0.0,130,2756@TOP@human_GAPDH_TAA_len41_fa0_ta20_fm6_tm14,c
2756@TOP@human_GAPDH_TAA_len41_fa0_ta20_fm6_tm14*131*c,1,1897,0,1,1899,0.0,131,2756@TOP@human_GAPDH_TAA_len41_fa0_ta20_fm6_tm14,c
2756@TOP@human_GAPDH_TAA_len41_fa0_ta20_fm6_tm14*132*t,0,0,0,1874,1874,0.0,132,2756@TOP@human_GAPDH_TAA_len41_fa0_ta20_fm6_tm14,t
2756@TOP@human_GAPDH_TAA_len41_fa0_ta20_fm6_tm14*133*g,0,0,1866,0,1866,1.0,133,2756@TOP@human_GAPDH_TAA_len41_fa0_ta20_fm6_tm14,g
2756@TOP@human_GAPDH_TAA_len41_fa0_ta20_fm6_tm14*134*g,0,0,1882,0,1882,1.0,134,2756@TOP@human_GAPDH_TAA_len41_fa0_ta20_fm6_tm14,g
2757@TOP@human_GAPDH_TAA_len41_fa0_ta20_fm6_tm14*114*t,2,0,0,1583,1585,0.0,114,2757@TOP@human_GAPDH_TAA_len41_fa0_ta20_fm6_tm14,t
2757@TOP@human_GAPDH_TAA_len41_fa0_ta20_fm6_tm14*115*c,0,1594,0,2,1596,0.0,115,2757@TOP@human_GAPDH_TAA_len41_fa0_ta20_fm6_tm14,c
2757@TOP@human_GAPDH_TAA_len41_fa0_ta20_fm6_tm14*116*c,0,1588,0,0,1588,0.0,116,2757@TOP@human_GAPDH_TAA_len41_fa0_ta20_fm6_tm14,c
2757@TOP@human_GAPDH_TAA_len41_fa0_ta20_fm6_tm14*117*a,1579,0,5,0,1584,0.003,117,2757@TOP@human_GAPDH_TAA_len41_fa0_ta20_fm6_tm14,a
2757@TOP@human_GAPDH_TAA_len41_fa0_ta20_fm6_tm14*118*a,1534,0,42,0,1576,0.027,118,2757@TOP@human_GAPDH_TAA_len41_fa0_ta20_fm6_tm14,a
2757@TOP@human_GAPDH_TAA_len41_fa0_ta20_fm6_tm14*119*g,0,0,1578,0,1578,1.0,119,2757@TOP@human_GAPDH_TAA_len41_fa0_ta20_fm6_tm14,g
2757@TOP@human_GAPDH_TAA_len41_fa0_ta20_fm6_tm14*120*g,0,0,1569,0,1569,1.0,120,2757@TOP@human_GAPDH_TAA_len41_fa0_ta20_fm6_tm14,g
2757@TOP@human_GAPDH_TAA_len41_fa0_ta20_fm6_tm14*121*a,1584,0,0,0,1584,0.0,121,2757@TOP@human_GAPDH_TAA_len41_fa0_ta20_fm6_tm14,a
2757@TOP@human_GAPDH_TAA_len41_fa0_ta20_fm6_tm14*122*g,0,0,1590,0,1590,1.0,122,2757@TOP@human_GAPDH_TAA_len41_fa0_ta20_fm6_tm14,g
2757@TOP@human_GAPDH_TAA_len41_fa0_ta20_fm6_tm14*123*t,0,0,0,1572,1572,0.0,123,2757@TOP@human_GAPDH_TAA_len41_fa0_ta20_fm6_tm14,t
2757@TOP@human_GAPDH_TAA_len41_fa0_ta20_fm6_tm14*124*a,1482,0,94,0,1576,0.06,124,2757@TOP@human_GAPDH_TAA_len41_fa0_ta20_fm6_tm14,a
2757@TOP@human_GAPDH_TAA_len41_fa0_ta20_fm6_tm14*125*a,1534,0,45,0,1579,0.028,125,2757@TOP@human_GAPDH_TAA_len41_fa0_ta20_fm6_tm14,a
2757@TOP@human_GAPDH_TAA_len41_fa0_ta20_fm6_tm14*126*g,0,0,1563,0,1563,1.0,126,2757@TOP@human_GAPDH_TAA_len41_fa0_ta20_fm6_tm14,g
2757@TOP@human_GAPDH_TAA_len41_fa0_ta20_fm6_tm14*127*a,1573,0,2,0,1575,0.001,127,2757@TOP@human_GAPDH_TAA_len41_fa0_ta20_fm6_tm14,a
2757@TOP@human_GAPDH_TAA_len41_fa0_ta20_fm6_tm14*128*c,0,1586,0,0,1586,0.0,128,2757@TOP@human_GAPDH_TAA_len41_fa0_ta20_fm6_tm14,c
2757@TOP@human_GAPDH_TAA_len41_fa0_ta20_fm6_tm14*129*c,0,1582,0,0,1582,0.0,129,2757@TOP@human_GAPDH_TAA_len41_fa0_ta20_fm6_tm14,c
2757@TOP@human_GAPDH_TAA_len41_fa0_ta20_fm6_tm14*130*c,0,1588,0,0,1588,0.0,130,2757@TOP@human_GAPDH_TAA_len41_fa0_ta20_fm6_tm14,c
2757@TOP@human_GAPDH_TAA_len41_fa0_ta20_fm6_tm14*131*c,0,1591,0,0,1591,0.0,131,2757@TOP@human_GAPDH_TAA_len41_fa0_ta20_fm6_tm14,c
2757@TOP@human_GAPDH_TAA_len41_fa0_ta20_fm6_tm14*132*t,0,0,0,1567,1567,0.0,132,2757@TOP@human_GAPDH_TAA_len41_fa0_ta20_fm6_tm14,t
2757@TOP@human_GAPDH_TAA_len41_fa0_ta20_fm6_tm14*133*g,2,0,1571,0,1573,0.999,133,2757@TOP@human_GAPDH_TAA_len41_fa0_ta20_fm6_tm14,g
2757@TOP@human_GAPDH_TAA_len41_fa0_ta20_fm6_tm14*134*g,0,0,1572,0,1572,1.0,134,2757@TOP@human_GAPDH_TAA_len41_fa0_ta20_fm6_tm14,g
2758@TOP@human_GAPDH_TAA_len41_fa0_ta20_fm6_tm14*114*t,0,3,0,558,561,0.0,114,2758@TOP@human_GAPDH_TAA_len41_fa0_ta20_fm6_tm14,t
2758@TOP@human_GAPDH_TAA_len41_fa0_ta20_fm6_tm14*115*c,0,571,0,0,571,0.0,115,2758@TOP@human_GAPDH_TAA_len41_fa0_ta20_fm6_tm14,c
2758@TOP@human_GAPDH_TAA_len41_fa0_ta20_fm6_tm14*116*c,0,565,0,0,565,0.0,116,2758@TOP@human_GAPDH_TAA_len41_fa0_ta20_fm6_tm14,c
2758@TOP@human_GAPDH_TAA_len41_fa0_ta20_fm6_tm14*117*a,571,0,1,0,572,0.002,117,2758@TOP@human_GAPDH_TAA_len41_fa0_ta20_fm6_tm14,a
2758@TOP@human_GAPDH_TAA_len41_fa0_ta20_fm6_tm14*118*a,535,0,32,0,567,0.056,118,2758@TOP@human_GAPDH_TAA_len41_fa0_ta20_fm6_tm14,a
2758@TOP@human_GAPDH_TAA_len41_fa0_ta20_fm6_tm14*119*g,0,0,562,0,562,1.0,119,2758@TOP@human_GAPDH_TAA_len41_fa0_ta20_fm6_tm14,g
2758@TOP@human_GAPDH_TAA_len41_fa0_ta20_fm6_tm14*120*g,0,0,552,0,552,1.0,120,2758@TOP@human_GAPDH_TAA_len41_fa0_ta20_fm6_tm14,g
2758@TOP@human_GAPDH_TAA_len41_fa0_ta20_fm6_tm14*121*a,566,0,0,0,566,0.0,121,2758@TOP@human_GAPDH_TAA_len41_fa0_ta20_fm6_tm14,a
2758@TOP@human_GAPDH_TAA_len41_fa0_ta20_fm6_tm14*122*g,0,1,562,0,563,0.998,122,2758@TOP@human_GAPDH_TAA_len41_fa0_ta20_fm6_tm14,g
2758@TOP@human_GAPDH_TAA_len41_fa0_ta20_fm6_tm14*123*t,0,0,1,558,559,0.002,123,2758@TOP@human_GAPDH_TAA_len41_fa0_ta20_fm6_tm14,t
2758@TOP@human_GAPDH_TAA_len41_fa0_ta20_fm6_tm14*124*a,482,0,76,0,558,0.136,124,2758@TOP@human_GAPDH_TAA_len41_fa0_ta20_fm6_tm14,a
2758@TOP@human_GAPDH_TAA_len41_fa0_ta20_fm6_tm14*125*a,469,0,94,0,563,0.167,125,2758@TOP@human_GAPDH_TAA_len41_fa0_ta20_fm6_tm14,a
2758@TOP@human_GAPDH_TAA_len41_fa0_ta20_fm6_tm14*126*g,0,0,554,0,554,1.0,126,2758@TOP@human_GAPDH_TAA_len41_fa0_ta20_fm6_tm14,g
2758@TOP@human_GAPDH_TAA_len41_fa0_ta20_fm6_tm14*127*a,564,0,5,0,569,0.009,127,2758@TOP@human_GAPDH_TAA_len41_fa0_ta20_fm6_tm14,a
2758@TOP@human_GAPDH_TAA_len41_fa0_ta20_fm6_tm14*128*c,0,572,0,0,572,0.0,128,2758@TOP@human_GAPDH_TAA_len41_fa0_ta20_fm6_tm14,c
2758@TOP@human_GAPDH_TAA_len41_fa0_ta20_fm6_tm14*129*c,0,565,0,0,565,0.0,129,2758@TOP@human_GAPDH_TAA_len41_fa0_ta20_fm6_tm14,c
2758@TOP@human_GAPDH_TAA_len41_fa0_ta20_fm6_tm14*130*c,0,566,0,0,566,0.0,130,2758@TOP@human_GAPDH_TAA_len41_fa0_ta20_fm6_tm14,c
2758@TOP@human_GAPDH_TAA_len41_fa0_ta20_fm6_tm14*131*c,0,570,0,0,570,0.0,131,2758@TOP@human_GAPDH_TAA_len41_fa0_ta20_fm6_tm14,c
2758@TOP@human_GAPDH_TAA_len41_fa0_ta20_fm6_tm14*132*t,0,0,0,556,556,0.0,132,2758@TOP@human_GAPDH_TAA_len41_fa0_ta20_fm6_tm14,t
2758@TOP@human_GAPDH_TAA_len41_fa0_ta20_fm6_tm14*133*g,0,0,559,0,559,1.0,133,2758@TOP@human_GAPDH_TAA_len41_fa0_ta20_fm6_tm14,g
2758@TOP@human_GAPDH_TAA_len41_fa0_ta20_fm6_tm14*134*g,0,0,560,0,560,1.0,134,2758@TOP@human_GAPDH_TAA_len41_fa0_ta20_fm6_tm14,g
2759@TOP@human_GAPDH_TAA_len41_fa0_ta20_fm6_tm14*114*t,0,0,0,833,833,0.0,114,2759@TOP@human_GAPDH_TAA_len41_fa0_ta20_fm6_tm14,t
2759@TOP@human_GAPDH_TAA_len41_fa0_ta20_fm6_tm14*115*c,0,841,0,0,841,0.0,115,2759@TOP@human_GAPDH_TAA_len41_fa0_ta20_fm6_tm14,c
2759@TOP@human_GAPDH_TAA_len41_fa0_ta20_fm6_tm14*116*c,0,835,0,0,835,0.0,116,2759@TOP@human_GAPDH_TAA_len41_fa0_ta20_fm6_tm14,c
2759@TOP@human_GAPDH_TAA_len41_fa0_ta20_fm6_tm14*117*a,832,0,7,0,839,0.008,117,2759@TOP@human_GAPDH_TAA_len41_fa0_ta20_fm6_tm14,a
2759@TOP@human_GAPDH_TAA_len41_fa0_ta20_fm6_tm14*118*a,803,0,28,0,831,0.034,118,2759@TOP@human_GAPDH_TAA_len41_fa0_ta20_fm6_tm14,a
2759@TOP@human_GAPDH_TAA_len41_fa0_ta20_fm6_tm14*119*g,0,0,826,0,826,1.0,119,2759@TOP@human_GAPDH_TAA_len41_fa0_ta20_fm6_tm14,g
2759@TOP@human_GAPDH_TAA_len41_fa0_ta20_fm6_tm14*120*g,0,0,820,0,820,1.0,120,2759@TOP@human_GAPDH_TAA_len41_fa0_ta20_fm6_tm14,g
2759@TOP@human_GAPDH_TAA_len41_fa0_ta20_fm6_tm14*121*a,833,0,0,0,833,0.0,121,2759@TOP@human_GAPDH_TAA_len41_fa0_ta20_fm6_tm14,a
2759@TOP@human_GAPDH_TAA_len41_fa0_ta20_fm6_tm14*122*g,0,0,835,0,835,1.0,122,2759@TOP@human_GAPDH_TAA_len41_fa0_ta20_fm6_tm14,g
2759@TOP@human_GAPDH_TAA_len41_fa0_ta20_fm6_tm14*123*t,0,0,0,824,824,0.0,123,2759@TOP@human_GAPDH_TAA_len41_fa0_ta20_fm6_tm14,t
2759@TOP@human_GAPDH_TAA_len41_fa0_ta20_fm6_tm14*124*a,638,0,187,0,825,0.227,124,2759@TOP@human_GAPDH_TAA_len41_fa0_ta20_fm6_tm14,a
2759@TOP@human_GAPDH_TAA_len41_fa0_ta20_fm6_tm14*125*a,739,0,80,0,819,0.098,125,2759@TOP@human_GAPDH_TAA_len41_fa0_ta20_fm6_tm14,a
2759@TOP@human_GAPDH_TAA_len41_fa0_ta20_fm6_tm14*126*g,0,0,822,0,822,1.0,126,2759@TOP@human_GAPDH_TAA_len41_fa0_ta20_fm6_tm14,g
2759@TOP@human_GAPDH_TAA_len41_fa0_ta20_fm6_tm14*127*a,834,0,2,0,836,0.002,127,2759@TOP@human_GAPDH_TAA_len41_fa0_ta20_fm6_tm14,a
2759@TOP@human_GAPDH_TAA_len41_fa0_ta20_fm6_tm14*128*c,0,834,0,0,834,0.0,128,2759@TOP@human_GAPDH_TAA_len41_fa0_ta20_fm6_tm14,c
2759@TOP@human_GAPDH_TAA_len41_fa0_ta20_fm6_tm14*129*c,0,831,0,0,831,0.0,129,2759@TOP@human_GAPDH_TAA_len41_fa0_ta20_fm6_tm14,c
2759@TOP@human_GAPDH_TAA_len41_fa0_ta20_fm6_tm14*130*c,0,830,0,0,830,0.0,130,2759@TOP@human_GAPDH_TAA_len41_fa0_ta20_fm6_tm14,c
2759@TOP@human_GAPDH_TAA_len41_fa0_ta20_fm6_tm14*131*c,0,840,0,0,840,0.0,131,2759@TOP@human_GAPDH_TAA_len41_fa0_ta20_fm6_tm14,c
2759@TOP@human_GAPDH_TAA_len41_fa0_ta20_fm6_tm14*132*t,0,0,0,824,824,0.0,132,2759@TOP@human_GAPDH_TAA_len41_fa0_ta20_fm6_tm14,t
2759@TOP@human_GAPDH_TAA_len41_fa0_ta20_fm6_tm14*133*g,0,0,828,0,828,1.0,133,2759@TOP@human_GAPDH_TAA_len41_fa0_ta20_fm6_tm14,g
2759@TOP@human_GAPDH_TAA_len41_fa0_ta20_fm6_tm14*134*g,0,0,829,0,829,1.0,134,2759@TOP@human_GAPDH_TAA_len41_fa0_ta20_fm6_tm14,g
2760@TOP@human_GAPDH_TAA_len41_fa0_ta20_fm6_tm14*114*t,1,4,0,20087,20092,0.0,114,2760@TOP@human_GAPDH_TAA_len41_fa0_ta20_fm6_tm14,t
2760@TOP@human_GAPDH_TAA_len41_fa0_ta20_fm6_tm14*115*c,0,20203,0,0,20203,0.0,115,2760@TOP@human_GAPDH_TAA_len41_fa0_ta20_fm6_tm14,c
2760@TOP@human_GAPDH_TAA_len41_fa0_ta20_fm6_tm14*116*c,0,20130,0,3,20133,0.0,116,2760@TOP@human_GAPDH_TAA_len41_fa0_ta20_fm6_tm14,c
2760@TOP@human_GAPDH_TAA_len41_fa0_ta20_fm6_tm14*117*a,20090,0,21,0,20111,0.001,117,2760@TOP@human_GAPDH_TAA_len41_fa0_ta20_fm6_tm14,a
2760@TOP@human_GAPDH_TAA_len41_fa0_ta20_fm6_tm14*118*a,19804,0,218,1,20023,0.011,118,2760@TOP@human_GAPDH_TAA_len41_fa0_ta20_fm6_tm14,a
2760@TOP@human_GAPDH_TAA_len41_fa0_ta20_fm6_tm14*119*g,1,0,19999,0,20000,1.0,119,2760@TOP@human_GAPDH_TAA_len41_fa0_ta20_fm6_tm14,g
2760@TOP@human_GAPDH_TAA_len41_fa0_ta20_fm6_tm14*120*g,0,0,19902,1,19903,1.0,120,2760@TOP@human_GAPDH_TAA_len41_fa0_ta20_fm6_tm14,g
2760@TOP@human_GAPDH_TAA_len41_fa0_ta20_fm6_tm14*121*a,20096,0,5,3,20104,0.0,121,2760@TOP@human_GAPDH_TAA_len41_fa0_ta20_fm6_tm14,a
2760@TOP@human_GAPDH_TAA_len41_fa0_ta20_fm6_tm14*122*g,0,0,20127,0,20127,1.0,122,2760@TOP@human_GAPDH_TAA_len41_fa0_ta20_fm6_tm14,g
2760@TOP@human_GAPDH_TAA_len41_fa0_ta20_fm6_tm14*123*t,1,4,3,19877,19885,0.0,123,2760@TOP@human_GAPDH_TAA_len41_fa0_ta20_fm6_tm14,t
2760@TOP@human_GAPDH_TAA_len41_fa0_ta20_fm6_tm14*124*a,9473,0,10461,3,19937,0.525,124,2760@TOP@human_GAPDH_TAA_len41_fa0_ta20_fm6_tm14,a
2760@TOP@human_GAPDH_TAA_len41_fa0_ta20_fm6_tm14*125*a,14542,3,5350,0,19895,0.269,125,2760@TOP@human_GAPDH_TAA_len41_fa0_ta20_fm6_tm14,a
2760@TOP@human_GAPDH_TAA_len41_fa0_ta20_fm6_tm14*126*g,1,2,19950,4,19957,1.0,126,2760@TOP@human_GAPDH_TAA_len41_fa0_ta20_fm6_tm14,g
2760@TOP@human_GAPDH_TAA_len41_fa0_ta20_fm6_tm14*127*a,19881,3,181,0,20065,0.009,127,2760@TOP@human_GAPDH_TAA_len41_fa0_ta20_fm6_tm14,a
2760@TOP@human_GAPDH_TAA_len41_fa0_ta20_fm6_tm14*128*c,1,20175,1,3,20180,0.0,128,2760@TOP@human_GAPDH_TAA_len41_fa0_ta20_fm6_tm14,c
2760@TOP@human_GAPDH_TAA_len41_fa0_ta20_fm6_tm14*129*c,0,20068,0,8,20076,0.0,129,2760@TOP@human_GAPDH_TAA_len41_fa0_ta20_fm6_tm14,c
2760@TOP@human_GAPDH_TAA_len41_fa0_ta20_fm6_tm14*130*c,1,20136,0,5,20142,0.0,130,2760@TOP@human_GAPDH_TAA_len41_fa0_ta20_fm6_tm14,c
2760@TOP@human_GAPDH_TAA_len41_fa0_ta20_fm6_tm14*131*c,0,20188,0,0,20188,0.0,131,2760@TOP@human_GAPDH_TAA_len41_fa0_ta20_fm6_tm14,c
2760@TOP@human_GAPDH_TAA_len41_fa0_ta20_fm6_tm14*132*t,5,4,1,19909,19919,0.0,132,2760@TOP@human_GAPDH_TAA_len41_fa0_ta20_fm6_tm14,t
2760@TOP@human_GAPDH_TAA_len41_fa0_ta20_fm6_tm14*133*g,0,0,19891,0,19891,1.0,133,2760@TOP@human_GAPDH_TAA_len41_fa0_ta20_fm6_tm14,g
2760@TOP@human_GAPDH_TAA_len41_fa0_ta20_fm6_tm14*134*g,1,4,19991,0,19996,1.0,134,2760@TOP@human_GAPDH_TAA_len41_fa0_ta20_fm6_tm14,g
2761@TOP@human_GAPDH_TAA_len41_fa0_ta20_fm6_tm14*114*t,0,1,0,970,971,0.0,114,2761@TOP@human_GAPDH_TAA_len41_fa0_ta20_fm6_tm14,t
2761@TOP@human_GAPDH_TAA_len41_fa0_ta20_fm6_tm14*115*c,0,978,0,0,978,0.0,115,2761@TOP@human_GAPDH_TAA_len41_fa0_ta20_fm6_tm14,c
2761@TOP@human_GAPDH_TAA_len41_fa0_ta20_fm6_tm14*116*c,0,974,0,0,974,0.0,116,2761@TOP@human_GAPDH_TAA_len41_fa0_ta20_fm6_tm14,c
2761@TOP@human_GAPDH_TAA_len41_fa0_ta20_fm6_tm14*117*a,973,0,0,0,973,0.0,117,2761@TOP@human_GAPDH_TAA_len41_fa0_ta20_fm6_tm14,a
2761@TOP@human_GAPDH_TAA_len41_fa0_ta20_fm6_tm14*118*a,944,0,21,0,965,0.022,118,2761@TOP@human_GAPDH_TAA_len41_fa0_ta20_fm6_tm14,a
2761@TOP@human_GAPDH_TAA_len41_fa0_ta20_fm6_tm14*119*g,0,0,964,0,964,1.0,119,2761@TOP@human_GAPDH_TAA_len41_fa0_ta20_fm6_tm14,g
2761@TOP@human_GAPDH_TAA_len41_fa0_ta20_fm6_tm14*120*g,0,0,962,0,962,1.0,120,2761@TOP@human_GAPDH_TAA_len41_fa0_ta20_fm6_tm14,g
2761@TOP@human_GAPDH_TAA_len41_fa0_ta20_fm6_tm14*121*a,973,0,0,0,973,0.0,121,2761@TOP@human_GAPDH_TAA_len41_fa0_ta20_fm6_tm14,a
2761@TOP@human_GAPDH_TAA_len41_fa0_ta20_fm6_tm14*122*g,0,0,974,0,974,1.0,122,2761@TOP@human_GAPDH_TAA_len41_fa0_ta20_fm6_tm14,g
2761@TOP@human_GAPDH_TAA_len41_fa0_ta20_fm6_tm14*123*t,0,0,0,963,963,0.0,123,2761@TOP@human_GAPDH_TAA_len41_fa0_ta20_fm6_tm14,t
2761@TOP@human_GAPDH_TAA_len41_fa0_ta20_fm6_tm14*124*a,804,0,159,0,963,0.165,124,2761@TOP@human_GAPDH_TAA_len41_fa0_ta20_fm6_tm14,a
2761@TOP@human_GAPDH_TAA_len41_fa0_ta20_fm6_tm14*125*a,909,0,50,1,960,0.052,125,2761@TOP@human_GAPDH_TAA_len41_fa0_ta20_fm6_tm14,a
2761@TOP@human_GAPDH_TAA_len41_fa0_ta20_fm6_tm14*126*g,0,0,961,0,961,1.0,126,2761@TOP@human_GAPDH_TAA_len41_fa0_ta20_fm6_tm14,g
2761@TOP@human_GAPDH_TAA_len41_fa0_ta20_fm6_tm14*127*a,973,0,1,0,974,0.001,127,2761@TOP@human_GAPDH_TAA_len41_fa0_ta20_fm6_tm14,a
2761@TOP@human_GAPDH_TAA_len41_fa0_ta20_fm6_tm14*128*c,0,970,0,0,970,0.0,128,2761@TOP@human_GAPDH_TAA_len41_fa0_ta20_fm6_tm14,c
2761@TOP@human_GAPDH_TAA_len41_fa0_ta20_fm6_tm14*129*c,0,961,0,0,961,0.0,129,2761@TOP@human_GAPDH_TAA_len41_fa0_ta20_fm6_tm14,c
2761@TOP@human_GAPDH_TAA_len41_fa0_ta20_fm6_tm14*130*c,0,972,0,0,972,0.0,130,2761@TOP@human_GAPDH_TAA_len41_fa0_ta20_fm6_tm14,c
2761@TOP@human_GAPDH_TAA_len41_fa0_ta20_fm6_tm14*131*c,0,973,0,0,973,0.0,131,2761@TOP@human_GAPDH_TAA_len41_fa0_ta20_fm6_tm14,c
2761@TOP@human_GAPDH_TAA_len41_fa0_ta20_fm6_tm14*132*t,0,0,0,961,961,0.0,132,2761@TOP@human_GAPDH_TAA_len41_fa0_ta20_fm6_tm14,t
2761@TOP@human_GAPDH_TAA_len41_fa0_ta20_fm6_tm14*133*g,0,0,964,0,964,1.0,133,2761@TOP@human_GAPDH_TAA_len41_fa0_ta20_fm6_tm14,g
2761@TOP@human_GAPDH_TAA_len41_fa0_ta20_fm6_tm14*134*g,0,0,962,0,962,1.0,134,2761@TOP@human_GAPDH_TAA_len41_fa0_ta20_fm6_tm14,g
2762@TOP@human_GAPDH_TAA_len41_fa0_ta20_fm6_tm14*114*t,0,0,0,597,597,0.0,114,2762@TOP@human_GAPDH_TAA_len41_fa0_ta20_fm6_tm14,t
2762@TOP@human_GAPDH_TAA_len41_fa0_ta20_fm6_tm14*115*c,0,602,0,0,602,0.0,115,2762@TOP@human_GAPDH_TAA_len41_fa0_ta20_fm6_tm14,c
2762@TOP@human_GAPDH_TAA_len41_fa0_ta20_fm6_tm14*116*c,0,596,0,0,596,0.0,116,2762@TOP@human_GAPDH_TAA_len41_fa0_ta20_fm6_tm14,c
2762@TOP@human_GAPDH_TAA_len41_fa0_ta20_fm6_tm14*117*a,594,0,1,0,595,0.002,117,2762@TOP@human_GAPDH_TAA_len41_fa0_ta20_fm6_tm14,a
2762@TOP@human_GAPDH_TAA_len41_fa0_ta20_fm6_tm14*118*a,570,0,22,0,592,0.037,118,2762@TOP@human_GAPDH_TAA_len41_fa0_ta20_fm6_tm14,a
2762@TOP@human_GAPDH_TAA_len41_fa0_ta20_fm6_tm14*119*g,0,0,589,0,589,1.0,119,2762@TOP@human_GAPDH_TAA_len41_fa0_ta20_fm6_tm14,g
2762@TOP@human_GAPDH_TAA_len41_fa0_ta20_fm6_tm14*120*g,0,0,591,0,591,1.0,120,2762@TOP@human_GAPDH_TAA_len41_fa0_ta20_fm6_tm14,g
2762@TOP@human_GAPDH_TAA_len41_fa0_ta20_fm6_tm14*121*a,598,0,0,0,598,0.0,121,2762@TOP@human_GAPDH_TAA_len41_fa0_ta20_fm6_tm14,a
2762@TOP@human_GAPDH_TAA_len41_fa0_ta20_fm6_tm14*122*g,0,0,598,0,598,1.0,122,2762@TOP@human_GAPDH_TAA_len41_fa0_ta20_fm6_tm14,g
2762@TOP@human_GAPDH_TAA_len41_fa0_ta20_fm6_tm14*123*t,0,0,0,584,584,0.0,123,2762@TOP@human_GAPDH_TAA_len41_fa0_ta20_fm6_tm14,t
2762@TOP@human_GAPDH_TAA_len41_fa0_ta20_fm6_tm14*124*a,514,0,74,0,588,0.126,124,2762@TOP@human_GAPDH_TAA_len41_fa0_ta20_fm6_tm14,a
2762@TOP@human_GAPDH_TAA_len41_fa0_ta20_fm6_tm14*125*a,534,0,48,0,582,0.082,125,2762@TOP@human_GAPDH_TAA_len41_fa0_ta20_fm6_tm14,a
2762@TOP@human_GAPDH_TAA_len41_fa0_ta20_fm6_tm14*126*g,0,0,591,0,591,1.0,126,2762@TOP@human_GAPDH_TAA_len41_fa0_ta20_fm6_tm14,g
2762@TOP@human_GAPDH_TAA_len41_fa0_ta20_fm6_tm14*127*a,585,0,9,0,594,0.015,127,2762@TOP@human_GAPDH_TAA_len41_fa0_ta20_fm6_tm14,a
2762@TOP@human_GAPDH_TAA_len41_fa0_ta20_fm6_tm14*128*c,0,599,0,0,599,0.0,128,2762@TOP@human_GAPDH_TAA_len41_fa0_ta20_fm6_tm14,c
2762@TOP@human_GAPDH_TAA_len41_fa0_ta20_fm6_tm14*129*c,0,590,0,0,590,0.0,129,2762@TOP@human_GAPDH_TAA_len41_fa0_ta20_fm6_tm14,c
2762@TOP@human_GAPDH_TAA_len41_fa0_ta20_fm6_tm14*130*c,0,597,0,0,597,0.0,130,2762@TOP@human_GAPDH_TAA_len41_fa0_ta20_fm6_tm14,c
2762@TOP@human_GAPDH_TAA_len41_fa0_ta20_fm6_tm14*131*c,0,598,0,0,598,0.0,131,2762@TOP@human_GAPDH_TAA_len41_fa0_ta20_fm6_tm14,c
2762@TOP@human_GAPDH_TAA_len41_fa0_ta20_fm6_tm14*132*t,1,0,1,586,588,0.002,132,2762@TOP@human_GAPDH_TAA_len41_fa0_ta20_fm6_tm14,t
2762@TOP@human_GAPDH_TAA_len41_fa0_ta20_fm6_tm14*133*g,0,0,592,0,592,1.0,133,2762@TOP@human_GAPDH_TAA_len41_fa0_ta20_fm6_tm14,g
2762@TOP@human_GAPDH_TAA_len41_fa0_ta20_fm6_tm14*134*g,0,0,588,0,588,1.0,134,2762@TOP@human_GAPDH_TAA_len41_fa0_ta20_fm6_tm14,g
2763@TOP@human_GAPDH_TAA_len41_fa0_ta20_fm6_tm14*114*t,3,1,0,4036,4040,0.0,114,2763@TOP@human_GAPDH_TAA_len41_fa0_ta20_fm6_tm14,t
2763@TOP@human_GAPDH_TAA_len41_fa0_ta20_fm6_tm14*115*c,0,4066,0,0,4066,0.0,115,2763@TOP@human_GAPDH_TAA_len41_fa0_ta20_fm6_tm14,c
2763@TOP@human_GAPDH_TAA_len41_fa0_ta20_fm6_tm14*116*c,0,4056,0,0,4056,0.0,116,2763@TOP@human_GAPDH_TAA_len41_fa0_ta20_fm6_tm14,c
2763@TOP@human_GAPDH_TAA_len41_fa0_ta20_fm6_tm14*117*a,4039,0,9,0,4048,0.002,117,2763@TOP@human_GAPDH_TAA_len41_fa0_ta20_fm6_tm14,a
2763@TOP@human_GAPDH_TAA_len41_fa0_ta20_fm6_tm14*118*a,3945,0,82,0,4027,0.02,118,2763@TOP@human_GAPDH_TAA_len41_fa0_ta20_fm6_tm14,a
2763@TOP@human_GAPDH_TAA_len41_fa0_ta20_fm6_tm14*119*g,0,1,4029,0,4030,1.0,119,2763@TOP@human_GAPDH_TAA_len41_fa0_ta20_fm6_tm14,g
2763@TOP@human_GAPDH_TAA_len41_fa0_ta20_fm6_tm14*120*g,0,0,4005,0,4005,1.0,120,2763@TOP@human_GAPDH_TAA_len41_fa0_ta20_fm6_tm14,g
2763@TOP@human_GAPDH_TAA_len41_fa0_ta20_fm6_tm14*121*a,4040,0,4,0,4044,0.001,121,2763@TOP@human_GAPDH_TAA_len41_fa0_ta20_fm6_tm14,a
2763@TOP@human_GAPDH_TAA_len41_fa0_ta20_fm6_tm14*122*g,0,0,4052,0,4052,1.0,122,2763@TOP@human_GAPDH_TAA_len41_fa0_ta20_fm6_tm14,g
2763@TOP@human_GAPDH_TAA_len41_fa0_ta20_fm6_tm14*123*t,0,1,1,3997,3999,0.0,123,2763@TOP@human_GAPDH_TAA_len41_fa0_ta20_fm6_tm14,t
2763@TOP@human_GAPDH_TAA_len41_fa0_ta20_fm6_tm14*124*a,3850,0,142,0,3992,0.036,124,2763@TOP@human_GAPDH_TAA_len41_fa0_ta20_fm6_tm14,a
2763@TOP@human_GAPDH_TAA_len41_fa0_ta20_fm6_tm14*125*a,3767,0,204,0,3971,0.051,125,2763@TOP@human_GAPDH_TAA_len41_fa0_ta20_fm6_tm14,a
2763@TOP@human_GAPDH_TAA_len41_fa0_ta20_fm6_tm14*126*g,0,0,4005,0,4005,1.0,126,2763@TOP@human_GAPDH_TAA_len41_fa0_ta20_fm6_tm14,g
2763@TOP@human_GAPDH_TAA_len41_fa0_ta20_fm6_tm14*127*a,4008,0,20,0,4028,0.005,127,2763@TOP@human_GAPDH_TAA_len41_fa0_ta20_fm6_tm14,a
2763@TOP@human_GAPDH_TAA_len41_fa0_ta20_fm6_tm14*128*c,0,4062,0,0,4062,0.0,128,2763@TOP@human_GAPDH_TAA_len41_fa0_ta20_fm6_tm14,c
2763@TOP@human_GAPDH_TAA_len41_fa0_ta20_fm6_tm14*129*c,0,4033,0,0,4033,0.0,129,2763@TOP@human_GAPDH_TAA_len41_fa0_ta20_fm6_tm14,c
2763@TOP@human_GAPDH_TAA_len41_fa0_ta20_fm6_tm14*130*c,0,4050,1,0,4051,0.0,130,2763@TOP@human_GAPDH_TAA_len41_fa0_ta20_fm6_tm14,c
2763@TOP@human_GAPDH_TAA_len41_fa0_ta20_fm6_tm14*131*c,0,4059,0,0,4059,0.0,131,2763@TOP@human_GAPDH_TAA_len41_fa0_ta20_fm6_tm14,c
2763@TOP@human_GAPDH_TAA_len41_fa0_ta20_fm6_tm14*132*t,2,4,0,3991,3997,0.0,132,2763@TOP@human_GAPDH_TAA_len41_fa0_ta20_fm6_tm14,t
2763@TOP@human_GAPDH_TAA_len41_fa0_ta20_fm6_tm14*133*g,0,0,3991,0,3991,1.0,133,2763@TOP@human_GAPDH_TAA_len41_fa0_ta20_fm6_tm14,g
2763@TOP@human_GAPDH_TAA_len41_fa0_ta20_fm6_tm14*134*g,0,1,4028,1,4030,1.0,134,2763@TOP@human_GAPDH_TAA_len41_fa0_ta20_fm6_tm14,g
2764@TOP@human_GAPDH_TAA_len41_fa0_ta20_fm6_tm14*114*t,2,10,0,25612,25624,0.0,114,2764@TOP@human_GAPDH_TAA_len41_fa0_ta20_fm6_tm14,t
2764@TOP@human_GAPDH_TAA_len41_fa0_ta20_fm6_tm14*115*c,0,25752,0,0,25752,0.0,115,2764@TOP@human_GAPDH_TAA_len41_fa0_ta20_fm6_tm14,c
2764@TOP@human_GAPDH_TAA_len41_fa0_ta20_fm6_tm14*116*c,0,25651,0,0,25651,0.0,116,2764@TOP@human_GAPDH_TAA_len41_fa0_ta20_fm6_tm14,c
2764@TOP@human_GAPDH_TAA_len41_fa0_ta20_fm6_tm14*117*a,25600,0,40,0,25640,0.002,117,2764@TOP@human_GAPDH_TAA_len41_fa0_ta20_fm6_tm14,a
2764@TOP@human_GAPDH_TAA_len41_fa0_ta20_fm6_tm14*118*a,25193,0,295,0,25488,0.012,118,2764@TOP@human_GAPDH_TAA_len41_fa0_ta20_fm6_tm14,a
2764@TOP@human_GAPDH_TAA_len41_fa0_ta20_fm6_tm14*119*g,1,0,25450,0,25451,1.0,119,2764@TOP@human_GAPDH_TAA_len41_fa0_ta20_fm6_tm14,g
2764@TOP@human_GAPDH_TAA_len41_fa0_ta20_fm6_tm14*120*g,0,1,25352,0,25353,1.0,120,2764@TOP@human_GAPDH_TAA_len41_fa0_ta20_fm6_tm14,g
2764@TOP@human_GAPDH_TAA_len41_fa0_ta20_fm6_tm14*121*a,25634,0,6,0,25640,0.0,121,2764@TOP@human_GAPDH_TAA_len41_fa0_ta20_fm6_tm14,a
2764@TOP@human_GAPDH_TAA_len41_fa0_ta20_fm6_tm14*122*g,0,0,25636,0,25636,1.0,122,2764@TOP@human_GAPDH_TAA_len41_fa0_ta20_fm6_tm14,g
2764@TOP@human_GAPDH_TAA_len41_fa0_ta20_fm6_tm14*123*t,2,3,3,25324,25332,0.0,123,2764@TOP@human_GAPDH_TAA_len41_fa0_ta20_fm6_tm14,t
2764@TOP@human_GAPDH_TAA_len41_fa0_ta20_fm6_tm14*124*a,19142,1,6181,0,25324,0.244,124,2764@TOP@human_GAPDH_TAA_len41_fa0_ta20_fm6_tm14,a
2764@TOP@human_GAPDH_TAA_len41_fa0_ta20_fm6_tm14*125*a,20891,3,4368,0,25262,0.173,125,2764@TOP@human_GAPDH_TAA_len41_fa0_ta20_fm6_tm14,a
2764@TOP@human_GAPDH_TAA_len41_fa0_ta20_fm6_tm14*126*g,0,0,25369,4,25373,1.0,126,2764@TOP@human_GAPDH_TAA_len41_fa0_ta20_fm6_tm14,g
2764@TOP@human_GAPDH_TAA_len41_fa0_ta20_fm6_tm14*127*a,25556,2,16,0,25574,0.001,127,2764@TOP@human_GAPDH_TAA_len41_fa0_ta20_fm6_tm14,a
2764@TOP@human_GAPDH_TAA_len41_fa0_ta20_fm6_tm14*128*c,0,25704,3,0,25707,0.0,128,2764@TOP@human_GAPDH_TAA_len41_fa0_ta20_fm6_tm14,c
2764@TOP@human_GAPDH_TAA_len41_fa0_ta20_fm6_tm14*129*c,0,25516,0,4,25520,0.0,129,2764@TOP@human_GAPDH_TAA_len41_fa0_ta20_fm6_tm14,c
2764@TOP@human_GAPDH_TAA_len41_fa0_ta20_fm6_tm14*130*c,1,25659,0,0,25660,0.0,130,2764@TOP@human_GAPDH_TAA_len41_fa0_ta20_fm6_tm14,c
2764@TOP@human_GAPDH_TAA_len41_fa0_ta20_fm6_tm14*131*c,3,25715,0,1,25719,0.0,131,2764@TOP@human_GAPDH_TAA_len41_fa0_ta20_fm6_tm14,c
2764@TOP@human_GAPDH_TAA_len41_fa0_ta20_fm6_tm14*132*t,2,10,1,25369,25382,0.0,132,2764@TOP@human_GAPDH_TAA_len41_fa0_ta20_fm6_tm14,t
2764@TOP@human_GAPDH_TAA_len41_fa0_ta20_fm6_tm14*133*g,1,0,25291,2,25294,1.0,133,2764@TOP@human_GAPDH_TAA_len41_fa0_ta20_fm6_tm14,g
2764@TOP@human_GAPDH_TAA_len41_fa0_ta20_fm6_tm14*134*g,0,0,25448,0,25448,1.0,134,2764@TOP@human_GAPDH_TAA_len41_fa0_ta20_fm6_tm14,g
2765@TOP@human_GAPDH_TAA_len41_fa0_ta20_fm6_tm14*114*t,0,2,0,17346,17348,0.0,114,2765@TOP@human_GAPDH_TAA_len41_fa0_ta20_fm6_tm14,t
2765@TOP@human_GAPDH_TAA_len41_fa0_ta20_fm6_tm14*115*c,1,17425,0,0,17426,0.0,115,2765@TOP@human_GAPDH_TAA_len41_fa0_ta20_fm6_tm14,c
2765@TOP@human_GAPDH_TAA_len41_fa0_ta20_fm6_tm14*116*c,0,17341,0,3,17344,0.0,116,2765@TOP@human_GAPDH_TAA_len41_fa0_ta20_fm6_tm14,c
2765@TOP@human_GAPDH_TAA_len41_fa0_ta20_fm6_tm14*117*a,17321,0,24,0,17345,0.001,117,2765@TOP@human_GAPDH_TAA_len41_fa0_ta20_fm6_tm14,a
2765@TOP@human_GAPDH_TAA_len41_fa0_ta20_fm6_tm14*118*a,17055,1,195,1,17252,0.011,118,2765@TOP@human_GAPDH_TAA_len41_fa0_ta20_fm6_tm14,a
2765@TOP@human_GAPDH_TAA_len41_fa0_ta20_fm6_tm14*119*g,0,1,17235,0,17236,1.0,119,2765@TOP@human_GAPDH_TAA_len41_fa0_ta20_fm6_tm14,g
2765@TOP@human_GAPDH_TAA_len41_fa0_ta20_fm6_tm14*120*g,0,0,17151,3,17154,1.0,120,2765@TOP@human_GAPDH_TAA_len41_fa0_ta20_fm6_tm14,g
2765@TOP@human_GAPDH_TAA_len41_fa0_ta20_fm6_tm14*121*a,17335,0,2,1,17338,0.0,121,2765@TOP@human_GAPDH_TAA_len41_fa0_ta20_fm6_tm14,a
2765@TOP@human_GAPDH_TAA_len41_fa0_ta20_fm6_tm14*122*g,1,0,17362,0,17363,1.0,122,2765@TOP@human_GAPDH_TAA_len41_fa0_ta20_fm6_tm14,g
2765@TOP@human_GAPDH_TAA_len41_fa0_ta20_fm6_tm14*123*t,0,1,1,17145,17147,0.0,123,2765@TOP@human_GAPDH_TAA_len41_fa0_ta20_fm6_tm14,t
2765@TOP@human_GAPDH_TAA_len41_fa0_ta20_fm6_tm14*124*a,12940,2,4157,0,17099,0.243,124,2765@TOP@human_GAPDH_TAA_len41_fa0_ta20_fm6_tm14,a
2765@TOP@human_GAPDH_TAA_len41_fa0_ta20_fm6_tm14*125*a,14259,0,2780,2,17041,0.163,125,2765@TOP@human_GAPDH_TAA_len41_fa0_ta20_fm6_tm14,a
2765@TOP@human_GAPDH_TAA_len41_fa0_ta20_fm6_tm14*126*g,0,1,17177,1,17179,1.0,126,2765@TOP@human_GAPDH_TAA_len41_fa0_ta20_fm6_tm14,g
2765@TOP@human_GAPDH_TAA_len41_fa0_ta20_fm6_tm14*127*a,16779,0,527,0,17306,0.03,127,2765@TOP@human_GAPDH_TAA_len41_fa0_ta20_fm6_tm14,a
2765@TOP@human_GAPDH_TAA_len41_fa0_ta20_fm6_tm14*128*c,2,17379,0,1,17382,0.0,128,2765@TOP@human_GAPDH_TAA_len41_fa0_ta20_fm6_tm14,c
2765@TOP@human_GAPDH_TAA_len41_fa0_ta20_fm6_tm14*129*c,0,17273,0,0,17273,0.0,129,2765@TOP@human_GAPDH_TAA_len41_fa0_ta20_fm6_tm14,c
2765@TOP@human_GAPDH_TAA_len41_fa0_ta20_fm6_tm14*130*c,1,17366,0,1,17368,0.0,130,2765@TOP@human_GAPDH_TAA_len41_fa0_ta20_fm6_tm14,c
2765@TOP@human_GAPDH_TAA_len41_fa0_ta20_fm6_tm14*131*c,2,17392,1,0,17395,0.0,131,2765@TOP@human_GAPDH_TAA_len41_fa0_ta20_fm6_tm14,c
2765@TOP@human_GAPDH_TAA_len41_fa0_ta20_fm6_tm14*132*t,3,6,1,17156,17166,0.0,132,2765@TOP@human_GAPDH_TAA_len41_fa0_ta20_fm6_tm14,t
2765@TOP@human_GAPDH_TAA_len41_fa0_ta20_fm6_tm14*133*g,1,1,17130,0,17132,1.0,133,2765@TOP@human_GAPDH_TAA_len41_fa0_ta20_fm6_tm14,g
2765@TOP@human_GAPDH_TAA_len41_fa0_ta20_fm6_tm14*134*g,1,1,17186,4,17192,1.0,134,2765@TOP@human_GAPDH_TAA_len41_fa0_ta20_fm6_tm14,g
2766@TOP@human_GAPDH_TAA_len41_fa0_ta20_fm6_tm14*114*t,1,0,0,814,815,0.0,114,2766@TOP@human_GAPDH_TAA_len41_fa0_ta20_fm6_tm14,t
2766@TOP@human_GAPDH_TAA_len41_fa0_ta20_fm6_tm14*115*c,0,821,0,0,821,0.0,115,2766@TOP@human_GAPDH_TAA_len41_fa0_ta20_fm6_tm14,c
2766@TOP@human_GAPDH_TAA_len41_fa0_ta20_fm6_tm14*116*c,0,817,0,0,817,0.0,116,2766@TOP@human_GAPDH_TAA_len41_fa0_ta20_fm6_tm14,c
2766@TOP@human_GAPDH_TAA_len41_fa0_ta20_fm6_tm14*117*a,816,0,1,0,817,0.001,117,2766@TOP@human_GAPDH_TAA_len41_fa0_ta20_fm6_tm14,a
2766@TOP@human_GAPDH_TAA_len41_fa0_ta20_fm6_tm14*118*a,790,0,22,0,812,0.027,118,2766@TOP@human_GAPDH_TAA_len41_fa0_ta20_fm6_tm14,a
2766@TOP@human_GAPDH_TAA_len41_fa0_ta20_fm6_tm14*119*g,0,0,810,0,810,1.0,119,2766@TOP@human_GAPDH_TAA_len41_fa0_ta20_fm6_tm14,g
2766@TOP@human_GAPDH_TAA_len41_fa0_ta20_fm6_tm14*120*g,0,0,806,0,806,1.0,120,2766@TOP@human_GAPDH_TAA_len41_fa0_ta20_fm6_tm14,g
2766@TOP@human_GAPDH_TAA_len41_fa0_ta20_fm6_tm14*121*a,814,0,1,0,815,0.001,121,2766@TOP@human_GAPDH_TAA_len41_fa0_ta20_fm6_tm14,a
2766@TOP@human_GAPDH_TAA_len41_fa0_ta20_fm6_tm14*122*g,0,0,818,0,818,1.0,122,2766@TOP@human_GAPDH_TAA_len41_fa0_ta20_fm6_tm14,g
2766@TOP@human_GAPDH_TAA_len41_fa0_ta20_fm6_tm14*123*t,0,0,0,803,803,0.0,123,2766@TOP@human_GAPDH_TAA_len41_fa0_ta20_fm6_tm14,t
2766@TOP@human_GAPDH_TAA_len41_fa0_ta20_fm6_tm14*124*a,680,0,120,0,800,0.15,124,2766@TOP@human_GAPDH_TAA_len41_fa0_ta20_fm6_tm14,a
2766@TOP@human_GAPDH_TAA_len41_fa0_ta20_fm6_tm14*125*a,696,0,111,0,807,0.138,125,2766@TOP@human_GAPDH_TAA_len41_fa0_ta20_fm6_tm14,a
2766@TOP@human_GAPDH_TAA_len41_fa0_ta20_fm6_tm14*126*g,0,0,812,0,812,1.0,126,2766@TOP@human_GAPDH_TAA_len41_fa0_ta20_fm6_tm14,g
2766@TOP@human_GAPDH_TAA_len41_fa0_ta20_fm6_tm14*127*a,813,0,1,0,814,0.001,127,2766@TOP@human_GAPDH_TAA_len41_fa0_ta20_fm6_tm14,a
2766@TOP@human_GAPDH_TAA_len41_fa0_ta20_fm6_tm14*128*c,0,817,0,0,817,0.0,128,2766@TOP@human_GAPDH_TAA_len41_fa0_ta20_fm6_tm14,c
2766@TOP@human_GAPDH_TAA_len41_fa0_ta20_fm6_tm14*129*c,1,809,0,0,810,0.0,129,2766@TOP@human_GAPDH_TAA_len41_fa0_ta20_fm6_tm14,c
2766@TOP@human_GAPDH_TAA_len41_fa0_ta20_fm6_tm14*130*c,0,815,0,0,815,0.0,130,2766@TOP@human_GAPDH_TAA_len41_fa0_ta20_fm6_tm14,c
2766@TOP@human_GAPDH_TAA_len41_fa0_ta20_fm6_tm14*131*c,0,816,0,0,816,0.0,131,2766@TOP@human_GAPDH_TAA_len41_fa0_ta20_fm6_tm14,c
2766@TOP@human_GAPDH_TAA_len41_fa0_ta20_fm6_tm14*132*t,0,0,0,806,806,0.0,132,2766@TOP@human_GAPDH_TAA_len41_fa0_ta20_fm6_tm14,t
2766@TOP@human_GAPDH_TAA_len41_fa0_ta20_fm6_tm14*133*g,0,1,802,0,803,0.999,133,2766@TOP@human_GAPDH_TAA_len41_fa0_ta20_fm6_tm14,g
2766@TOP@human_GAPDH_TAA_len41_fa0_ta20_fm6_tm14*134*g,0,0,807,0,807,1.0,134,2766@TOP@human_GAPDH_TAA_len41_fa0_ta20_fm6_tm14,g
2767@TOP@human_GAPDH_TAA_len41_fa0_ta20_fm6_tm14*114*t,0,1,0,1268,1269,0.0,114,2767@TOP@human_GAPDH_TAA_len41_fa0_ta20_fm6_tm14,t
2767@TOP@human_GAPDH_TAA_len41_fa0_ta20_fm6_tm14*115*c,0,1273,0,0,1273,0.0,115,2767@TOP@human_GAPDH_TAA_len41_fa0_ta20_fm6_tm14,c
2767@TOP@human_GAPDH_TAA_len41_fa0_ta20_fm6_tm14*116*c,0,1263,0,0,1263,0.0,116,2767@TOP@human_GAPDH_TAA_len41_fa0_ta20_fm6_tm14,c
2767@TOP@human_GAPDH_TAA_len41_fa0_ta20_fm6_tm14*117*a,1265,0,2,0,1267,0.002,117,2767@TOP@human_GAPDH_TAA_len41_fa0_ta20_fm6_tm14,a
2767@TOP@human_GAPDH_TAA_len41_fa0_ta20_fm6_tm14*118*a,1228,0,29,0,1257,0.023,118,2767@TOP@human_GAPDH_TAA_len41_fa0_ta20_fm6_tm14,a
2767@TOP@human_GAPDH_TAA_len41_fa0_ta20_fm6_tm14*119*g,0,0,1258,0,1258,1.0,119,2767@TOP@human_GAPDH_TAA_len41_fa0_ta20_fm6_tm14,g
2767@TOP@human_GAPDH_TAA_len41_fa0_ta20_fm6_tm14*120*g,0,0,1242,0,1242,1.0,120,2767@TOP@human_GAPDH_TAA_len41_fa0_ta20_fm6_tm14,g
2767@TOP@human_GAPDH_TAA_len41_fa0_ta20_fm6_tm14*121*a,1264,0,3,0,1267,0.002,121,2767@TOP@human_GAPDH_TAA_len41_fa0_ta20_fm6_tm14,a
2767@TOP@human_GAPDH_TAA_len41_fa0_ta20_fm6_tm14*122*g,0,0,1266,0,1266,1.0,122,2767@TOP@human_GAPDH_TAA_len41_fa0_ta20_fm6_tm14,g
2767@TOP@human_GAPDH_TAA_len41_fa0_ta20_fm6_tm14*123*t,0,0,0,1249,1249,0.0,123,2767@TOP@human_GAPDH_TAA_len41_fa0_ta20_fm6_tm14,t
2767@TOP@human_GAPDH_TAA_len41_fa0_ta20_fm6_tm14*124*a,829,0,420,0,1249,0.336,124,2767@TOP@human_GAPDH_TAA_len41_fa0_ta20_fm6_tm14,a
2767@TOP@human_GAPDH_TAA_len41_fa0_ta20_fm6_tm14*125*a,1038,0,202,0,1240,0.163,125,2767@TOP@human_GAPDH_TAA_len41_fa0_ta20_fm6_tm14,a
2767@TOP@human_GAPDH_TAA_len41_fa0_ta20_fm6_tm14*126*g,0,0,1251,0,1251,1.0,126,2767@TOP@human_GAPDH_TAA_len41_fa0_ta20_fm6_tm14,g
2767@TOP@human_GAPDH_TAA_len41_fa0_ta20_fm6_tm14*127*a,1268,0,0,0,1268,0.0,127,2767@TOP@human_GAPDH_TAA_len41_fa0_ta20_fm6_tm14,a
2767@TOP@human_GAPDH_TAA_len41_fa0_ta20_fm6_tm14*128*c,0,1270,0,0,1270,0.0,128,2767@TOP@human_GAPDH_TAA_len41_fa0_ta20_fm6_tm14,c
2767@TOP@human_GAPDH_TAA_len41_fa0_ta20_fm6_tm14*129*c,0,1261,0,0,1261,0.0,129,2767@TOP@human_GAPDH_TAA_len41_fa0_ta20_fm6_tm14,c
2767@TOP@human_GAPDH_TAA_len41_fa0_ta20_fm6_tm14*130*c,0,1268,0,0,1268,0.0,130,2767@TOP@human_GAPDH_TAA_len41_fa0_ta20_fm6_tm14,c
2767@TOP@human_GAPDH_TAA_len41_fa0_ta20_fm6_tm14*131*c,0,1271,0,0,1271,0.0,131,2767@TOP@human_GAPDH_TAA_len41_fa0_ta20_fm6_tm14,c
2767@TOP@human_GAPDH_TAA_len41_fa0_ta20_fm6_tm14*132*t,0,0,0,1257,1257,0.0,132,2767@TOP@human_GAPDH_TAA_len41_fa0_ta20_fm6_tm14,t
2767@TOP@human_GAPDH_TAA_len41_fa0_ta20_fm6_tm14*133*g,0,0,1252,0,1252,1.0,133,2767@TOP@human_GAPDH_TAA_len41_fa0_ta20_fm6_tm14,g
2767@TOP@human_GAPDH_TAA_len41_fa0_ta20_fm6_tm14*134*g,0,0,1249,2,1251,0.998,134,2767@TOP@human_GAPDH_TAA_len41_fa0_ta20_fm6_tm14,g
2768@TOP@human_GAPDH_TAA_len41_fa0_ta20_fm6_tm14*114*t,0,1,0,625,626,0.0,114,2768@TOP@human_GAPDH_TAA_len41_fa0_ta20_fm6_tm14,t
2768@TOP@human_GAPDH_TAA_len41_fa0_ta20_fm6_tm14*115*c,0,627,0,0,627,0.0,115,2768@TOP@human_GAPDH_TAA_len41_fa0_ta20_fm6_tm14,c
2768@TOP@human_GAPDH_TAA_len41_fa0_ta20_fm6_tm14*116*c,0,624,0,0,624,0.0,116,2768@TOP@human_GAPDH_TAA_len41_fa0_ta20_fm6_tm14,c
2768@TOP@human_GAPDH_TAA_len41_fa0_ta20_fm6_tm14*117*a,617,0,8,0,625,0.013,117,2768@TOP@human_GAPDH_TAA_len41_fa0_ta20_fm6_tm14,a
2768@TOP@human_GAPDH_TAA_len41_fa0_ta20_fm6_tm14*118*a,608,0,12,0,620,0.019,118,2768@TOP@human_GAPDH_TAA_len41_fa0_ta20_fm6_tm14,a
2768@TOP@human_GAPDH_TAA_len41_fa0_ta20_fm6_tm14*119*g,0,0,622,0,622,1.0,119,2768@TOP@human_GAPDH_TAA_len41_fa0_ta20_fm6_tm14,g
2768@TOP@human_GAPDH_TAA_len41_fa0_ta20_fm6_tm14*120*g,0,0,619,0,619,1.0,120,2768@TOP@human_GAPDH_TAA_len41_fa0_ta20_fm6_tm14,g
2768@TOP@human_GAPDH_TAA_len41_fa0_ta20_fm6_tm14*121*a,627,0,0,0,627,0.0,121,2768@TOP@human_GAPDH_TAA_len41_fa0_ta20_fm6_tm14,a
2768@TOP@human_GAPDH_TAA_len41_fa0_ta20_fm6_tm14*122*g,0,0,628,0,628,1.0,122,2768@TOP@human_GAPDH_TAA_len41_fa0_ta20_fm6_tm14,g
2768@TOP@human_GAPDH_TAA_len41_fa0_ta20_fm6_tm14*123*t,0,0,0,613,613,0.0,123,2768@TOP@human_GAPDH_TAA_len41_fa0_ta20_fm6_tm14,t
2768@TOP@human_GAPDH_TAA_len41_fa0_ta20_fm6_tm14*124*a,521,0,99,0,620,0.16,124,2768@TOP@human_GAPDH_TAA_len41_fa0_ta20_fm6_tm14,a
2768@TOP@human_GAPDH_TAA_len41_fa0_ta20_fm6_tm14*125*a,590,0,23,0,613,0.038,125,2768@TOP@human_GAPDH_TAA_len41_fa0_ta20_fm6_tm14,a
2768@TOP@human_GAPDH_TAA_len41_fa0_ta20_fm6_tm14*126*g,0,0,621,0,621,1.0,126,2768@TOP@human_GAPDH_TAA_len41_fa0_ta20_fm6_tm14,g
2768@TOP@human_GAPDH_TAA_len41_fa0_ta20_fm6_tm14*127*a,618,0,3,0,621,0.005,127,2768@TOP@human_GAPDH_TAA_len41_fa0_ta20_fm6_tm14,a
2768@TOP@human_GAPDH_TAA_len41_fa0_ta20_fm6_tm14*128*c,0,629,0,0,629,0.0,128,2768@TOP@human_GAPDH_TAA_len41_fa0_ta20_fm6_tm14,c
2768@TOP@human_GAPDH_TAA_len41_fa0_ta20_fm6_tm14*129*c,0,624,0,0,624,0.0,129,2768@TOP@human_GAPDH_TAA_len41_fa0_ta20_fm6_tm14,c
2768@TOP@human_GAPDH_TAA_len41_fa0_ta20_fm6_tm14*130*c,0,625,0,0,625,0.0,130,2768@TOP@human_GAPDH_TAA_len41_fa0_ta20_fm6_tm14,c
2768@TOP@human_GAPDH_TAA_len41_fa0_ta20_fm6_tm14*131*c,0,626,0,0,626,0.0,131,2768@TOP@human_GAPDH_TAA_len41_fa0_ta20_fm6_tm14,c
2768@TOP@human_GAPDH_TAA_len41_fa0_ta20_fm6_tm14*132*t,0,0,0,617,617,0.0,132,2768@TOP@human_GAPDH_TAA_len41_fa0_ta20_fm6_tm14,t
2768@TOP@human_GAPDH_TAA_len41_fa0_ta20_fm6_tm14*133*g,0,0,612,0,612,1.0,133,2768@TOP@human_GAPDH_TAA_len41_fa0_ta20_fm6_tm14,g
2768@TOP@human_GAPDH_TAA_len41_fa0_ta20_fm6_tm14*134*g,0,0,619,0,619,1.0,134,2768@TOP@human_GAPDH_TAA_len41_fa0_ta20_fm6_tm14,g
2769@TOP@human_GAPDH_TAA_len41_fa0_ta20_fm6_tm14*114*t,0,0,0,563,563,0.0,114,2769@TOP@human_GAPDH_TAA_len41_fa0_ta20_fm6_tm14,t
2769@TOP@human_GAPDH_TAA_len41_fa0_ta20_fm6_tm14*115*c,0,574,0,0,574,0.0,115,2769@TOP@human_GAPDH_TAA_len41_fa0_ta20_fm6_tm14,c
2769@TOP@human_GAPDH_TAA_len41_fa0_ta20_fm6_tm14*116*c,0,570,0,0,570,0.0,116,2769@TOP@human_GAPDH_TAA_len41_fa0_ta20_fm6_tm14,c
2769@TOP@human_GAPDH_TAA_len41_fa0_ta20_fm6_tm14*117*a,571,0,0,0,571,0.0,117,2769@TOP@human_GAPDH_TAA_len41_fa0_ta20_fm6_tm14,a
2769@TOP@human_GAPDH_TAA_len41_fa0_ta20_fm6_tm14*118*a,558,0,12,0,570,0.021,118,2769@TOP@human_GAPDH_TAA_len41_fa0_ta20_fm6_tm14,a
2769@TOP@human_GAPDH_TAA_len41_fa0_ta20_fm6_tm14*119*g,0,0,567,0,567,1.0,119,2769@TOP@human_GAPDH_TAA_len41_fa0_ta20_fm6_tm14,g
2769@TOP@human_GAPDH_TAA_len41_fa0_ta20_fm6_tm14*120*g,0,0,554,0,554,1.0,120,2769@TOP@human_GAPDH_TAA_len41_fa0_ta20_fm6_tm14,g
2769@TOP@human_GAPDH_TAA_len41_fa0_ta20_fm6_tm14*121*a,573,0,0,0,573,0.0,121,2769@TOP@human_GAPDH_TAA_len41_fa0_ta20_fm6_tm14,a
2769@TOP@human_GAPDH_TAA_len41_fa0_ta20_fm6_tm14*122*g,0,0,572,0,572,1.0,122,2769@TOP@human_GAPDH_TAA_len41_fa0_ta20_fm6_tm14,g
2769@TOP@human_GAPDH_TAA_len41_fa0_ta20_fm6_tm14*123*t,0,0,0,562,562,0.0,123,2769@TOP@human_GAPDH_TAA_len41_fa0_ta20_fm6_tm14,t
2769@TOP@human_GAPDH_TAA_len41_fa0_ta20_fm6_tm14*124*a,358,0,205,0,563,0.364,124,2769@TOP@human_GAPDH_TAA_len41_fa0_ta20_fm6_tm14,a
2769@TOP@human_GAPDH_TAA_len41_fa0_ta20_fm6_tm14*125*a,485,0,70,0,555,0.126,125,2769@TOP@human_GAPDH_TAA_len41_fa0_ta20_fm6_tm14,a
2769@TOP@human_GAPDH_TAA_len41_fa0_ta20_fm6_tm14*126*g,0,1,567,0,568,0.998,126,2769@TOP@human_GAPDH_TAA_len41_fa0_ta20_fm6_tm14,g
2769@TOP@human_GAPDH_TAA_len41_fa0_ta20_fm6_tm14*127*a,562,0,4,0,566,0.007,127,2769@TOP@human_GAPDH_TAA_len41_fa0_ta20_fm6_tm14,a
2769@TOP@human_GAPDH_TAA_len41_fa0_ta20_fm6_tm14*128*c,0,570,0,0,570,0.0,128,2769@TOP@human_GAPDH_TAA_len41_fa0_ta20_fm6_tm14,c
2769@TOP@human_GAPDH_TAA_len41_fa0_ta20_fm6_tm14*129*c,0,567,0,0,567,0.0,129,2769@TOP@human_GAPDH_TAA_len41_fa0_ta20_fm6_tm14,c
2769@TOP@human_GAPDH_TAA_len41_fa0_ta20_fm6_tm14*130*c,0,570,0,0,570,0.0,130,2769@TOP@human_GAPDH_TAA_len41_fa0_ta20_fm6_tm14,c
2769@TOP@human_GAPDH_TAA_len41_fa0_ta20_fm6_tm14*131*c,0,572,0,0,572,0.0,131,2769@TOP@human_GAPDH_TAA_len41_fa0_ta20_fm6_tm14,c
2769@TOP@human_GAPDH_TAA_len41_fa0_ta20_fm6_tm14*132*t,0,0,0,556,556,0.0,132,2769@TOP@human_GAPDH_TAA_len41_fa0_ta20_fm6_tm14,t
2769@TOP@human_GAPDH_TAA_len41_fa0_ta20_fm6_tm14*133*g,0,0,554,0,554,1.0,133,2769@TOP@human_GAPDH_TAA_len41_fa0_ta20_fm6_tm14,g
2769@TOP@human_GAPDH_TAA_len41_fa0_ta20_fm6_tm14*134*g,0,0,569,0,569,1.0,134,2769@TOP@human_GAPDH_TAA_len41_fa0_ta20_fm6_tm14,g
2770@TOP@human_GAPDH_TAA_len41_fa0_ta20_fm6_tm14*114*t,0,3,0,3815,3818,0.0,114,2770@TOP@human_GAPDH_TAA_len41_fa0_ta20_fm6_tm14,t
2770@TOP@human_GAPDH_TAA_len41_fa0_ta20_fm6_tm14*115*c,0,3855,0,0,3855,0.0,115,2770@TOP@human_GAPDH_TAA_len41_fa0_ta20_fm6_tm14,c
2770@TOP@human_GAPDH_TAA_len41_fa0_ta20_fm6_tm14*116*c,1,3831,0,0,3832,0.0,116,2770@TOP@human_GAPDH_TAA_len41_fa0_ta20_fm6_tm14,c
2770@TOP@human_GAPDH_TAA_len41_fa0_ta20_fm6_tm14*117*a,3823,0,15,0,3838,0.004,117,2770@TOP@human_GAPDH_TAA_len41_fa0_ta20_fm6_tm14,a
2770@TOP@human_GAPDH_TAA_len41_fa0_ta20_fm6_tm14*118*a,3703,0,112,0,3815,0.029,118,2770@TOP@human_GAPDH_TAA_len41_fa0_ta20_fm6_tm14,a
2770@TOP@human_GAPDH_TAA_len41_fa0_ta20_fm6_tm14*119*g,0,0,3808,0,3808,1.0,119,2770@TOP@human_GAPDH_TAA_len41_fa0_ta20_fm6_tm14,g
2770@TOP@human_GAPDH_TAA_len41_fa0_ta20_fm6_tm14*120*g,1,0,3789,0,3790,1.0,120,2770@TOP@human_GAPDH_TAA_len41_fa0_ta20_fm6_tm14,g
2770@TOP@human_GAPDH_TAA_len41_fa0_ta20_fm6_tm14*121*a,3826,0,2,0,3828,0.001,121,2770@TOP@human_GAPDH_TAA_len41_fa0_ta20_fm6_tm14,a
2770@TOP@human_GAPDH_TAA_len41_fa0_ta20_fm6_tm14*122*g,1,0,3834,0,3835,1.0,122,2770@TOP@human_GAPDH_TAA_len41_fa0_ta20_fm6_tm14,g
2770@TOP@human_GAPDH_TAA_len41_fa0_ta20_fm6_tm14*123*t,0,1,0,3797,3798,0.0,123,2770@TOP@human_GAPDH_TAA_len41_fa0_ta20_fm6_tm14,t
2770@TOP@human_GAPDH_TAA_len41_fa0_ta20_fm6_tm14*124*a,1787,0,1998,1,3786,0.528,124,2770@TOP@human_GAPDH_TAA_len41_fa0_ta20_fm6_tm14,a
2770@TOP@human_GAPDH_TAA_len41_fa0_ta20_fm6_tm14*125*a,1582,1,2212,0,3795,0.583,125,2770@TOP@human_GAPDH_TAA_len41_fa0_ta20_fm6_tm14,a
2770@TOP@human_GAPDH_TAA_len41_fa0_ta20_fm6_tm14*126*g,0,0,3793,0,3793,1.0,126,2770@TOP@human_GAPDH_TAA_len41_fa0_ta20_fm6_tm14,g
2770@TOP@human_GAPDH_TAA_len41_fa0_ta20_fm6_tm14*127*a,3816,0,6,0,3822,0.002,127,2770@TOP@human_GAPDH_TAA_len41_fa0_ta20_fm6_tm14,a
2770@TOP@human_GAPDH_TAA_len41_fa0_ta20_fm6_tm14*128*c,0,3843,1,0,3844,0.0,128,2770@TOP@human_GAPDH_TAA_len41_fa0_ta20_fm6_tm14,c
2770@TOP@human_GAPDH_TAA_len41_fa0_ta20_fm6_tm14*129*c,0,3827,0,0,3827,0.0,129,2770@TOP@human_GAPDH_TAA_len41_fa0_ta20_fm6_tm14,c
2770@TOP@human_GAPDH_TAA_len41_fa0_ta20_fm6_tm14*130*c,1,3837,0,0,3838,0.0,130,2770@TOP@human_GAPDH_TAA_len41_fa0_ta20_fm6_tm14,c
2770@TOP@human_GAPDH_TAA_len41_fa0_ta20_fm6_tm14*131*c,1,3844,0,0,3845,0.0,131,2770@TOP@human_GAPDH_TAA_len41_fa0_ta20_fm6_tm14,c
2770@TOP@human_GAPDH_TAA_len41_fa0_ta20_fm6_tm14*132*t,0,3,0,3794,3797,0.0,132,2770@TOP@human_GAPDH_TAA_len41_fa0_ta20_fm6_tm14,t
2770@TOP@human_GAPDH_TAA_len41_fa0_ta20_fm6_tm14*133*g,0,0,3800,0,3800,1.0,133,2770@TOP@human_GAPDH_TAA_len41_fa0_ta20_fm6_tm14,g
2770@TOP@human_GAPDH_TAA_len41_fa0_ta20_fm6_tm14*134*g,0,0,3810,0,3810,1.0,134,2770@TOP@human_GAPDH_TAA_len41_fa0_ta20_fm6_tm14,g
2771@TOP@human_GAPDH_TAA_len41_fa0_ta20_fm6_tm14*114*t,1,1,0,6725,6727,0.0,114,2771@TOP@human_GAPDH_TAA_len41_fa0_ta20_fm6_tm14,t
2771@TOP@human_GAPDH_TAA_len41_fa0_ta20_fm6_tm14*115*c,0,6754,0,0,6754,0.0,115,2771@TOP@human_GAPDH_TAA_len41_fa0_ta20_fm6_tm14,c
2771@TOP@human_GAPDH_TAA_len41_fa0_ta20_fm6_tm14*116*c,1,6733,0,0,6734,0.0,116,2771@TOP@human_GAPDH_TAA_len41_fa0_ta20_fm6_tm14,c
2771@TOP@human_GAPDH_TAA_len41_fa0_ta20_fm6_tm14*117*a,6708,0,4,0,6712,0.001,117,2771@TOP@human_GAPDH_TAA_len41_fa0_ta20_fm6_tm14,a
2771@TOP@human_GAPDH_TAA_len41_fa0_ta20_fm6_tm14*118*a,6560,0,110,3,6673,0.016,118,2771@TOP@human_GAPDH_TAA_len41_fa0_ta20_fm6_tm14,a
2771@TOP@human_GAPDH_TAA_len41_fa0_ta20_fm6_tm14*119*g,0,1,6685,0,6686,1.0,119,2771@TOP@human_GAPDH_TAA_len41_fa0_ta20_fm6_tm14,g
2771@TOP@human_GAPDH_TAA_len41_fa0_ta20_fm6_tm14*120*g,0,0,6658,0,6658,1.0,120,2771@TOP@human_GAPDH_TAA_len41_fa0_ta20_fm6_tm14,g
2771@TOP@human_GAPDH_TAA_len41_fa0_ta20_fm6_tm14*121*a,6716,0,4,0,6720,0.001,121,2771@TOP@human_GAPDH_TAA_len41_fa0_ta20_fm6_tm14,a
2771@TOP@human_GAPDH_TAA_len41_fa0_ta20_fm6_tm14*122*g,1,0,6734,0,6735,1.0,122,2771@TOP@human_GAPDH_TAA_len41_fa0_ta20_fm6_tm14,g
2771@TOP@human_GAPDH_TAA_len41_fa0_ta20_fm6_tm14*123*t,2,0,1,6655,6658,0.0,123,2771@TOP@human_GAPDH_TAA_len41_fa0_ta20_fm6_tm14,t
2771@TOP@human_GAPDH_TAA_len41_fa0_ta20_fm6_tm14*124*a,3065,0,3602,0,6667,0.54,124,2771@TOP@human_GAPDH_TAA_len41_fa0_ta20_fm6_tm14,a
2771@TOP@human_GAPDH_TAA_len41_fa0_ta20_fm6_tm14*125*a,3644,0,2978,0,6622,0.45,125,2771@TOP@human_GAPDH_TAA_len41_fa0_ta20_fm6_tm14,a
2771@TOP@human_GAPDH_TAA_len41_fa0_ta20_fm6_tm14*126*g,0,0,6676,1,6677,1.0,126,2771@TOP@human_GAPDH_TAA_len41_fa0_ta20_fm6_tm14,g
2771@TOP@human_GAPDH_TAA_len41_fa0_ta20_fm6_tm14*127*a,6711,1,2,0,6714,0.0,127,2771@TOP@human_GAPDH_TAA_len41_fa0_ta20_fm6_tm14,a
2771@TOP@human_GAPDH_TAA_len41_fa0_ta20_fm6_tm14*128*c,0,6727,0,0,6727,0.0,128,2771@TOP@human_GAPDH_TAA_len41_fa0_ta20_fm6_tm14,c
2771@TOP@human_GAPDH_TAA_len41_fa0_ta20_fm6_tm14*129*c,0,6708,0,0,6708,0.0,129,2771@TOP@human_GAPDH_TAA_len41_fa0_ta20_fm6_tm14,c
2771@TOP@human_GAPDH_TAA_len41_fa0_ta20_fm6_tm14*130*c,0,6718,0,6,6724,0.0,130,2771@TOP@human_GAPDH_TAA_len41_fa0_ta20_fm6_tm14,c
2771@TOP@human_GAPDH_TAA_len41_fa0_ta20_fm6_tm14*131*c,3,6741,0,0,6744,0.0,131,2771@TOP@human_GAPDH_TAA_len41_fa0_ta20_fm6_tm14,c
2771@TOP@human_GAPDH_TAA_len41_fa0_ta20_fm6_tm14*132*t,0,0,0,6675,6675,0.0,132,2771@TOP@human_GAPDH_TAA_len41_fa0_ta20_fm6_tm14,t
2771@TOP@human_GAPDH_TAA_len41_fa0_ta20_fm6_tm14*133*g,0,1,6662,0,6663,1.0,133,2771@TOP@human_GAPDH_TAA_len41_fa0_ta20_fm6_tm14,g
2771@TOP@human_GAPDH_TAA_len41_fa0_ta20_fm6_tm14*134*g,0,0,6683,0,6683,1.0,134,2771@TOP@human_GAPDH_TAA_len41_fa0_ta20_fm6_tm14,g
2772@TOP@human_GAPDH_TAA_len41_fa0_ta20_fm6_tm14*114*t,0,0,0,2375,2375,0.0,114,2772@TOP@human_GAPDH_TAA_len41_fa0_ta20_fm6_tm14,t
2772@TOP@human_GAPDH_TAA_len41_fa0_ta20_fm6_tm14*115*c,0,2384,0,0,2384,0.0,115,2772@TOP@human_GAPDH_TAA_len41_fa0_ta20_fm6_tm14,c
2772@TOP@human_GAPDH_TAA_len41_fa0_ta20_fm6_tm14*116*c,0,2368,0,0,2368,0.0,116,2772@TOP@human_GAPDH_TAA_len41_fa0_ta20_fm6_tm14,c
2772@TOP@human_GAPDH_TAA_len41_fa0_ta20_fm6_tm14*117*a,2374,0,0,0,2374,0.0,117,2772@TOP@human_GAPDH_TAA_len41_fa0_ta20_fm6_tm14,a
2772@TOP@human_GAPDH_TAA_len41_fa0_ta20_fm6_tm14*118*a,2315,0,43,0,2358,0.018,118,2772@TOP@human_GAPDH_TAA_len41_fa0_ta20_fm6_tm14,a
2772@TOP@human_GAPDH_TAA_len41_fa0_ta20_fm6_tm14*119*g,0,0,2353,0,2353,1.0,119,2772@TOP@human_GAPDH_TAA_len41_fa0_ta20_fm6_tm14,g
2772@TOP@human_GAPDH_TAA_len41_fa0_ta20_fm6_tm14*120*g,0,0,2333,0,2333,1.0,120,2772@TOP@human_GAPDH_TAA_len41_fa0_ta20_fm6_tm14,g
2772@TOP@human_GAPDH_TAA_len41_fa0_ta20_fm6_tm14*121*a,2374,0,1,0,2375,0.0,121,2772@TOP@human_GAPDH_TAA_len41_fa0_ta20_fm6_tm14,a
2772@TOP@human_GAPDH_TAA_len41_fa0_ta20_fm6_tm14*122*g,0,0,2369,0,2369,1.0,122,2772@TOP@human_GAPDH_TAA_len41_fa0_ta20_fm6_tm14,g
2772@TOP@human_GAPDH_TAA_len41_fa0_ta20_fm6_tm14*123*t,0,0,0,2333,2333,0.0,123,2772@TOP@human_GAPDH_TAA_len41_fa0_ta20_fm6_tm14,t
2772@TOP@human_GAPDH_TAA_len41_fa0_ta20_fm6_tm14*124*a,1894,1,452,0,2347,0.193,124,2772@TOP@human_GAPDH_TAA_len41_fa0_ta20_fm6_tm14,a
2772@TOP@human_GAPDH_TAA_len41_fa0_ta20_fm6_tm14*125*a,1855,0,476,0,2331,0.204,125,2772@TOP@human_GAPDH_TAA_len41_fa0_ta20_fm6_tm14,a
2772@TOP@human_GAPDH_TAA_len41_fa0_ta20_fm6_tm14*126*g,0,0,2347,0,2347,1.0,126,2772@TOP@human_GAPDH_TAA_len41_fa0_ta20_fm6_tm14,g
2772@TOP@human_GAPDH_TAA_len41_fa0_ta20_fm6_tm14*127*a,2280,0,85,0,2365,0.036,127,2772@TOP@human_GAPDH_TAA_len41_fa0_ta20_fm6_tm14,a
2772@TOP@human_GAPDH_TAA_len41_fa0_ta20_fm6_tm14*128*c,0,2377,0,0,2377,0.0,128,2772@TOP@human_GAPDH_TAA_len41_fa0_ta20_fm6_tm14,c
2772@TOP@human_GAPDH_TAA_len41_fa0_ta20_fm6_tm14*129*c,0,2357,0,0,2357,0.0,129,2772@TOP@human_GAPDH_TAA_len41_fa0_ta20_fm6_tm14,c
2772@TOP@human_GAPDH_TAA_len41_fa0_ta20_fm6_tm14*130*c,0,2376,0,0,2376,0.0,130,2772@TOP@human_GAPDH_TAA_len41_fa0_ta20_fm6_tm14,c
2772@TOP@human_GAPDH_TAA_len41_fa0_ta20_fm6_tm14*131*c,0,2373,0,4,2377,0.0,131,2772@TOP@human_GAPDH_TAA_len41_fa0_ta20_fm6_tm14,c
2772@TOP@human_GAPDH_TAA_len41_fa0_ta20_fm6_tm14*132*t,1,1,0,2341,2343,0.0,132,2772@TOP@human_GAPDH_TAA_len41_fa0_ta20_fm6_tm14,t
2772@TOP@human_GAPDH_TAA_len41_fa0_ta20_fm6_tm14*133*g,0,0,2335,0,2335,1.0,133,2772@TOP@human_GAPDH_TAA_len41_fa0_ta20_fm6_tm14,g
2772@TOP@human_GAPDH_TAA_len41_fa0_ta20_fm6_tm14*134*g,0,0,2364,1,2365,1.0,134,2772@TOP@human_GAPDH_TAA_len41_fa0_ta20_fm6_tm14,g
2773@TOP@human_GAPDH_TAA_len41_fa0_ta20_fm6_tm14*114*t,1,5,0,6943,6949,0.0,114,2773@TOP@human_GAPDH_TAA_len41_fa0_ta20_fm6_tm14,t
2773@TOP@human_GAPDH_TAA_len41_fa0_ta20_fm6_tm14*115*c,0,6999,0,0,6999,0.0,115,2773@TOP@human_GAPDH_TAA_len41_fa0_ta20_fm6_tm14,c
2773@TOP@human_GAPDH_TAA_len41_fa0_ta20_fm6_tm14*116*c,0,6971,0,1,6972,0.0,116,2773@TOP@human_GAPDH_TAA_len41_fa0_ta20_fm6_tm14,c
2773@TOP@human_GAPDH_TAA_len41_fa0_ta20_fm6_tm14*117*a,6947,0,19,0,6966,0.003,117,2773@TOP@human_GAPDH_TAA_len41_fa0_ta20_fm6_tm14,a
2773@TOP@human_GAPDH_TAA_len41_fa0_ta20_fm6_tm14*118*a,6775,0,149,0,6924,0.022,118,2773@TOP@human_GAPDH_TAA_len41_fa0_ta20_fm6_tm14,a
2773@TOP@human_GAPDH_TAA_len41_fa0_ta20_fm6_tm14*119*g,0,0,6918,0,6918,1.0,119,2773@TOP@human_GAPDH_TAA_len41_fa0_ta20_fm6_tm14,g
2773@TOP@human_GAPDH_TAA_len41_fa0_ta20_fm6_tm14*120*g,0,0,6896,0,6896,1.0,120,2773@TOP@human_GAPDH_TAA_len41_fa0_ta20_fm6_tm14,g
2773@TOP@human_GAPDH_TAA_len41_fa0_ta20_fm6_tm14*121*a,6958,0,3,0,6961,0.0,121,2773@TOP@human_GAPDH_TAA_len41_fa0_ta20_fm6_tm14,a
2773@TOP@human_GAPDH_TAA_len41_fa0_ta20_fm6_tm14*122*g,1,0,6987,0,6988,1.0,122,2773@TOP@human_GAPDH_TAA_len41_fa0_ta20_fm6_tm14,g
2773@TOP@human_GAPDH_TAA_len41_fa0_ta20_fm6_tm14*123*t,1,0,0,6881,6882,0.0,123,2773@TOP@human_GAPDH_TAA_len41_fa0_ta20_fm6_tm14,t
2773@TOP@human_GAPDH_TAA_len41_fa0_ta20_fm6_tm14*124*a,5146,0,1750,0,6896,0.254,124,2773@TOP@human_GAPDH_TAA_len41_fa0_ta20_fm6_tm14,a
2773@TOP@human_GAPDH_TAA_len41_fa0_ta20_fm6_tm14*125*a,6311,2,558,0,6871,0.081,125,2773@TOP@human_GAPDH_TAA_len41_fa0_ta20_fm6_tm14,a
2773@TOP@human_GAPDH_TAA_len41_fa0_ta20_fm6_tm14*126*g,0,0,6915,0,6915,1.0,126,2773@TOP@human_GAPDH_TAA_len41_fa0_ta20_fm6_tm14,g
2773@TOP@human_GAPDH_TAA_len41_fa0_ta20_fm6_tm14*127*a,6864,1,90,0,6955,0.013,127,2773@TOP@human_GAPDH_TAA_len41_fa0_ta20_fm6_tm14,a
2773@TOP@human_GAPDH_TAA_len41_fa0_ta20_fm6_tm14*128*c,1,6984,0,1,6986,0.0,128,2773@TOP@human_GAPDH_TAA_len41_fa0_ta20_fm6_tm14,c
2773@TOP@human_GAPDH_TAA_len41_fa0_ta20_fm6_tm14*129*c,0,6942,0,0,6942,0.0,129,2773@TOP@human_GAPDH_TAA_len41_fa0_ta20_fm6_tm14,c
2773@TOP@human_GAPDH_TAA_len41_fa0_ta20_fm6_tm14*130*c,0,6979,0,0,6979,0.0,130,2773@TOP@human_GAPDH_TAA_len41_fa0_ta20_fm6_tm14,c
2773@TOP@human_GAPDH_TAA_len41_fa0_ta20_fm6_tm14*131*c,0,6976,0,0,6976,0.0,131,2773@TOP@human_GAPDH_TAA_len41_fa0_ta20_fm6_tm14,c
2773@TOP@human_GAPDH_TAA_len41_fa0_ta20_fm6_tm14*132*t,1,1,0,6880,6882,0.0,132,2773@TOP@human_GAPDH_TAA_len41_fa0_ta20_fm6_tm14,t
2773@TOP@human_GAPDH_TAA_len41_fa0_ta20_fm6_tm14*133*g,1,0,6868,3,6872,0.999,133,2773@TOP@human_GAPDH_TAA_len41_fa0_ta20_fm6_tm14,g
2773@TOP@human_GAPDH_TAA_len41_fa0_ta20_fm6_tm14*134*g,1,0,6905,0,6906,1.0,134,2773@TOP@human_GAPDH_TAA_len41_fa0_ta20_fm6_tm14,g
2774@TOP@human_GAPDH_TAA_len41_fa0_ta20_fm6_tm14*114*t,0,5,0,5389,5394,0.0,114,2774@TOP@human_GAPDH_TAA_len41_fa0_ta20_fm6_tm14,t
2774@TOP@human_GAPDH_TAA_len41_fa0_ta20_fm6_tm14*115*c,0,5426,0,0,5426,0.0,115,2774@TOP@human_GAPDH_TAA_len41_fa0_ta20_fm6_tm14,c
2774@TOP@human_GAPDH_TAA_len41_fa0_ta20_fm6_tm14*116*c,0,5401,0,0,5401,0.0,116,2774@TOP@human_GAPDH_TAA_len41_fa0_ta20_fm6_tm14,c
2774@TOP@human_GAPDH_TAA_len41_fa0_ta20_fm6_tm14*117*a,5385,0,6,0,5391,0.001,117,2774@TOP@human_GAPDH_TAA_len41_fa0_ta20_fm6_tm14,a
2774@TOP@human_GAPDH_TAA_len41_fa0_ta20_fm6_tm14*118*a,5302,0,58,0,5360,0.011,118,2774@TOP@human_GAPDH_TAA_len41_fa0_ta20_fm6_tm14,a
2774@TOP@human_GAPDH_TAA_len41_fa0_ta20_fm6_tm14*119*g,0,0,5382,0,5382,1.0,119,2774@TOP@human_GAPDH_TAA_len41_fa0_ta20_fm6_tm14,g
2774@TOP@human_GAPDH_TAA_len41_fa0_ta20_fm6_tm14*120*g,0,0,5354,0,5354,1.0,120,2774@TOP@human_GAPDH_TAA_len41_fa0_ta20_fm6_tm14,g
2774@TOP@human_GAPDH_TAA_len41_fa0_ta20_fm6_tm14*121*a,5383,0,7,0,5390,0.001,121,2774@TOP@human_GAPDH_TAA_len41_fa0_ta20_fm6_tm14,a
2774@TOP@human_GAPDH_TAA_len41_fa0_ta20_fm6_tm14*122*g,1,0,5407,0,5408,1.0,122,2774@TOP@human_GAPDH_TAA_len41_fa0_ta20_fm6_tm14,g
2774@TOP@human_GAPDH_TAA_len41_fa0_ta20_fm6_tm14*123*t,2,0,3,5304,5309,0.001,123,2774@TOP@human_GAPDH_TAA_len41_fa0_ta20_fm6_tm14,t
2774@TOP@human_GAPDH_TAA_len41_fa0_ta20_fm6_tm14*124*a,5163,0,121,0,5284,0.023,124,2774@TOP@human_GAPDH_TAA_len41_fa0_ta20_fm6_tm14,a
2774@TOP@human_GAPDH_TAA_len41_fa0_ta20_fm6_tm14*125*a,4801,0,519,0,5320,0.098,125,2774@TOP@human_GAPDH_TAA_len41_fa0_ta20_fm6_tm14,a
2774@TOP@human_GAPDH_TAA_len41_fa0_ta20_fm6_tm14*126*g,0,0,5333,0,5333,1.0,126,2774@TOP@human_GAPDH_TAA_len41_fa0_ta20_fm6_tm14,g
2774@TOP@human_GAPDH_TAA_len41_fa0_ta20_fm6_tm14*127*a,5340,0,52,0,5392,0.01,127,2774@TOP@human_GAPDH_TAA_len41_fa0_ta20_fm6_tm14,a
2774@TOP@human_GAPDH_TAA_len41_fa0_ta20_fm6_tm14*128*c,0,5415,1,0,5416,0.0,128,2774@TOP@human_GAPDH_TAA_len41_fa0_ta20_fm6_tm14,c
2774@TOP@human_GAPDH_TAA_len41_fa0_ta20_fm6_tm14*129*c,0,5388,0,2,5390,0.0,129,2774@TOP@human_GAPDH_TAA_len41_fa0_ta20_fm6_tm14,c
2774@TOP@human_GAPDH_TAA_len41_fa0_ta20_fm6_tm14*130*c,0,5408,0,0,5408,0.0,130,2774@TOP@human_GAPDH_TAA_len41_fa0_ta20_fm6_tm14,c
2774@TOP@human_GAPDH_TAA_len41_fa0_ta20_fm6_tm14*131*c,0,5416,0,0,5416,0.0,131,2774@TOP@human_GAPDH_TAA_len41_fa0_ta20_fm6_tm14,c
2774@TOP@human_GAPDH_TAA_len41_fa0_ta20_fm6_tm14*132*t,0,1,0,5327,5328,0.0,132,2774@TOP@human_GAPDH_TAA_len41_fa0_ta20_fm6_tm14,t
2774@TOP@human_GAPDH_TAA_len41_fa0_ta20_fm6_tm14*133*g,0,0,5322,1,5323,1.0,133,2774@TOP@human_GAPDH_TAA_len41_fa0_ta20_fm6_tm14,g
2774@TOP@human_GAPDH_TAA_len41_fa0_ta20_fm6_tm14*134*g,0,0,5354,0,5354,1.0,134,2774@TOP@human_GAPDH_TAA_len41_fa0_ta20_fm6_tm14,g
2775@TOP@human_GAPDH_TAA_len41_fa0_ta20_fm6_tm14*114*t,4,1,0,10703,10708,0.0,114,2775@TOP@human_GAPDH_TAA_len41_fa0_ta20_fm6_tm14,t
2775@TOP@human_GAPDH_TAA_len41_fa0_ta20_fm6_tm14*115*c,0,10769,0,0,10769,0.0,115,2775@TOP@human_GAPDH_TAA_len41_fa0_ta20_fm6_tm14,c
2775@TOP@human_GAPDH_TAA_len41_fa0_ta20_fm6_tm14*116*c,0,10725,0,2,10727,0.0,116,2775@TOP@human_GAPDH_TAA_len41_fa0_ta20_fm6_tm14,c
2775@TOP@human_GAPDH_TAA_len41_fa0_ta20_fm6_tm14*117*a,10708,0,25,0,10733,0.002,117,2775@TOP@human_GAPDH_TAA_len41_fa0_ta20_fm6_tm14,a
2775@TOP@human_GAPDH_TAA_len41_fa0_ta20_fm6_tm14*118*a,10531,0,123,2,10656,0.012,118,2775@TOP@human_GAPDH_TAA_len41_fa0_ta20_fm6_tm14,a
2775@TOP@human_GAPDH_TAA_len41_fa0_ta20_fm6_tm14*119*g,0,0,10643,1,10644,1.0,119,2775@TOP@human_GAPDH_TAA_len41_fa0_ta20_fm6_tm14,g
2775@TOP@human_GAPDH_TAA_len41_fa0_ta20_fm6_tm14*120*g,0,0,10610,0,10610,1.0,120,2775@TOP@human_GAPDH_TAA_len41_fa0_ta20_fm6_tm14,g
2775@TOP@human_GAPDH_TAA_len41_fa0_ta20_fm6_tm14*121*a,10704,0,3,0,10707,0.0,121,2775@TOP@human_GAPDH_TAA_len41_fa0_ta20_fm6_tm14,a
2775@TOP@human_GAPDH_TAA_len41_fa0_ta20_fm6_tm14*122*g,1,0,10720,0,10721,1.0,122,2775@TOP@human_GAPDH_TAA_len41_fa0_ta20_fm6_tm14,g
2775@TOP@human_GAPDH_TAA_len41_fa0_ta20_fm6_tm14*123*t,1,6,2,10583,10592,0.0,123,2775@TOP@human_GAPDH_TAA_len41_fa0_ta20_fm6_tm14,t
2775@TOP@human_GAPDH_TAA_len41_fa0_ta20_fm6_tm14*124*a,10269,0,273,0,10542,0.026,124,2775@TOP@human_GAPDH_TAA_len41_fa0_ta20_fm6_tm14,a
2775@TOP@human_GAPDH_TAA_len41_fa0_ta20_fm6_tm14*125*a,9325,0,1225,0,10550,0.116,125,2775@TOP@human_GAPDH_TAA_len41_fa0_ta20_fm6_tm14,a
2775@TOP@human_GAPDH_TAA_len41_fa0_ta20_fm6_tm14*126*g,0,0,10593,0,10593,1.0,126,2775@TOP@human_GAPDH_TAA_len41_fa0_ta20_fm6_tm14,g
2775@TOP@human_GAPDH_TAA_len41_fa0_ta20_fm6_tm14*127*a,10664,0,37,1,10702,0.003,127,2775@TOP@human_GAPDH_TAA_len41_fa0_ta20_fm6_tm14,a
2775@TOP@human_GAPDH_TAA_len41_fa0_ta20_fm6_tm14*128*c,0,10735,2,1,10738,0.0,128,2775@TOP@human_GAPDH_TAA_len41_fa0_ta20_fm6_tm14,c
2775@TOP@human_GAPDH_TAA_len41_fa0_ta20_fm6_tm14*129*c,0,10663,0,0,10663,0.0,129,2775@TOP@human_GAPDH_TAA_len41_fa0_ta20_fm6_tm14,c
2775@TOP@human_GAPDH_TAA_len41_fa0_ta20_fm6_tm14*130*c,1,10719,0,1,10721,0.0,130,2775@TOP@human_GAPDH_TAA_len41_fa0_ta20_fm6_tm14,c
2775@TOP@human_GAPDH_TAA_len41_fa0_ta20_fm6_tm14*131*c,0,10741,0,1,10742,0.0,131,2775@TOP@human_GAPDH_TAA_len41_fa0_ta20_fm6_tm14,c
2775@TOP@human_GAPDH_TAA_len41_fa0_ta20_fm6_tm14*132*t,1,5,0,10595,10601,0.0,132,2775@TOP@human_GAPDH_TAA_len41_fa0_ta20_fm6_tm14,t
2775@TOP@human_GAPDH_TAA_len41_fa0_ta20_fm6_tm14*133*g,0,0,10575,1,10576,1.0,133,2775@TOP@human_GAPDH_TAA_len41_fa0_ta20_fm6_tm14,g
2775@TOP@human_GAPDH_TAA_len41_fa0_ta20_fm6_tm14*134*g,2,2,10618,0,10622,1.0,134,2775@TOP@human_GAPDH_TAA_len41_fa0_ta20_fm6_tm14,g
2776@TOP@human_GAPDH_TAA_len41_fa0_ta20_fm6_tm14*114*t,0,0,0,1620,1620,0.0,114,2776@TOP@human_GAPDH_TAA_len41_fa0_ta20_fm6_tm14,t
2776@TOP@human_GAPDH_TAA_len41_fa0_ta20_fm6_tm14*115*c,0,1628,0,0,1628,0.0,115,2776@TOP@human_GAPDH_TAA_len41_fa0_ta20_fm6_tm14,c
2776@TOP@human_GAPDH_TAA_len41_fa0_ta20_fm6_tm14*116*c,0,1622,0,0,1622,0.0,116,2776@TOP@human_GAPDH_TAA_len41_fa0_ta20_fm6_tm14,c
2776@TOP@human_GAPDH_TAA_len41_fa0_ta20_fm6_tm14*117*a,1619,0,2,0,1621,0.001,117,2776@TOP@human_GAPDH_TAA_len41_fa0_ta20_fm6_tm14,a
2776@TOP@human_GAPDH_TAA_len41_fa0_ta20_fm6_tm14*118*a,1554,0,55,0,1609,0.034,118,2776@TOP@human_GAPDH_TAA_len41_fa0_ta20_fm6_tm14,a
2776@TOP@human_GAPDH_TAA_len41_fa0_ta20_fm6_tm14*119*g,0,0,1607,0,1607,1.0,119,2776@TOP@human_GAPDH_TAA_len41_fa0_ta20_fm6_tm14,g
2776@TOP@human_GAPDH_TAA_len41_fa0_ta20_fm6_tm14*120*g,0,1,1606,0,1607,0.999,120,2776@TOP@human_GAPDH_TAA_len41_fa0_ta20_fm6_tm14,g
2776@TOP@human_GAPDH_TAA_len41_fa0_ta20_fm6_tm14*121*a,1618,0,1,0,1619,0.001,121,2776@TOP@human_GAPDH_TAA_len41_fa0_ta20_fm6_tm14,a
2776@TOP@human_GAPDH_TAA_len41_fa0_ta20_fm6_tm14*122*g,0,0,1628,0,1628,1.0,122,2776@TOP@human_GAPDH_TAA_len41_fa0_ta20_fm6_tm14,g
2776@TOP@human_GAPDH_TAA_len41_fa0_ta20_fm6_tm14*123*t,0,0,0,1598,1598,0.0,123,2776@TOP@human_GAPDH_TAA_len41_fa0_ta20_fm6_tm14,t
2776@TOP@human_GAPDH_TAA_len41_fa0_ta20_fm6_tm14*124*a,971,0,633,0,1604,0.395,124,2776@TOP@human_GAPDH_TAA_len41_fa0_ta20_fm6_tm14,a
2776@TOP@human_GAPDH_TAA_len41_fa0_ta20_fm6_tm14*125*a,1318,0,276,0,1594,0.173,125,2776@TOP@human_GAPDH_TAA_len41_fa0_ta20_fm6_tm14,a
2776@TOP@human_GAPDH_TAA_len41_fa0_ta20_fm6_tm14*126*g,0,0,1606,0,1606,1.0,126,2776@TOP@human_GAPDH_TAA_len41_fa0_ta20_fm6_tm14,g
2776@TOP@human_GAPDH_TAA_len41_fa0_ta20_fm6_tm14*127*a,1577,0,41,0,1618,0.025,127,2776@TOP@human_GAPDH_TAA_len41_fa0_ta20_fm6_tm14,a
2776@TOP@human_GAPDH_TAA_len41_fa0_ta20_fm6_tm14*128*c,0,1628,0,1,1629,0.0,128,2776@TOP@human_GAPDH_TAA_len41_fa0_ta20_fm6_tm14,c
2776@TOP@human_GAPDH_TAA_len41_fa0_ta20_fm6_tm14*129*c,0,1609,0,0,1609,0.0,129,2776@TOP@human_GAPDH_TAA_len41_fa0_ta20_fm6_tm14,c
2776@TOP@human_GAPDH_TAA_len41_fa0_ta20_fm6_tm14*130*c,0,1620,0,0,1620,0.0,130,2776@TOP@human_GAPDH_TAA_len41_fa0_ta20_fm6_tm14,c
2776@TOP@human_GAPDH_TAA_len41_fa0_ta20_fm6_tm14*131*c,0,1625,0,0,1625,0.0,131,2776@TOP@human_GAPDH_TAA_len41_fa0_ta20_fm6_tm14,c
2776@TOP@human_GAPDH_TAA_len41_fa0_ta20_fm6_tm14*132*t,1,0,0,1606,1607,0.0,132,2776@TOP@human_GAPDH_TAA_len41_fa0_ta20_fm6_tm14,t
2776@TOP@human_GAPDH_TAA_len41_fa0_ta20_fm6_tm14*133*g,0,0,1599,0,1599,1.0,133,2776@TOP@human_GAPDH_TAA_len41_fa0_ta20_fm6_tm14,g
2776@TOP@human_GAPDH_TAA_len41_fa0_ta20_fm6_tm14*134*g,0,0,1607,0,1607,1.0,134,2776@TOP@human_GAPDH_TAA_len41_fa0_ta20_fm6_tm14,g
2777@TOP@human_GAPDH_TAA_len41_fa0_ta20_fm6_tm14*114*t,0,0,0,438,438,0.0,114,2777@TOP@human_GAPDH_TAA_len41_fa0_ta20_fm6_tm14,t
2777@TOP@human_GAPDH_TAA_len41_fa0_ta20_fm6_tm14*115*c,0,438,0,0,438,0.0,115,2777@TOP@human_GAPDH_TAA_len41_fa0_ta20_fm6_tm14,c
2777@TOP@human_GAPDH_TAA_len41_fa0_ta20_fm6_tm14*116*c,0,436,0,0,436,0.0,116,2777@TOP@human_GAPDH_TAA_len41_fa0_ta20_fm6_tm14,c
2777@TOP@human_GAPDH_TAA_len41_fa0_ta20_fm6_tm14*117*a,434,0,1,0,435,0.002,117,2777@TOP@human_GAPDH_TAA_len41_fa0_ta20_fm6_tm14,a
2777@TOP@human_GAPDH_TAA_len41_fa0_ta20_fm6_tm14*118*a,421,1,7,0,429,0.016,118,2777@TOP@human_GAPDH_TAA_len41_fa0_ta20_fm6_tm14,a
2777@TOP@human_GAPDH_TAA_len41_fa0_ta20_fm6_tm14*119*g,0,0,435,0,435,1.0,119,2777@TOP@human_GAPDH_TAA_len41_fa0_ta20_fm6_tm14,g
2777@TOP@human_GAPDH_TAA_len41_fa0_ta20_fm6_tm14*120*g,0,0,430,0,430,1.0,120,2777@TOP@human_GAPDH_TAA_len41_fa0_ta20_fm6_tm14,g
2777@TOP@human_GAPDH_TAA_len41_fa0_ta20_fm6_tm14*121*a,435,0,3,0,438,0.007,121,2777@TOP@human_GAPDH_TAA_len41_fa0_ta20_fm6_tm14,a
2777@TOP@human_GAPDH_TAA_len41_fa0_ta20_fm6_tm14*122*g,0,0,436,0,436,1.0,122,2777@TOP@human_GAPDH_TAA_len41_fa0_ta20_fm6_tm14,g
2777@TOP@human_GAPDH_TAA_len41_fa0_ta20_fm6_tm14*123*t,0,0,0,429,429,0.0,123,2777@TOP@human_GAPDH_TAA_len41_fa0_ta20_fm6_tm14,t
2777@TOP@human_GAPDH_TAA_len41_fa0_ta20_fm6_tm14*124*a,329,0,94,0,423,0.222,124,2777@TOP@human_GAPDH_TAA_len41_fa0_ta20_fm6_tm14,a
2777@TOP@human_GAPDH_TAA_len41_fa0_ta20_fm6_tm14*125*a,305,0,124,0,429,0.289,125,2777@TOP@human_GAPDH_TAA_len41_fa0_ta20_fm6_tm14,a
2777@TOP@human_GAPDH_TAA_len41_fa0_ta20_fm6_tm14*126*g,0,0,432,0,432,1.0,126,2777@TOP@human_GAPDH_TAA_len41_fa0_ta20_fm6_tm14,g
2777@TOP@human_GAPDH_TAA_len41_fa0_ta20_fm6_tm14*127*a,426,0,10,0,436,0.023,127,2777@TOP@human_GAPDH_TAA_len41_fa0_ta20_fm6_tm14,a
2777@TOP@human_GAPDH_TAA_len41_fa0_ta20_fm6_tm14*128*c,0,436,0,0,436,0.0,128,2777@TOP@human_GAPDH_TAA_len41_fa0_ta20_fm6_tm14,c
2777@TOP@human_GAPDH_TAA_len41_fa0_ta20_fm6_tm14*129*c,0,437,0,0,437,0.0,129,2777@TOP@human_GAPDH_TAA_len41_fa0_ta20_fm6_tm14,c
2777@TOP@human_GAPDH_TAA_len41_fa0_ta20_fm6_tm14*130*c,3,434,0,0,437,0.0,130,2777@TOP@human_GAPDH_TAA_len41_fa0_ta20_fm6_tm14,c
2777@TOP@human_GAPDH_TAA_len41_fa0_ta20_fm6_tm14*131*c,0,438,0,0,438,0.0,131,2777@TOP@human_GAPDH_TAA_len41_fa0_ta20_fm6_tm14,c
2777@TOP@human_GAPDH_TAA_len41_fa0_ta20_fm6_tm14*132*t,0,0,0,433,433,0.0,132,2777@TOP@human_GAPDH_TAA_len41_fa0_ta20_fm6_tm14,t
2777@TOP@human_GAPDH_TAA_len41_fa0_ta20_fm6_tm14*133*g,0,0,431,0,431,1.0,133,2777@TOP@human_GAPDH_TAA_len41_fa0_ta20_fm6_tm14,g
2777@TOP@human_GAPDH_TAA_len41_fa0_ta20_fm6_tm14*134*g,0,0,433,0,433,1.0,134,2777@TOP@human_GAPDH_TAA_len41_fa0_ta20_fm6_tm14,g
2778@TOP@human_GAPDH_TAA_len41_fa0_ta20_fm6_tm14*114*t,0,0,0,511,511,0.0,114,2778@TOP@human_GAPDH_TAA_len41_fa0_ta20_fm6_tm14,t
2778@TOP@human_GAPDH_TAA_len41_fa0_ta20_fm6_tm14*115*c,0,515,0,0,515,0.0,115,2778@TOP@human_GAPDH_TAA_len41_fa0_ta20_fm6_tm14,c
2778@TOP@human_GAPDH_TAA_len41_fa0_ta20_fm6_tm14*116*c,0,506,0,0,506,0.0,116,2778@TOP@human_GAPDH_TAA_len41_fa0_ta20_fm6_tm14,c
2778@TOP@human_GAPDH_TAA_len41_fa0_ta20_fm6_tm14*117*a,501,0,4,0,505,0.008,117,2778@TOP@human_GAPDH_TAA_len41_fa0_ta20_fm6_tm14,a
2778@TOP@human_GAPDH_TAA_len41_fa0_ta20_fm6_tm14*118*a,495,0,6,0,501,0.012,118,2778@TOP@human_GAPDH_TAA_len41_fa0_ta20_fm6_tm14,a
2778@TOP@human_GAPDH_TAA_len41_fa0_ta20_fm6_tm14*119*g,0,0,504,0,504,1.0,119,2778@TOP@human_GAPDH_TAA_len41_fa0_ta20_fm6_tm14,g
2778@TOP@human_GAPDH_TAA_len41_fa0_ta20_fm6_tm14*120*g,0,0,504,0,504,1.0,120,2778@TOP@human_GAPDH_TAA_len41_fa0_ta20_fm6_tm14,g
2778@TOP@human_GAPDH_TAA_len41_fa0_ta20_fm6_tm14*121*a,510,0,0,0,510,0.0,121,2778@TOP@human_GAPDH_TAA_len41_fa0_ta20_fm6_tm14,a
2778@TOP@human_GAPDH_TAA_len41_fa0_ta20_fm6_tm14*122*g,0,0,510,0,510,1.0,122,2778@TOP@human_GAPDH_TAA_len41_fa0_ta20_fm6_tm14,g
2778@TOP@human_GAPDH_TAA_len41_fa0_ta20_fm6_tm14*123*t,0,0,0,504,504,0.0,123,2778@TOP@human_GAPDH_TAA_len41_fa0_ta20_fm6_tm14,t
2778@TOP@human_GAPDH_TAA_len41_fa0_ta20_fm6_tm14*124*a,358,1,143,0,502,0.285,124,2778@TOP@human_GAPDH_TAA_len41_fa0_ta20_fm6_tm14,a
2778@TOP@human_GAPDH_TAA_len41_fa0_ta20_fm6_tm14*125*a,398,0,99,0,497,0.199,125,2778@TOP@human_GAPDH_TAA_len41_fa0_ta20_fm6_tm14,a
2778@TOP@human_GAPDH_TAA_len41_fa0_ta20_fm6_tm14*126*g,0,0,501,0,501,1.0,126,2778@TOP@human_GAPDH_TAA_len41_fa0_ta20_fm6_tm14,g
2778@TOP@human_GAPDH_TAA_len41_fa0_ta20_fm6_tm14*127*a,494,0,14,0,508,0.028,127,2778@TOP@human_GAPDH_TAA_len41_fa0_ta20_fm6_tm14,a
2778@TOP@human_GAPDH_TAA_len41_fa0_ta20_fm6_tm14*128*c,0,515,0,0,515,0.0,128,2778@TOP@human_GAPDH_TAA_len41_fa0_ta20_fm6_tm14,c
2778@TOP@human_GAPDH_TAA_len41_fa0_ta20_fm6_tm14*129*c,0,510,0,0,510,0.0,129,2778@TOP@human_GAPDH_TAA_len41_fa0_ta20_fm6_tm14,c
2778@TOP@human_GAPDH_TAA_len41_fa0_ta20_fm6_tm14*130*c,1,510,0,0,511,0.0,130,2778@TOP@human_GAPDH_TAA_len41_fa0_ta20_fm6_tm14,c
2778@TOP@human_GAPDH_TAA_len41_fa0_ta20_fm6_tm14*131*c,0,513,0,0,513,0.0,131,2778@TOP@human_GAPDH_TAA_len41_fa0_ta20_fm6_tm14,c
2778@TOP@human_GAPDH_TAA_len41_fa0_ta20_fm6_tm14*132*t,0,0,0,502,502,0.0,132,2778@TOP@human_GAPDH_TAA_len41_fa0_ta20_fm6_tm14,t
2778@TOP@human_GAPDH_TAA_len41_fa0_ta20_fm6_tm14*133*g,0,0,499,0,499,1.0,133,2778@TOP@human_GAPDH_TAA_len41_fa0_ta20_fm6_tm14,g
2778@TOP@human_GAPDH_TAA_len41_fa0_ta20_fm6_tm14*134*g,0,1,508,0,509,0.998,134,2778@TOP@human_GAPDH_TAA_len41_fa0_ta20_fm6_tm14,g
2779@TOP@human_GAPDH_TAA_len41_fa0_ta20_fm6_tm14*114*t,0,0,0,3401,3401,0.0,114,2779@TOP@human_GAPDH_TAA_len41_fa0_ta20_fm6_tm14,t
2779@TOP@human_GAPDH_TAA_len41_fa0_ta20_fm6_tm14*115*c,0,3415,0,0,3415,0.0,115,2779@TOP@human_GAPDH_TAA_len41_fa0_ta20_fm6_tm14,c
2779@TOP@human_GAPDH_TAA_len41_fa0_ta20_fm6_tm14*116*c,0,3399,0,0,3399,0.0,116,2779@TOP@human_GAPDH_TAA_len41_fa0_ta20_fm6_tm14,c
2779@TOP@human_GAPDH_TAA_len41_fa0_ta20_fm6_tm14*117*a,3393,0,2,2,3397,0.001,117,2779@TOP@human_GAPDH_TAA_len41_fa0_ta20_fm6_tm14,a
2779@TOP@human_GAPDH_TAA_len41_fa0_ta20_fm6_tm14*118*a,3308,0,68,0,3376,0.02,118,2779@TOP@human_GAPDH_TAA_len41_fa0_ta20_fm6_tm14,a
2779@TOP@human_GAPDH_TAA_len41_fa0_ta20_fm6_tm14*119*g,0,0,3373,0,3373,1.0,119,2779@TOP@human_GAPDH_TAA_len41_fa0_ta20_fm6_tm14,g
2779@TOP@human_GAPDH_TAA_len41_fa0_ta20_fm6_tm14*120*g,1,0,3361,1,3363,0.999,120,2779@TOP@human_GAPDH_TAA_len41_fa0_ta20_fm6_tm14,g
2779@TOP@human_GAPDH_TAA_len41_fa0_ta20_fm6_tm14*121*a,3392,0,1,0,3393,0.0,121,2779@TOP@human_GAPDH_TAA_len41_fa0_ta20_fm6_tm14,a
2779@TOP@human_GAPDH_TAA_len41_fa0_ta20_fm6_tm14*122*g,0,0,3403,0,3403,1.0,122,2779@TOP@human_GAPDH_TAA_len41_fa0_ta20_fm6_tm14,g
2779@TOP@human_GAPDH_TAA_len41_fa0_ta20_fm6_tm14*123*t,0,0,2,3344,3346,0.001,123,2779@TOP@human_GAPDH_TAA_len41_fa0_ta20_fm6_tm14,t
2779@TOP@human_GAPDH_TAA_len41_fa0_ta20_fm6_tm14*124*a,2880,0,462,0,3342,0.138,124,2779@TOP@human_GAPDH_TAA_len41_fa0_ta20_fm6_tm14,a
2779@TOP@human_GAPDH_TAA_len41_fa0_ta20_fm6_tm14*125*a,2978,1,361,1,3341,0.108,125,2779@TOP@human_GAPDH_TAA_len41_fa0_ta20_fm6_tm14,a
2779@TOP@human_GAPDH_TAA_len41_fa0_ta20_fm6_tm14*126*g,0,0,3360,0,3360,1.0,126,2779@TOP@human_GAPDH_TAA_len41_fa0_ta20_fm6_tm14,g
2779@TOP@human_GAPDH_TAA_len41_fa0_ta20_fm6_tm14*127*a,3293,0,89,0,3382,0.026,127,2779@TOP@human_GAPDH_TAA_len41_fa0_ta20_fm6_tm14,a
2779@TOP@human_GAPDH_TAA_len41_fa0_ta20_fm6_tm14*128*c,0,3410,0,0,3410,0.0,128,2779@TOP@human_GAPDH_TAA_len41_fa0_ta20_fm6_tm14,c
2779@TOP@human_GAPDH_TAA_len41_fa0_ta20_fm6_tm14*129*c,0,3382,0,1,3383,0.0,129,2779@TOP@human_GAPDH_TAA_len41_fa0_ta20_fm6_tm14,c
2779@TOP@human_GAPDH_TAA_len41_fa0_ta20_fm6_tm14*130*c,0,3392,0,2,3394,0.0,130,2779@TOP@human_GAPDH_TAA_len41_fa0_ta20_fm6_tm14,c
2779@TOP@human_GAPDH_TAA_len41_fa0_ta20_fm6_tm14*131*c,1,3408,0,0,3409,0.0,131,2779@TOP@human_GAPDH_TAA_len41_fa0_ta20_fm6_tm14,c
2779@TOP@human_GAPDH_TAA_len41_fa0_ta20_fm6_tm14*132*t,2,1,0,3361,3364,0.0,132,2779@TOP@human_GAPDH_TAA_len41_fa0_ta20_fm6_tm14,t
2779@TOP@human_GAPDH_TAA_len41_fa0_ta20_fm6_tm14*133*g,1,0,3354,0,3355,1.0,133,2779@TOP@human_GAPDH_TAA_len41_fa0_ta20_fm6_tm14,g
2779@TOP@human_GAPDH_TAA_len41_fa0_ta20_fm6_tm14*134*g,0,0,3361,0,3361,1.0,134,2779@TOP@human_GAPDH_TAA_len41_fa0_ta20_fm6_tm14,g
2780@TOP@human_GAPDH_TAA_len41_fa0_ta20_fm6_tm14*114*t,0,0,0,1423,1423,0.0,114,2780@TOP@human_GAPDH_TAA_len41_fa0_ta20_fm6_tm14,t
2780@TOP@human_GAPDH_TAA_len41_fa0_ta20_fm6_tm14*115*c,0,1430,0,0,1430,0.0,115,2780@TOP@human_GAPDH_TAA_len41_fa0_ta20_fm6_tm14,c
2780@TOP@human_GAPDH_TAA_len41_fa0_ta20_fm6_tm14*116*c,0,1418,0,0,1418,0.0,116,2780@TOP@human_GAPDH_TAA_len41_fa0_ta20_fm6_tm14,c
2780@TOP@human_GAPDH_TAA_len41_fa0_ta20_fm6_tm14*117*a,1416,0,4,0,1420,0.003,117,2780@TOP@human_GAPDH_TAA_len41_fa0_ta20_fm6_tm14,a
2780@TOP@human_GAPDH_TAA_len41_fa0_ta20_fm6_tm14*118*a,1380,0,30,0,1410,0.021,118,2780@TOP@human_GAPDH_TAA_len41_fa0_ta20_fm6_tm14,a
2780@TOP@human_GAPDH_TAA_len41_fa0_ta20_fm6_tm14*119*g,0,0,1408,0,1408,1.0,119,2780@TOP@human_GAPDH_TAA_len41_fa0_ta20_fm6_tm14,g
2780@TOP@human_GAPDH_TAA_len41_fa0_ta20_fm6_tm14*120*g,0,0,1402,1,1403,0.999,120,2780@TOP@human_GAPDH_TAA_len41_fa0_ta20_fm6_tm14,g
2780@TOP@human_GAPDH_TAA_len41_fa0_ta20_fm6_tm14*121*a,1422,0,1,0,1423,0.001,121,2780@TOP@human_GAPDH_TAA_len41_fa0_ta20_fm6_tm14,a
2780@TOP@human_GAPDH_TAA_len41_fa0_ta20_fm6_tm14*122*g,0,0,1424,0,1424,1.0,122,2780@TOP@human_GAPDH_TAA_len41_fa0_ta20_fm6_tm14,g
2780@TOP@human_GAPDH_TAA_len41_fa0_ta20_fm6_tm14*123*t,0,0,1,1405,1406,0.001,123,2780@TOP@human_GAPDH_TAA_len41_fa0_ta20_fm6_tm14,t
2780@TOP@human_GAPDH_TAA_len41_fa0_ta20_fm6_tm14*124*a,964,0,449,0,1413,0.318,124,2780@TOP@human_GAPDH_TAA_len41_fa0_ta20_fm6_tm14,a
2780@TOP@human_GAPDH_TAA_len41_fa0_ta20_fm6_tm14*125*a,1061,0,336,0,1397,0.241,125,2780@TOP@human_GAPDH_TAA_len41_fa0_ta20_fm6_tm14,a
2780@TOP@human_GAPDH_TAA_len41_fa0_ta20_fm6_tm14*126*g,0,0,1408,0,1408,1.0,126,2780@TOP@human_GAPDH_TAA_len41_fa0_ta20_fm6_tm14,g
2780@TOP@human_GAPDH_TAA_len41_fa0_ta20_fm6_tm14*127*a,1406,0,15,0,1421,0.011,127,2780@TOP@human_GAPDH_TAA_len41_fa0_ta20_fm6_tm14,a
2780@TOP@human_GAPDH_TAA_len41_fa0_ta20_fm6_tm14*128*c,0,1427,0,0,1427,0.0,128,2780@TOP@human_GAPDH_TAA_len41_fa0_ta20_fm6_tm14,c
2780@TOP@human_GAPDH_TAA_len41_fa0_ta20_fm6_tm14*129*c,0,1418,0,0,1418,0.0,129,2780@TOP@human_GAPDH_TAA_len41_fa0_ta20_fm6_tm14,c
2780@TOP@human_GAPDH_TAA_len41_fa0_ta20_fm6_tm14*130*c,0,1426,0,0,1426,0.0,130,2780@TOP@human_GAPDH_TAA_len41_fa0_ta20_fm6_tm14,c
2780@TOP@human_GAPDH_TAA_len41_fa0_ta20_fm6_tm14*131*c,0,1428,0,0,1428,0.0,131,2780@TOP@human_GAPDH_TAA_len41_fa0_ta20_fm6_tm14,c
2780@TOP@human_GAPDH_TAA_len41_fa0_ta20_fm6_tm14*132*t,1,0,0,1408,1409,0.0,132,2780@TOP@human_GAPDH_TAA_len41_fa0_ta20_fm6_tm14,t
2780@TOP@human_GAPDH_TAA_len41_fa0_ta20_fm6_tm14*133*g,0,0,1402,0,1402,1.0,133,2780@TOP@human_GAPDH_TAA_len41_fa0_ta20_fm6_tm14,g
2780@TOP@human_GAPDH_TAA_len41_fa0_ta20_fm6_tm14*134*g,0,0,1410,0,1410,1.0,134,2780@TOP@human_GAPDH_TAA_len41_fa0_ta20_fm6_tm14,g
2781@TOP@human_GAPDH_TAA_len41_fa0_ta20_fm6_tm14*114*t,0,0,0,750,750,0.0,114,2781@TOP@human_GAPDH_TAA_len41_fa0_ta20_fm6_tm14,t
2781@TOP@human_GAPDH_TAA_len41_fa0_ta20_fm6_tm14*115*c,0,754,0,0,754,0.0,115,2781@TOP@human_GAPDH_TAA_len41_fa0_ta20_fm6_tm14,c
2781@TOP@human_GAPDH_TAA_len41_fa0_ta20_fm6_tm14*116*c,0,752,0,0,752,0.0,116,2781@TOP@human_GAPDH_TAA_len41_fa0_ta20_fm6_tm14,c
2781@TOP@human_GAPDH_TAA_len41_fa0_ta20_fm6_tm14*117*a,747,0,3,0,750,0.004,117,2781@TOP@human_GAPDH_TAA_len41_fa0_ta20_fm6_tm14,a
2781@TOP@human_GAPDH_TAA_len41_fa0_ta20_fm6_tm14*118*a,720,0,23,0,743,0.031,118,2781@TOP@human_GAPDH_TAA_len41_fa0_ta20_fm6_tm14,a
2781@TOP@human_GAPDH_TAA_len41_fa0_ta20_fm6_tm14*119*g,0,0,748,0,748,1.0,119,2781@TOP@human_GAPDH_TAA_len41_fa0_ta20_fm6_tm14,g
2781@TOP@human_GAPDH_TAA_len41_fa0_ta20_fm6_tm14*120*g,0,0,739,0,739,1.0,120,2781@TOP@human_GAPDH_TAA_len41_fa0_ta20_fm6_tm14,g
2781@TOP@human_GAPDH_TAA_len41_fa0_ta20_fm6_tm14*121*a,751,0,1,0,752,0.001,121,2781@TOP@human_GAPDH_TAA_len41_fa0_ta20_fm6_tm14,a
2781@TOP@human_GAPDH_TAA_len41_fa0_ta20_fm6_tm14*122*g,0,0,748,0,748,1.0,122,2781@TOP@human_GAPDH_TAA_len41_fa0_ta20_fm6_tm14,g
2781@TOP@human_GAPDH_TAA_len41_fa0_ta20_fm6_tm14*123*t,0,0,0,737,737,0.0,123,2781@TOP@human_GAPDH_TAA_len41_fa0_ta20_fm6_tm14,t
2781@TOP@human_GAPDH_TAA_len41_fa0_ta20_fm6_tm14*124*a,623,0,111,0,734,0.151,124,2781@TOP@human_GAPDH_TAA_len41_fa0_ta20_fm6_tm14,a
2781@TOP@human_GAPDH_TAA_len41_fa0_ta20_fm6_tm14*125*a,645,0,81,0,726,0.112,125,2781@TOP@human_GAPDH_TAA_len41_fa0_ta20_fm6_tm14,a
2781@TOP@human_GAPDH_TAA_len41_fa0_ta20_fm6_tm14*126*g,0,0,739,0,739,1.0,126,2781@TOP@human_GAPDH_TAA_len41_fa0_ta20_fm6_tm14,g
2781@TOP@human_GAPDH_TAA_len41_fa0_ta20_fm6_tm14*127*a,740,0,1,0,741,0.001,127,2781@TOP@human_GAPDH_TAA_len41_fa0_ta20_fm6_tm14,a
2781@TOP@human_GAPDH_TAA_len41_fa0_ta20_fm6_tm14*128*c,0,749,1,0,750,0.001,128,2781@TOP@human_GAPDH_TAA_len41_fa0_ta20_fm6_tm14,c
2781@TOP@human_GAPDH_TAA_len41_fa0_ta20_fm6_tm14*129*c,0,746,0,0,746,0.0,129,2781@TOP@human_GAPDH_TAA_len41_fa0_ta20_fm6_tm14,c
2781@TOP@human_GAPDH_TAA_len41_fa0_ta20_fm6_tm14*130*c,0,751,0,0,751,0.0,130,2781@TOP@human_GAPDH_TAA_len41_fa0_ta20_fm6_tm14,c
2781@TOP@human_GAPDH_TAA_len41_fa0_ta20_fm6_tm14*131*c,0,749,0,0,749,0.0,131,2781@TOP@human_GAPDH_TAA_len41_fa0_ta20_fm6_tm14,c
2781@TOP@human_GAPDH_TAA_len41_fa0_ta20_fm6_tm14*132*t,0,0,0,739,739,0.0,132,2781@TOP@human_GAPDH_TAA_len41_fa0_ta20_fm6_tm14,t
2781@TOP@human_GAPDH_TAA_len41_fa0_ta20_fm6_tm14*133*g,0,0,737,0,737,1.0,133,2781@TOP@human_GAPDH_TAA_len41_fa0_ta20_fm6_tm14,g
2781@TOP@human_GAPDH_TAA_len41_fa0_ta20_fm6_tm14*134*g,0,0,740,0,740,1.0,134,2781@TOP@human_GAPDH_TAA_len41_fa0_ta20_fm6_tm14,g
2782@TOP@human_GAPDH_TAA_len41_fa0_ta20_fm6_tm14*114*t,0,0,0,1032,1032,0.0,114,2782@TOP@human_GAPDH_TAA_len41_fa0_ta20_fm6_tm14,t
2782@TOP@human_GAPDH_TAA_len41_fa0_ta20_fm6_tm14*115*c,0,1041,0,0,1041,0.0,115,2782@TOP@human_GAPDH_TAA_len41_fa0_ta20_fm6_tm14,c
2782@TOP@human_GAPDH_TAA_len41_fa0_ta20_fm6_tm14*116*c,0,1035,0,0,1035,0.0,116,2782@TOP@human_GAPDH_TAA_len41_fa0_ta20_fm6_tm14,c
2782@TOP@human_GAPDH_TAA_len41_fa0_ta20_fm6_tm14*117*a,1026,0,7,0,1033,0.007,117,2782@TOP@human_GAPDH_TAA_len41_fa0_ta20_fm6_tm14,a
2782@TOP@human_GAPDH_TAA_len41_fa0_ta20_fm6_tm14*118*a,1009,0,21,0,1030,0.02,118,2782@TOP@human_GAPDH_TAA_len41_fa0_ta20_fm6_tm14,a
2782@TOP@human_GAPDH_TAA_len41_fa0_ta20_fm6_tm14*119*g,0,0,1028,0,1028,1.0,119,2782@TOP@human_GAPDH_TAA_len41_fa0_ta20_fm6_tm14,g
2782@TOP@human_GAPDH_TAA_len41_fa0_ta20_fm6_tm14*120*g,0,0,1013,0,1013,1.0,120,2782@TOP@human_GAPDH_TAA_len41_fa0_ta20_fm6_tm14,g
2782@TOP@human_GAPDH_TAA_len41_fa0_ta20_fm6_tm14*121*a,1034,0,3,0,1037,0.003,121,2782@TOP@human_GAPDH_TAA_len41_fa0_ta20_fm6_tm14,a
2782@TOP@human_GAPDH_TAA_len41_fa0_ta20_fm6_tm14*122*g,0,0,1038,0,1038,1.0,122,2782@TOP@human_GAPDH_TAA_len41_fa0_ta20_fm6_tm14,g
2782@TOP@human_GAPDH_TAA_len41_fa0_ta20_fm6_tm14*123*t,0,0,0,1013,1013,0.0,123,2782@TOP@human_GAPDH_TAA_len41_fa0_ta20_fm6_tm14,t
2782@TOP@human_GAPDH_TAA_len41_fa0_ta20_fm6_tm14*124*a,775,0,248,0,1023,0.242,124,2782@TOP@human_GAPDH_TAA_len41_fa0_ta20_fm6_tm14,a
2782@TOP@human_GAPDH_TAA_len41_fa0_ta20_fm6_tm14*125*a,837,1,172,0,1010,0.17,125,2782@TOP@human_GAPDH_TAA_len41_fa0_ta20_fm6_tm14,a
2782@TOP@human_GAPDH_TAA_len41_fa0_ta20_fm6_tm14*126*g,0,0,1027,0,1027,1.0,126,2782@TOP@human_GAPDH_TAA_len41_fa0_ta20_fm6_tm14,g
2782@TOP@human_GAPDH_TAA_len41_fa0_ta20_fm6_tm14*127*a,1023,0,5,0,1028,0.005,127,2782@TOP@human_GAPDH_TAA_len41_fa0_ta20_fm6_tm14,a
2782@TOP@human_GAPDH_TAA_len41_fa0_ta20_fm6_tm14*128*c,0,1034,0,0,1034,0.0,128,2782@TOP@human_GAPDH_TAA_len41_fa0_ta20_fm6_tm14,c
2782@TOP@human_GAPDH_TAA_len41_fa0_ta20_fm6_tm14*129*c,0,1025,0,0,1025,0.0,129,2782@TOP@human_GAPDH_TAA_len41_fa0_ta20_fm6_tm14,c
2782@TOP@human_GAPDH_TAA_len41_fa0_ta20_fm6_tm14*130*c,0,1036,0,0,1036,0.0,130,2782@TOP@human_GAPDH_TAA_len41_fa0_ta20_fm6_tm14,c
2782@TOP@human_GAPDH_TAA_len41_fa0_ta20_fm6_tm14*131*c,0,1037,0,0,1037,0.0,131,2782@TOP@human_GAPDH_TAA_len41_fa0_ta20_fm6_tm14,c
2782@TOP@human_GAPDH_TAA_len41_fa0_ta20_fm6_tm14*132*t,3,0,0,1020,1023,0.0,132,2782@TOP@human_GAPDH_TAA_len41_fa0_ta20_fm6_tm14,t
2782@TOP@human_GAPDH_TAA_len41_fa0_ta20_fm6_tm14*133*g,0,0,1016,0,1016,1.0,133,2782@TOP@human_GAPDH_TAA_len41_fa0_ta20_fm6_tm14,g
2782@TOP@human_GAPDH_TAA_len41_fa0_ta20_fm6_tm14*134*g,0,0,1032,0,1032,1.0,134,2782@TOP@human_GAPDH_TAA_len41_fa0_ta20_fm6_tm14,g
2783@TOP@human_GAPDH_TAA_len41_fa0_ta20_fm6_tm14*114*t,0,0,0,950,950,0.0,114,2783@TOP@human_GAPDH_TAA_len41_fa0_ta20_fm6_tm14,t
2783@TOP@human_GAPDH_TAA_len41_fa0_ta20_fm6_tm14*115*c,0,960,0,0,960,0.0,115,2783@TOP@human_GAPDH_TAA_len41_fa0_ta20_fm6_tm14,c
2783@TOP@human_GAPDH_TAA_len41_fa0_ta20_fm6_tm14*116*c,0,957,0,0,957,0.0,116,2783@TOP@human_GAPDH_TAA_len41_fa0_ta20_fm6_tm14,c
2783@TOP@human_GAPDH_TAA_len41_fa0_ta20_fm6_tm14*117*a,946,0,5,0,951,0.005,117,2783@TOP@human_GAPDH_TAA_len41_fa0_ta20_fm6_tm14,a
2783@TOP@human_GAPDH_TAA_len41_fa0_ta20_fm6_tm14*118*a,899,0,56,0,955,0.059,118,2783@TOP@human_GAPDH_TAA_len41_fa0_ta20_fm6_tm14,a
2783@TOP@human_GAPDH_TAA_len41_fa0_ta20_fm6_tm14*119*g,0,0,947,0,947,1.0,119,2783@TOP@human_GAPDH_TAA_len41_fa0_ta20_fm6_tm14,g
2783@TOP@human_GAPDH_TAA_len41_fa0_ta20_fm6_tm14*120*g,0,0,939,0,939,1.0,120,2783@TOP@human_GAPDH_TAA_len41_fa0_ta20_fm6_tm14,g
2783@TOP@human_GAPDH_TAA_len41_fa0_ta20_fm6_tm14*121*a,954,0,0,0,954,0.0,121,2783@TOP@human_GAPDH_TAA_len41_fa0_ta20_fm6_tm14,a
2783@TOP@human_GAPDH_TAA_len41_fa0_ta20_fm6_tm14*122*g,0,0,954,0,954,1.0,122,2783@TOP@human_GAPDH_TAA_len41_fa0_ta20_fm6_tm14,g
2783@TOP@human_GAPDH_TAA_len41_fa0_ta20_fm6_tm14*123*t,1,0,0,936,937,0.0,123,2783@TOP@human_GAPDH_TAA_len41_fa0_ta20_fm6_tm14,t
2783@TOP@human_GAPDH_TAA_len41_fa0_ta20_fm6_tm14*124*a,652,0,282,0,934,0.302,124,2783@TOP@human_GAPDH_TAA_len41_fa0_ta20_fm6_tm14,a
2783@TOP@human_GAPDH_TAA_len41_fa0_ta20_fm6_tm14*125*a,727,0,203,1,931,0.218,125,2783@TOP@human_GAPDH_TAA_len41_fa0_ta20_fm6_tm14,a
2783@TOP@human_GAPDH_TAA_len41_fa0_ta20_fm6_tm14*126*g,0,0,937,0,937,1.0,126,2783@TOP@human_GAPDH_TAA_len41_fa0_ta20_fm6_tm14,g
2783@TOP@human_GAPDH_TAA_len41_fa0_ta20_fm6_tm14*127*a,952,0,4,0,956,0.004,127,2783@TOP@human_GAPDH_TAA_len41_fa0_ta20_fm6_tm14,a
2783@TOP@human_GAPDH_TAA_len41_fa0_ta20_fm6_tm14*128*c,0,958,0,0,958,0.0,128,2783@TOP@human_GAPDH_TAA_len41_fa0_ta20_fm6_tm14,c
2783@TOP@human_GAPDH_TAA_len41_fa0_ta20_fm6_tm14*129*c,0,954,0,0,954,0.0,129,2783@TOP@human_GAPDH_TAA_len41_fa0_ta20_fm6_tm14,c
2783@TOP@human_GAPDH_TAA_len41_fa0_ta20_fm6_tm14*130*c,0,954,0,0,954,0.0,130,2783@TOP@human_GAPDH_TAA_len41_fa0_ta20_fm6_tm14,c
2783@TOP@human_GAPDH_TAA_len41_fa0_ta20_fm6_tm14*131*c,0,954,0,0,954,0.0,131,2783@TOP@human_GAPDH_TAA_len41_fa0_ta20_fm6_tm14,c
2783@TOP@human_GAPDH_TAA_len41_fa0_ta20_fm6_tm14*132*t,0,0,0,946,946,0.0,132,2783@TOP@human_GAPDH_TAA_len41_fa0_ta20_fm6_tm14,t
2783@TOP@human_GAPDH_TAA_len41_fa0_ta20_fm6_tm14*133*g,0,0,936,0,936,1.0,133,2783@TOP@human_GAPDH_TAA_len41_fa0_ta20_fm6_tm14,g
2783@TOP@human_GAPDH_TAA_len41_fa0_ta20_fm6_tm14*134*g,0,0,945,0,945,1.0,134,2783@TOP@human_GAPDH_TAA_len41_fa0_ta20_fm6_tm14,g
2784@TOP@human_GAPDH_TAA_len41_fa0_ta20_fm6_tm14*114*t,0,2,0,14145,14147,0.0,114,2784@TOP@human_GAPDH_TAA_len41_fa0_ta20_fm6_tm14,t
2784@TOP@human_GAPDH_TAA_len41_fa0_ta20_fm6_tm14*115*c,0,14239,0,2,14241,0.0,115,2784@TOP@human_GAPDH_TAA_len41_fa0_ta20_fm6_tm14,c
2784@TOP@human_GAPDH_TAA_len41_fa0_ta20_fm6_tm14*116*c,0,14180,0,0,14180,0.0,116,2784@TOP@human_GAPDH_TAA_len41_fa0_ta20_fm6_tm14,c
2784@TOP@human_GAPDH_TAA_len41_fa0_ta20_fm6_tm14*117*a,14165,0,18,0,14183,0.001,117,2784@TOP@human_GAPDH_TAA_len41_fa0_ta20_fm6_tm14,a
2784@TOP@human_GAPDH_TAA_len41_fa0_ta20_fm6_tm14*118*a,13976,0,113,1,14090,0.008,118,2784@TOP@human_GAPDH_TAA_len41_fa0_ta20_fm6_tm14,a
2784@TOP@human_GAPDH_TAA_len41_fa0_ta20_fm6_tm14*119*g,1,0,14074,0,14075,1.0,119,2784@TOP@human_GAPDH_TAA_len41_fa0_ta20_fm6_tm14,g
2784@TOP@human_GAPDH_TAA_len41_fa0_ta20_fm6_tm14*120*g,1,0,14010,0,14011,1.0,120,2784@TOP@human_GAPDH_TAA_len41_fa0_ta20_fm6_tm14,g
2784@TOP@human_GAPDH_TAA_len41_fa0_ta20_fm6_tm14*121*a,14162,0,7,0,14169,0.0,121,2784@TOP@human_GAPDH_TAA_len41_fa0_ta20_fm6_tm14,a
2784@TOP@human_GAPDH_TAA_len41_fa0_ta20_fm6_tm14*122*g,1,0,14166,0,14167,1.0,122,2784@TOP@human_GAPDH_TAA_len41_fa0_ta20_fm6_tm14,g
2784@TOP@human_GAPDH_TAA_len41_fa0_ta20_fm6_tm14*123*t,1,1,3,14013,14018,0.0,123,2784@TOP@human_GAPDH_TAA_len41_fa0_ta20_fm6_tm14,t
2784@TOP@human_GAPDH_TAA_len41_fa0_ta20_fm6_tm14*124*a,9161,1,4844,1,14007,0.346,124,2784@TOP@human_GAPDH_TAA_len41_fa0_ta20_fm6_tm14,a
2784@TOP@human_GAPDH_TAA_len41_fa0_ta20_fm6_tm14*125*a,11725,1,2243,3,13972,0.161,125,2784@TOP@human_GAPDH_TAA_len41_fa0_ta20_fm6_tm14,a
2784@TOP@human_GAPDH_TAA_len41_fa0_ta20_fm6_tm14*126*g,2,0,14048,1,14051,1.0,126,2784@TOP@human_GAPDH_TAA_len41_fa0_ta20_fm6_tm14,g
2784@TOP@human_GAPDH_TAA_len41_fa0_ta20_fm6_tm14*127*a,14088,2,51,0,14141,0.004,127,2784@TOP@human_GAPDH_TAA_len41_fa0_ta20_fm6_tm14,a
2784@TOP@human_GAPDH_TAA_len41_fa0_ta20_fm6_tm14*128*c,0,14203,0,1,14204,0.0,128,2784@TOP@human_GAPDH_TAA_len41_fa0_ta20_fm6_tm14,c
2784@TOP@human_GAPDH_TAA_len41_fa0_ta20_fm6_tm14*129*c,2,14121,0,0,14123,0.0,129,2784@TOP@human_GAPDH_TAA_len41_fa0_ta20_fm6_tm14,c
2784@TOP@human_GAPDH_TAA_len41_fa0_ta20_fm6_tm14*130*c,0,14187,0,2,14189,0.0,130,2784@TOP@human_GAPDH_TAA_len41_fa0_ta20_fm6_tm14,c
2784@TOP@human_GAPDH_TAA_len41_fa0_ta20_fm6_tm14*131*c,3,14206,0,2,14211,0.0,131,2784@TOP@human_GAPDH_TAA_len41_fa0_ta20_fm6_tm14,c
2784@TOP@human_GAPDH_TAA_len41_fa0_ta20_fm6_tm14*132*t,2,2,2,14045,14051,0.0,132,2784@TOP@human_GAPDH_TAA_len41_fa0_ta20_fm6_tm14,t
2784@TOP@human_GAPDH_TAA_len41_fa0_ta20_fm6_tm14*133*g,3,0,13981,0,13984,1.0,133,2784@TOP@human_GAPDH_TAA_len41_fa0_ta20_fm6_tm14,g
2784@TOP@human_GAPDH_TAA_len41_fa0_ta20_fm6_tm14*134*g,2,0,14040,1,14043,1.0,134,2784@TOP@human_GAPDH_TAA_len41_fa0_ta20_fm6_tm14,g
2785@TOP@human_GAPDH_TAA_len41_fa0_ta20_fm6_tm14*114*t,5,2,0,20177,20184,0.0,114,2785@TOP@human_GAPDH_TAA_len41_fa0_ta20_fm6_tm14,t
2785@TOP@human_GAPDH_TAA_len41_fa0_ta20_fm6_tm14*115*c,0,20301,0,0,20301,0.0,115,2785@TOP@human_GAPDH_TAA_len41_fa0_ta20_fm6_tm14,c
2785@TOP@human_GAPDH_TAA_len41_fa0_ta20_fm6_tm14*116*c,0,20231,0,0,20231,0.0,116,2785@TOP@human_GAPDH_TAA_len41_fa0_ta20_fm6_tm14,c
2785@TOP@human_GAPDH_TAA_len41_fa0_ta20_fm6_tm14*117*a,20169,1,34,0,20204,0.002,117,2785@TOP@human_GAPDH_TAA_len41_fa0_ta20_fm6_tm14,a
2785@TOP@human_GAPDH_TAA_len41_fa0_ta20_fm6_tm14*118*a,19798,1,269,0,20068,0.013,118,2785@TOP@human_GAPDH_TAA_len41_fa0_ta20_fm6_tm14,a
2785@TOP@human_GAPDH_TAA_len41_fa0_ta20_fm6_tm14*119*g,0,1,20076,0,20077,1.0,119,2785@TOP@human_GAPDH_TAA_len41_fa0_ta20_fm6_tm14,g
2785@TOP@human_GAPDH_TAA_len41_fa0_ta20_fm6_tm14*120*g,2,0,20000,0,20002,1.0,120,2785@TOP@human_GAPDH_TAA_len41_fa0_ta20_fm6_tm14,g
2785@TOP@human_GAPDH_TAA_len41_fa0_ta20_fm6_tm14*121*a,20179,0,10,1,20190,0.0,121,2785@TOP@human_GAPDH_TAA_len41_fa0_ta20_fm6_tm14,a
2785@TOP@human_GAPDH_TAA_len41_fa0_ta20_fm6_tm14*122*g,3,0,20198,0,20201,1.0,122,2785@TOP@human_GAPDH_TAA_len41_fa0_ta20_fm6_tm14,g
2785@TOP@human_GAPDH_TAA_len41_fa0_ta20_fm6_tm14*123*t,1,0,2,19975,19978,0.0,123,2785@TOP@human_GAPDH_TAA_len41_fa0_ta20_fm6_tm14,t
2785@TOP@human_GAPDH_TAA_len41_fa0_ta20_fm6_tm14*124*a,11611,0,8366,1,19978,0.419,124,2785@TOP@human_GAPDH_TAA_len41_fa0_ta20_fm6_tm14,a
2785@TOP@human_GAPDH_TAA_len41_fa0_ta20_fm6_tm14*125*a,14100,1,5802,2,19905,0.291,125,2785@TOP@human_GAPDH_TAA_len41_fa0_ta20_fm6_tm14,a
2785@TOP@human_GAPDH_TAA_len41_fa0_ta20_fm6_tm14*126*g,3,0,20032,2,20037,1.0,126,2785@TOP@human_GAPDH_TAA_len41_fa0_ta20_fm6_tm14,g
2785@TOP@human_GAPDH_TAA_len41_fa0_ta20_fm6_tm14*127*a,19961,1,185,0,20147,0.009,127,2785@TOP@human_GAPDH_TAA_len41_fa0_ta20_fm6_tm14,a
2785@TOP@human_GAPDH_TAA_len41_fa0_ta20_fm6_tm14*128*c,1,20256,3,3,20263,0.0,128,2785@TOP@human_GAPDH_TAA_len41_fa0_ta20_fm6_tm14,c
2785@TOP@human_GAPDH_TAA_len41_fa0_ta20_fm6_tm14*129*c,5,20109,0,1,20115,0.0,129,2785@TOP@human_GAPDH_TAA_len41_fa0_ta20_fm6_tm14,c
2785@TOP@human_GAPDH_TAA_len41_fa0_ta20_fm6_tm14*130*c,1,20250,1,1,20253,0.0,130,2785@TOP@human_GAPDH_TAA_len41_fa0_ta20_fm6_tm14,c
2785@TOP@human_GAPDH_TAA_len41_fa0_ta20_fm6_tm14*131*c,0,20270,0,0,20270,0.0,131,2785@TOP@human_GAPDH_TAA_len41_fa0_ta20_fm6_tm14,c
2785@TOP@human_GAPDH_TAA_len41_fa0_ta20_fm6_tm14*132*t,5,14,4,20023,20046,0.0,132,2785@TOP@human_GAPDH_TAA_len41_fa0_ta20_fm6_tm14,t
2785@TOP@human_GAPDH_TAA_len41_fa0_ta20_fm6_tm14*133*g,3,0,19948,2,19953,1.0,133,2785@TOP@human_GAPDH_TAA_len41_fa0_ta20_fm6_tm14,g
2785@TOP@human_GAPDH_TAA_len41_fa0_ta20_fm6_tm14*134*g,4,1,20077,2,20084,1.0,134,2785@TOP@human_GAPDH_TAA_len41_fa0_ta20_fm6_tm14,g
2786@TOP@human_GAPDH_TAA_len41_fa0_ta20_fm6_tm14*114*t,0,4,0,20883,20887,0.0,114,2786@TOP@human_GAPDH_TAA_len41_fa0_ta20_fm6_tm14,t
2786@TOP@human_GAPDH_TAA_len41_fa0_ta20_fm6_tm14*115*c,0,21005,0,1,21006,0.0,115,2786@TOP@human_GAPDH_TAA_len41_fa0_ta20_fm6_tm14,c
2786@TOP@human_GAPDH_TAA_len41_fa0_ta20_fm6_tm14*116*c,0,20925,0,2,20927,0.0,116,2786@TOP@human_GAPDH_TAA_len41_fa0_ta20_fm6_tm14,c
2786@TOP@human_GAPDH_TAA_len41_fa0_ta20_fm6_tm14*117*a,20879,0,24,1,20904,0.001,117,2786@TOP@human_GAPDH_TAA_len41_fa0_ta20_fm6_tm14,a
2786@TOP@human_GAPDH_TAA_len41_fa0_ta20_fm6_tm14*118*a,20621,1,181,0,20803,0.009,118,2786@TOP@human_GAPDH_TAA_len41_fa0_ta20_fm6_tm14,a
2786@TOP@human_GAPDH_TAA_len41_fa0_ta20_fm6_tm14*119*g,0,0,20748,0,20748,1.0,119,2786@TOP@human_GAPDH_TAA_len41_fa0_ta20_fm6_tm14,g
2786@TOP@human_GAPDH_TAA_len41_fa0_ta20_fm6_tm14*120*g,2,1,20671,0,20674,1.0,120,2786@TOP@human_GAPDH_TAA_len41_fa0_ta20_fm6_tm14,g
2786@TOP@human_GAPDH_TAA_len41_fa0_ta20_fm6_tm14*121*a,20913,0,4,2,20919,0.0,121,2786@TOP@human_GAPDH_TAA_len41_fa0_ta20_fm6_tm14,a
2786@TOP@human_GAPDH_TAA_len41_fa0_ta20_fm6_tm14*122*g,0,0,20930,0,20930,1.0,122,2786@TOP@human_GAPDH_TAA_len41_fa0_ta20_fm6_tm14,g
2786@TOP@human_GAPDH_TAA_len41_fa0_ta20_fm6_tm14*123*t,3,0,2,20666,20671,0.0,123,2786@TOP@human_GAPDH_TAA_len41_fa0_ta20_fm6_tm14,t
2786@TOP@human_GAPDH_TAA_len41_fa0_ta20_fm6_tm14*124*a,12084,0,8614,1,20699,0.416,124,2786@TOP@human_GAPDH_TAA_len41_fa0_ta20_fm6_tm14,a
2786@TOP@human_GAPDH_TAA_len41_fa0_ta20_fm6_tm14*125*a,14669,1,5934,1,20605,0.288,125,2786@TOP@human_GAPDH_TAA_len41_fa0_ta20_fm6_tm14,a
2786@TOP@human_GAPDH_TAA_len41_fa0_ta20_fm6_tm14*126*g,2,2,20703,1,20708,1.0,126,2786@TOP@human_GAPDH_TAA_len41_fa0_ta20_fm6_tm14,g
2786@TOP@human_GAPDH_TAA_len41_fa0_ta20_fm6_tm14*127*a,20746,1,116,0,20863,0.006,127,2786@TOP@human_GAPDH_TAA_len41_fa0_ta20_fm6_tm14,a
2786@TOP@human_GAPDH_TAA_len41_fa0_ta20_fm6_tm14*128*c,0,20955,0,3,20958,0.0,128,2786@TOP@human_GAPDH_TAA_len41_fa0_ta20_fm6_tm14,c
2786@TOP@human_GAPDH_TAA_len41_fa0_ta20_fm6_tm14*129*c,3,20861,0,0,20864,0.0,129,2786@TOP@human_GAPDH_TAA_len41_fa0_ta20_fm6_tm14,c
2786@TOP@human_GAPDH_TAA_len41_fa0_ta20_fm6_tm14*130*c,0,20939,0,1,20940,0.0,130,2786@TOP@human_GAPDH_TAA_len41_fa0_ta20_fm6_tm14,c
2786@TOP@human_GAPDH_TAA_len41_fa0_ta20_fm6_tm14*131*c,0,20970,0,1,20971,0.0,131,2786@TOP@human_GAPDH_TAA_len41_fa0_ta20_fm6_tm14,c
2786@TOP@human_GAPDH_TAA_len41_fa0_ta20_fm6_tm14*132*t,1,1,0,20722,20724,0.0,132,2786@TOP@human_GAPDH_TAA_len41_fa0_ta20_fm6_tm14,t
2786@TOP@human_GAPDH_TAA_len41_fa0_ta20_fm6_tm14*133*g,3,0,20696,1,20700,1.0,133,2786@TOP@human_GAPDH_TAA_len41_fa0_ta20_fm6_tm14,g
2786@TOP@human_GAPDH_TAA_len41_fa0_ta20_fm6_tm14*134*g,5,2,20730,1,20738,1.0,134,2786@TOP@human_GAPDH_TAA_len41_fa0_ta20_fm6_tm14,g
2787@TOP@human_GAPDH_TAA_len41_fa0_ta20_fm6_tm14*114*t,0,0,0,981,981,0.0,114,2787@TOP@human_GAPDH_TAA_len41_fa0_ta20_fm6_tm14,t
2787@TOP@human_GAPDH_TAA_len41_fa0_ta20_fm6_tm14*115*c,0,988,0,0,988,0.0,115,2787@TOP@human_GAPDH_TAA_len41_fa0_ta20_fm6_tm14,c
2787@TOP@human_GAPDH_TAA_len41_fa0_ta20_fm6_tm14*116*c,0,981,0,0,981,0.0,116,2787@TOP@human_GAPDH_TAA_len41_fa0_ta20_fm6_tm14,c
2787@TOP@human_GAPDH_TAA_len41_fa0_ta20_fm6_tm14*117*a,985,0,1,0,986,0.001,117,2787@TOP@human_GAPDH_TAA_len41_fa0_ta20_fm6_tm14,a
2787@TOP@human_GAPDH_TAA_len41_fa0_ta20_fm6_tm14*118*a,912,0,56,0,968,0.058,118,2787@TOP@human_GAPDH_TAA_len41_fa0_ta20_fm6_tm14,a
2787@TOP@human_GAPDH_TAA_len41_fa0_ta20_fm6_tm14*119*g,0,0,969,0,969,1.0,119,2787@TOP@human_GAPDH_TAA_len41_fa0_ta20_fm6_tm14,g
2787@TOP@human_GAPDH_TAA_len41_fa0_ta20_fm6_tm14*120*g,0,0,965,0,965,1.0,120,2787@TOP@human_GAPDH_TAA_len41_fa0_ta20_fm6_tm14,g
2787@TOP@human_GAPDH_TAA_len41_fa0_ta20_fm6_tm14*121*a,978,0,0,0,978,0.0,121,2787@TOP@human_GAPDH_TAA_len41_fa0_ta20_fm6_tm14,a
2787@TOP@human_GAPDH_TAA_len41_fa0_ta20_fm6_tm14*122*g,0,0,984,0,984,1.0,122,2787@TOP@human_GAPDH_TAA_len41_fa0_ta20_fm6_tm14,g
2787@TOP@human_GAPDH_TAA_len41_fa0_ta20_fm6_tm14*123*t,0,1,0,956,957,0.0,123,2787@TOP@human_GAPDH_TAA_len41_fa0_ta20_fm6_tm14,t
2787@TOP@human_GAPDH_TAA_len41_fa0_ta20_fm6_tm14*124*a,836,0,128,0,964,0.133,124,2787@TOP@human_GAPDH_TAA_len41_fa0_ta20_fm6_tm14,a
2787@TOP@human_GAPDH_TAA_len41_fa0_ta20_fm6_tm14*125*a,847,0,101,0,948,0.107,125,2787@TOP@human_GAPDH_TAA_len41_fa0_ta20_fm6_tm14,a
2787@TOP@human_GAPDH_TAA_len41_fa0_ta20_fm6_tm14*126*g,0,0,966,3,969,0.997,126,2787@TOP@human_GAPDH_TAA_len41_fa0_ta20_fm6_tm14,g
2787@TOP@human_GAPDH_TAA_len41_fa0_ta20_fm6_tm14*127*a,977,0,8,0,985,0.008,127,2787@TOP@human_GAPDH_TAA_len41_fa0_ta20_fm6_tm14,a
2787@TOP@human_GAPDH_TAA_len41_fa0_ta20_fm6_tm14*128*c,0,986,0,1,987,0.0,128,2787@TOP@human_GAPDH_TAA_len41_fa0_ta20_fm6_tm14,c
2787@TOP@human_GAPDH_TAA_len41_fa0_ta20_fm6_tm14*129*c,1,975,0,0,976,0.0,129,2787@TOP@human_GAPDH_TAA_len41_fa0_ta20_fm6_tm14,c
2787@TOP@human_GAPDH_TAA_len41_fa0_ta20_fm6_tm14*130*c,0,978,0,0,978,0.0,130,2787@TOP@human_GAPDH_TAA_len41_fa0_ta20_fm6_tm14,c
2787@TOP@human_GAPDH_TAA_len41_fa0_ta20_fm6_tm14*131*c,0,987,0,0,987,0.0,131,2787@TOP@human_GAPDH_TAA_len41_fa0_ta20_fm6_tm14,c
2787@TOP@human_GAPDH_TAA_len41_fa0_ta20_fm6_tm14*132*t,0,0,0,963,963,0.0,132,2787@TOP@human_GAPDH_TAA_len41_fa0_ta20_fm6_tm14,t
2787@TOP@human_GAPDH_TAA_len41_fa0_ta20_fm6_tm14*133*g,0,0,970,0,970,1.0,133,2787@TOP@human_GAPDH_TAA_len41_fa0_ta20_fm6_tm14,g
2787@TOP@human_GAPDH_TAA_len41_fa0_ta20_fm6_tm14*134*g,0,0,971,0,971,1.0,134,2787@TOP@human_GAPDH_TAA_len41_fa0_ta20_fm6_tm14,g
2788@TOP@human_GAPDH_TAA_len41_fa0_ta20_fm6_tm14*114*t,0,2,0,802,804,0.0,114,2788@TOP@human_GAPDH_TAA_len41_fa0_ta20_fm6_tm14,t
2788@TOP@human_GAPDH_TAA_len41_fa0_ta20_fm6_tm14*115*c,0,808,0,0,808,0.0,115,2788@TOP@human_GAPDH_TAA_len41_fa0_ta20_fm6_tm14,c
2788@TOP@human_GAPDH_TAA_len41_fa0_ta20_fm6_tm14*116*c,0,805,0,0,805,0.0,116,2788@TOP@human_GAPDH_TAA_len41_fa0_ta20_fm6_tm14,c
2788@TOP@human_GAPDH_TAA_len41_fa0_ta20_fm6_tm14*117*a,798,0,2,0,800,0.002,117,2788@TOP@human_GAPDH_TAA_len41_fa0_ta20_fm6_tm14,a
2788@TOP@human_GAPDH_TAA_len41_fa0_ta20_fm6_tm14*118*a,766,0,32,0,798,0.04,118,2788@TOP@human_GAPDH_TAA_len41_fa0_ta20_fm6_tm14,a
2788@TOP@human_GAPDH_TAA_len41_fa0_ta20_fm6_tm14*119*g,0,0,801,0,801,1.0,119,2788@TOP@human_GAPDH_TAA_len41_fa0_ta20_fm6_tm14,g
2788@TOP@human_GAPDH_TAA_len41_fa0_ta20_fm6_tm14*120*g,0,0,794,0,794,1.0,120,2788@TOP@human_GAPDH_TAA_len41_fa0_ta20_fm6_tm14,g
2788@TOP@human_GAPDH_TAA_len41_fa0_ta20_fm6_tm14*121*a,804,0,0,0,804,0.0,121,2788@TOP@human_GAPDH_TAA_len41_fa0_ta20_fm6_tm14,a
2788@TOP@human_GAPDH_TAA_len41_fa0_ta20_fm6_tm14*122*g,0,0,802,0,802,1.0,122,2788@TOP@human_GAPDH_TAA_len41_fa0_ta20_fm6_tm14,g
2788@TOP@human_GAPDH_TAA_len41_fa0_ta20_fm6_tm14*123*t,0,0,0,789,789,0.0,123,2788@TOP@human_GAPDH_TAA_len41_fa0_ta20_fm6_tm14,t
2788@TOP@human_GAPDH_TAA_len41_fa0_ta20_fm6_tm14*124*a,657,0,137,0,794,0.173,124,2788@TOP@human_GAPDH_TAA_len41_fa0_ta20_fm6_tm14,a
2788@TOP@human_GAPDH_TAA_len41_fa0_ta20_fm6_tm14*125*a,685,0,107,0,792,0.135,125,2788@TOP@human_GAPDH_TAA_len41_fa0_ta20_fm6_tm14,a
2788@TOP@human_GAPDH_TAA_len41_fa0_ta20_fm6_tm14*126*g,0,0,787,0,787,1.0,126,2788@TOP@human_GAPDH_TAA_len41_fa0_ta20_fm6_tm14,g
2788@TOP@human_GAPDH_TAA_len41_fa0_ta20_fm6_tm14*127*a,800,1,3,0,804,0.004,127,2788@TOP@human_GAPDH_TAA_len41_fa0_ta20_fm6_tm14,a
2788@TOP@human_GAPDH_TAA_len41_fa0_ta20_fm6_tm14*128*c,0,807,0,0,807,0.0,128,2788@TOP@human_GAPDH_TAA_len41_fa0_ta20_fm6_tm14,c
2788@TOP@human_GAPDH_TAA_len41_fa0_ta20_fm6_tm14*129*c,0,789,0,1,790,0.0,129,2788@TOP@human_GAPDH_TAA_len41_fa0_ta20_fm6_tm14,c
2788@TOP@human_GAPDH_TAA_len41_fa0_ta20_fm6_tm14*130*c,0,805,0,0,805,0.0,130,2788@TOP@human_GAPDH_TAA_len41_fa0_ta20_fm6_tm14,c
2788@TOP@human_GAPDH_TAA_len41_fa0_ta20_fm6_tm14*131*c,0,804,0,0,804,0.0,131,2788@TOP@human_GAPDH_TAA_len41_fa0_ta20_fm6_tm14,c
2788@TOP@human_GAPDH_TAA_len41_fa0_ta20_fm6_tm14*132*t,0,0,0,795,795,0.0,132,2788@TOP@human_GAPDH_TAA_len41_fa0_ta20_fm6_tm14,t
2788@TOP@human_GAPDH_TAA_len41_fa0_ta20_fm6_tm14*133*g,0,0,790,0,790,1.0,133,2788@TOP@human_GAPDH_TAA_len41_fa0_ta20_fm6_tm14,g
2788@TOP@human_GAPDH_TAA_len41_fa0_ta20_fm6_tm14*134*g,0,0,792,0,792,1.0,134,2788@TOP@human_GAPDH_TAA_len41_fa0_ta20_fm6_tm14,g
2789@TOP@human_GAPDH_TAA_len41_fa0_ta20_fm6_tm14*114*t,0,2,0,17183,17185,0.0,114,2789@TOP@human_GAPDH_TAA_len41_fa0_ta20_fm6_tm14,t
2789@TOP@human_GAPDH_TAA_len41_fa0_ta20_fm6_tm14*115*c,0,17269,0,3,17272,0.0,115,2789@TOP@human_GAPDH_TAA_len41_fa0_ta20_fm6_tm14,c
2789@TOP@human_GAPDH_TAA_len41_fa0_ta20_fm6_tm14*116*c,1,17208,0,2,17211,0.0,116,2789@TOP@human_GAPDH_TAA_len41_fa0_ta20_fm6_tm14,c
2789@TOP@human_GAPDH_TAA_len41_fa0_ta20_fm6_tm14*117*a,17179,0,28,0,17207,0.002,117,2789@TOP@human_GAPDH_TAA_len41_fa0_ta20_fm6_tm14,a
2789@TOP@human_GAPDH_TAA_len41_fa0_ta20_fm6_tm14*118*a,16891,0,209,0,17100,0.012,118,2789@TOP@human_GAPDH_TAA_len41_fa0_ta20_fm6_tm14,a
2789@TOP@human_GAPDH_TAA_len41_fa0_ta20_fm6_tm14*119*g,0,0,17098,0,17098,1.0,119,2789@TOP@human_GAPDH_TAA_len41_fa0_ta20_fm6_tm14,g
2789@TOP@human_GAPDH_TAA_len41_fa0_ta20_fm6_tm14*120*g,0,0,17010,0,17010,1.0,120,2789@TOP@human_GAPDH_TAA_len41_fa0_ta20_fm6_tm14,g
2789@TOP@human_GAPDH_TAA_len41_fa0_ta20_fm6_tm14*121*a,17173,0,15,0,17188,0.001,121,2789@TOP@human_GAPDH_TAA_len41_fa0_ta20_fm6_tm14,a
2789@TOP@human_GAPDH_TAA_len41_fa0_ta20_fm6_tm14*122*g,0,0,17213,0,17213,1.0,122,2789@TOP@human_GAPDH_TAA_len41_fa0_ta20_fm6_tm14,g
2789@TOP@human_GAPDH_TAA_len41_fa0_ta20_fm6_tm14*123*t,0,2,3,17012,17017,0.0,123,2789@TOP@human_GAPDH_TAA_len41_fa0_ta20_fm6_tm14,t
2789@TOP@human_GAPDH_TAA_len41_fa0_ta20_fm6_tm14*124*a,13422,1,3512,0,16935,0.207,124,2789@TOP@human_GAPDH_TAA_len41_fa0_ta20_fm6_tm14,a
2789@TOP@human_GAPDH_TAA_len41_fa0_ta20_fm6_tm14*125*a,13657,1,3319,0,16977,0.195,125,2789@TOP@human_GAPDH_TAA_len41_fa0_ta20_fm6_tm14,a
2789@TOP@human_GAPDH_TAA_len41_fa0_ta20_fm6_tm14*126*g,1,0,16954,2,16957,1.0,126,2789@TOP@human_GAPDH_TAA_len41_fa0_ta20_fm6_tm14,g
2789@TOP@human_GAPDH_TAA_len41_fa0_ta20_fm6_tm14*127*a,16911,2,251,0,17164,0.015,127,2789@TOP@human_GAPDH_TAA_len41_fa0_ta20_fm6_tm14,a
2789@TOP@human_GAPDH_TAA_len41_fa0_ta20_fm6_tm14*128*c,0,17222,2,2,17226,0.0,128,2789@TOP@human_GAPDH_TAA_len41_fa0_ta20_fm6_tm14,c
2789@TOP@human_GAPDH_TAA_len41_fa0_ta20_fm6_tm14*129*c,4,17135,0,2,17141,0.0,129,2789@TOP@human_GAPDH_TAA_len41_fa0_ta20_fm6_tm14,c
2789@TOP@human_GAPDH_TAA_len41_fa0_ta20_fm6_tm14*130*c,2,17200,0,0,17202,0.0,130,2789@TOP@human_GAPDH_TAA_len41_fa0_ta20_fm6_tm14,c
2789@TOP@human_GAPDH_TAA_len41_fa0_ta20_fm6_tm14*131*c,3,17231,1,0,17235,0.0,131,2789@TOP@human_GAPDH_TAA_len41_fa0_ta20_fm6_tm14,c
2789@TOP@human_GAPDH_TAA_len41_fa0_ta20_fm6_tm14*132*t,0,1,1,17024,17026,0.0,132,2789@TOP@human_GAPDH_TAA_len41_fa0_ta20_fm6_tm14,t
2789@TOP@human_GAPDH_TAA_len41_fa0_ta20_fm6_tm14*133*g,2,0,16961,0,16963,1.0,133,2789@TOP@human_GAPDH_TAA_len41_fa0_ta20_fm6_tm14,g
2789@TOP@human_GAPDH_TAA_len41_fa0_ta20_fm6_tm14*134*g,0,1,17039,0,17040,1.0,134,2789@TOP@human_GAPDH_TAA_len41_fa0_ta20_fm6_tm14,g
2790@TOP@human_GAPDH_TAA_len41_fa0_ta20_fm6_tm14*114*t,0,11,0,24242,24253,0.0,114,2790@TOP@human_GAPDH_TAA_len41_fa0_ta20_fm6_tm14,t
2790@TOP@human_GAPDH_TAA_len41_fa0_ta20_fm6_tm14*115*c,1,24376,0,1,24378,0.0,115,2790@TOP@human_GAPDH_TAA_len41_fa0_ta20_fm6_tm14,c
2790@TOP@human_GAPDH_TAA_len41_fa0_ta20_fm6_tm14*116*c,0,24272,0,1,24273,0.0,116,2790@TOP@human_GAPDH_TAA_len41_fa0_ta20_fm6_tm14,c
2790@TOP@human_GAPDH_TAA_len41_fa0_ta20_fm6_tm14*117*a,24236,0,43,1,24280,0.002,117,2790@TOP@human_GAPDH_TAA_len41_fa0_ta20_fm6_tm14,a
2790@TOP@human_GAPDH_TAA_len41_fa0_ta20_fm6_tm14*118*a,23867,1,270,0,24138,0.011,118,2790@TOP@human_GAPDH_TAA_len41_fa0_ta20_fm6_tm14,a
2790@TOP@human_GAPDH_TAA_len41_fa0_ta20_fm6_tm14*119*g,4,0,24119,0,24123,1.0,119,2790@TOP@human_GAPDH_TAA_len41_fa0_ta20_fm6_tm14,g
2790@TOP@human_GAPDH_TAA_len41_fa0_ta20_fm6_tm14*120*g,0,0,24011,1,24012,1.0,120,2790@TOP@human_GAPDH_TAA_len41_fa0_ta20_fm6_tm14,g
2790@TOP@human_GAPDH_TAA_len41_fa0_ta20_fm6_tm14*121*a,24268,0,7,0,24275,0.0,121,2790@TOP@human_GAPDH_TAA_len41_fa0_ta20_fm6_tm14,a
2790@TOP@human_GAPDH_TAA_len41_fa0_ta20_fm6_tm14*122*g,0,0,24276,1,24277,1.0,122,2790@TOP@human_GAPDH_TAA_len41_fa0_ta20_fm6_tm14,g
2790@TOP@human_GAPDH_TAA_len41_fa0_ta20_fm6_tm14*123*t,2,1,1,23974,23978,0.0,123,2790@TOP@human_GAPDH_TAA_len41_fa0_ta20_fm6_tm14,t
2790@TOP@human_GAPDH_TAA_len41_fa0_ta20_fm6_tm14*124*a,14395,0,9599,1,23995,0.4,124,2790@TOP@human_GAPDH_TAA_len41_fa0_ta20_fm6_tm14,a
2790@TOP@human_GAPDH_TAA_len41_fa0_ta20_fm6_tm14*125*a,22301,1,1658,1,23961,0.069,125,2790@TOP@human_GAPDH_TAA_len41_fa0_ta20_fm6_tm14,a
2790@TOP@human_GAPDH_TAA_len41_fa0_ta20_fm6_tm14*126*g,1,1,24052,1,24055,1.0,126,2790@TOP@human_GAPDH_TAA_len41_fa0_ta20_fm6_tm14,g
2790@TOP@human_GAPDH_TAA_len41_fa0_ta20_fm6_tm14*127*a,24078,2,162,0,24242,0.007,127,2790@TOP@human_GAPDH_TAA_len41_fa0_ta20_fm6_tm14,a
2790@TOP@human_GAPDH_TAA_len41_fa0_ta20_fm6_tm14*128*c,0,24323,2,0,24325,0.0,128,2790@TOP@human_GAPDH_TAA_len41_fa0_ta20_fm6_tm14,c
2790@TOP@human_GAPDH_TAA_len41_fa0_ta20_fm6_tm14*129*c,0,24188,1,3,24192,0.0,129,2790@TOP@human_GAPDH_TAA_len41_fa0_ta20_fm6_tm14,c
2790@TOP@human_GAPDH_TAA_len41_fa0_ta20_fm6_tm14*130*c,1,24289,0,2,24292,0.0,130,2790@TOP@human_GAPDH_TAA_len41_fa0_ta20_fm6_tm14,c
2790@TOP@human_GAPDH_TAA_len41_fa0_ta20_fm6_tm14*131*c,5,24341,0,5,24351,0.0,131,2790@TOP@human_GAPDH_TAA_len41_fa0_ta20_fm6_tm14,c
2790@TOP@human_GAPDH_TAA_len41_fa0_ta20_fm6_tm14*132*t,3,4,2,24022,24031,0.0,132,2790@TOP@human_GAPDH_TAA_len41_fa0_ta20_fm6_tm14,t
2790@TOP@human_GAPDH_TAA_len41_fa0_ta20_fm6_tm14*133*g,2,0,23945,2,23949,1.0,133,2790@TOP@human_GAPDH_TAA_len41_fa0_ta20_fm6_tm14,g
2790@TOP@human_GAPDH_TAA_len41_fa0_ta20_fm6_tm14*134*g,1,1,24108,0,24110,1.0,134,2790@TOP@human_GAPDH_TAA_len41_fa0_ta20_fm6_tm14,g
2791@TOP@human_GAPDH_TAA_len41_fa0_ta20_fm6_tm14*114*t,0,2,0,2856,2858,0.0,114,2791@TOP@human_GAPDH_TAA_len41_fa0_ta20_fm6_tm14,t
2791@TOP@human_GAPDH_TAA_len41_fa0_ta20_fm6_tm14*115*c,0,2869,0,0,2869,0.0,115,2791@TOP@human_GAPDH_TAA_len41_fa0_ta20_fm6_tm14,c
2791@TOP@human_GAPDH_TAA_len41_fa0_ta20_fm6_tm14*116*c,0,2858,0,0,2858,0.0,116,2791@TOP@human_GAPDH_TAA_len41_fa0_ta20_fm6_tm14,c
2791@TOP@human_GAPDH_TAA_len41_fa0_ta20_fm6_tm14*117*a,2851,0,6,0,2857,0.002,117,2791@TOP@human_GAPDH_TAA_len41_fa0_ta20_fm6_tm14,a
2791@TOP@human_GAPDH_TAA_len41_fa0_ta20_fm6_tm14*118*a,2811,0,33,0,2844,0.012,118,2791@TOP@human_GAPDH_TAA_len41_fa0_ta20_fm6_tm14,a
2791@TOP@human_GAPDH_TAA_len41_fa0_ta20_fm6_tm14*119*g,0,0,2832,0,2832,1.0,119,2791@TOP@human_GAPDH_TAA_len41_fa0_ta20_fm6_tm14,g
2791@TOP@human_GAPDH_TAA_len41_fa0_ta20_fm6_tm14*120*g,0,0,2819,0,2819,1.0,120,2791@TOP@human_GAPDH_TAA_len41_fa0_ta20_fm6_tm14,g
2791@TOP@human_GAPDH_TAA_len41_fa0_ta20_fm6_tm14*121*a,2857,0,2,1,2860,0.001,121,2791@TOP@human_GAPDH_TAA_len41_fa0_ta20_fm6_tm14,a
2791@TOP@human_GAPDH_TAA_len41_fa0_ta20_fm6_tm14*122*g,0,0,2851,0,2851,1.0,122,2791@TOP@human_GAPDH_TAA_len41_fa0_ta20_fm6_tm14,g
2791@TOP@human_GAPDH_TAA_len41_fa0_ta20_fm6_tm14*123*t,2,0,1,2809,2812,0.0,123,2791@TOP@human_GAPDH_TAA_len41_fa0_ta20_fm6_tm14,t
2791@TOP@human_GAPDH_TAA_len41_fa0_ta20_fm6_tm14*124*a,2065,1,756,2,2824,0.268,124,2791@TOP@human_GAPDH_TAA_len41_fa0_ta20_fm6_tm14,a
2791@TOP@human_GAPDH_TAA_len41_fa0_ta20_fm6_tm14*125*a,2264,0,533,0,2797,0.191,125,2791@TOP@human_GAPDH_TAA_len41_fa0_ta20_fm6_tm14,a
2791@TOP@human_GAPDH_TAA_len41_fa0_ta20_fm6_tm14*126*g,0,0,2814,0,2814,1.0,126,2791@TOP@human_GAPDH_TAA_len41_fa0_ta20_fm6_tm14,g
2791@TOP@human_GAPDH_TAA_len41_fa0_ta20_fm6_tm14*127*a,2739,0,110,0,2849,0.039,127,2791@TOP@human_GAPDH_TAA_len41_fa0_ta20_fm6_tm14,a
2791@TOP@human_GAPDH_TAA_len41_fa0_ta20_fm6_tm14*128*c,0,2861,0,1,2862,0.0,128,2791@TOP@human_GAPDH_TAA_len41_fa0_ta20_fm6_tm14,c
2791@TOP@human_GAPDH_TAA_len41_fa0_ta20_fm6_tm14*129*c,0,2838,0,0,2838,0.0,129,2791@TOP@human_GAPDH_TAA_len41_fa0_ta20_fm6_tm14,c
2791@TOP@human_GAPDH_TAA_len41_fa0_ta20_fm6_tm14*130*c,0,2852,0,1,2853,0.0,130,2791@TOP@human_GAPDH_TAA_len41_fa0_ta20_fm6_tm14,c
2791@TOP@human_GAPDH_TAA_len41_fa0_ta20_fm6_tm14*131*c,0,2867,0,0,2867,0.0,131,2791@TOP@human_GAPDH_TAA_len41_fa0_ta20_fm6_tm14,c
2791@TOP@human_GAPDH_TAA_len41_fa0_ta20_fm6_tm14*132*t,0,0,0,2817,2817,0.0,132,2791@TOP@human_GAPDH_TAA_len41_fa0_ta20_fm6_tm14,t
2791@TOP@human_GAPDH_TAA_len41_fa0_ta20_fm6_tm14*133*g,0,0,2810,0,2810,1.0,133,2791@TOP@human_GAPDH_TAA_len41_fa0_ta20_fm6_tm14,g
2791@TOP@human_GAPDH_TAA_len41_fa0_ta20_fm6_tm14*134*g,0,0,2827,1,2828,1.0,134,2791@TOP@human_GAPDH_TAA_len41_fa0_ta20_fm6_tm14,g
2792@TOP@human_GAPDH_TAA_len41_fa0_ta20_fm6_tm14*114*t,0,11,0,20845,20856,0.0,114,2792@TOP@human_GAPDH_TAA_len41_fa0_ta20_fm6_tm14,t
2792@TOP@human_GAPDH_TAA_len41_fa0_ta20_fm6_tm14*115*c,1,20963,0,3,20967,0.0,115,2792@TOP@human_GAPDH_TAA_len41_fa0_ta20_fm6_tm14,c
2792@TOP@human_GAPDH_TAA_len41_fa0_ta20_fm6_tm14*116*c,2,20892,0,1,20895,0.0,116,2792@TOP@human_GAPDH_TAA_len41_fa0_ta20_fm6_tm14,c
2792@TOP@human_GAPDH_TAA_len41_fa0_ta20_fm6_tm14*117*a,20848,0,36,0,20884,0.002,117,2792@TOP@human_GAPDH_TAA_len41_fa0_ta20_fm6_tm14,a
2792@TOP@human_GAPDH_TAA_len41_fa0_ta20_fm6_tm14*118*a,20534,2,229,3,20768,0.011,118,2792@TOP@human_GAPDH_TAA_len41_fa0_ta20_fm6_tm14,a
2792@TOP@human_GAPDH_TAA_len41_fa0_ta20_fm6_tm14*119*g,6,0,20712,1,20719,1.0,119,2792@TOP@human_GAPDH_TAA_len41_fa0_ta20_fm6_tm14,g
2792@TOP@human_GAPDH_TAA_len41_fa0_ta20_fm6_tm14*120*g,3,0,20636,0,20639,1.0,120,2792@TOP@human_GAPDH_TAA_len41_fa0_ta20_fm6_tm14,g
2792@TOP@human_GAPDH_TAA_len41_fa0_ta20_fm6_tm14*121*a,20851,0,10,2,20863,0.0,121,2792@TOP@human_GAPDH_TAA_len41_fa0_ta20_fm6_tm14,a
2792@TOP@human_GAPDH_TAA_len41_fa0_ta20_fm6_tm14*122*g,0,0,20876,1,20877,1.0,122,2792@TOP@human_GAPDH_TAA_len41_fa0_ta20_fm6_tm14,g
2792@TOP@human_GAPDH_TAA_len41_fa0_ta20_fm6_tm14*123*t,6,6,7,20639,20658,0.0,123,2792@TOP@human_GAPDH_TAA_len41_fa0_ta20_fm6_tm14,t
2792@TOP@human_GAPDH_TAA_len41_fa0_ta20_fm6_tm14*124*a,13854,0,6782,1,20637,0.329,124,2792@TOP@human_GAPDH_TAA_len41_fa0_ta20_fm6_tm14,a
2792@TOP@human_GAPDH_TAA_len41_fa0_ta20_fm6_tm14*125*a,15945,2,4676,0,20623,0.227,125,2792@TOP@human_GAPDH_TAA_len41_fa0_ta20_fm6_tm14,a
2792@TOP@human_GAPDH_TAA_len41_fa0_ta20_fm6_tm14*126*g,0,1,20664,1,20666,1.0,126,2792@TOP@human_GAPDH_TAA_len41_fa0_ta20_fm6_tm14,g
2792@TOP@human_GAPDH_TAA_len41_fa0_ta20_fm6_tm14*127*a,20593,0,240,0,20833,0.012,127,2792@TOP@human_GAPDH_TAA_len41_fa0_ta20_fm6_tm14,a
2792@TOP@human_GAPDH_TAA_len41_fa0_ta20_fm6_tm14*128*c,0,20904,5,1,20910,0.0,128,2792@TOP@human_GAPDH_TAA_len41_fa0_ta20_fm6_tm14,c
2792@TOP@human_GAPDH_TAA_len41_fa0_ta20_fm6_tm14*129*c,2,20785,0,0,20787,0.0,129,2792@TOP@human_GAPDH_TAA_len41_fa0_ta20_fm6_tm14,c
2792@TOP@human_GAPDH_TAA_len41_fa0_ta20_fm6_tm14*130*c,2,20902,0,0,20904,0.0,130,2792@TOP@human_GAPDH_TAA_len41_fa0_ta20_fm6_tm14,c
2792@TOP@human_GAPDH_TAA_len41_fa0_ta20_fm6_tm14*131*c,3,20934,0,3,20940,0.0,131,2792@TOP@human_GAPDH_TAA_len41_fa0_ta20_fm6_tm14,c
2792@TOP@human_GAPDH_TAA_len41_fa0_ta20_fm6_tm14*132*t,2,7,4,20682,20695,0.0,132,2792@TOP@human_GAPDH_TAA_len41_fa0_ta20_fm6_tm14,t
2792@TOP@human_GAPDH_TAA_len41_fa0_ta20_fm6_tm14*133*g,2,0,20586,0,20588,1.0,133,2792@TOP@human_GAPDH_TAA_len41_fa0_ta20_fm6_tm14,g
2792@TOP@human_GAPDH_TAA_len41_fa0_ta20_fm6_tm14*134*g,2,2,20746,1,20751,1.0,134,2792@TOP@human_GAPDH_TAA_len41_fa0_ta20_fm6_tm14,g
2793@TOP@human_GAPDH_TAA_len41_fa0_ta20_fm6_tm14*114*t,0,0,0,1771,1771,0.0,114,2793@TOP@human_GAPDH_TAA_len41_fa0_ta20_fm6_tm14,t
2793@TOP@human_GAPDH_TAA_len41_fa0_ta20_fm6_tm14*115*c,0,1781,0,0,1781,0.0,115,2793@TOP@human_GAPDH_TAA_len41_fa0_ta20_fm6_tm14,c
2793@TOP@human_GAPDH_TAA_len41_fa0_ta20_fm6_tm14*116*c,0,1770,0,0,1770,0.0,116,2793@TOP@human_GAPDH_TAA_len41_fa0_ta20_fm6_tm14,c
2793@TOP@human_GAPDH_TAA_len41_fa0_ta20_fm6_tm14*117*a,1771,0,2,0,1773,0.001,117,2793@TOP@human_GAPDH_TAA_len41_fa0_ta20_fm6_tm14,a
2793@TOP@human_GAPDH_TAA_len41_fa0_ta20_fm6_tm14*118*a,1720,0,40,0,1760,0.023,118,2793@TOP@human_GAPDH_TAA_len41_fa0_ta20_fm6_tm14,a
2793@TOP@human_GAPDH_TAA_len41_fa0_ta20_fm6_tm14*119*g,0,0,1751,0,1751,1.0,119,2793@TOP@human_GAPDH_TAA_len41_fa0_ta20_fm6_tm14,g
2793@TOP@human_GAPDH_TAA_len41_fa0_ta20_fm6_tm14*120*g,0,0,1746,0,1746,1.0,120,2793@TOP@human_GAPDH_TAA_len41_fa0_ta20_fm6_tm14,g
2793@TOP@human_GAPDH_TAA_len41_fa0_ta20_fm6_tm14*121*a,1774,0,2,0,1776,0.001,121,2793@TOP@human_GAPDH_TAA_len41_fa0_ta20_fm6_tm14,a
2793@TOP@human_GAPDH_TAA_len41_fa0_ta20_fm6_tm14*122*g,0,0,1773,0,1773,1.0,122,2793@TOP@human_GAPDH_TAA_len41_fa0_ta20_fm6_tm14,g
2793@TOP@human_GAPDH_TAA_len41_fa0_ta20_fm6_tm14*123*t,0,1,0,1753,1754,0.0,123,2793@TOP@human_GAPDH_TAA_len41_fa0_ta20_fm6_tm14,t
2793@TOP@human_GAPDH_TAA_len41_fa0_ta20_fm6_tm14*124*a,1234,0,530,0,1764,0.3,124,2793@TOP@human_GAPDH_TAA_len41_fa0_ta20_fm6_tm14,a
2793@TOP@human_GAPDH_TAA_len41_fa0_ta20_fm6_tm14*125*a,1397,0,361,0,1758,0.205,125,2793@TOP@human_GAPDH_TAA_len41_fa0_ta20_fm6_tm14,a
2793@TOP@human_GAPDH_TAA_len41_fa0_ta20_fm6_tm14*126*g,0,0,1760,0,1760,1.0,126,2793@TOP@human_GAPDH_TAA_len41_fa0_ta20_fm6_tm14,g
2793@TOP@human_GAPDH_TAA_len41_fa0_ta20_fm6_tm14*127*a,1764,0,9,0,1773,0.005,127,2793@TOP@human_GAPDH_TAA_len41_fa0_ta20_fm6_tm14,a
2793@TOP@human_GAPDH_TAA_len41_fa0_ta20_fm6_tm14*128*c,0,1778,0,1,1779,0.0,128,2793@TOP@human_GAPDH_TAA_len41_fa0_ta20_fm6_tm14,c
2793@TOP@human_GAPDH_TAA_len41_fa0_ta20_fm6_tm14*129*c,0,1765,0,0,1765,0.0,129,2793@TOP@human_GAPDH_TAA_len41_fa0_ta20_fm6_tm14,c
2793@TOP@human_GAPDH_TAA_len41_fa0_ta20_fm6_tm14*130*c,0,1776,0,0,1776,0.0,130,2793@TOP@human_GAPDH_TAA_len41_fa0_ta20_fm6_tm14,c
2793@TOP@human_GAPDH_TAA_len41_fa0_ta20_fm6_tm14*131*c,0,1778,0,0,1778,0.0,131,2793@TOP@human_GAPDH_TAA_len41_fa0_ta20_fm6_tm14,c
2793@TOP@human_GAPDH_TAA_len41_fa0_ta20_fm6_tm14*132*t,0,0,0,1751,1751,0.0,132,2793@TOP@human_GAPDH_TAA_len41_fa0_ta20_fm6_tm14,t
2793@TOP@human_GAPDH_TAA_len41_fa0_ta20_fm6_tm14*133*g,0,0,1746,0,1746,1.0,133,2793@TOP@human_GAPDH_TAA_len41_fa0_ta20_fm6_tm14,g
2793@TOP@human_GAPDH_TAA_len41_fa0_ta20_fm6_tm14*134*g,0,0,1763,0,1763,1.0,134,2793@TOP@human_GAPDH_TAA_len41_fa0_ta20_fm6_tm14,g
2794@TOP@human_GAPDH_TAA_len41_fa0_ta20_fm6_tm14*114*t,0,2,0,2159,2161,0.0,114,2794@TOP@human_GAPDH_TAA_len41_fa0_ta20_fm6_tm14,t
2794@TOP@human_GAPDH_TAA_len41_fa0_ta20_fm6_tm14*115*c,0,2172,0,0,2172,0.0,115,2794@TOP@human_GAPDH_TAA_len41_fa0_ta20_fm6_tm14,c
2794@TOP@human_GAPDH_TAA_len41_fa0_ta20_fm6_tm14*116*c,0,2164,0,0,2164,0.0,116,2794@TOP@human_GAPDH_TAA_len41_fa0_ta20_fm6_tm14,c
2794@TOP@human_GAPDH_TAA_len41_fa0_ta20_fm6_tm14*117*a,2153,0,6,0,2159,0.003,117,2794@TOP@human_GAPDH_TAA_len41_fa0_ta20_fm6_tm14,a
2794@TOP@human_GAPDH_TAA_len41_fa0_ta20_fm6_tm14*118*a,2079,0,74,0,2153,0.034,118,2794@TOP@human_GAPDH_TAA_len41_fa0_ta20_fm6_tm14,a
2794@TOP@human_GAPDH_TAA_len41_fa0_ta20_fm6_tm14*119*g,0,0,2146,0,2146,1.0,119,2794@TOP@human_GAPDH_TAA_len41_fa0_ta20_fm6_tm14,g
2794@TOP@human_GAPDH_TAA_len41_fa0_ta20_fm6_tm14*120*g,0,0,2139,0,2139,1.0,120,2794@TOP@human_GAPDH_TAA_len41_fa0_ta20_fm6_tm14,g
2794@TOP@human_GAPDH_TAA_len41_fa0_ta20_fm6_tm14*121*a,2163,0,4,0,2167,0.002,121,2794@TOP@human_GAPDH_TAA_len41_fa0_ta20_fm6_tm14,a
2794@TOP@human_GAPDH_TAA_len41_fa0_ta20_fm6_tm14*122*g,0,0,2161,0,2161,1.0,122,2794@TOP@human_GAPDH_TAA_len41_fa0_ta20_fm6_tm14,g
2794@TOP@human_GAPDH_TAA_len41_fa0_ta20_fm6_tm14*123*t,0,0,0,2135,2135,0.0,123,2794@TOP@human_GAPDH_TAA_len41_fa0_ta20_fm6_tm14,t
2794@TOP@human_GAPDH_TAA_len41_fa0_ta20_fm6_tm14*124*a,962,0,1184,0,2146,0.552,124,2794@TOP@human_GAPDH_TAA_len41_fa0_ta20_fm6_tm14,a
2794@TOP@human_GAPDH_TAA_len41_fa0_ta20_fm6_tm14*125*a,1167,0,964,1,2132,0.452,125,2794@TOP@human_GAPDH_TAA_len41_fa0_ta20_fm6_tm14,a
2794@TOP@human_GAPDH_TAA_len41_fa0_ta20_fm6_tm14*126*g,0,0,2147,0,2147,1.0,126,2794@TOP@human_GAPDH_TAA_len41_fa0_ta20_fm6_tm14,g
2794@TOP@human_GAPDH_TAA_len41_fa0_ta20_fm6_tm14*127*a,2116,0,41,0,2157,0.019,127,2794@TOP@human_GAPDH_TAA_len41_fa0_ta20_fm6_tm14,a
2794@TOP@human_GAPDH_TAA_len41_fa0_ta20_fm6_tm14*128*c,0,2167,0,0,2167,0.0,128,2794@TOP@human_GAPDH_TAA_len41_fa0_ta20_fm6_tm14,c
2794@TOP@human_GAPDH_TAA_len41_fa0_ta20_fm6_tm14*129*c,0,2153,0,0,2153,0.0,129,2794@TOP@human_GAPDH_TAA_len41_fa0_ta20_fm6_tm14,c
2794@TOP@human_GAPDH_TAA_len41_fa0_ta20_fm6_tm14*130*c,0,2162,0,0,2162,0.0,130,2794@TOP@human_GAPDH_TAA_len41_fa0_ta20_fm6_tm14,c
2794@TOP@human_GAPDH_TAA_len41_fa0_ta20_fm6_tm14*131*c,0,2164,0,0,2164,0.0,131,2794@TOP@human_GAPDH_TAA_len41_fa0_ta20_fm6_tm14,c
2794@TOP@human_GAPDH_TAA_len41_fa0_ta20_fm6_tm14*132*t,0,0,0,2135,2135,0.0,132,2794@TOP@human_GAPDH_TAA_len41_fa0_ta20_fm6_tm14,t
2794@TOP@human_GAPDH_TAA_len41_fa0_ta20_fm6_tm14*133*g,0,0,2136,0,2136,1.0,133,2794@TOP@human_GAPDH_TAA_len41_fa0_ta20_fm6_tm14,g
2794@TOP@human_GAPDH_TAA_len41_fa0_ta20_fm6_tm14*134*g,0,0,2140,0,2140,1.0,134,2794@TOP@human_GAPDH_TAA_len41_fa0_ta20_fm6_tm14,g
2795@TOP@human_GAPDH_TAA_len41_fa0_ta20_fm6_tm14*114*t,3,3,0,15065,15071,0.0,114,2795@TOP@human_GAPDH_TAA_len41_fa0_ta20_fm6_tm14,t
2795@TOP@human_GAPDH_TAA_len41_fa0_ta20_fm6_tm14*115*c,1,15147,0,1,15149,0.0,115,2795@TOP@human_GAPDH_TAA_len41_fa0_ta20_fm6_tm14,c
2795@TOP@human_GAPDH_TAA_len41_fa0_ta20_fm6_tm14*116*c,0,15093,0,0,15093,0.0,116,2795@TOP@human_GAPDH_TAA_len41_fa0_ta20_fm6_tm14,c
2795@TOP@human_GAPDH_TAA_len41_fa0_ta20_fm6_tm14*117*a,15044,0,25,1,15070,0.002,117,2795@TOP@human_GAPDH_TAA_len41_fa0_ta20_fm6_tm14,a
2795@TOP@human_GAPDH_TAA_len41_fa0_ta20_fm6_tm14*118*a,14785,0,177,1,14963,0.012,118,2795@TOP@human_GAPDH_TAA_len41_fa0_ta20_fm6_tm14,a
2795@TOP@human_GAPDH_TAA_len41_fa0_ta20_fm6_tm14*119*g,0,1,14969,0,14970,1.0,119,2795@TOP@human_GAPDH_TAA_len41_fa0_ta20_fm6_tm14,g
2795@TOP@human_GAPDH_TAA_len41_fa0_ta20_fm6_tm14*120*g,0,0,14894,0,14894,1.0,120,2795@TOP@human_GAPDH_TAA_len41_fa0_ta20_fm6_tm14,g
2795@TOP@human_GAPDH_TAA_len41_fa0_ta20_fm6_tm14*121*a,15084,0,4,0,15088,0.0,121,2795@TOP@human_GAPDH_TAA_len41_fa0_ta20_fm6_tm14,a
2795@TOP@human_GAPDH_TAA_len41_fa0_ta20_fm6_tm14*122*g,2,0,15086,0,15088,1.0,122,2795@TOP@human_GAPDH_TAA_len41_fa0_ta20_fm6_tm14,g
2795@TOP@human_GAPDH_TAA_len41_fa0_ta20_fm6_tm14*123*t,2,0,3,14906,14911,0.0,123,2795@TOP@human_GAPDH_TAA_len41_fa0_ta20_fm6_tm14,t
2795@TOP@human_GAPDH_TAA_len41_fa0_ta20_fm6_tm14*124*a,9849,0,5064,1,14914,0.34,124,2795@TOP@human_GAPDH_TAA_len41_fa0_ta20_fm6_tm14,a
2795@TOP@human_GAPDH_TAA_len41_fa0_ta20_fm6_tm14*125*a,11437,1,3417,4,14859,0.23,125,2795@TOP@human_GAPDH_TAA_len41_fa0_ta20_fm6_tm14,a
2795@TOP@human_GAPDH_TAA_len41_fa0_ta20_fm6_tm14*126*g,1,0,14919,0,14920,1.0,126,2795@TOP@human_GAPDH_TAA_len41_fa0_ta20_fm6_tm14,g
2795@TOP@human_GAPDH_TAA_len41_fa0_ta20_fm6_tm14*127*a,14923,0,129,1,15053,0.009,127,2795@TOP@human_GAPDH_TAA_len41_fa0_ta20_fm6_tm14,a
2795@TOP@human_GAPDH_TAA_len41_fa0_ta20_fm6_tm14*128*c,2,15101,3,0,15106,0.0,128,2795@TOP@human_GAPDH_TAA_len41_fa0_ta20_fm6_tm14,c
2795@TOP@human_GAPDH_TAA_len41_fa0_ta20_fm6_tm14*129*c,0,15038,0,0,15038,0.0,129,2795@TOP@human_GAPDH_TAA_len41_fa0_ta20_fm6_tm14,c
2795@TOP@human_GAPDH_TAA_len41_fa0_ta20_fm6_tm14*130*c,0,15105,1,0,15106,0.0,130,2795@TOP@human_GAPDH_TAA_len41_fa0_ta20_fm6_tm14,c
2795@TOP@human_GAPDH_TAA_len41_fa0_ta20_fm6_tm14*131*c,1,15121,0,1,15123,0.0,131,2795@TOP@human_GAPDH_TAA_len41_fa0_ta20_fm6_tm14,c
2795@TOP@human_GAPDH_TAA_len41_fa0_ta20_fm6_tm14*132*t,3,2,4,14929,14938,0.0,132,2795@TOP@human_GAPDH_TAA_len41_fa0_ta20_fm6_tm14,t
2795@TOP@human_GAPDH_TAA_len41_fa0_ta20_fm6_tm14*133*g,0,0,14877,0,14877,1.0,133,2795@TOP@human_GAPDH_TAA_len41_fa0_ta20_fm6_tm14,g
2795@TOP@human_GAPDH_TAA_len41_fa0_ta20_fm6_tm14*134*g,0,0,14982,0,14982,1.0,134,2795@TOP@human_GAPDH_TAA_len41_fa0_ta20_fm6_tm14,g
2796@TOP@human_GAPDH_TAA_len41_fa0_ta20_fm6_tm14*114*t,2,2,0,20520,20524,0.0,114,2796@TOP@human_GAPDH_TAA_len41_fa0_ta20_fm6_tm14,t
2796@TOP@human_GAPDH_TAA_len41_fa0_ta20_fm6_tm14*115*c,0,20668,1,0,20669,0.0,115,2796@TOP@human_GAPDH_TAA_len41_fa0_ta20_fm6_tm14,c
2796@TOP@human_GAPDH_TAA_len41_fa0_ta20_fm6_tm14*116*c,0,20589,0,2,20591,0.0,116,2796@TOP@human_GAPDH_TAA_len41_fa0_ta20_fm6_tm14,c
2796@TOP@human_GAPDH_TAA_len41_fa0_ta20_fm6_tm14*117*a,20538,0,21,0,20559,0.001,117,2796@TOP@human_GAPDH_TAA_len41_fa0_ta20_fm6_tm14,a
2796@TOP@human_GAPDH_TAA_len41_fa0_ta20_fm6_tm14*118*a,20141,0,271,3,20415,0.013,118,2796@TOP@human_GAPDH_TAA_len41_fa0_ta20_fm6_tm14,a
2796@TOP@human_GAPDH_TAA_len41_fa0_ta20_fm6_tm14*119*g,0,0,20436,1,20437,1.0,119,2796@TOP@human_GAPDH_TAA_len41_fa0_ta20_fm6_tm14,g
2796@TOP@human_GAPDH_TAA_len41_fa0_ta20_fm6_tm14*120*g,0,0,20336,2,20338,1.0,120,2796@TOP@human_GAPDH_TAA_len41_fa0_ta20_fm6_tm14,g
2796@TOP@human_GAPDH_TAA_len41_fa0_ta20_fm6_tm14*121*a,20548,0,4,1,20553,0.0,121,2796@TOP@human_GAPDH_TAA_len41_fa0_ta20_fm6_tm14,a
2796@TOP@human_GAPDH_TAA_len41_fa0_ta20_fm6_tm14*122*g,0,0,20584,0,20584,1.0,122,2796@TOP@human_GAPDH_TAA_len41_fa0_ta20_fm6_tm14,g
2796@TOP@human_GAPDH_TAA_len41_fa0_ta20_fm6_tm14*123*t,2,1,6,20338,20347,0.0,123,2796@TOP@human_GAPDH_TAA_len41_fa0_ta20_fm6_tm14,t
2796@TOP@human_GAPDH_TAA_len41_fa0_ta20_fm6_tm14*124*a,11056,0,9275,2,20333,0.456,124,2796@TOP@human_GAPDH_TAA_len41_fa0_ta20_fm6_tm14,a
2796@TOP@human_GAPDH_TAA_len41_fa0_ta20_fm6_tm14*125*a,13515,0,6748,1,20264,0.333,125,2796@TOP@human_GAPDH_TAA_len41_fa0_ta20_fm6_tm14,a
2796@TOP@human_GAPDH_TAA_len41_fa0_ta20_fm6_tm14*126*g,1,0,20355,0,20356,1.0,126,2796@TOP@human_GAPDH_TAA_len41_fa0_ta20_fm6_tm14,g
2796@TOP@human_GAPDH_TAA_len41_fa0_ta20_fm6_tm14*127*a,20424,2,81,4,20511,0.004,127,2796@TOP@human_GAPDH_TAA_len41_fa0_ta20_fm6_tm14,a
2796@TOP@human_GAPDH_TAA_len41_fa0_ta20_fm6_tm14*128*c,0,20618,0,1,20619,0.0,128,2796@TOP@human_GAPDH_TAA_len41_fa0_ta20_fm6_tm14,c
2796@TOP@human_GAPDH_TAA_len41_fa0_ta20_fm6_tm14*129*c,2,20493,0,1,20496,0.0,129,2796@TOP@human_GAPDH_TAA_len41_fa0_ta20_fm6_tm14,c
2796@TOP@human_GAPDH_TAA_len41_fa0_ta20_fm6_tm14*130*c,0,20595,0,0,20595,0.0,130,2796@TOP@human_GAPDH_TAA_len41_fa0_ta20_fm6_tm14,c
2796@TOP@human_GAPDH_TAA_len41_fa0_ta20_fm6_tm14*131*c,3,20625,0,0,20628,0.0,131,2796@TOP@human_GAPDH_TAA_len41_fa0_ta20_fm6_tm14,c
2796@TOP@human_GAPDH_TAA_len41_fa0_ta20_fm6_tm14*132*t,5,5,0,20357,20367,0.0,132,2796@TOP@human_GAPDH_TAA_len41_fa0_ta20_fm6_tm14,t
2796@TOP@human_GAPDH_TAA_len41_fa0_ta20_fm6_tm14*133*g,1,0,20302,4,20307,1.0,133,2796@TOP@human_GAPDH_TAA_len41_fa0_ta20_fm6_tm14,g
2796@TOP@human_GAPDH_TAA_len41_fa0_ta20_fm6_tm14*134*g,1,0,20399,0,20400,1.0,134,2796@TOP@human_GAPDH_TAA_len41_fa0_ta20_fm6_tm14,g
2797@TOP@human_GAPDH_TAA_len41_fa0_ta20_fm6_tm14*114*t,0,1,0,2730,2731,0.0,114,2797@TOP@human_GAPDH_TAA_len41_fa0_ta20_fm6_tm14,t
2797@TOP@human_GAPDH_TAA_len41_fa0_ta20_fm6_tm14*115*c,0,2740,0,1,2741,0.0,115,2797@TOP@human_GAPDH_TAA_len41_fa0_ta20_fm6_tm14,c
2797@TOP@human_GAPDH_TAA_len41_fa0_ta20_fm6_tm14*116*c,0,2736,0,0,2736,0.0,116,2797@TOP@human_GAPDH_TAA_len41_fa0_ta20_fm6_tm14,c
2797@TOP@human_GAPDH_TAA_len41_fa0_ta20_fm6_tm14*117*a,2724,0,6,0,2730,0.002,117,2797@TOP@human_GAPDH_TAA_len41_fa0_ta20_fm6_tm14,a
2797@TOP@human_GAPDH_TAA_len41_fa0_ta20_fm6_tm14*118*a,2668,0,47,0,2715,0.017,118,2797@TOP@human_GAPDH_TAA_len41_fa0_ta20_fm6_tm14,a
2797@TOP@human_GAPDH_TAA_len41_fa0_ta20_fm6_tm14*119*g,0,0,2712,0,2712,1.0,119,2797@TOP@human_GAPDH_TAA_len41_fa0_ta20_fm6_tm14,g
2797@TOP@human_GAPDH_TAA_len41_fa0_ta20_fm6_tm14*120*g,0,0,2705,0,2705,1.0,120,2797@TOP@human_GAPDH_TAA_len41_fa0_ta20_fm6_tm14,g
2797@TOP@human_GAPDH_TAA_len41_fa0_ta20_fm6_tm14*121*a,2723,0,2,0,2725,0.001,121,2797@TOP@human_GAPDH_TAA_len41_fa0_ta20_fm6_tm14,a
2797@TOP@human_GAPDH_TAA_len41_fa0_ta20_fm6_tm14*122*g,0,0,2731,0,2731,1.0,122,2797@TOP@human_GAPDH_TAA_len41_fa0_ta20_fm6_tm14,g
2797@TOP@human_GAPDH_TAA_len41_fa0_ta20_fm6_tm14*123*t,0,0,0,2702,2702,0.0,123,2797@TOP@human_GAPDH_TAA_len41_fa0_ta20_fm6_tm14,t
2797@TOP@human_GAPDH_TAA_len41_fa0_ta20_fm6_tm14*124*a,2594,0,89,0,2683,0.033,124,2797@TOP@human_GAPDH_TAA_len41_fa0_ta20_fm6_tm14,a
2797@TOP@human_GAPDH_TAA_len41_fa0_ta20_fm6_tm14*125*a,2561,0,131,0,2692,0.049,125,2797@TOP@human_GAPDH_TAA_len41_fa0_ta20_fm6_tm14,a
2797@TOP@human_GAPDH_TAA_len41_fa0_ta20_fm6_tm14*126*g,0,0,2690,0,2690,1.0,126,2797@TOP@human_GAPDH_TAA_len41_fa0_ta20_fm6_tm14,g
2797@TOP@human_GAPDH_TAA_len41_fa0_ta20_fm6_tm14*127*a,2713,0,6,0,2719,0.002,127,2797@TOP@human_GAPDH_TAA_len41_fa0_ta20_fm6_tm14,a
2797@TOP@human_GAPDH_TAA_len41_fa0_ta20_fm6_tm14*128*c,0,2735,0,0,2735,0.0,128,2797@TOP@human_GAPDH_TAA_len41_fa0_ta20_fm6_tm14,c
2797@TOP@human_GAPDH_TAA_len41_fa0_ta20_fm6_tm14*129*c,0,2719,0,0,2719,0.0,129,2797@TOP@human_GAPDH_TAA_len41_fa0_ta20_fm6_tm14,c
2797@TOP@human_GAPDH_TAA_len41_fa0_ta20_fm6_tm14*130*c,0,2724,0,1,2725,0.0,130,2797@TOP@human_GAPDH_TAA_len41_fa0_ta20_fm6_tm14,c
2797@TOP@human_GAPDH_TAA_len41_fa0_ta20_fm6_tm14*131*c,1,2738,0,0,2739,0.0,131,2797@TOP@human_GAPDH_TAA_len41_fa0_ta20_fm6_tm14,c
2797@TOP@human_GAPDH_TAA_len41_fa0_ta20_fm6_tm14*132*t,0,1,0,2697,2698,0.0,132,2797@TOP@human_GAPDH_TAA_len41_fa0_ta20_fm6_tm14,t
2797@TOP@human_GAPDH_TAA_len41_fa0_ta20_fm6_tm14*133*g,0,0,2691,0,2691,1.0,133,2797@TOP@human_GAPDH_TAA_len41_fa0_ta20_fm6_tm14,g
2797@TOP@human_GAPDH_TAA_len41_fa0_ta20_fm6_tm14*134*g,0,0,2702,0,2702,1.0,134,2797@TOP@human_GAPDH_TAA_len41_fa0_ta20_fm6_tm14,g
2798@TOP@human_GAPDH_TAA_len41_fa0_ta20_fm6_tm14*114*t,3,0,0,1098,1101,0.0,114,2798@TOP@human_GAPDH_TAA_len41_fa0_ta20_fm6_tm14,t
2798@TOP@human_GAPDH_TAA_len41_fa0_ta20_fm6_tm14*115*c,0,1110,0,0,1110,0.0,115,2798@TOP@human_GAPDH_TAA_len41_fa0_ta20_fm6_tm14,c
2798@TOP@human_GAPDH_TAA_len41_fa0_ta20_fm6_tm14*116*c,0,1104,0,0,1104,0.0,116,2798@TOP@human_GAPDH_TAA_len41_fa0_ta20_fm6_tm14,c
2798@TOP@human_GAPDH_TAA_len41_fa0_ta20_fm6_tm14*117*a,1098,0,5,0,1103,0.005,117,2798@TOP@human_GAPDH_TAA_len41_fa0_ta20_fm6_tm14,a
2798@TOP@human_GAPDH_TAA_len41_fa0_ta20_fm6_tm14*118*a,1051,0,44,0,1095,0.04,118,2798@TOP@human_GAPDH_TAA_len41_fa0_ta20_fm6_tm14,a
2798@TOP@human_GAPDH_TAA_len41_fa0_ta20_fm6_tm14*119*g,0,0,1092,0,1092,1.0,119,2798@TOP@human_GAPDH_TAA_len41_fa0_ta20_fm6_tm14,g
2798@TOP@human_GAPDH_TAA_len41_fa0_ta20_fm6_tm14*120*g,0,0,1091,0,1091,1.0,120,2798@TOP@human_GAPDH_TAA_len41_fa0_ta20_fm6_tm14,g
2798@TOP@human_GAPDH_TAA_len41_fa0_ta20_fm6_tm14*121*a,1099,0,3,0,1102,0.003,121,2798@TOP@human_GAPDH_TAA_len41_fa0_ta20_fm6_tm14,a
2798@TOP@human_GAPDH_TAA_len41_fa0_ta20_fm6_tm14*122*g,0,0,1103,0,1103,1.0,122,2798@TOP@human_GAPDH_TAA_len41_fa0_ta20_fm6_tm14,g
2798@TOP@human_GAPDH_TAA_len41_fa0_ta20_fm6_tm14*123*t,0,0,1,1085,1086,0.001,123,2798@TOP@human_GAPDH_TAA_len41_fa0_ta20_fm6_tm14,t
2798@TOP@human_GAPDH_TAA_len41_fa0_ta20_fm6_tm14*124*a,541,0,555,0,1096,0.506,124,2798@TOP@human_GAPDH_TAA_len41_fa0_ta20_fm6_tm14,a
2798@TOP@human_GAPDH_TAA_len41_fa0_ta20_fm6_tm14*125*a,553,0,530,0,1083,0.489,125,2798@TOP@human_GAPDH_TAA_len41_fa0_ta20_fm6_tm14,a
2798@TOP@human_GAPDH_TAA_len41_fa0_ta20_fm6_tm14*126*g,0,0,1097,0,1097,1.0,126,2798@TOP@human_GAPDH_TAA_len41_fa0_ta20_fm6_tm14,g
2798@TOP@human_GAPDH_TAA_len41_fa0_ta20_fm6_tm14*127*a,1088,0,14,0,1102,0.013,127,2798@TOP@human_GAPDH_TAA_len41_fa0_ta20_fm6_tm14,a
2798@TOP@human_GAPDH_TAA_len41_fa0_ta20_fm6_tm14*128*c,0,1105,0,0,1105,0.0,128,2798@TOP@human_GAPDH_TAA_len41_fa0_ta20_fm6_tm14,c
2798@TOP@human_GAPDH_TAA_len41_fa0_ta20_fm6_tm14*129*c,0,1105,0,0,1105,0.0,129,2798@TOP@human_GAPDH_TAA_len41_fa0_ta20_fm6_tm14,c
2798@TOP@human_GAPDH_TAA_len41_fa0_ta20_fm6_tm14*130*c,0,1106,0,0,1106,0.0,130,2798@TOP@human_GAPDH_TAA_len41_fa0_ta20_fm6_tm14,c
2798@TOP@human_GAPDH_TAA_len41_fa0_ta20_fm6_tm14*131*c,0,1109,0,0,1109,0.0,131,2798@TOP@human_GAPDH_TAA_len41_fa0_ta20_fm6_tm14,c
2798@TOP@human_GAPDH_TAA_len41_fa0_ta20_fm6_tm14*132*t,0,0,0,1098,1098,0.0,132,2798@TOP@human_GAPDH_TAA_len41_fa0_ta20_fm6_tm14,t
2798@TOP@human_GAPDH_TAA_len41_fa0_ta20_fm6_tm14*133*g,0,0,1088,0,1088,1.0,133,2798@TOP@human_GAPDH_TAA_len41_fa0_ta20_fm6_tm14,g
2798@TOP@human_GAPDH_TAA_len41_fa0_ta20_fm6_tm14*134*g,0,0,1101,0,1101,1.0,134,2798@TOP@human_GAPDH_TAA_len41_fa0_ta20_fm6_tm14,g
2799@TOP@human_GAPDH_TAA_len41_fa0_ta20_fm6_tm14*114*t,0,0,0,359,359,0.0,114,2799@TOP@human_GAPDH_TAA_len41_fa0_ta20_fm6_tm14,t
2799@TOP@human_GAPDH_TAA_len41_fa0_ta20_fm6_tm14*115*c,0,365,0,0,365,0.0,115,2799@TOP@human_GAPDH_TAA_len41_fa0_ta20_fm6_tm14,c
2799@TOP@human_GAPDH_TAA_len41_fa0_ta20_fm6_tm14*116*c,0,360,0,0,360,0.0,116,2799@TOP@human_GAPDH_TAA_len41_fa0_ta20_fm6_tm14,c
2799@TOP@human_GAPDH_TAA_len41_fa0_ta20_fm6_tm14*117*a,358,0,2,1,361,0.006,117,2799@TOP@human_GAPDH_TAA_len41_fa0_ta20_fm6_tm14,a
2799@TOP@human_GAPDH_TAA_len41_fa0_ta20_fm6_tm14*118*a,348,0,8,0,356,0.022,118,2799@TOP@human_GAPDH_TAA_len41_fa0_ta20_fm6_tm14,a
2799@TOP@human_GAPDH_TAA_len41_fa0_ta20_fm6_tm14*119*g,0,0,355,0,355,1.0,119,2799@TOP@human_GAPDH_TAA_len41_fa0_ta20_fm6_tm14,g
2799@TOP@human_GAPDH_TAA_len41_fa0_ta20_fm6_tm14*120*g,0,0,355,0,355,1.0,120,2799@TOP@human_GAPDH_TAA_len41_fa0_ta20_fm6_tm14,g
2799@TOP@human_GAPDH_TAA_len41_fa0_ta20_fm6_tm14*121*a,362,0,2,0,364,0.005,121,2799@TOP@human_GAPDH_TAA_len41_fa0_ta20_fm6_tm14,a
2799@TOP@human_GAPDH_TAA_len41_fa0_ta20_fm6_tm14*122*g,0,0,362,0,362,1.0,122,2799@TOP@human_GAPDH_TAA_len41_fa0_ta20_fm6_tm14,g
2799@TOP@human_GAPDH_TAA_len41_fa0_ta20_fm6_tm14*123*t,0,0,0,350,350,0.0,123,2799@TOP@human_GAPDH_TAA_len41_fa0_ta20_fm6_tm14,t
2799@TOP@human_GAPDH_TAA_len41_fa0_ta20_fm6_tm14*124*a,279,0,73,0,352,0.207,124,2799@TOP@human_GAPDH_TAA_len41_fa0_ta20_fm6_tm14,a
2799@TOP@human_GAPDH_TAA_len41_fa0_ta20_fm6_tm14*125*a,294,0,63,0,357,0.176,125,2799@TOP@human_GAPDH_TAA_len41_fa0_ta20_fm6_tm14,a
2799@TOP@human_GAPDH_TAA_len41_fa0_ta20_fm6_tm14*126*g,0,0,356,0,356,1.0,126,2799@TOP@human_GAPDH_TAA_len41_fa0_ta20_fm6_tm14,g
2799@TOP@human_GAPDH_TAA_len41_fa0_ta20_fm6_tm14*127*a,358,0,5,0,363,0.014,127,2799@TOP@human_GAPDH_TAA_len41_fa0_ta20_fm6_tm14,a
2799@TOP@human_GAPDH_TAA_len41_fa0_ta20_fm6_tm14*128*c,0,363,0,0,363,0.0,128,2799@TOP@human_GAPDH_TAA_len41_fa0_ta20_fm6_tm14,c
2799@TOP@human_GAPDH_TAA_len41_fa0_ta20_fm6_tm14*129*c,0,357,0,0,357,0.0,129,2799@TOP@human_GAPDH_TAA_len41_fa0_ta20_fm6_tm14,c
2799@TOP@human_GAPDH_TAA_len41_fa0_ta20_fm6_tm14*130*c,0,361,0,0,361,0.0,130,2799@TOP@human_GAPDH_TAA_len41_fa0_ta20_fm6_tm14,c
2799@TOP@human_GAPDH_TAA_len41_fa0_ta20_fm6_tm14*131*c,0,365,0,0,365,0.0,131,2799@TOP@human_GAPDH_TAA_len41_fa0_ta20_fm6_tm14,c
2799@TOP@human_GAPDH_TAA_len41_fa0_ta20_fm6_tm14*132*t,0,1,0,354,355,0.0,132,2799@TOP@human_GAPDH_TAA_len41_fa0_ta20_fm6_tm14,t
2799@TOP@human_GAPDH_TAA_len41_fa0_ta20_fm6_tm14*133*g,1,0,354,0,355,0.997,133,2799@TOP@human_GAPDH_TAA_len41_fa0_ta20_fm6_tm14,g
2799@TOP@human_GAPDH_TAA_len41_fa0_ta20_fm6_tm14*134*g,0,0,361,0,361,1.0,134,2799@TOP@human_GAPDH_TAA_len41_fa0_ta20_fm6_tm14,g
2800@TOP@human_GAPDH_TAA_len41_fa0_ta20_fm6_tm14*114*t,0,0,0,703,703,0.0,114,2800@TOP@human_GAPDH_TAA_len41_fa0_ta20_fm6_tm14,t
2800@TOP@human_GAPDH_TAA_len41_fa0_ta20_fm6_tm14*115*c,0,706,0,0,706,0.0,115,2800@TOP@human_GAPDH_TAA_len41_fa0_ta20_fm6_tm14,c
2800@TOP@human_GAPDH_TAA_len41_fa0_ta20_fm6_tm14*116*c,0,700,0,0,700,0.0,116,2800@TOP@human_GAPDH_TAA_len41_fa0_ta20_fm6_tm14,c
2800@TOP@human_GAPDH_TAA_len41_fa0_ta20_fm6_tm14*117*a,703,0,0,0,703,0.0,117,2800@TOP@human_GAPDH_TAA_len41_fa0_ta20_fm6_tm14,a
2800@TOP@human_GAPDH_TAA_len41_fa0_ta20_fm6_tm14*118*a,686,0,14,0,700,0.02,118,2800@TOP@human_GAPDH_TAA_len41_fa0_ta20_fm6_tm14,a
2800@TOP@human_GAPDH_TAA_len41_fa0_ta20_fm6_tm14*119*g,0,0,697,0,697,1.0,119,2800@TOP@human_GAPDH_TAA_len41_fa0_ta20_fm6_tm14,g
2800@TOP@human_GAPDH_TAA_len41_fa0_ta20_fm6_tm14*120*g,0,0,689,0,689,1.0,120,2800@TOP@human_GAPDH_TAA_len41_fa0_ta20_fm6_tm14,g
2800@TOP@human_GAPDH_TAA_len41_fa0_ta20_fm6_tm14*121*a,703,0,3,0,706,0.004,121,2800@TOP@human_GAPDH_TAA_len41_fa0_ta20_fm6_tm14,a
2800@TOP@human_GAPDH_TAA_len41_fa0_ta20_fm6_tm14*122*g,0,0,702,0,702,1.0,122,2800@TOP@human_GAPDH_TAA_len41_fa0_ta20_fm6_tm14,g
2800@TOP@human_GAPDH_TAA_len41_fa0_ta20_fm6_tm14*123*t,0,0,1,695,696,0.001,123,2800@TOP@human_GAPDH_TAA_len41_fa0_ta20_fm6_tm14,t
2800@TOP@human_GAPDH_TAA_len41_fa0_ta20_fm6_tm14*124*a,496,0,196,0,692,0.283,124,2800@TOP@human_GAPDH_TAA_len41_fa0_ta20_fm6_tm14,a
2800@TOP@human_GAPDH_TAA_len41_fa0_ta20_fm6_tm14*125*a,632,0,58,0,690,0.084,125,2800@TOP@human_GAPDH_TAA_len41_fa0_ta20_fm6_tm14,a
2800@TOP@human_GAPDH_TAA_len41_fa0_ta20_fm6_tm14*126*g,0,0,691,0,691,1.0,126,2800@TOP@human_GAPDH_TAA_len41_fa0_ta20_fm6_tm14,g
2800@TOP@human_GAPDH_TAA_len41_fa0_ta20_fm6_tm14*127*a,699,0,2,0,701,0.003,127,2800@TOP@human_GAPDH_TAA_len41_fa0_ta20_fm6_tm14,a
2800@TOP@human_GAPDH_TAA_len41_fa0_ta20_fm6_tm14*128*c,0,706,0,0,706,0.0,128,2800@TOP@human_GAPDH_TAA_len41_fa0_ta20_fm6_tm14,c
2800@TOP@human_GAPDH_TAA_len41_fa0_ta20_fm6_tm14*129*c,0,695,0,0,695,0.0,129,2800@TOP@human_GAPDH_TAA_len41_fa0_ta20_fm6_tm14,c
2800@TOP@human_GAPDH_TAA_len41_fa0_ta20_fm6_tm14*130*c,0,701,0,0,701,0.0,130,2800@TOP@human_GAPDH_TAA_len41_fa0_ta20_fm6_tm14,c
2800@TOP@human_GAPDH_TAA_len41_fa0_ta20_fm6_tm14*131*c,0,705,0,0,705,0.0,131,2800@TOP@human_GAPDH_TAA_len41_fa0_ta20_fm6_tm14,c
2800@TOP@human_GAPDH_TAA_len41_fa0_ta20_fm6_tm14*132*t,0,0,0,694,694,0.0,132,2800@TOP@human_GAPDH_TAA_len41_fa0_ta20_fm6_tm14,t
2800@TOP@human_GAPDH_TAA_len41_fa0_ta20_fm6_tm14*133*g,0,0,692,0,692,1.0,133,2800@TOP@human_GAPDH_TAA_len41_fa0_ta20_fm6_tm14,g
2800@TOP@human_GAPDH_TAA_len41_fa0_ta20_fm6_tm14*134*g,0,3,697,0,700,0.996,134,2800@TOP@human_GAPDH_TAA_len41_fa0_ta20_fm6_tm14,g
2801@TOP@human_GAPDH_TAA_len41_fa0_ta20_fm6_tm14*114*t,0,1,0,1075,1076,0.0,114,2801@TOP@human_GAPDH_TAA_len41_fa0_ta20_fm6_tm14,t
2801@TOP@human_GAPDH_TAA_len41_fa0_ta20_fm6_tm14*115*c,0,1084,0,0,1084,0.0,115,2801@TOP@human_GAPDH_TAA_len41_fa0_ta20_fm6_tm14,c
2801@TOP@human_GAPDH_TAA_len41_fa0_ta20_fm6_tm14*116*c,0,1079,0,0,1079,0.0,116,2801@TOP@human_GAPDH_TAA_len41_fa0_ta20_fm6_tm14,c
2801@TOP@human_GAPDH_TAA_len41_fa0_ta20_fm6_tm14*117*a,1081,0,1,0,1082,0.001,117,2801@TOP@human_GAPDH_TAA_len41_fa0_ta20_fm6_tm14,a
2801@TOP@human_GAPDH_TAA_len41_fa0_ta20_fm6_tm14*118*a,1044,0,28,0,1072,0.026,118,2801@TOP@human_GAPDH_TAA_len41_fa0_ta20_fm6_tm14,a
2801@TOP@human_GAPDH_TAA_len41_fa0_ta20_fm6_tm14*119*g,0,0,1062,0,1062,1.0,119,2801@TOP@human_GAPDH_TAA_len41_fa0_ta20_fm6_tm14,g
2801@TOP@human_GAPDH_TAA_len41_fa0_ta20_fm6_tm14*120*g,0,0,1066,0,1066,1.0,120,2801@TOP@human_GAPDH_TAA_len41_fa0_ta20_fm6_tm14,g
2801@TOP@human_GAPDH_TAA_len41_fa0_ta20_fm6_tm14*121*a,1069,0,4,0,1073,0.004,121,2801@TOP@human_GAPDH_TAA_len41_fa0_ta20_fm6_tm14,a
2801@TOP@human_GAPDH_TAA_len41_fa0_ta20_fm6_tm14*122*g,0,0,1079,0,1079,1.0,122,2801@TOP@human_GAPDH_TAA_len41_fa0_ta20_fm6_tm14,g
2801@TOP@human_GAPDH_TAA_len41_fa0_ta20_fm6_tm14*123*t,0,0,1,1070,1071,0.001,123,2801@TOP@human_GAPDH_TAA_len41_fa0_ta20_fm6_tm14,t
2801@TOP@human_GAPDH_TAA_len41_fa0_ta20_fm6_tm14*124*a,639,0,420,0,1059,0.397,124,2801@TOP@human_GAPDH_TAA_len41_fa0_ta20_fm6_tm14,a
2801@TOP@human_GAPDH_TAA_len41_fa0_ta20_fm6_tm14*125*a,730,1,321,0,1052,0.305,125,2801@TOP@human_GAPDH_TAA_len41_fa0_ta20_fm6_tm14,a
2801@TOP@human_GAPDH_TAA_len41_fa0_ta20_fm6_tm14*126*g,0,0,1064,0,1064,1.0,126,2801@TOP@human_GAPDH_TAA_len41_fa0_ta20_fm6_tm14,g
2801@TOP@human_GAPDH_TAA_len41_fa0_ta20_fm6_tm14*127*a,1035,0,39,0,1074,0.036,127,2801@TOP@human_GAPDH_TAA_len41_fa0_ta20_fm6_tm14,a
2801@TOP@human_GAPDH_TAA_len41_fa0_ta20_fm6_tm14*128*c,0,1081,0,0,1081,0.0,128,2801@TOP@human_GAPDH_TAA_len41_fa0_ta20_fm6_tm14,c
2801@TOP@human_GAPDH_TAA_len41_fa0_ta20_fm6_tm14*129*c,0,1079,0,0,1079,0.0,129,2801@TOP@human_GAPDH_TAA_len41_fa0_ta20_fm6_tm14,c
2801@TOP@human_GAPDH_TAA_len41_fa0_ta20_fm6_tm14*130*c,0,1076,0,0,1076,0.0,130,2801@TOP@human_GAPDH_TAA_len41_fa0_ta20_fm6_tm14,c
2801@TOP@human_GAPDH_TAA_len41_fa0_ta20_fm6_tm14*131*c,0,1082,0,0,1082,0.0,131,2801@TOP@human_GAPDH_TAA_len41_fa0_ta20_fm6_tm14,c
2801@TOP@human_GAPDH_TAA_len41_fa0_ta20_fm6_tm14*132*t,0,0,0,1065,1065,0.0,132,2801@TOP@human_GAPDH_TAA_len41_fa0_ta20_fm6_tm14,t
2801@TOP@human_GAPDH_TAA_len41_fa0_ta20_fm6_tm14*133*g,0,0,1065,0,1065,1.0,133,2801@TOP@human_GAPDH_TAA_len41_fa0_ta20_fm6_tm14,g
2801@TOP@human_GAPDH_TAA_len41_fa0_ta20_fm6_tm14*134*g,0,0,1070,0,1070,1.0,134,2801@TOP@human_GAPDH_TAA_len41_fa0_ta20_fm6_tm14,g
2802@TOP@human_GAPDH_TAA_len41_fa0_ta20_fm6_tm14*114*t,1,0,0,1871,1872,0.0,114,2802@TOP@human_GAPDH_TAA_len41_fa0_ta20_fm6_tm14,t
2802@TOP@human_GAPDH_TAA_len41_fa0_ta20_fm6_tm14*115*c,0,1881,0,0,1881,0.0,115,2802@TOP@human_GAPDH_TAA_len41_fa0_ta20_fm6_tm14,c
2802@TOP@human_GAPDH_TAA_len41_fa0_ta20_fm6_tm14*116*c,0,1876,0,0,1876,0.0,116,2802@TOP@human_GAPDH_TAA_len41_fa0_ta20_fm6_tm14,c
2802@TOP@human_GAPDH_TAA_len41_fa0_ta20_fm6_tm14*117*a,1867,0,4,0,1871,0.002,117,2802@TOP@human_GAPDH_TAA_len41_fa0_ta20_fm6_tm14,a
2802@TOP@human_GAPDH_TAA_len41_fa0_ta20_fm6_tm14*118*a,1818,0,44,0,1862,0.024,118,2802@TOP@human_GAPDH_TAA_len41_fa0_ta20_fm6_tm14,a
2802@TOP@human_GAPDH_TAA_len41_fa0_ta20_fm6_tm14*119*g,0,0,1862,0,1862,1.0,119,2802@TOP@human_GAPDH_TAA_len41_fa0_ta20_fm6_tm14,g
2802@TOP@human_GAPDH_TAA_len41_fa0_ta20_fm6_tm14*120*g,1,0,1853,0,1854,0.999,120,2802@TOP@human_GAPDH_TAA_len41_fa0_ta20_fm6_tm14,g
2802@TOP@human_GAPDH_TAA_len41_fa0_ta20_fm6_tm14*121*a,1865,0,0,1,1866,0.0,121,2802@TOP@human_GAPDH_TAA_len41_fa0_ta20_fm6_tm14,a
2802@TOP@human_GAPDH_TAA_len41_fa0_ta20_fm6_tm14*122*g,0,0,1876,0,1876,1.0,122,2802@TOP@human_GAPDH_TAA_len41_fa0_ta20_fm6_tm14,g
2802@TOP@human_GAPDH_TAA_len41_fa0_ta20_fm6_tm14*123*t,0,0,2,1850,1852,0.001,123,2802@TOP@human_GAPDH_TAA_len41_fa0_ta20_fm6_tm14,t
2802@TOP@human_GAPDH_TAA_len41_fa0_ta20_fm6_tm14*124*a,1770,0,68,0,1838,0.037,124,2802@TOP@human_GAPDH_TAA_len41_fa0_ta20_fm6_tm14,a
2802@TOP@human_GAPDH_TAA_len41_fa0_ta20_fm6_tm14*125*a,1440,1,398,0,1839,0.216,125,2802@TOP@human_GAPDH_TAA_len41_fa0_ta20_fm6_tm14,a
2802@TOP@human_GAPDH_TAA_len41_fa0_ta20_fm6_tm14*126*g,0,0,1849,0,1849,1.0,126,2802@TOP@human_GAPDH_TAA_len41_fa0_ta20_fm6_tm14,g
2802@TOP@human_GAPDH_TAA_len41_fa0_ta20_fm6_tm14*127*a,1856,0,9,0,1865,0.005,127,2802@TOP@human_GAPDH_TAA_len41_fa0_ta20_fm6_tm14,a
2802@TOP@human_GAPDH_TAA_len41_fa0_ta20_fm6_tm14*128*c,0,1875,0,0,1875,0.0,128,2802@TOP@human_GAPDH_TAA_len41_fa0_ta20_fm6_tm14,c
2802@TOP@human_GAPDH_TAA_len41_fa0_ta20_fm6_tm14*129*c,0,1867,0,0,1867,0.0,129,2802@TOP@human_GAPDH_TAA_len41_fa0_ta20_fm6_tm14,c
2802@TOP@human_GAPDH_TAA_len41_fa0_ta20_fm6_tm14*130*c,1,1871,0,0,1872,0.0,130,2802@TOP@human_GAPDH_TAA_len41_fa0_ta20_fm6_tm14,c
2802@TOP@human_GAPDH_TAA_len41_fa0_ta20_fm6_tm14*131*c,2,1872,0,0,1874,0.0,131,2802@TOP@human_GAPDH_TAA_len41_fa0_ta20_fm6_tm14,c
2802@TOP@human_GAPDH_TAA_len41_fa0_ta20_fm6_tm14*132*t,0,0,0,1840,1840,0.0,132,2802@TOP@human_GAPDH_TAA_len41_fa0_ta20_fm6_tm14,t
2802@TOP@human_GAPDH_TAA_len41_fa0_ta20_fm6_tm14*133*g,0,0,1840,0,1840,1.0,133,2802@TOP@human_GAPDH_TAA_len41_fa0_ta20_fm6_tm14,g
2802@TOP@human_GAPDH_TAA_len41_fa0_ta20_fm6_tm14*134*g,0,0,1864,0,1864,1.0,134,2802@TOP@human_GAPDH_TAA_len41_fa0_ta20_fm6_tm14,g
2803@TOP@human_GAPDH_TAA_len41_fa0_ta20_fm6_tm14*114*t,0,1,2,3686,3689,0.001,114,2803@TOP@human_GAPDH_TAA_len41_fa0_ta20_fm6_tm14,t
2803@TOP@human_GAPDH_TAA_len41_fa0_ta20_fm6_tm14*115*c,0,3711,0,0,3711,0.0,115,2803@TOP@human_GAPDH_TAA_len41_fa0_ta20_fm6_tm14,c
2803@TOP@human_GAPDH_TAA_len41_fa0_ta20_fm6_tm14*116*c,0,3698,0,0,3698,0.0,116,2803@TOP@human_GAPDH_TAA_len41_fa0_ta20_fm6_tm14,c
2803@TOP@human_GAPDH_TAA_len41_fa0_ta20_fm6_tm14*117*a,3674,0,9,0,3683,0.002,117,2803@TOP@human_GAPDH_TAA_len41_fa0_ta20_fm6_tm14,a
2803@TOP@human_GAPDH_TAA_len41_fa0_ta20_fm6_tm14*118*a,3426,0,247,0,3673,0.067,118,2803@TOP@human_GAPDH_TAA_len41_fa0_ta20_fm6_tm14,a
2803@TOP@human_GAPDH_TAA_len41_fa0_ta20_fm6_tm14*119*g,0,0,3654,0,3654,1.0,119,2803@TOP@human_GAPDH_TAA_len41_fa0_ta20_fm6_tm14,g
2803@TOP@human_GAPDH_TAA_len41_fa0_ta20_fm6_tm14*120*g,0,0,3667,0,3667,1.0,120,2803@TOP@human_GAPDH_TAA_len41_fa0_ta20_fm6_tm14,g
2803@TOP@human_GAPDH_TAA_len41_fa0_ta20_fm6_tm14*121*a,3690,0,1,0,3691,0.0,121,2803@TOP@human_GAPDH_TAA_len41_fa0_ta20_fm6_tm14,a
2803@TOP@human_GAPDH_TAA_len41_fa0_ta20_fm6_tm14*122*g,0,0,3694,0,3694,1.0,122,2803@TOP@human_GAPDH_TAA_len41_fa0_ta20_fm6_tm14,g
2803@TOP@human_GAPDH_TAA_len41_fa0_ta20_fm6_tm14*123*t,2,0,1,3653,3656,0.0,123,2803@TOP@human_GAPDH_TAA_len41_fa0_ta20_fm6_tm14,t
2803@TOP@human_GAPDH_TAA_len41_fa0_ta20_fm6_tm14*124*a,3407,0,206,0,3613,0.057,124,2803@TOP@human_GAPDH_TAA_len41_fa0_ta20_fm6_tm14,a
2803@TOP@human_GAPDH_TAA_len41_fa0_ta20_fm6_tm14*125*a,2433,1,1199,0,3633,0.33,125,2803@TOP@human_GAPDH_TAA_len41_fa0_ta20_fm6_tm14,a
2803@TOP@human_GAPDH_TAA_len41_fa0_ta20_fm6_tm14*126*g,1,0,3645,1,3647,0.999,126,2803@TOP@human_GAPDH_TAA_len41_fa0_ta20_fm6_tm14,g
2803@TOP@human_GAPDH_TAA_len41_fa0_ta20_fm6_tm14*127*a,3664,0,23,0,3687,0.006,127,2803@TOP@human_GAPDH_TAA_len41_fa0_ta20_fm6_tm14,a
2803@TOP@human_GAPDH_TAA_len41_fa0_ta20_fm6_tm14*128*c,0,3703,3,0,3706,0.001,128,2803@TOP@human_GAPDH_TAA_len41_fa0_ta20_fm6_tm14,c
2803@TOP@human_GAPDH_TAA_len41_fa0_ta20_fm6_tm14*129*c,0,3675,0,2,3677,0.0,129,2803@TOP@human_GAPDH_TAA_len41_fa0_ta20_fm6_tm14,c
2803@TOP@human_GAPDH_TAA_len41_fa0_ta20_fm6_tm14*130*c,0,3693,0,0,3693,0.0,130,2803@TOP@human_GAPDH_TAA_len41_fa0_ta20_fm6_tm14,c
2803@TOP@human_GAPDH_TAA_len41_fa0_ta20_fm6_tm14*131*c,0,3707,0,0,3707,0.0,131,2803@TOP@human_GAPDH_TAA_len41_fa0_ta20_fm6_tm14,c
2803@TOP@human_GAPDH_TAA_len41_fa0_ta20_fm6_tm14*132*t,0,2,0,3651,3653,0.0,132,2803@TOP@human_GAPDH_TAA_len41_fa0_ta20_fm6_tm14,t
2803@TOP@human_GAPDH_TAA_len41_fa0_ta20_fm6_tm14*133*g,3,0,3649,0,3652,0.999,133,2803@TOP@human_GAPDH_TAA_len41_fa0_ta20_fm6_tm14,g
2803@TOP@human_GAPDH_TAA_len41_fa0_ta20_fm6_tm14*134*g,0,2,3664,0,3666,0.999,134,2803@TOP@human_GAPDH_TAA_len41_fa0_ta20_fm6_tm14,g
2804@TOP@human_GAPDH_TAA_len41_fa0_ta20_fm6_tm14*114*t,0,0,0,820,820,0.0,114,2804@TOP@human_GAPDH_TAA_len41_fa0_ta20_fm6_tm14,t
2804@TOP@human_GAPDH_TAA_len41_fa0_ta20_fm6_tm14*115*c,0,826,0,0,826,0.0,115,2804@TOP@human_GAPDH_TAA_len41_fa0_ta20_fm6_tm14,c
2804@TOP@human_GAPDH_TAA_len41_fa0_ta20_fm6_tm14*116*c,0,817,0,0,817,0.0,116,2804@TOP@human_GAPDH_TAA_len41_fa0_ta20_fm6_tm14,c
2804@TOP@human_GAPDH_TAA_len41_fa0_ta20_fm6_tm14*117*a,816,0,6,0,822,0.007,117,2804@TOP@human_GAPDH_TAA_len41_fa0_ta20_fm6_tm14,a
2804@TOP@human_GAPDH_TAA_len41_fa0_ta20_fm6_tm14*118*a,782,0,35,0,817,0.043,118,2804@TOP@human_GAPDH_TAA_len41_fa0_ta20_fm6_tm14,a
2804@TOP@human_GAPDH_TAA_len41_fa0_ta20_fm6_tm14*119*g,0,0,815,0,815,1.0,119,2804@TOP@human_GAPDH_TAA_len41_fa0_ta20_fm6_tm14,g
2804@TOP@human_GAPDH_TAA_len41_fa0_ta20_fm6_tm14*120*g,0,0,802,0,802,1.0,120,2804@TOP@human_GAPDH_TAA_len41_fa0_ta20_fm6_tm14,g
2804@TOP@human_GAPDH_TAA_len41_fa0_ta20_fm6_tm14*121*a,818,0,1,0,819,0.001,121,2804@TOP@human_GAPDH_TAA_len41_fa0_ta20_fm6_tm14,a
2804@TOP@human_GAPDH_TAA_len41_fa0_ta20_fm6_tm14*122*g,0,0,819,0,819,1.0,122,2804@TOP@human_GAPDH_TAA_len41_fa0_ta20_fm6_tm14,g
2804@TOP@human_GAPDH_TAA_len41_fa0_ta20_fm6_tm14*123*t,0,3,0,809,812,0.0,123,2804@TOP@human_GAPDH_TAA_len41_fa0_ta20_fm6_tm14,t
2804@TOP@human_GAPDH_TAA_len41_fa0_ta20_fm6_tm14*124*a,472,0,340,0,812,0.419,124,2804@TOP@human_GAPDH_TAA_len41_fa0_ta20_fm6_tm14,a
2804@TOP@human_GAPDH_TAA_len41_fa0_ta20_fm6_tm14*125*a,529,0,279,0,808,0.345,125,2804@TOP@human_GAPDH_TAA_len41_fa0_ta20_fm6_tm14,a
2804@TOP@human_GAPDH_TAA_len41_fa0_ta20_fm6_tm14*126*g,0,0,811,0,811,1.0,126,2804@TOP@human_GAPDH_TAA_len41_fa0_ta20_fm6_tm14,g
2804@TOP@human_GAPDH_TAA_len41_fa0_ta20_fm6_tm14*127*a,803,0,11,0,814,0.014,127,2804@TOP@human_GAPDH_TAA_len41_fa0_ta20_fm6_tm14,a
2804@TOP@human_GAPDH_TAA_len41_fa0_ta20_fm6_tm14*128*c,0,824,0,0,824,0.0,128,2804@TOP@human_GAPDH_TAA_len41_fa0_ta20_fm6_tm14,c
2804@TOP@human_GAPDH_TAA_len41_fa0_ta20_fm6_tm14*129*c,0,818,0,0,818,0.0,129,2804@TOP@human_GAPDH_TAA_len41_fa0_ta20_fm6_tm14,c
2804@TOP@human_GAPDH_TAA_len41_fa0_ta20_fm6_tm14*130*c,0,818,0,0,818,0.0,130,2804@TOP@human_GAPDH_TAA_len41_fa0_ta20_fm6_tm14,c
2804@TOP@human_GAPDH_TAA_len41_fa0_ta20_fm6_tm14*131*c,0,823,0,0,823,0.0,131,2804@TOP@human_GAPDH_TAA_len41_fa0_ta20_fm6_tm14,c
2804@TOP@human_GAPDH_TAA_len41_fa0_ta20_fm6_tm14*132*t,0,0,0,810,810,0.0,132,2804@TOP@human_GAPDH_TAA_len41_fa0_ta20_fm6_tm14,t
2804@TOP@human_GAPDH_TAA_len41_fa0_ta20_fm6_tm14*133*g,0,0,802,0,802,1.0,133,2804@TOP@human_GAPDH_TAA_len41_fa0_ta20_fm6_tm14,g
2804@TOP@human_GAPDH_TAA_len41_fa0_ta20_fm6_tm14*134*g,0,0,814,0,814,1.0,134,2804@TOP@human_GAPDH_TAA_len41_fa0_ta20_fm6_tm14,g
2805@TOP@human_GAPDH_TAA_len41_fa0_ta20_fm6_tm14*114*t,0,0,0,595,595,0.0,114,2805@TOP@human_GAPDH_TAA_len41_fa0_ta20_fm6_tm14,t
2805@TOP@human_GAPDH_TAA_len41_fa0_ta20_fm6_tm14*115*c,0,600,0,0,600,0.0,115,2805@TOP@human_GAPDH_TAA_len41_fa0_ta20_fm6_tm14,c
2805@TOP@human_GAPDH_TAA_len41_fa0_ta20_fm6_tm14*116*c,0,596,0,0,596,0.0,116,2805@TOP@human_GAPDH_TAA_len41_fa0_ta20_fm6_tm14,c
2805@TOP@human_GAPDH_TAA_len41_fa0_ta20_fm6_tm14*117*a,593,0,3,2,598,0.005,117,2805@TOP@human_GAPDH_TAA_len41_fa0_ta20_fm6_tm14,a
2805@TOP@human_GAPDH_TAA_len41_fa0_ta20_fm6_tm14*118*a,560,0,36,0,596,0.06,118,2805@TOP@human_GAPDH_TAA_len41_fa0_ta20_fm6_tm14,a
2805@TOP@human_GAPDH_TAA_len41_fa0_ta20_fm6_tm14*119*g,0,0,594,0,594,1.0,119,2805@TOP@human_GAPDH_TAA_len41_fa0_ta20_fm6_tm14,g
2805@TOP@human_GAPDH_TAA_len41_fa0_ta20_fm6_tm14*120*g,0,0,590,0,590,1.0,120,2805@TOP@human_GAPDH_TAA_len41_fa0_ta20_fm6_tm14,g
2805@TOP@human_GAPDH_TAA_len41_fa0_ta20_fm6_tm14*121*a,592,0,1,0,593,0.002,121,2805@TOP@human_GAPDH_TAA_len41_fa0_ta20_fm6_tm14,a
2805@TOP@human_GAPDH_TAA_len41_fa0_ta20_fm6_tm14*122*g,0,0,599,0,599,1.0,122,2805@TOP@human_GAPDH_TAA_len41_fa0_ta20_fm6_tm14,g
2805@TOP@human_GAPDH_TAA_len41_fa0_ta20_fm6_tm14*123*t,0,0,0,593,593,0.0,123,2805@TOP@human_GAPDH_TAA_len41_fa0_ta20_fm6_tm14,t
2805@TOP@human_GAPDH_TAA_len41_fa0_ta20_fm6_tm14*124*a,395,0,194,0,589,0.329,124,2805@TOP@human_GAPDH_TAA_len41_fa0_ta20_fm6_tm14,a
2805@TOP@human_GAPDH_TAA_len41_fa0_ta20_fm6_tm14*125*a,447,0,142,0,589,0.241,125,2805@TOP@human_GAPDH_TAA_len41_fa0_ta20_fm6_tm14,a
2805@TOP@human_GAPDH_TAA_len41_fa0_ta20_fm6_tm14*126*g,0,0,586,0,586,1.0,126,2805@TOP@human_GAPDH_TAA_len41_fa0_ta20_fm6_tm14,g
2805@TOP@human_GAPDH_TAA_len41_fa0_ta20_fm6_tm14*127*a,585,0,6,0,591,0.01,127,2805@TOP@human_GAPDH_TAA_len41_fa0_ta20_fm6_tm14,a
2805@TOP@human_GAPDH_TAA_len41_fa0_ta20_fm6_tm14*128*c,0,598,0,0,598,0.0,128,2805@TOP@human_GAPDH_TAA_len41_fa0_ta20_fm6_tm14,c
2805@TOP@human_GAPDH_TAA_len41_fa0_ta20_fm6_tm14*129*c,0,598,0,0,598,0.0,129,2805@TOP@human_GAPDH_TAA_len41_fa0_ta20_fm6_tm14,c
2805@TOP@human_GAPDH_TAA_len41_fa0_ta20_fm6_tm14*130*c,0,596,0,0,596,0.0,130,2805@TOP@human_GAPDH_TAA_len41_fa0_ta20_fm6_tm14,c
2805@TOP@human_GAPDH_TAA_len41_fa0_ta20_fm6_tm14*131*c,0,598,0,0,598,0.0,131,2805@TOP@human_GAPDH_TAA_len41_fa0_ta20_fm6_tm14,c
2805@TOP@human_GAPDH_TAA_len41_fa0_ta20_fm6_tm14*132*t,0,0,0,590,590,0.0,132,2805@TOP@human_GAPDH_TAA_len41_fa0_ta20_fm6_tm14,t
2805@TOP@human_GAPDH_TAA_len41_fa0_ta20_fm6_tm14*133*g,0,0,594,0,594,1.0,133,2805@TOP@human_GAPDH_TAA_len41_fa0_ta20_fm6_tm14,g
2805@TOP@human_GAPDH_TAA_len41_fa0_ta20_fm6_tm14*134*g,0,0,593,0,593,1.0,134,2805@TOP@human_GAPDH_TAA_len41_fa0_ta20_fm6_tm14,g
2806@TOP@human_GAPDH_TAA_len41_fa0_ta20_fm6_tm14*114*t,9,6,0,17169,17184,0.0,114,2806@TOP@human_GAPDH_TAA_len41_fa0_ta20_fm6_tm14,t
2806@TOP@human_GAPDH_TAA_len41_fa0_ta20_fm6_tm14*115*c,0,17268,2,0,17270,0.0,115,2806@TOP@human_GAPDH_TAA_len41_fa0_ta20_fm6_tm14,c
2806@TOP@human_GAPDH_TAA_len41_fa0_ta20_fm6_tm14*116*c,1,17210,0,1,17212,0.0,116,2806@TOP@human_GAPDH_TAA_len41_fa0_ta20_fm6_tm14,c
2806@TOP@human_GAPDH_TAA_len41_fa0_ta20_fm6_tm14*117*a,17157,0,18,0,17175,0.001,117,2806@TOP@human_GAPDH_TAA_len41_fa0_ta20_fm6_tm14,a
2806@TOP@human_GAPDH_TAA_len41_fa0_ta20_fm6_tm14*118*a,16961,0,179,1,17141,0.01,118,2806@TOP@human_GAPDH_TAA_len41_fa0_ta20_fm6_tm14,a
2806@TOP@human_GAPDH_TAA_len41_fa0_ta20_fm6_tm14*119*g,0,1,17105,0,17106,1.0,119,2806@TOP@human_GAPDH_TAA_len41_fa0_ta20_fm6_tm14,g
2806@TOP@human_GAPDH_TAA_len41_fa0_ta20_fm6_tm14*120*g,1,0,17014,1,17016,1.0,120,2806@TOP@human_GAPDH_TAA_len41_fa0_ta20_fm6_tm14,g
2806@TOP@human_GAPDH_TAA_len41_fa0_ta20_fm6_tm14*121*a,17171,0,2,0,17173,0.0,121,2806@TOP@human_GAPDH_TAA_len41_fa0_ta20_fm6_tm14,a
2806@TOP@human_GAPDH_TAA_len41_fa0_ta20_fm6_tm14*122*g,1,0,17203,0,17204,1.0,122,2806@TOP@human_GAPDH_TAA_len41_fa0_ta20_fm6_tm14,g
2806@TOP@human_GAPDH_TAA_len41_fa0_ta20_fm6_tm14*123*t,3,5,5,17018,17031,0.0,123,2806@TOP@human_GAPDH_TAA_len41_fa0_ta20_fm6_tm14,t
2806@TOP@human_GAPDH_TAA_len41_fa0_ta20_fm6_tm14*124*a,8012,0,9031,1,17044,0.53,124,2806@TOP@human_GAPDH_TAA_len41_fa0_ta20_fm6_tm14,a
2806@TOP@human_GAPDH_TAA_len41_fa0_ta20_fm6_tm14*125*a,11666,1,5336,1,17004,0.314,125,2806@TOP@human_GAPDH_TAA_len41_fa0_ta20_fm6_tm14,a
2806@TOP@human_GAPDH_TAA_len41_fa0_ta20_fm6_tm14*126*g,0,5,17064,3,17072,1.0,126,2806@TOP@human_GAPDH_TAA_len41_fa0_ta20_fm6_tm14,g
2806@TOP@human_GAPDH_TAA_len41_fa0_ta20_fm6_tm14*127*a,17071,4,93,0,17168,0.005,127,2806@TOP@human_GAPDH_TAA_len41_fa0_ta20_fm6_tm14,a
2806@TOP@human_GAPDH_TAA_len41_fa0_ta20_fm6_tm14*128*c,0,17234,1,1,17236,0.0,128,2806@TOP@human_GAPDH_TAA_len41_fa0_ta20_fm6_tm14,c
2806@TOP@human_GAPDH_TAA_len41_fa0_ta20_fm6_tm14*129*c,0,17124,0,0,17124,0.0,129,2806@TOP@human_GAPDH_TAA_len41_fa0_ta20_fm6_tm14,c
2806@TOP@human_GAPDH_TAA_len41_fa0_ta20_fm6_tm14*130*c,0,17210,0,2,17212,0.0,130,2806@TOP@human_GAPDH_TAA_len41_fa0_ta20_fm6_tm14,c
2806@TOP@human_GAPDH_TAA_len41_fa0_ta20_fm6_tm14*131*c,4,17259,0,0,17263,0.0,131,2806@TOP@human_GAPDH_TAA_len41_fa0_ta20_fm6_tm14,c
2806@TOP@human_GAPDH_TAA_len41_fa0_ta20_fm6_tm14*132*t,2,3,1,17055,17061,0.0,132,2806@TOP@human_GAPDH_TAA_len41_fa0_ta20_fm6_tm14,t
2806@TOP@human_GAPDH_TAA_len41_fa0_ta20_fm6_tm14*133*g,0,1,17019,0,17020,1.0,133,2806@TOP@human_GAPDH_TAA_len41_fa0_ta20_fm6_tm14,g
2806@TOP@human_GAPDH_TAA_len41_fa0_ta20_fm6_tm14*134*g,3,0,17076,0,17079,1.0,134,2806@TOP@human_GAPDH_TAA_len41_fa0_ta20_fm6_tm14,g
2807@TOP@human_GAPDH_TAA_len41_fa0_ta20_fm6_tm14*114*t,0,0,0,1593,1593,0.0,114,2807@TOP@human_GAPDH_TAA_len41_fa0_ta20_fm6_tm14,t
2807@TOP@human_GAPDH_TAA_len41_fa0_ta20_fm6_tm14*115*c,0,1598,0,0,1598,0.0,115,2807@TOP@human_GAPDH_TAA_len41_fa0_ta20_fm6_tm14,c
2807@TOP@human_GAPDH_TAA_len41_fa0_ta20_fm6_tm14*116*c,0,1585,0,0,1585,0.0,116,2807@TOP@human_GAPDH_TAA_len41_fa0_ta20_fm6_tm14,c
2807@TOP@human_GAPDH_TAA_len41_fa0_ta20_fm6_tm14*117*a,1582,0,5,0,1587,0.003,117,2807@TOP@human_GAPDH_TAA_len41_fa0_ta20_fm6_tm14,a
2807@TOP@human_GAPDH_TAA_len41_fa0_ta20_fm6_tm14*118*a,1539,0,48,0,1587,0.03,118,2807@TOP@human_GAPDH_TAA_len41_fa0_ta20_fm6_tm14,a
2807@TOP@human_GAPDH_TAA_len41_fa0_ta20_fm6_tm14*119*g,0,0,1576,0,1576,1.0,119,2807@TOP@human_GAPDH_TAA_len41_fa0_ta20_fm6_tm14,g
2807@TOP@human_GAPDH_TAA_len41_fa0_ta20_fm6_tm14*120*g,0,0,1575,1,1576,0.999,120,2807@TOP@human_GAPDH_TAA_len41_fa0_ta20_fm6_tm14,g
2807@TOP@human_GAPDH_TAA_len41_fa0_ta20_fm6_tm14*121*a,1589,0,1,0,1590,0.001,121,2807@TOP@human_GAPDH_TAA_len41_fa0_ta20_fm6_tm14,a
2807@TOP@human_GAPDH_TAA_len41_fa0_ta20_fm6_tm14*122*g,0,0,1594,0,1594,1.0,122,2807@TOP@human_GAPDH_TAA_len41_fa0_ta20_fm6_tm14,g
2807@TOP@human_GAPDH_TAA_len41_fa0_ta20_fm6_tm14*123*t,0,0,0,1576,1576,0.0,123,2807@TOP@human_GAPDH_TAA_len41_fa0_ta20_fm6_tm14,t
2807@TOP@human_GAPDH_TAA_len41_fa0_ta20_fm6_tm14*124*a,1035,0,538,0,1573,0.342,124,2807@TOP@human_GAPDH_TAA_len41_fa0_ta20_fm6_tm14,a
2807@TOP@human_GAPDH_TAA_len41_fa0_ta20_fm6_tm14*125*a,1235,1,334,0,1570,0.213,125,2807@TOP@human_GAPDH_TAA_len41_fa0_ta20_fm6_tm14,a
2807@TOP@human_GAPDH_TAA_len41_fa0_ta20_fm6_tm14*126*g,0,0,1574,0,1574,1.0,126,2807@TOP@human_GAPDH_TAA_len41_fa0_ta20_fm6_tm14,g
2807@TOP@human_GAPDH_TAA_len41_fa0_ta20_fm6_tm14*127*a,1581,0,4,0,1585,0.003,127,2807@TOP@human_GAPDH_TAA_len41_fa0_ta20_fm6_tm14,a
2807@TOP@human_GAPDH_TAA_len41_fa0_ta20_fm6_tm14*128*c,1,1584,0,0,1585,0.0,128,2807@TOP@human_GAPDH_TAA_len41_fa0_ta20_fm6_tm14,c
2807@TOP@human_GAPDH_TAA_len41_fa0_ta20_fm6_tm14*129*c,0,1583,0,0,1583,0.0,129,2807@TOP@human_GAPDH_TAA_len41_fa0_ta20_fm6_tm14,c
2807@TOP@human_GAPDH_TAA_len41_fa0_ta20_fm6_tm14*130*c,0,1587,0,0,1587,0.0,130,2807@TOP@human_GAPDH_TAA_len41_fa0_ta20_fm6_tm14,c
2807@TOP@human_GAPDH_TAA_len41_fa0_ta20_fm6_tm14*131*c,0,1595,0,0,1595,0.0,131,2807@TOP@human_GAPDH_TAA_len41_fa0_ta20_fm6_tm14,c
2807@TOP@human_GAPDH_TAA_len41_fa0_ta20_fm6_tm14*132*t,0,0,0,1570,1570,0.0,132,2807@TOP@human_GAPDH_TAA_len41_fa0_ta20_fm6_tm14,t
2807@TOP@human_GAPDH_TAA_len41_fa0_ta20_fm6_tm14*133*g,0,0,1570,1,1571,0.999,133,2807@TOP@human_GAPDH_TAA_len41_fa0_ta20_fm6_tm14,g
2807@TOP@human_GAPDH_TAA_len41_fa0_ta20_fm6_tm14*134*g,0,1,1575,0,1576,0.999,134,2807@TOP@human_GAPDH_TAA_len41_fa0_ta20_fm6_tm14,g
2808@TOP@human_GAPDH_TAA_len41_fa0_ta20_fm6_tm14*114*t,0,1,0,916,917,0.0,114,2808@TOP@human_GAPDH_TAA_len41_fa0_ta20_fm6_tm14,t
2808@TOP@human_GAPDH_TAA_len41_fa0_ta20_fm6_tm14*115*c,0,925,0,0,925,0.0,115,2808@TOP@human_GAPDH_TAA_len41_fa0_ta20_fm6_tm14,c
2808@TOP@human_GAPDH_TAA_len41_fa0_ta20_fm6_tm14*116*c,0,916,0,0,916,0.0,116,2808@TOP@human_GAPDH_TAA_len41_fa0_ta20_fm6_tm14,c
2808@TOP@human_GAPDH_TAA_len41_fa0_ta20_fm6_tm14*117*a,922,0,3,0,925,0.003,117,2808@TOP@human_GAPDH_TAA_len41_fa0_ta20_fm6_tm14,a
2808@TOP@human_GAPDH_TAA_len41_fa0_ta20_fm6_tm14*118*a,882,0,33,0,915,0.036,118,2808@TOP@human_GAPDH_TAA_len41_fa0_ta20_fm6_tm14,a
2808@TOP@human_GAPDH_TAA_len41_fa0_ta20_fm6_tm14*119*g,0,0,916,0,916,1.0,119,2808@TOP@human_GAPDH_TAA_len41_fa0_ta20_fm6_tm14,g
2808@TOP@human_GAPDH_TAA_len41_fa0_ta20_fm6_tm14*120*g,0,0,909,0,909,1.0,120,2808@TOP@human_GAPDH_TAA_len41_fa0_ta20_fm6_tm14,g
2808@TOP@human_GAPDH_TAA_len41_fa0_ta20_fm6_tm14*121*a,914,0,2,0,916,0.002,121,2808@TOP@human_GAPDH_TAA_len41_fa0_ta20_fm6_tm14,a
2808@TOP@human_GAPDH_TAA_len41_fa0_ta20_fm6_tm14*122*g,0,0,921,0,921,1.0,122,2808@TOP@human_GAPDH_TAA_len41_fa0_ta20_fm6_tm14,g
2808@TOP@human_GAPDH_TAA_len41_fa0_ta20_fm6_tm14*123*t,0,0,0,914,914,0.0,123,2808@TOP@human_GAPDH_TAA_len41_fa0_ta20_fm6_tm14,t
2808@TOP@human_GAPDH_TAA_len41_fa0_ta20_fm6_tm14*124*a,676,0,223,0,899,0.248,124,2808@TOP@human_GAPDH_TAA_len41_fa0_ta20_fm6_tm14,a
2808@TOP@human_GAPDH_TAA_len41_fa0_ta20_fm6_tm14*125*a,774,1,127,0,902,0.141,125,2808@TOP@human_GAPDH_TAA_len41_fa0_ta20_fm6_tm14,a
2808@TOP@human_GAPDH_TAA_len41_fa0_ta20_fm6_tm14*126*g,0,0,914,0,914,1.0,126,2808@TOP@human_GAPDH_TAA_len41_fa0_ta20_fm6_tm14,g
2808@TOP@human_GAPDH_TAA_len41_fa0_ta20_fm6_tm14*127*a,898,0,21,0,919,0.023,127,2808@TOP@human_GAPDH_TAA_len41_fa0_ta20_fm6_tm14,a
2808@TOP@human_GAPDH_TAA_len41_fa0_ta20_fm6_tm14*128*c,0,923,0,1,924,0.0,128,2808@TOP@human_GAPDH_TAA_len41_fa0_ta20_fm6_tm14,c
2808@TOP@human_GAPDH_TAA_len41_fa0_ta20_fm6_tm14*129*c,0,919,0,0,919,0.0,129,2808@TOP@human_GAPDH_TAA_len41_fa0_ta20_fm6_tm14,c
2808@TOP@human_GAPDH_TAA_len41_fa0_ta20_fm6_tm14*130*c,0,920,0,0,920,0.0,130,2808@TOP@human_GAPDH_TAA_len41_fa0_ta20_fm6_tm14,c
2808@TOP@human_GAPDH_TAA_len41_fa0_ta20_fm6_tm14*131*c,0,924,0,0,924,0.0,131,2808@TOP@human_GAPDH_TAA_len41_fa0_ta20_fm6_tm14,c
2808@TOP@human_GAPDH_TAA_len41_fa0_ta20_fm6_tm14*132*t,0,0,0,910,910,0.0,132,2808@TOP@human_GAPDH_TAA_len41_fa0_ta20_fm6_tm14,t
2808@TOP@human_GAPDH_TAA_len41_fa0_ta20_fm6_tm14*133*g,0,1,906,0,907,0.999,133,2808@TOP@human_GAPDH_TAA_len41_fa0_ta20_fm6_tm14,g
2808@TOP@human_GAPDH_TAA_len41_fa0_ta20_fm6_tm14*134*g,0,0,909,0,909,1.0,134,2808@TOP@human_GAPDH_TAA_len41_fa0_ta20_fm6_tm14,g
2809@TOP@human_GAPDH_TAA_len41_fa0_ta20_fm6_tm14*114*t,2,3,0,14414,14419,0.0,114,2809@TOP@human_GAPDH_TAA_len41_fa0_ta20_fm6_tm14,t
2809@TOP@human_GAPDH_TAA_len41_fa0_ta20_fm6_tm14*115*c,1,14492,0,0,14493,0.0,115,2809@TOP@human_GAPDH_TAA_len41_fa0_ta20_fm6_tm14,c
2809@TOP@human_GAPDH_TAA_len41_fa0_ta20_fm6_tm14*116*c,0,14437,0,0,14437,0.0,116,2809@TOP@human_GAPDH_TAA_len41_fa0_ta20_fm6_tm14,c
2809@TOP@human_GAPDH_TAA_len41_fa0_ta20_fm6_tm14*117*a,14413,0,9,0,14422,0.001,117,2809@TOP@human_GAPDH_TAA_len41_fa0_ta20_fm6_tm14,a
2809@TOP@human_GAPDH_TAA_len41_fa0_ta20_fm6_tm14*118*a,14186,0,171,0,14357,0.012,118,2809@TOP@human_GAPDH_TAA_len41_fa0_ta20_fm6_tm14,a
2809@TOP@human_GAPDH_TAA_len41_fa0_ta20_fm6_tm14*119*g,0,0,14320,0,14320,1.0,119,2809@TOP@human_GAPDH_TAA_len41_fa0_ta20_fm6_tm14,g
2809@TOP@human_GAPDH_TAA_len41_fa0_ta20_fm6_tm14*120*g,0,0,14295,1,14296,1.0,120,2809@TOP@human_GAPDH_TAA_len41_fa0_ta20_fm6_tm14,g
2809@TOP@human_GAPDH_TAA_len41_fa0_ta20_fm6_tm14*121*a,14409,0,2,0,14411,0.0,121,2809@TOP@human_GAPDH_TAA_len41_fa0_ta20_fm6_tm14,a
2809@TOP@human_GAPDH_TAA_len41_fa0_ta20_fm6_tm14*122*g,0,0,14440,0,14440,1.0,122,2809@TOP@human_GAPDH_TAA_len41_fa0_ta20_fm6_tm14,g
2809@TOP@human_GAPDH_TAA_len41_fa0_ta20_fm6_tm14*123*t,1,1,3,14255,14260,0.0,123,2809@TOP@human_GAPDH_TAA_len41_fa0_ta20_fm6_tm14,t
2809@TOP@human_GAPDH_TAA_len41_fa0_ta20_fm6_tm14*124*a,11190,0,3012,0,14202,0.212,124,2809@TOP@human_GAPDH_TAA_len41_fa0_ta20_fm6_tm14,a
2809@TOP@human_GAPDH_TAA_len41_fa0_ta20_fm6_tm14*125*a,11645,0,2549,0,14194,0.18,125,2809@TOP@human_GAPDH_TAA_len41_fa0_ta20_fm6_tm14,a
2809@TOP@human_GAPDH_TAA_len41_fa0_ta20_fm6_tm14*126*g,3,0,14268,1,14272,1.0,126,2809@TOP@human_GAPDH_TAA_len41_fa0_ta20_fm6_tm14,g
2809@TOP@human_GAPDH_TAA_len41_fa0_ta20_fm6_tm14*127*a,14308,0,83,3,14394,0.006,127,2809@TOP@human_GAPDH_TAA_len41_fa0_ta20_fm6_tm14,a
2809@TOP@human_GAPDH_TAA_len41_fa0_ta20_fm6_tm14*128*c,0,14456,0,1,14457,0.0,128,2809@TOP@human_GAPDH_TAA_len41_fa0_ta20_fm6_tm14,c
2809@TOP@human_GAPDH_TAA_len41_fa0_ta20_fm6_tm14*129*c,2,14376,1,1,14380,0.0,129,2809@TOP@human_GAPDH_TAA_len41_fa0_ta20_fm6_tm14,c
2809@TOP@human_GAPDH_TAA_len41_fa0_ta20_fm6_tm14*130*c,1,14441,0,0,14442,0.0,130,2809@TOP@human_GAPDH_TAA_len41_fa0_ta20_fm6_tm14,c
2809@TOP@human_GAPDH_TAA_len41_fa0_ta20_fm6_tm14*131*c,1,14467,0,0,14468,0.0,131,2809@TOP@human_GAPDH_TAA_len41_fa0_ta20_fm6_tm14,c
2809@TOP@human_GAPDH_TAA_len41_fa0_ta20_fm6_tm14*132*t,2,4,1,14269,14276,0.0,132,2809@TOP@human_GAPDH_TAA_len41_fa0_ta20_fm6_tm14,t
2809@TOP@human_GAPDH_TAA_len41_fa0_ta20_fm6_tm14*133*g,2,0,14240,0,14242,1.0,133,2809@TOP@human_GAPDH_TAA_len41_fa0_ta20_fm6_tm14,g
2809@TOP@human_GAPDH_TAA_len41_fa0_ta20_fm6_tm14*134*g,2,0,14318,2,14322,1.0,134,2809@TOP@human_GAPDH_TAA_len41_fa0_ta20_fm6_tm14,g
2810@TOP@human_GAPDH_TAA_len41_fa0_ta20_fm6_tm14*114*t,1,1,0,6641,6643,0.0,114,2810@TOP@human_GAPDH_TAA_len41_fa0_ta20_fm6_tm14,t
2810@TOP@human_GAPDH_TAA_len41_fa0_ta20_fm6_tm14*115*c,0,6674,0,0,6674,0.0,115,2810@TOP@human_GAPDH_TAA_len41_fa0_ta20_fm6_tm14,c
2810@TOP@human_GAPDH_TAA_len41_fa0_ta20_fm6_tm14*116*c,0,6656,0,1,6657,0.0,116,2810@TOP@human_GAPDH_TAA_len41_fa0_ta20_fm6_tm14,c
2810@TOP@human_GAPDH_TAA_len41_fa0_ta20_fm6_tm14*117*a,6636,0,9,0,6645,0.001,117,2810@TOP@human_GAPDH_TAA_len41_fa0_ta20_fm6_tm14,a
2810@TOP@human_GAPDH_TAA_len41_fa0_ta20_fm6_tm14*118*a,6489,0,119,1,6609,0.018,118,2810@TOP@human_GAPDH_TAA_len41_fa0_ta20_fm6_tm14,a
2810@TOP@human_GAPDH_TAA_len41_fa0_ta20_fm6_tm14*119*g,0,0,6616,0,6616,1.0,119,2810@TOP@human_GAPDH_TAA_len41_fa0_ta20_fm6_tm14,g
2810@TOP@human_GAPDH_TAA_len41_fa0_ta20_fm6_tm14*120*g,0,0,6584,0,6584,1.0,120,2810@TOP@human_GAPDH_TAA_len41_fa0_ta20_fm6_tm14,g
2810@TOP@human_GAPDH_TAA_len41_fa0_ta20_fm6_tm14*121*a,6636,0,2,1,6639,0.0,121,2810@TOP@human_GAPDH_TAA_len41_fa0_ta20_fm6_tm14,a
2810@TOP@human_GAPDH_TAA_len41_fa0_ta20_fm6_tm14*122*g,0,0,6647,0,6647,1.0,122,2810@TOP@human_GAPDH_TAA_len41_fa0_ta20_fm6_tm14,g
2810@TOP@human_GAPDH_TAA_len41_fa0_ta20_fm6_tm14*123*t,2,0,5,6570,6577,0.001,123,2810@TOP@human_GAPDH_TAA_len41_fa0_ta20_fm6_tm14,t
2810@TOP@human_GAPDH_TAA_len41_fa0_ta20_fm6_tm14*124*a,4693,0,1852,0,6545,0.283,124,2810@TOP@human_GAPDH_TAA_len41_fa0_ta20_fm6_tm14,a
2810@TOP@human_GAPDH_TAA_len41_fa0_ta20_fm6_tm14*125*a,5341,0,1207,1,6549,0.184,125,2810@TOP@human_GAPDH_TAA_len41_fa0_ta20_fm6_tm14,a
2810@TOP@human_GAPDH_TAA_len41_fa0_ta20_fm6_tm14*126*g,0,0,6563,0,6563,1.0,126,2810@TOP@human_GAPDH_TAA_len41_fa0_ta20_fm6_tm14,g
2810@TOP@human_GAPDH_TAA_len41_fa0_ta20_fm6_tm14*127*a,6592,3,35,0,6630,0.005,127,2810@TOP@human_GAPDH_TAA_len41_fa0_ta20_fm6_tm14,a
2810@TOP@human_GAPDH_TAA_len41_fa0_ta20_fm6_tm14*128*c,0,6662,0,0,6662,0.0,128,2810@TOP@human_GAPDH_TAA_len41_fa0_ta20_fm6_tm14,c
2810@TOP@human_GAPDH_TAA_len41_fa0_ta20_fm6_tm14*129*c,0,6611,0,0,6611,0.0,129,2810@TOP@human_GAPDH_TAA_len41_fa0_ta20_fm6_tm14,c
2810@TOP@human_GAPDH_TAA_len41_fa0_ta20_fm6_tm14*130*c,0,6644,0,0,6644,0.0,130,2810@TOP@human_GAPDH_TAA_len41_fa0_ta20_fm6_tm14,c
2810@TOP@human_GAPDH_TAA_len41_fa0_ta20_fm6_tm14*131*c,0,6664,0,0,6664,0.0,131,2810@TOP@human_GAPDH_TAA_len41_fa0_ta20_fm6_tm14,c
2810@TOP@human_GAPDH_TAA_len41_fa0_ta20_fm6_tm14*132*t,0,1,1,6571,6573,0.0,132,2810@TOP@human_GAPDH_TAA_len41_fa0_ta20_fm6_tm14,t
2810@TOP@human_GAPDH_TAA_len41_fa0_ta20_fm6_tm14*133*g,0,0,6561,4,6565,0.999,133,2810@TOP@human_GAPDH_TAA_len41_fa0_ta20_fm6_tm14,g
2810@TOP@human_GAPDH_TAA_len41_fa0_ta20_fm6_tm14*134*g,0,0,6593,0,6593,1.0,134,2810@TOP@human_GAPDH_TAA_len41_fa0_ta20_fm6_tm14,g
2811@TOP@human_GAPDH_TAA_len41_fa0_ta20_fm6_tm14*114*t,1,3,1,9157,9162,0.0,114,2811@TOP@human_GAPDH_TAA_len41_fa0_ta20_fm6_tm14,t
2811@TOP@human_GAPDH_TAA_len41_fa0_ta20_fm6_tm14*115*c,0,9230,0,1,9231,0.0,115,2811@TOP@human_GAPDH_TAA_len41_fa0_ta20_fm6_tm14,c
2811@TOP@human_GAPDH_TAA_len41_fa0_ta20_fm6_tm14*116*c,0,9190,0,1,9191,0.0,116,2811@TOP@human_GAPDH_TAA_len41_fa0_ta20_fm6_tm14,c
2811@TOP@human_GAPDH_TAA_len41_fa0_ta20_fm6_tm14*117*a,9173,0,15,0,9188,0.002,117,2811@TOP@human_GAPDH_TAA_len41_fa0_ta20_fm6_tm14,a
2811@TOP@human_GAPDH_TAA_len41_fa0_ta20_fm6_tm14*118*a,9015,0,123,1,9139,0.013,118,2811@TOP@human_GAPDH_TAA_len41_fa0_ta20_fm6_tm14,a
2811@TOP@human_GAPDH_TAA_len41_fa0_ta20_fm6_tm14*119*g,0,1,9117,0,9118,1.0,119,2811@TOP@human_GAPDH_TAA_len41_fa0_ta20_fm6_tm14,g
2811@TOP@human_GAPDH_TAA_len41_fa0_ta20_fm6_tm14*120*g,1,0,9094,0,9095,1.0,120,2811@TOP@human_GAPDH_TAA_len41_fa0_ta20_fm6_tm14,g
2811@TOP@human_GAPDH_TAA_len41_fa0_ta20_fm6_tm14*121*a,9176,0,4,0,9180,0.0,121,2811@TOP@human_GAPDH_TAA_len41_fa0_ta20_fm6_tm14,a
2811@TOP@human_GAPDH_TAA_len41_fa0_ta20_fm6_tm14*122*g,1,1,9194,0,9196,1.0,122,2811@TOP@human_GAPDH_TAA_len41_fa0_ta20_fm6_tm14,g
2811@TOP@human_GAPDH_TAA_len41_fa0_ta20_fm6_tm14*123*t,2,0,1,9076,9079,0.0,123,2811@TOP@human_GAPDH_TAA_len41_fa0_ta20_fm6_tm14,t
2811@TOP@human_GAPDH_TAA_len41_fa0_ta20_fm6_tm14*124*a,8583,1,467,1,9052,0.052,124,2811@TOP@human_GAPDH_TAA_len41_fa0_ta20_fm6_tm14,a
2811@TOP@human_GAPDH_TAA_len41_fa0_ta20_fm6_tm14*125*a,8708,0,294,0,9002,0.033,125,2811@TOP@human_GAPDH_TAA_len41_fa0_ta20_fm6_tm14,a
2811@TOP@human_GAPDH_TAA_len41_fa0_ta20_fm6_tm14*126*g,0,0,9064,0,9064,1.0,126,2811@TOP@human_GAPDH_TAA_len41_fa0_ta20_fm6_tm14,g
2811@TOP@human_GAPDH_TAA_len41_fa0_ta20_fm6_tm14*127*a,9133,0,23,0,9156,0.003,127,2811@TOP@human_GAPDH_TAA_len41_fa0_ta20_fm6_tm14,a
2811@TOP@human_GAPDH_TAA_len41_fa0_ta20_fm6_tm14*128*c,0,9202,1,0,9203,0.0,128,2811@TOP@human_GAPDH_TAA_len41_fa0_ta20_fm6_tm14,c
2811@TOP@human_GAPDH_TAA_len41_fa0_ta20_fm6_tm14*129*c,1,9139,0,4,9144,0.0,129,2811@TOP@human_GAPDH_TAA_len41_fa0_ta20_fm6_tm14,c
2811@TOP@human_GAPDH_TAA_len41_fa0_ta20_fm6_tm14*130*c,0,9188,0,3,9191,0.0,130,2811@TOP@human_GAPDH_TAA_len41_fa0_ta20_fm6_tm14,c
2811@TOP@human_GAPDH_TAA_len41_fa0_ta20_fm6_tm14*131*c,0,9212,0,0,9212,0.0,131,2811@TOP@human_GAPDH_TAA_len41_fa0_ta20_fm6_tm14,c
2811@TOP@human_GAPDH_TAA_len41_fa0_ta20_fm6_tm14*132*t,1,7,1,9086,9095,0.0,132,2811@TOP@human_GAPDH_TAA_len41_fa0_ta20_fm6_tm14,t
2811@TOP@human_GAPDH_TAA_len41_fa0_ta20_fm6_tm14*133*g,1,0,9068,1,9070,1.0,133,2811@TOP@human_GAPDH_TAA_len41_fa0_ta20_fm6_tm14,g
2811@TOP@human_GAPDH_TAA_len41_fa0_ta20_fm6_tm14*134*g,0,0,9133,1,9134,1.0,134,2811@TOP@human_GAPDH_TAA_len41_fa0_ta20_fm6_tm14,g
2812@TOP@human_GAPDH_TAA_len41_fa0_ta20_fm6_tm14*114*t,0,0,0,5175,5175,0.0,114,2812@TOP@human_GAPDH_TAA_len41_fa0_ta20_fm6_tm14,t
2812@TOP@human_GAPDH_TAA_len41_fa0_ta20_fm6_tm14*115*c,0,5201,0,0,5201,0.0,115,2812@TOP@human_GAPDH_TAA_len41_fa0_ta20_fm6_tm14,c
2812@TOP@human_GAPDH_TAA_len41_fa0_ta20_fm6_tm14*116*c,1,5189,0,0,5190,0.0,116,2812@TOP@human_GAPDH_TAA_len41_fa0_ta20_fm6_tm14,c
2812@TOP@human_GAPDH_TAA_len41_fa0_ta20_fm6_tm14*117*a,5159,1,21,0,5181,0.004,117,2812@TOP@human_GAPDH_TAA_len41_fa0_ta20_fm6_tm14,a
2812@TOP@human_GAPDH_TAA_len41_fa0_ta20_fm6_tm14*118*a,5001,0,154,0,5155,0.03,118,2812@TOP@human_GAPDH_TAA_len41_fa0_ta20_fm6_tm14,a
2812@TOP@human_GAPDH_TAA_len41_fa0_ta20_fm6_tm14*119*g,1,0,5132,0,5133,1.0,119,2812@TOP@human_GAPDH_TAA_len41_fa0_ta20_fm6_tm14,g
2812@TOP@human_GAPDH_TAA_len41_fa0_ta20_fm6_tm14*120*g,0,0,5110,0,5110,1.0,120,2812@TOP@human_GAPDH_TAA_len41_fa0_ta20_fm6_tm14,g
2812@TOP@human_GAPDH_TAA_len41_fa0_ta20_fm6_tm14*121*a,5163,0,4,0,5167,0.001,121,2812@TOP@human_GAPDH_TAA_len41_fa0_ta20_fm6_tm14,a
2812@TOP@human_GAPDH_TAA_len41_fa0_ta20_fm6_tm14*122*g,3,0,5180,0,5183,0.999,122,2812@TOP@human_GAPDH_TAA_len41_fa0_ta20_fm6_tm14,g
2812@TOP@human_GAPDH_TAA_len41_fa0_ta20_fm6_tm14*123*t,0,0,3,5101,5104,0.001,123,2812@TOP@human_GAPDH_TAA_len41_fa0_ta20_fm6_tm14,t
2812@TOP@human_GAPDH_TAA_len41_fa0_ta20_fm6_tm14*124*a,4553,0,518,0,5071,0.102,124,2812@TOP@human_GAPDH_TAA_len41_fa0_ta20_fm6_tm14,a
2812@TOP@human_GAPDH_TAA_len41_fa0_ta20_fm6_tm14*125*a,4664,0,436,0,5100,0.085,125,2812@TOP@human_GAPDH_TAA_len41_fa0_ta20_fm6_tm14,a
2812@TOP@human_GAPDH_TAA_len41_fa0_ta20_fm6_tm14*126*g,0,0,5119,0,5119,1.0,126,2812@TOP@human_GAPDH_TAA_len41_fa0_ta20_fm6_tm14,g
2812@TOP@human_GAPDH_TAA_len41_fa0_ta20_fm6_tm14*127*a,5155,0,7,2,5164,0.001,127,2812@TOP@human_GAPDH_TAA_len41_fa0_ta20_fm6_tm14,a
2812@TOP@human_GAPDH_TAA_len41_fa0_ta20_fm6_tm14*128*c,0,5189,1,0,5190,0.0,128,2812@TOP@human_GAPDH_TAA_len41_fa0_ta20_fm6_tm14,c
2812@TOP@human_GAPDH_TAA_len41_fa0_ta20_fm6_tm14*129*c,0,5136,0,0,5136,0.0,129,2812@TOP@human_GAPDH_TAA_len41_fa0_ta20_fm6_tm14,c
2812@TOP@human_GAPDH_TAA_len41_fa0_ta20_fm6_tm14*130*c,2,5170,0,0,5172,0.0,130,2812@TOP@human_GAPDH_TAA_len41_fa0_ta20_fm6_tm14,c
2812@TOP@human_GAPDH_TAA_len41_fa0_ta20_fm6_tm14*131*c,0,5194,0,0,5194,0.0,131,2812@TOP@human_GAPDH_TAA_len41_fa0_ta20_fm6_tm14,c
2812@TOP@human_GAPDH_TAA_len41_fa0_ta20_fm6_tm14*132*t,0,2,0,5121,5123,0.0,132,2812@TOP@human_GAPDH_TAA_len41_fa0_ta20_fm6_tm14,t
2812@TOP@human_GAPDH_TAA_len41_fa0_ta20_fm6_tm14*133*g,0,0,5103,0,5103,1.0,133,2812@TOP@human_GAPDH_TAA_len41_fa0_ta20_fm6_tm14,g
2812@TOP@human_GAPDH_TAA_len41_fa0_ta20_fm6_tm14*134*g,0,1,5120,0,5121,1.0,134,2812@TOP@human_GAPDH_TAA_len41_fa0_ta20_fm6_tm14,g
2813@TOP@human_GAPDH_TAA_len41_fa0_ta20_fm6_tm14*114*t,0,3,0,4939,4942,0.0,114,2813@TOP@human_GAPDH_TAA_len41_fa0_ta20_fm6_tm14,t
2813@TOP@human_GAPDH_TAA_len41_fa0_ta20_fm6_tm14*115*c,0,4979,0,0,4979,0.0,115,2813@TOP@human_GAPDH_TAA_len41_fa0_ta20_fm6_tm14,c
2813@TOP@human_GAPDH_TAA_len41_fa0_ta20_fm6_tm14*116*c,0,4951,0,0,4951,0.0,116,2813@TOP@human_GAPDH_TAA_len41_fa0_ta20_fm6_tm14,c
2813@TOP@human_GAPDH_TAA_len41_fa0_ta20_fm6_tm14*117*a,4948,0,9,1,4958,0.002,117,2813@TOP@human_GAPDH_TAA_len41_fa0_ta20_fm6_tm14,a
2813@TOP@human_GAPDH_TAA_len41_fa0_ta20_fm6_tm14*118*a,4847,1,77,0,4925,0.016,118,2813@TOP@human_GAPDH_TAA_len41_fa0_ta20_fm6_tm14,a
2813@TOP@human_GAPDH_TAA_len41_fa0_ta20_fm6_tm14*119*g,0,0,4926,0,4926,1.0,119,2813@TOP@human_GAPDH_TAA_len41_fa0_ta20_fm6_tm14,g
2813@TOP@human_GAPDH_TAA_len41_fa0_ta20_fm6_tm14*120*g,0,0,4899,0,4899,1.0,120,2813@TOP@human_GAPDH_TAA_len41_fa0_ta20_fm6_tm14,g
2813@TOP@human_GAPDH_TAA_len41_fa0_ta20_fm6_tm14*121*a,4943,0,0,0,4943,0.0,121,2813@TOP@human_GAPDH_TAA_len41_fa0_ta20_fm6_tm14,a
2813@TOP@human_GAPDH_TAA_len41_fa0_ta20_fm6_tm14*122*g,0,0,4956,0,4956,1.0,122,2813@TOP@human_GAPDH_TAA_len41_fa0_ta20_fm6_tm14,g
2813@TOP@human_GAPDH_TAA_len41_fa0_ta20_fm6_tm14*123*t,0,1,2,4891,4894,0.0,123,2813@TOP@human_GAPDH_TAA_len41_fa0_ta20_fm6_tm14,t
2813@TOP@human_GAPDH_TAA_len41_fa0_ta20_fm6_tm14*124*a,4567,0,307,0,4874,0.063,124,2813@TOP@human_GAPDH_TAA_len41_fa0_ta20_fm6_tm14,a
2813@TOP@human_GAPDH_TAA_len41_fa0_ta20_fm6_tm14*125*a,4180,0,678,0,4858,0.14,125,2813@TOP@human_GAPDH_TAA_len41_fa0_ta20_fm6_tm14,a
2813@TOP@human_GAPDH_TAA_len41_fa0_ta20_fm6_tm14*126*g,0,0,4909,0,4909,1.0,126,2813@TOP@human_GAPDH_TAA_len41_fa0_ta20_fm6_tm14,g
2813@TOP@human_GAPDH_TAA_len41_fa0_ta20_fm6_tm14*127*a,4940,0,3,0,4943,0.001,127,2813@TOP@human_GAPDH_TAA_len41_fa0_ta20_fm6_tm14,a
2813@TOP@human_GAPDH_TAA_len41_fa0_ta20_fm6_tm14*128*c,0,4961,1,0,4962,0.0,128,2813@TOP@human_GAPDH_TAA_len41_fa0_ta20_fm6_tm14,c
2813@TOP@human_GAPDH_TAA_len41_fa0_ta20_fm6_tm14*129*c,0,4913,0,0,4913,0.0,129,2813@TOP@human_GAPDH_TAA_len41_fa0_ta20_fm6_tm14,c
2813@TOP@human_GAPDH_TAA_len41_fa0_ta20_fm6_tm14*130*c,0,4961,0,0,4961,0.0,130,2813@TOP@human_GAPDH_TAA_len41_fa0_ta20_fm6_tm14,c
2813@TOP@human_GAPDH_TAA_len41_fa0_ta20_fm6_tm14*131*c,0,4972,0,0,4972,0.0,131,2813@TOP@human_GAPDH_TAA_len41_fa0_ta20_fm6_tm14,c
2813@TOP@human_GAPDH_TAA_len41_fa0_ta20_fm6_tm14*132*t,0,0,2,4902,4904,0.0,132,2813@TOP@human_GAPDH_TAA_len41_fa0_ta20_fm6_tm14,t
2813@TOP@human_GAPDH_TAA_len41_fa0_ta20_fm6_tm14*133*g,0,0,4894,4,4898,0.999,133,2813@TOP@human_GAPDH_TAA_len41_fa0_ta20_fm6_tm14,g
2813@TOP@human_GAPDH_TAA_len41_fa0_ta20_fm6_tm14*134*g,0,0,4917,0,4917,1.0,134,2813@TOP@human_GAPDH_TAA_len41_fa0_ta20_fm6_tm14,g
2814@TOP@human_GAPDH_TAA_len41_fa0_ta20_fm6_tm14*114*t,0,0,0,1478,1478,0.0,114,2814@TOP@human_GAPDH_TAA_len41_fa0_ta20_fm6_tm14,t
2814@TOP@human_GAPDH_TAA_len41_fa0_ta20_fm6_tm14*115*c,0,1485,0,0,1485,0.0,115,2814@TOP@human_GAPDH_TAA_len41_fa0_ta20_fm6_tm14,c
2814@TOP@human_GAPDH_TAA_len41_fa0_ta20_fm6_tm14*116*c,0,1477,0,0,1477,0.0,116,2814@TOP@human_GAPDH_TAA_len41_fa0_ta20_fm6_tm14,c
2814@TOP@human_GAPDH_TAA_len41_fa0_ta20_fm6_tm14*117*a,1471,0,2,0,1473,0.001,117,2814@TOP@human_GAPDH_TAA_len41_fa0_ta20_fm6_tm14,a
2814@TOP@human_GAPDH_TAA_len41_fa0_ta20_fm6_tm14*118*a,1441,0,35,0,1476,0.024,118,2814@TOP@human_GAPDH_TAA_len41_fa0_ta20_fm6_tm14,a
2814@TOP@human_GAPDH_TAA_len41_fa0_ta20_fm6_tm14*119*g,0,0,1471,0,1471,1.0,119,2814@TOP@human_GAPDH_TAA_len41_fa0_ta20_fm6_tm14,g
2814@TOP@human_GAPDH_TAA_len41_fa0_ta20_fm6_tm14*120*g,0,0,1460,0,1460,1.0,120,2814@TOP@human_GAPDH_TAA_len41_fa0_ta20_fm6_tm14,g
2814@TOP@human_GAPDH_TAA_len41_fa0_ta20_fm6_tm14*121*a,1473,0,3,0,1476,0.002,121,2814@TOP@human_GAPDH_TAA_len41_fa0_ta20_fm6_tm14,a
2814@TOP@human_GAPDH_TAA_len41_fa0_ta20_fm6_tm14*122*g,0,0,1479,0,1479,1.0,122,2814@TOP@human_GAPDH_TAA_len41_fa0_ta20_fm6_tm14,g
2814@TOP@human_GAPDH_TAA_len41_fa0_ta20_fm6_tm14*123*t,0,0,0,1459,1459,0.0,123,2814@TOP@human_GAPDH_TAA_len41_fa0_ta20_fm6_tm14,t
2814@TOP@human_GAPDH_TAA_len41_fa0_ta20_fm6_tm14*124*a,1361,0,89,0,1450,0.061,124,2814@TOP@human_GAPDH_TAA_len41_fa0_ta20_fm6_tm14,a
2814@TOP@human_GAPDH_TAA_len41_fa0_ta20_fm6_tm14*125*a,1341,0,113,0,1454,0.078,125,2814@TOP@human_GAPDH_TAA_len41_fa0_ta20_fm6_tm14,a
2814@TOP@human_GAPDH_TAA_len41_fa0_ta20_fm6_tm14*126*g,0,0,1454,0,1454,1.0,126,2814@TOP@human_GAPDH_TAA_len41_fa0_ta20_fm6_tm14,g
2814@TOP@human_GAPDH_TAA_len41_fa0_ta20_fm6_tm14*127*a,1465,0,11,0,1476,0.007,127,2814@TOP@human_GAPDH_TAA_len41_fa0_ta20_fm6_tm14,a
2814@TOP@human_GAPDH_TAA_len41_fa0_ta20_fm6_tm14*128*c,0,1480,0,0,1480,0.0,128,2814@TOP@human_GAPDH_TAA_len41_fa0_ta20_fm6_tm14,c
2814@TOP@human_GAPDH_TAA_len41_fa0_ta20_fm6_tm14*129*c,0,1467,0,0,1467,0.0,129,2814@TOP@human_GAPDH_TAA_len41_fa0_ta20_fm6_tm14,c
2814@TOP@human_GAPDH_TAA_len41_fa0_ta20_fm6_tm14*130*c,0,1481,0,1,1482,0.0,130,2814@TOP@human_GAPDH_TAA_len41_fa0_ta20_fm6_tm14,c
2814@TOP@human_GAPDH_TAA_len41_fa0_ta20_fm6_tm14*131*c,0,1484,0,0,1484,0.0,131,2814@TOP@human_GAPDH_TAA_len41_fa0_ta20_fm6_tm14,c
2814@TOP@human_GAPDH_TAA_len41_fa0_ta20_fm6_tm14*132*t,0,0,0,1457,1457,0.0,132,2814@TOP@human_GAPDH_TAA_len41_fa0_ta20_fm6_tm14,t
2814@TOP@human_GAPDH_TAA_len41_fa0_ta20_fm6_tm14*133*g,0,0,1462,0,1462,1.0,133,2814@TOP@human_GAPDH_TAA_len41_fa0_ta20_fm6_tm14,g
2814@TOP@human_GAPDH_TAA_len41_fa0_ta20_fm6_tm14*134*g,0,0,1469,0,1469,1.0,134,2814@TOP@human_GAPDH_TAA_len41_fa0_ta20_fm6_tm14,g
2815@TOP@human_GAPDH_TAA_len41_fa0_ta20_fm6_tm14*114*t,0,0,0,963,963,0.0,114,2815@TOP@human_GAPDH_TAA_len41_fa0_ta20_fm6_tm14,t
2815@TOP@human_GAPDH_TAA_len41_fa0_ta20_fm6_tm14*115*c,0,969,0,0,969,0.0,115,2815@TOP@human_GAPDH_TAA_len41_fa0_ta20_fm6_tm14,c
2815@TOP@human_GAPDH_TAA_len41_fa0_ta20_fm6_tm14*116*c,0,962,0,2,964,0.0,116,2815@TOP@human_GAPDH_TAA_len41_fa0_ta20_fm6_tm14,c
2815@TOP@human_GAPDH_TAA_len41_fa0_ta20_fm6_tm14*117*a,962,0,1,0,963,0.001,117,2815@TOP@human_GAPDH_TAA_len41_fa0_ta20_fm6_tm14,a
2815@TOP@human_GAPDH_TAA_len41_fa0_ta20_fm6_tm14*118*a,934,0,25,0,959,0.026,118,2815@TOP@human_GAPDH_TAA_len41_fa0_ta20_fm6_tm14,a
2815@TOP@human_GAPDH_TAA_len41_fa0_ta20_fm6_tm14*119*g,0,0,955,0,955,1.0,119,2815@TOP@human_GAPDH_TAA_len41_fa0_ta20_fm6_tm14,g
2815@TOP@human_GAPDH_TAA_len41_fa0_ta20_fm6_tm14*120*g,0,0,948,0,948,1.0,120,2815@TOP@human_GAPDH_TAA_len41_fa0_ta20_fm6_tm14,g
2815@TOP@human_GAPDH_TAA_len41_fa0_ta20_fm6_tm14*121*a,961,0,0,0,961,0.0,121,2815@TOP@human_GAPDH_TAA_len41_fa0_ta20_fm6_tm14,a
2815@TOP@human_GAPDH_TAA_len41_fa0_ta20_fm6_tm14*122*g,0,0,960,0,960,1.0,122,2815@TOP@human_GAPDH_TAA_len41_fa0_ta20_fm6_tm14,g
2815@TOP@human_GAPDH_TAA_len41_fa0_ta20_fm6_tm14*123*t,0,2,0,948,950,0.0,123,2815@TOP@human_GAPDH_TAA_len41_fa0_ta20_fm6_tm14,t
2815@TOP@human_GAPDH_TAA_len41_fa0_ta20_fm6_tm14*124*a,799,0,151,0,950,0.159,124,2815@TOP@human_GAPDH_TAA_len41_fa0_ta20_fm6_tm14,a
2815@TOP@human_GAPDH_TAA_len41_fa0_ta20_fm6_tm14*125*a,801,1,144,0,946,0.152,125,2815@TOP@human_GAPDH_TAA_len41_fa0_ta20_fm6_tm14,a
2815@TOP@human_GAPDH_TAA_len41_fa0_ta20_fm6_tm14*126*g,0,0,955,0,955,1.0,126,2815@TOP@human_GAPDH_TAA_len41_fa0_ta20_fm6_tm14,g
2815@TOP@human_GAPDH_TAA_len41_fa0_ta20_fm6_tm14*127*a,949,0,14,0,963,0.015,127,2815@TOP@human_GAPDH_TAA_len41_fa0_ta20_fm6_tm14,a
2815@TOP@human_GAPDH_TAA_len41_fa0_ta20_fm6_tm14*128*c,0,965,0,0,965,0.0,128,2815@TOP@human_GAPDH_TAA_len41_fa0_ta20_fm6_tm14,c
2815@TOP@human_GAPDH_TAA_len41_fa0_ta20_fm6_tm14*129*c,0,959,0,0,959,0.0,129,2815@TOP@human_GAPDH_TAA_len41_fa0_ta20_fm6_tm14,c
2815@TOP@human_GAPDH_TAA_len41_fa0_ta20_fm6_tm14*130*c,0,962,0,1,963,0.0,130,2815@TOP@human_GAPDH_TAA_len41_fa0_ta20_fm6_tm14,c
2815@TOP@human_GAPDH_TAA_len41_fa0_ta20_fm6_tm14*131*c,0,967,0,0,967,0.0,131,2815@TOP@human_GAPDH_TAA_len41_fa0_ta20_fm6_tm14,c
2815@TOP@human_GAPDH_TAA_len41_fa0_ta20_fm6_tm14*132*t,0,0,0,950,950,0.0,132,2815@TOP@human_GAPDH_TAA_len41_fa0_ta20_fm6_tm14,t
2815@TOP@human_GAPDH_TAA_len41_fa0_ta20_fm6_tm14*133*g,0,0,946,0,946,1.0,133,2815@TOP@human_GAPDH_TAA_len41_fa0_ta20_fm6_tm14,g
2815@TOP@human_GAPDH_TAA_len41_fa0_ta20_fm6_tm14*134*g,2,0,956,0,958,0.998,134,2815@TOP@human_GAPDH_TAA_len41_fa0_ta20_fm6_tm14,g
2816@TOP@human_GAPDH_TAA_len41_fa0_ta20_fm6_tm14*114*t,0,0,0,996,996,0.0,114,2816@TOP@human_GAPDH_TAA_len41_fa0_ta20_fm6_tm14,t
2816@TOP@human_GAPDH_TAA_len41_fa0_ta20_fm6_tm14*115*c,0,1007,0,0,1007,0.0,115,2816@TOP@human_GAPDH_TAA_len41_fa0_ta20_fm6_tm14,c
2816@TOP@human_GAPDH_TAA_len41_fa0_ta20_fm6_tm14*116*c,0,1004,0,0,1004,0.0,116,2816@TOP@human_GAPDH_TAA_len41_fa0_ta20_fm6_tm14,c
2816@TOP@human_GAPDH_TAA_len41_fa0_ta20_fm6_tm14*117*a,995,0,3,0,998,0.003,117,2816@TOP@human_GAPDH_TAA_len41_fa0_ta20_fm6_tm14,a
2816@TOP@human_GAPDH_TAA_len41_fa0_ta20_fm6_tm14*118*a,980,0,16,0,996,0.016,118,2816@TOP@human_GAPDH_TAA_len41_fa0_ta20_fm6_tm14,a
2816@TOP@human_GAPDH_TAA_len41_fa0_ta20_fm6_tm14*119*g,0,0,989,0,989,1.0,119,2816@TOP@human_GAPDH_TAA_len41_fa0_ta20_fm6_tm14,g
2816@TOP@human_GAPDH_TAA_len41_fa0_ta20_fm6_tm14*120*g,0,0,983,0,983,1.0,120,2816@TOP@human_GAPDH_TAA_len41_fa0_ta20_fm6_tm14,g
2816@TOP@human_GAPDH_TAA_len41_fa0_ta20_fm6_tm14*121*a,999,0,2,0,1001,0.002,121,2816@TOP@human_GAPDH_TAA_len41_fa0_ta20_fm6_tm14,a
2816@TOP@human_GAPDH_TAA_len41_fa0_ta20_fm6_tm14*122*g,0,0,1000,0,1000,1.0,122,2816@TOP@human_GAPDH_TAA_len41_fa0_ta20_fm6_tm14,g
2816@TOP@human_GAPDH_TAA_len41_fa0_ta20_fm6_tm14*123*t,0,0,0,985,985,0.0,123,2816@TOP@human_GAPDH_TAA_len41_fa0_ta20_fm6_tm14,t
2816@TOP@human_GAPDH_TAA_len41_fa0_ta20_fm6_tm14*124*a,710,0,275,0,985,0.279,124,2816@TOP@human_GAPDH_TAA_len41_fa0_ta20_fm6_tm14,a
2816@TOP@human_GAPDH_TAA_len41_fa0_ta20_fm6_tm14*125*a,823,0,169,0,992,0.17,125,2816@TOP@human_GAPDH_TAA_len41_fa0_ta20_fm6_tm14,a
2816@TOP@human_GAPDH_TAA_len41_fa0_ta20_fm6_tm14*126*g,0,0,985,0,985,1.0,126,2816@TOP@human_GAPDH_TAA_len41_fa0_ta20_fm6_tm14,g
2816@TOP@human_GAPDH_TAA_len41_fa0_ta20_fm6_tm14*127*a,986,0,11,0,997,0.011,127,2816@TOP@human_GAPDH_TAA_len41_fa0_ta20_fm6_tm14,a
2816@TOP@human_GAPDH_TAA_len41_fa0_ta20_fm6_tm14*128*c,0,1006,0,0,1006,0.0,128,2816@TOP@human_GAPDH_TAA_len41_fa0_ta20_fm6_tm14,c
2816@TOP@human_GAPDH_TAA_len41_fa0_ta20_fm6_tm14*129*c,0,990,0,0,990,0.0,129,2816@TOP@human_GAPDH_TAA_len41_fa0_ta20_fm6_tm14,c
2816@TOP@human_GAPDH_TAA_len41_fa0_ta20_fm6_tm14*130*c,0,996,0,0,996,0.0,130,2816@TOP@human_GAPDH_TAA_len41_fa0_ta20_fm6_tm14,c
2816@TOP@human_GAPDH_TAA_len41_fa0_ta20_fm6_tm14*131*c,0,1003,0,0,1003,0.0,131,2816@TOP@human_GAPDH_TAA_len41_fa0_ta20_fm6_tm14,c
2816@TOP@human_GAPDH_TAA_len41_fa0_ta20_fm6_tm14*132*t,0,0,0,986,986,0.0,132,2816@TOP@human_GAPDH_TAA_len41_fa0_ta20_fm6_tm14,t
2816@TOP@human_GAPDH_TAA_len41_fa0_ta20_fm6_tm14*133*g,0,0,986,0,986,1.0,133,2816@TOP@human_GAPDH_TAA_len41_fa0_ta20_fm6_tm14,g
2816@TOP@human_GAPDH_TAA_len41_fa0_ta20_fm6_tm14*134*g,0,1,997,0,998,0.999,134,2816@TOP@human_GAPDH_TAA_len41_fa0_ta20_fm6_tm14,g
2817@TOP@human_GAPDH_TAA_len41_fa0_ta20_fm6_tm14*114*t,0,0,0,693,693,0.0,114,2817@TOP@human_GAPDH_TAA_len41_fa0_ta20_fm6_tm14,t
2817@TOP@human_GAPDH_TAA_len41_fa0_ta20_fm6_tm14*115*c,0,699,0,0,699,0.0,115,2817@TOP@human_GAPDH_TAA_len41_fa0_ta20_fm6_tm14,c
2817@TOP@human_GAPDH_TAA_len41_fa0_ta20_fm6_tm14*116*c,0,692,0,0,692,0.0,116,2817@TOP@human_GAPDH_TAA_len41_fa0_ta20_fm6_tm14,c
2817@TOP@human_GAPDH_TAA_len41_fa0_ta20_fm6_tm14*117*a,687,0,4,0,691,0.006,117,2817@TOP@human_GAPDH_TAA_len41_fa0_ta20_fm6_tm14,a
2817@TOP@human_GAPDH_TAA_len41_fa0_ta20_fm6_tm14*118*a,661,0,30,0,691,0.043,118,2817@TOP@human_GAPDH_TAA_len41_fa0_ta20_fm6_tm14,a
2817@TOP@human_GAPDH_TAA_len41_fa0_ta20_fm6_tm14*119*g,0,0,687,0,687,1.0,119,2817@TOP@human_GAPDH_TAA_len41_fa0_ta20_fm6_tm14,g
2817@TOP@human_GAPDH_TAA_len41_fa0_ta20_fm6_tm14*120*g,0,0,685,0,685,1.0,120,2817@TOP@human_GAPDH_TAA_len41_fa0_ta20_fm6_tm14,g
2817@TOP@human_GAPDH_TAA_len41_fa0_ta20_fm6_tm14*121*a,689,0,0,0,689,0.0,121,2817@TOP@human_GAPDH_TAA_len41_fa0_ta20_fm6_tm14,a
2817@TOP@human_GAPDH_TAA_len41_fa0_ta20_fm6_tm14*122*g,1,0,693,0,694,0.999,122,2817@TOP@human_GAPDH_TAA_len41_fa0_ta20_fm6_tm14,g
2817@TOP@human_GAPDH_TAA_len41_fa0_ta20_fm6_tm14*123*t,0,0,0,687,687,0.0,123,2817@TOP@human_GAPDH_TAA_len41_fa0_ta20_fm6_tm14,t
2817@TOP@human_GAPDH_TAA_len41_fa0_ta20_fm6_tm14*124*a,435,0,253,0,688,0.368,124,2817@TOP@human_GAPDH_TAA_len41_fa0_ta20_fm6_tm14,a
2817@TOP@human_GAPDH_TAA_len41_fa0_ta20_fm6_tm14*125*a,469,0,210,0,679,0.309,125,2817@TOP@human_GAPDH_TAA_len41_fa0_ta20_fm6_tm14,a
2817@TOP@human_GAPDH_TAA_len41_fa0_ta20_fm6_tm14*126*g,0,0,680,0,680,1.0,126,2817@TOP@human_GAPDH_TAA_len41_fa0_ta20_fm6_tm14,g
2817@TOP@human_GAPDH_TAA_len41_fa0_ta20_fm6_tm14*127*a,683,0,11,0,694,0.016,127,2817@TOP@human_GAPDH_TAA_len41_fa0_ta20_fm6_tm14,a
2817@TOP@human_GAPDH_TAA_len41_fa0_ta20_fm6_tm14*128*c,0,696,0,0,696,0.0,128,2817@TOP@human_GAPDH_TAA_len41_fa0_ta20_fm6_tm14,c
2817@TOP@human_GAPDH_TAA_len41_fa0_ta20_fm6_tm14*129*c,0,690,0,0,690,0.0,129,2817@TOP@human_GAPDH_TAA_len41_fa0_ta20_fm6_tm14,c
2817@TOP@human_GAPDH_TAA_len41_fa0_ta20_fm6_tm14*130*c,0,696,0,0,696,0.0,130,2817@TOP@human_GAPDH_TAA_len41_fa0_ta20_fm6_tm14,c
2817@TOP@human_GAPDH_TAA_len41_fa0_ta20_fm6_tm14*131*c,0,698,0,0,698,0.0,131,2817@TOP@human_GAPDH_TAA_len41_fa0_ta20_fm6_tm14,c
2817@TOP@human_GAPDH_TAA_len41_fa0_ta20_fm6_tm14*132*t,0,3,0,684,687,0.0,132,2817@TOP@human_GAPDH_TAA_len41_fa0_ta20_fm6_tm14,t
2817@TOP@human_GAPDH_TAA_len41_fa0_ta20_fm6_tm14*133*g,0,0,685,0,685,1.0,133,2817@TOP@human_GAPDH_TAA_len41_fa0_ta20_fm6_tm14,g
2817@TOP@human_GAPDH_TAA_len41_fa0_ta20_fm6_tm14*134*g,0,0,689,0,689,1.0,134,2817@TOP@human_GAPDH_TAA_len41_fa0_ta20_fm6_tm14,g
2818@TOP@human_GAPDH_TAA_len41_fa0_ta20_fm6_tm14*114*t,1,3,0,13383,13387,0.0,114,2818@TOP@human_GAPDH_TAA_len41_fa0_ta20_fm6_tm14,t
2818@TOP@human_GAPDH_TAA_len41_fa0_ta20_fm6_tm14*115*c,0,13447,0,0,13447,0.0,115,2818@TOP@human_GAPDH_TAA_len41_fa0_ta20_fm6_tm14,c
2818@TOP@human_GAPDH_TAA_len41_fa0_ta20_fm6_tm14*116*c,0,13396,1,1,13398,0.0,116,2818@TOP@human_GAPDH_TAA_len41_fa0_ta20_fm6_tm14,c
2818@TOP@human_GAPDH_TAA_len41_fa0_ta20_fm6_tm14*117*a,13360,0,21,0,13381,0.002,117,2818@TOP@human_GAPDH_TAA_len41_fa0_ta20_fm6_tm14,a
2818@TOP@human_GAPDH_TAA_len41_fa0_ta20_fm6_tm14*118*a,13099,0,218,0,13317,0.016,118,2818@TOP@human_GAPDH_TAA_len41_fa0_ta20_fm6_tm14,a
2818@TOP@human_GAPDH_TAA_len41_fa0_ta20_fm6_tm14*119*g,0,0,13287,3,13290,1.0,119,2818@TOP@human_GAPDH_TAA_len41_fa0_ta20_fm6_tm14,g
2818@TOP@human_GAPDH_TAA_len41_fa0_ta20_fm6_tm14*120*g,0,0,13236,0,13236,1.0,120,2818@TOP@human_GAPDH_TAA_len41_fa0_ta20_fm6_tm14,g
2818@TOP@human_GAPDH_TAA_len41_fa0_ta20_fm6_tm14*121*a,13377,0,4,0,13381,0.0,121,2818@TOP@human_GAPDH_TAA_len41_fa0_ta20_fm6_tm14,a
2818@TOP@human_GAPDH_TAA_len41_fa0_ta20_fm6_tm14*122*g,0,0,13389,0,13389,1.0,122,2818@TOP@human_GAPDH_TAA_len41_fa0_ta20_fm6_tm14,g
2818@TOP@human_GAPDH_TAA_len41_fa0_ta20_fm6_tm14*123*t,0,1,0,13221,13222,0.0,123,2818@TOP@human_GAPDH_TAA_len41_fa0_ta20_fm6_tm14,t
2818@TOP@human_GAPDH_TAA_len41_fa0_ta20_fm6_tm14*124*a,12778,1,361,2,13142,0.027,124,2818@TOP@human_GAPDH_TAA_len41_fa0_ta20_fm6_tm14,a
2818@TOP@human_GAPDH_TAA_len41_fa0_ta20_fm6_tm14*125*a,12470,2,692,2,13166,0.053,125,2818@TOP@human_GAPDH_TAA_len41_fa0_ta20_fm6_tm14,a
2818@TOP@human_GAPDH_TAA_len41_fa0_ta20_fm6_tm14*126*g,3,0,13224,0,13227,1.0,126,2818@TOP@human_GAPDH_TAA_len41_fa0_ta20_fm6_tm14,g
2818@TOP@human_GAPDH_TAA_len41_fa0_ta20_fm6_tm14*127*a,13313,0,28,1,13342,0.002,127,2818@TOP@human_GAPDH_TAA_len41_fa0_ta20_fm6_tm14,a
2818@TOP@human_GAPDH_TAA_len41_fa0_ta20_fm6_tm14*128*c,0,13414,1,0,13415,0.0,128,2818@TOP@human_GAPDH_TAA_len41_fa0_ta20_fm6_tm14,c
2818@TOP@human_GAPDH_TAA_len41_fa0_ta20_fm6_tm14*129*c,1,13330,0,0,13331,0.0,129,2818@TOP@human_GAPDH_TAA_len41_fa0_ta20_fm6_tm14,c
2818@TOP@human_GAPDH_TAA_len41_fa0_ta20_fm6_tm14*130*c,0,13378,0,2,13380,0.0,130,2818@TOP@human_GAPDH_TAA_len41_fa0_ta20_fm6_tm14,c
2818@TOP@human_GAPDH_TAA_len41_fa0_ta20_fm6_tm14*131*c,1,13420,1,0,13422,0.0,131,2818@TOP@human_GAPDH_TAA_len41_fa0_ta20_fm6_tm14,c
2818@TOP@human_GAPDH_TAA_len41_fa0_ta20_fm6_tm14*132*t,1,5,0,13262,13268,0.0,132,2818@TOP@human_GAPDH_TAA_len41_fa0_ta20_fm6_tm14,t
2818@TOP@human_GAPDH_TAA_len41_fa0_ta20_fm6_tm14*133*g,1,0,13211,0,13212,1.0,133,2818@TOP@human_GAPDH_TAA_len41_fa0_ta20_fm6_tm14,g
2818@TOP@human_GAPDH_TAA_len41_fa0_ta20_fm6_tm14*134*g,0,0,13284,1,13285,1.0,134,2818@TOP@human_GAPDH_TAA_len41_fa0_ta20_fm6_tm14,g
2819@TOP@human_GAPDH_TAA_len41_fa0_ta20_fm6_tm14*114*t,3,5,0,19538,19546,0.0,114,2819@TOP@human_GAPDH_TAA_len41_fa0_ta20_fm6_tm14,t
2819@TOP@human_GAPDH_TAA_len41_fa0_ta20_fm6_tm14*115*c,0,19651,0,1,19652,0.0,115,2819@TOP@human_GAPDH_TAA_len41_fa0_ta20_fm6_tm14,c
2819@TOP@human_GAPDH_TAA_len41_fa0_ta20_fm6_tm14*116*c,0,19571,0,2,19573,0.0,116,2819@TOP@human_GAPDH_TAA_len41_fa0_ta20_fm6_tm14,c
2819@TOP@human_GAPDH_TAA_len41_fa0_ta20_fm6_tm14*117*a,19520,0,25,0,19545,0.001,117,2819@TOP@human_GAPDH_TAA_len41_fa0_ta20_fm6_tm14,a
2819@TOP@human_GAPDH_TAA_len41_fa0_ta20_fm6_tm14*118*a,19114,0,338,0,19452,0.017,118,2819@TOP@human_GAPDH_TAA_len41_fa0_ta20_fm6_tm14,a
2819@TOP@human_GAPDH_TAA_len41_fa0_ta20_fm6_tm14*119*g,1,0,19415,0,19416,1.0,119,2819@TOP@human_GAPDH_TAA_len41_fa0_ta20_fm6_tm14,g
2819@TOP@human_GAPDH_TAA_len41_fa0_ta20_fm6_tm14*120*g,1,0,19346,0,19347,1.0,120,2819@TOP@human_GAPDH_TAA_len41_fa0_ta20_fm6_tm14,g
2819@TOP@human_GAPDH_TAA_len41_fa0_ta20_fm6_tm14*121*a,19544,0,17,0,19561,0.001,121,2819@TOP@human_GAPDH_TAA_len41_fa0_ta20_fm6_tm14,a
2819@TOP@human_GAPDH_TAA_len41_fa0_ta20_fm6_tm14*122*g,3,0,19570,0,19573,1.0,122,2819@TOP@human_GAPDH_TAA_len41_fa0_ta20_fm6_tm14,g
2819@TOP@human_GAPDH_TAA_len41_fa0_ta20_fm6_tm14*123*t,0,5,2,19326,19333,0.0,123,2819@TOP@human_GAPDH_TAA_len41_fa0_ta20_fm6_tm14,t
2819@TOP@human_GAPDH_TAA_len41_fa0_ta20_fm6_tm14*124*a,18627,0,645,1,19273,0.033,124,2819@TOP@human_GAPDH_TAA_len41_fa0_ta20_fm6_tm14,a
2819@TOP@human_GAPDH_TAA_len41_fa0_ta20_fm6_tm14*125*a,18372,0,855,0,19227,0.044,125,2819@TOP@human_GAPDH_TAA_len41_fa0_ta20_fm6_tm14,a
2819@TOP@human_GAPDH_TAA_len41_fa0_ta20_fm6_tm14*126*g,1,0,19321,1,19323,1.0,126,2819@TOP@human_GAPDH_TAA_len41_fa0_ta20_fm6_tm14,g
2819@TOP@human_GAPDH_TAA_len41_fa0_ta20_fm6_tm14*127*a,19488,1,15,0,19504,0.001,127,2819@TOP@human_GAPDH_TAA_len41_fa0_ta20_fm6_tm14,a
2819@TOP@human_GAPDH_TAA_len41_fa0_ta20_fm6_tm14*128*c,0,19611,2,0,19613,0.0,128,2819@TOP@human_GAPDH_TAA_len41_fa0_ta20_fm6_tm14,c
2819@TOP@human_GAPDH_TAA_len41_fa0_ta20_fm6_tm14*129*c,1,19464,0,5,19470,0.0,129,2819@TOP@human_GAPDH_TAA_len41_fa0_ta20_fm6_tm14,c
2819@TOP@human_GAPDH_TAA_len41_fa0_ta20_fm6_tm14*130*c,2,19564,0,2,19568,0.0,130,2819@TOP@human_GAPDH_TAA_len41_fa0_ta20_fm6_tm14,c
2819@TOP@human_GAPDH_TAA_len41_fa0_ta20_fm6_tm14*131*c,0,19613,0,0,19613,0.0,131,2819@TOP@human_GAPDH_TAA_len41_fa0_ta20_fm6_tm14,c
2819@TOP@human_GAPDH_TAA_len41_fa0_ta20_fm6_tm14*132*t,2,6,1,19342,19351,0.0,132,2819@TOP@human_GAPDH_TAA_len41_fa0_ta20_fm6_tm14,t
2819@TOP@human_GAPDH_TAA_len41_fa0_ta20_fm6_tm14*133*g,2,0,19328,3,19333,1.0,133,2819@TOP@human_GAPDH_TAA_len41_fa0_ta20_fm6_tm14,g
2819@TOP@human_GAPDH_TAA_len41_fa0_ta20_fm6_tm14*134*g,1,6,19385,1,19393,1.0,134,2819@TOP@human_GAPDH_TAA_len41_fa0_ta20_fm6_tm14,g
2820@TOP@human_GAPDH_TAA_len41_fa0_ta20_fm6_tm14*114*t,0,1,0,8156,8157,0.0,114,2820@TOP@human_GAPDH_TAA_len41_fa0_ta20_fm6_tm14,t
2820@TOP@human_GAPDH_TAA_len41_fa0_ta20_fm6_tm14*115*c,0,8198,1,1,8200,0.0,115,2820@TOP@human_GAPDH_TAA_len41_fa0_ta20_fm6_tm14,c
2820@TOP@human_GAPDH_TAA_len41_fa0_ta20_fm6_tm14*116*c,1,8160,0,0,8161,0.0,116,2820@TOP@human_GAPDH_TAA_len41_fa0_ta20_fm6_tm14,c
2820@TOP@human_GAPDH_TAA_len41_fa0_ta20_fm6_tm14*117*a,8142,0,21,0,8163,0.003,117,2820@TOP@human_GAPDH_TAA_len41_fa0_ta20_fm6_tm14,a
2820@TOP@human_GAPDH_TAA_len41_fa0_ta20_fm6_tm14*118*a,7982,0,119,0,8101,0.015,118,2820@TOP@human_GAPDH_TAA_len41_fa0_ta20_fm6_tm14,a
2820@TOP@human_GAPDH_TAA_len41_fa0_ta20_fm6_tm14*119*g,1,0,8117,0,8118,1.0,119,2820@TOP@human_GAPDH_TAA_len41_fa0_ta20_fm6_tm14,g
2820@TOP@human_GAPDH_TAA_len41_fa0_ta20_fm6_tm14*120*g,0,0,8071,0,8071,1.0,120,2820@TOP@human_GAPDH_TAA_len41_fa0_ta20_fm6_tm14,g
2820@TOP@human_GAPDH_TAA_len41_fa0_ta20_fm6_tm14*121*a,8144,0,2,0,8146,0.0,121,2820@TOP@human_GAPDH_TAA_len41_fa0_ta20_fm6_tm14,a
2820@TOP@human_GAPDH_TAA_len41_fa0_ta20_fm6_tm14*122*g,0,0,8167,0,8167,1.0,122,2820@TOP@human_GAPDH_TAA_len41_fa0_ta20_fm6_tm14,g
2820@TOP@human_GAPDH_TAA_len41_fa0_ta20_fm6_tm14*123*t,2,0,0,8097,8099,0.0,123,2820@TOP@human_GAPDH_TAA_len41_fa0_ta20_fm6_tm14,t
2820@TOP@human_GAPDH_TAA_len41_fa0_ta20_fm6_tm14*124*a,3709,1,4344,0,8054,0.539,124,2820@TOP@human_GAPDH_TAA_len41_fa0_ta20_fm6_tm14,a
2820@TOP@human_GAPDH_TAA_len41_fa0_ta20_fm6_tm14*125*a,2509,0,5549,0,8058,0.689,125,2820@TOP@human_GAPDH_TAA_len41_fa0_ta20_fm6_tm14,a
2820@TOP@human_GAPDH_TAA_len41_fa0_ta20_fm6_tm14*126*g,1,1,8106,0,8108,1.0,126,2820@TOP@human_GAPDH_TAA_len41_fa0_ta20_fm6_tm14,g
2820@TOP@human_GAPDH_TAA_len41_fa0_ta20_fm6_tm14*127*a,8020,0,135,0,8155,0.017,127,2820@TOP@human_GAPDH_TAA_len41_fa0_ta20_fm6_tm14,a
2820@TOP@human_GAPDH_TAA_len41_fa0_ta20_fm6_tm14*128*c,1,8177,1,0,8179,0.0,128,2820@TOP@human_GAPDH_TAA_len41_fa0_ta20_fm6_tm14,c
2820@TOP@human_GAPDH_TAA_len41_fa0_ta20_fm6_tm14*129*c,0,8159,0,0,8159,0.0,129,2820@TOP@human_GAPDH_TAA_len41_fa0_ta20_fm6_tm14,c
2820@TOP@human_GAPDH_TAA_len41_fa0_ta20_fm6_tm14*130*c,0,8173,0,0,8173,0.0,130,2820@TOP@human_GAPDH_TAA_len41_fa0_ta20_fm6_tm14,c
2820@TOP@human_GAPDH_TAA_len41_fa0_ta20_fm6_tm14*131*c,0,8192,0,0,8192,0.0,131,2820@TOP@human_GAPDH_TAA_len41_fa0_ta20_fm6_tm14,c
2820@TOP@human_GAPDH_TAA_len41_fa0_ta20_fm6_tm14*132*t,1,0,0,8083,8084,0.0,132,2820@TOP@human_GAPDH_TAA_len41_fa0_ta20_fm6_tm14,t
2820@TOP@human_GAPDH_TAA_len41_fa0_ta20_fm6_tm14*133*g,0,0,8088,1,8089,1.0,133,2820@TOP@human_GAPDH_TAA_len41_fa0_ta20_fm6_tm14,g
2820@TOP@human_GAPDH_TAA_len41_fa0_ta20_fm6_tm14*134*g,1,0,8104,0,8105,1.0,134,2820@TOP@human_GAPDH_TAA_len41_fa0_ta20_fm6_tm14,g
2821@TOP@human_GAPDH_TAA_len41_fa0_ta20_fm6_tm14*114*t,2,8,0,21973,21983,0.0,114,2821@TOP@human_GAPDH_TAA_len41_fa0_ta20_fm6_tm14,t
2821@TOP@human_GAPDH_TAA_len41_fa0_ta20_fm6_tm14*115*c,1,22107,0,2,22110,0.0,115,2821@TOP@human_GAPDH_TAA_len41_fa0_ta20_fm6_tm14,c
2821@TOP@human_GAPDH_TAA_len41_fa0_ta20_fm6_tm14*116*c,0,22030,0,1,22031,0.0,116,2821@TOP@human_GAPDH_TAA_len41_fa0_ta20_fm6_tm14,c
2821@TOP@human_GAPDH_TAA_len41_fa0_ta20_fm6_tm14*117*a,21983,0,23,0,22006,0.001,117,2821@TOP@human_GAPDH_TAA_len41_fa0_ta20_fm6_tm14,a
2821@TOP@human_GAPDH_TAA_len41_fa0_ta20_fm6_tm14*118*a,21588,0,280,2,21870,0.013,118,2821@TOP@human_GAPDH_TAA_len41_fa0_ta20_fm6_tm14,a
2821@TOP@human_GAPDH_TAA_len41_fa0_ta20_fm6_tm14*119*g,3,0,21848,0,21851,1.0,119,2821@TOP@human_GAPDH_TAA_len41_fa0_ta20_fm6_tm14,g
2821@TOP@human_GAPDH_TAA_len41_fa0_ta20_fm6_tm14*120*g,3,1,21801,2,21807,1.0,120,2821@TOP@human_GAPDH_TAA_len41_fa0_ta20_fm6_tm14,g
2821@TOP@human_GAPDH_TAA_len41_fa0_ta20_fm6_tm14*121*a,21988,0,5,0,21993,0.0,121,2821@TOP@human_GAPDH_TAA_len41_fa0_ta20_fm6_tm14,a
2821@TOP@human_GAPDH_TAA_len41_fa0_ta20_fm6_tm14*122*g,0,0,22040,0,22040,1.0,122,2821@TOP@human_GAPDH_TAA_len41_fa0_ta20_fm6_tm14,g
2821@TOP@human_GAPDH_TAA_len41_fa0_ta20_fm6_tm14*123*t,0,5,1,21725,21731,0.0,123,2821@TOP@human_GAPDH_TAA_len41_fa0_ta20_fm6_tm14,t
2821@TOP@human_GAPDH_TAA_len41_fa0_ta20_fm6_tm14*124*a,13126,0,8647,1,21774,0.397,124,2821@TOP@human_GAPDH_TAA_len41_fa0_ta20_fm6_tm14,a
2821@TOP@human_GAPDH_TAA_len41_fa0_ta20_fm6_tm14*125*a,15899,1,5801,4,21705,0.267,125,2821@TOP@human_GAPDH_TAA_len41_fa0_ta20_fm6_tm14,a
2821@TOP@human_GAPDH_TAA_len41_fa0_ta20_fm6_tm14*126*g,1,1,21782,1,21785,1.0,126,2821@TOP@human_GAPDH_TAA_len41_fa0_ta20_fm6_tm14,g
2821@TOP@human_GAPDH_TAA_len41_fa0_ta20_fm6_tm14*127*a,21765,0,157,2,21924,0.007,127,2821@TOP@human_GAPDH_TAA_len41_fa0_ta20_fm6_tm14,a
2821@TOP@human_GAPDH_TAA_len41_fa0_ta20_fm6_tm14*128*c,1,22041,2,4,22048,0.0,128,2821@TOP@human_GAPDH_TAA_len41_fa0_ta20_fm6_tm14,c
2821@TOP@human_GAPDH_TAA_len41_fa0_ta20_fm6_tm14*129*c,2,21961,0,0,21963,0.0,129,2821@TOP@human_GAPDH_TAA_len41_fa0_ta20_fm6_tm14,c
2821@TOP@human_GAPDH_TAA_len41_fa0_ta20_fm6_tm14*130*c,2,22024,0,2,22028,0.0,130,2821@TOP@human_GAPDH_TAA_len41_fa0_ta20_fm6_tm14,c
2821@TOP@human_GAPDH_TAA_len41_fa0_ta20_fm6_tm14*131*c,3,22082,0,2,22087,0.0,131,2821@TOP@human_GAPDH_TAA_len41_fa0_ta20_fm6_tm14,c
2821@TOP@human_GAPDH_TAA_len41_fa0_ta20_fm6_tm14*132*t,2,1,0,21766,21769,0.0,132,2821@TOP@human_GAPDH_TAA_len41_fa0_ta20_fm6_tm14,t
2821@TOP@human_GAPDH_TAA_len41_fa0_ta20_fm6_tm14*133*g,5,0,21752,0,21757,1.0,133,2821@TOP@human_GAPDH_TAA_len41_fa0_ta20_fm6_tm14,g
2821@TOP@human_GAPDH_TAA_len41_fa0_ta20_fm6_tm14*134*g,1,1,21872,0,21874,1.0,134,2821@TOP@human_GAPDH_TAA_len41_fa0_ta20_fm6_tm14,g
2822@TOP@human_GAPDH_TAA_len41_fa0_ta20_fm6_tm14*114*t,0,1,0,326,327,0.0,114,2822@TOP@human_GAPDH_TAA_len41_fa0_ta20_fm6_tm14,t
2822@TOP@human_GAPDH_TAA_len41_fa0_ta20_fm6_tm14*115*c,0,336,0,0,336,0.0,115,2822@TOP@human_GAPDH_TAA_len41_fa0_ta20_fm6_tm14,c
2822@TOP@human_GAPDH_TAA_len41_fa0_ta20_fm6_tm14*116*c,0,330,0,0,330,0.0,116,2822@TOP@human_GAPDH_TAA_len41_fa0_ta20_fm6_tm14,c
2822@TOP@human_GAPDH_TAA_len41_fa0_ta20_fm6_tm14*117*a,337,0,0,0,337,0.0,117,2822@TOP@human_GAPDH_TAA_len41_fa0_ta20_fm6_tm14,a
2822@TOP@human_GAPDH_TAA_len41_fa0_ta20_fm6_tm14*118*a,313,0,16,0,329,0.049,118,2822@TOP@human_GAPDH_TAA_len41_fa0_ta20_fm6_tm14,a
2822@TOP@human_GAPDH_TAA_len41_fa0_ta20_fm6_tm14*119*g,0,0,324,0,324,1.0,119,2822@TOP@human_GAPDH_TAA_len41_fa0_ta20_fm6_tm14,g
2822@TOP@human_GAPDH_TAA_len41_fa0_ta20_fm6_tm14*120*g,0,0,317,0,317,1.0,120,2822@TOP@human_GAPDH_TAA_len41_fa0_ta20_fm6_tm14,g
2822@TOP@human_GAPDH_TAA_len41_fa0_ta20_fm6_tm14*121*a,332,0,0,0,332,0.0,121,2822@TOP@human_GAPDH_TAA_len41_fa0_ta20_fm6_tm14,a
2822@TOP@human_GAPDH_TAA_len41_fa0_ta20_fm6_tm14*122*g,0,0,333,0,333,1.0,122,2822@TOP@human_GAPDH_TAA_len41_fa0_ta20_fm6_tm14,g
2822@TOP@human_GAPDH_TAA_len41_fa0_ta20_fm6_tm14*123*t,0,0,0,321,321,0.0,123,2822@TOP@human_GAPDH_TAA_len41_fa0_ta20_fm6_tm14,t
2822@TOP@human_GAPDH_TAA_len41_fa0_ta20_fm6_tm14*124*a,263,0,62,0,325,0.191,124,2822@TOP@human_GAPDH_TAA_len41_fa0_ta20_fm6_tm14,a
2822@TOP@human_GAPDH_TAA_len41_fa0_ta20_fm6_tm14*125*a,290,0,32,0,322,0.099,125,2822@TOP@human_GAPDH_TAA_len41_fa0_ta20_fm6_tm14,a
2822@TOP@human_GAPDH_TAA_len41_fa0_ta20_fm6_tm14*126*g,0,0,328,0,328,1.0,126,2822@TOP@human_GAPDH_TAA_len41_fa0_ta20_fm6_tm14,g
2822@TOP@human_GAPDH_TAA_len41_fa0_ta20_fm6_tm14*127*a,324,0,8,0,332,0.024,127,2822@TOP@human_GAPDH_TAA_len41_fa0_ta20_fm6_tm14,a
2822@TOP@human_GAPDH_TAA_len41_fa0_ta20_fm6_tm14*128*c,0,335,0,0,335,0.0,128,2822@TOP@human_GAPDH_TAA_len41_fa0_ta20_fm6_tm14,c
2822@TOP@human_GAPDH_TAA_len41_fa0_ta20_fm6_tm14*129*c,0,324,0,0,324,0.0,129,2822@TOP@human_GAPDH_TAA_len41_fa0_ta20_fm6_tm14,c
2822@TOP@human_GAPDH_TAA_len41_fa0_ta20_fm6_tm14*130*c,0,332,0,0,332,0.0,130,2822@TOP@human_GAPDH_TAA_len41_fa0_ta20_fm6_tm14,c
2822@TOP@human_GAPDH_TAA_len41_fa0_ta20_fm6_tm14*131*c,0,336,0,0,336,0.0,131,2822@TOP@human_GAPDH_TAA_len41_fa0_ta20_fm6_tm14,c
2822@TOP@human_GAPDH_TAA_len41_fa0_ta20_fm6_tm14*132*t,0,0,0,324,324,0.0,132,2822@TOP@human_GAPDH_TAA_len41_fa0_ta20_fm6_tm14,t
2822@TOP@human_GAPDH_TAA_len41_fa0_ta20_fm6_tm14*133*g,0,0,326,0,326,1.0,133,2822@TOP@human_GAPDH_TAA_len41_fa0_ta20_fm6_tm14,g
2822@TOP@human_GAPDH_TAA_len41_fa0_ta20_fm6_tm14*134*g,0,0,324,0,324,1.0,134,2822@TOP@human_GAPDH_TAA_len41_fa0_ta20_fm6_tm14,g
2823@TOP@human_GAPDH_TAA_len41_fa0_ta20_fm6_tm14*114*t,0,0,0,1657,1657,0.0,114,2823@TOP@human_GAPDH_TAA_len41_fa0_ta20_fm6_tm14,t
2823@TOP@human_GAPDH_TAA_len41_fa0_ta20_fm6_tm14*115*c,0,1670,0,0,1670,0.0,115,2823@TOP@human_GAPDH_TAA_len41_fa0_ta20_fm6_tm14,c
2823@TOP@human_GAPDH_TAA_len41_fa0_ta20_fm6_tm14*116*c,0,1660,0,1,1661,0.0,116,2823@TOP@human_GAPDH_TAA_len41_fa0_ta20_fm6_tm14,c
2823@TOP@human_GAPDH_TAA_len41_fa0_ta20_fm6_tm14*117*a,1659,0,1,0,1660,0.001,117,2823@TOP@human_GAPDH_TAA_len41_fa0_ta20_fm6_tm14,a
2823@TOP@human_GAPDH_TAA_len41_fa0_ta20_fm6_tm14*118*a,1609,0,41,2,1652,0.025,118,2823@TOP@human_GAPDH_TAA_len41_fa0_ta20_fm6_tm14,a
2823@TOP@human_GAPDH_TAA_len41_fa0_ta20_fm6_tm14*119*g,0,0,1654,0,1654,1.0,119,2823@TOP@human_GAPDH_TAA_len41_fa0_ta20_fm6_tm14,g
2823@TOP@human_GAPDH_TAA_len41_fa0_ta20_fm6_tm14*120*g,0,0,1634,0,1634,1.0,120,2823@TOP@human_GAPDH_TAA_len41_fa0_ta20_fm6_tm14,g
2823@TOP@human_GAPDH_TAA_len41_fa0_ta20_fm6_tm14*121*a,1660,0,1,0,1661,0.001,121,2823@TOP@human_GAPDH_TAA_len41_fa0_ta20_fm6_tm14,a
2823@TOP@human_GAPDH_TAA_len41_fa0_ta20_fm6_tm14*122*g,0,0,1664,0,1664,1.0,122,2823@TOP@human_GAPDH_TAA_len41_fa0_ta20_fm6_tm14,g
2823@TOP@human_GAPDH_TAA_len41_fa0_ta20_fm6_tm14*123*t,1,0,0,1629,1630,0.0,123,2823@TOP@human_GAPDH_TAA_len41_fa0_ta20_fm6_tm14,t
2823@TOP@human_GAPDH_TAA_len41_fa0_ta20_fm6_tm14*124*a,1506,0,131,0,1637,0.08,124,2823@TOP@human_GAPDH_TAA_len41_fa0_ta20_fm6_tm14,a
2823@TOP@human_GAPDH_TAA_len41_fa0_ta20_fm6_tm14*125*a,1519,0,108,0,1627,0.066,125,2823@TOP@human_GAPDH_TAA_len41_fa0_ta20_fm6_tm14,a
2823@TOP@human_GAPDH_TAA_len41_fa0_ta20_fm6_tm14*126*g,0,0,1626,0,1626,1.0,126,2823@TOP@human_GAPDH_TAA_len41_fa0_ta20_fm6_tm14,g
2823@TOP@human_GAPDH_TAA_len41_fa0_ta20_fm6_tm14*127*a,1653,1,0,0,1654,0.0,127,2823@TOP@human_GAPDH_TAA_len41_fa0_ta20_fm6_tm14,a
2823@TOP@human_GAPDH_TAA_len41_fa0_ta20_fm6_tm14*128*c,0,1664,0,0,1664,0.0,128,2823@TOP@human_GAPDH_TAA_len41_fa0_ta20_fm6_tm14,c
2823@TOP@human_GAPDH_TAA_len41_fa0_ta20_fm6_tm14*129*c,0,1653,0,0,1653,0.0,129,2823@TOP@human_GAPDH_TAA_len41_fa0_ta20_fm6_tm14,c
2823@TOP@human_GAPDH_TAA_len41_fa0_ta20_fm6_tm14*130*c,0,1659,0,1,1660,0.0,130,2823@TOP@human_GAPDH_TAA_len41_fa0_ta20_fm6_tm14,c
2823@TOP@human_GAPDH_TAA_len41_fa0_ta20_fm6_tm14*131*c,1,1668,0,0,1669,0.0,131,2823@TOP@human_GAPDH_TAA_len41_fa0_ta20_fm6_tm14,c
2823@TOP@human_GAPDH_TAA_len41_fa0_ta20_fm6_tm14*132*t,0,0,0,1637,1637,0.0,132,2823@TOP@human_GAPDH_TAA_len41_fa0_ta20_fm6_tm14,t
2823@TOP@human_GAPDH_TAA_len41_fa0_ta20_fm6_tm14*133*g,2,0,1632,0,1634,0.999,133,2823@TOP@human_GAPDH_TAA_len41_fa0_ta20_fm6_tm14,g
2823@TOP@human_GAPDH_TAA_len41_fa0_ta20_fm6_tm14*134*g,0,3,1640,0,1643,0.998,134,2823@TOP@human_GAPDH_TAA_len41_fa0_ta20_fm6_tm14,g
2824@TOP@human_GAPDH_TAA_len41_fa0_ta20_fm6_tm14*114*t,0,0,0,288,288,0.0,114,2824@TOP@human_GAPDH_TAA_len41_fa0_ta20_fm6_tm14,t
2824@TOP@human_GAPDH_TAA_len41_fa0_ta20_fm6_tm14*115*c,0,290,0,0,290,0.0,115,2824@TOP@human_GAPDH_TAA_len41_fa0_ta20_fm6_tm14,c
2824@TOP@human_GAPDH_TAA_len41_fa0_ta20_fm6_tm14*116*c,0,287,0,0,287,0.0,116,2824@TOP@human_GAPDH_TAA_len41_fa0_ta20_fm6_tm14,c
2824@TOP@human_GAPDH_TAA_len41_fa0_ta20_fm6_tm14*117*a,288,0,0,0,288,0.0,117,2824@TOP@human_GAPDH_TAA_len41_fa0_ta20_fm6_tm14,a
2824@TOP@human_GAPDH_TAA_len41_fa0_ta20_fm6_tm14*118*a,289,0,1,0,290,0.003,118,2824@TOP@human_GAPDH_TAA_len41_fa0_ta20_fm6_tm14,a
2824@TOP@human_GAPDH_TAA_len41_fa0_ta20_fm6_tm14*119*g,0,0,286,0,286,1.0,119,2824@TOP@human_GAPDH_TAA_len41_fa0_ta20_fm6_tm14,g
2824@TOP@human_GAPDH_TAA_len41_fa0_ta20_fm6_tm14*120*g,0,0,283,0,283,1.0,120,2824@TOP@human_GAPDH_TAA_len41_fa0_ta20_fm6_tm14,g
2824@TOP@human_GAPDH_TAA_len41_fa0_ta20_fm6_tm14*121*a,290,0,0,0,290,0.0,121,2824@TOP@human_GAPDH_TAA_len41_fa0_ta20_fm6_tm14,a
2824@TOP@human_GAPDH_TAA_len41_fa0_ta20_fm6_tm14*122*g,0,0,289,0,289,1.0,122,2824@TOP@human_GAPDH_TAA_len41_fa0_ta20_fm6_tm14,g
2824@TOP@human_GAPDH_TAA_len41_fa0_ta20_fm6_tm14*123*t,0,0,1,278,279,0.004,123,2824@TOP@human_GAPDH_TAA_len41_fa0_ta20_fm6_tm14,t
2824@TOP@human_GAPDH_TAA_len41_fa0_ta20_fm6_tm14*124*a,192,0,90,0,282,0.319,124,2824@TOP@human_GAPDH_TAA_len41_fa0_ta20_fm6_tm14,a
2824@TOP@human_GAPDH_TAA_len41_fa0_ta20_fm6_tm14*125*a,239,0,42,0,281,0.149,125,2824@TOP@human_GAPDH_TAA_len41_fa0_ta20_fm6_tm14,a
2824@TOP@human_GAPDH_TAA_len41_fa0_ta20_fm6_tm14*126*g,0,0,289,0,289,1.0,126,2824@TOP@human_GAPDH_TAA_len41_fa0_ta20_fm6_tm14,g
2824@TOP@human_GAPDH_TAA_len41_fa0_ta20_fm6_tm14*127*a,284,0,4,0,288,0.014,127,2824@TOP@human_GAPDH_TAA_len41_fa0_ta20_fm6_tm14,a
2824@TOP@human_GAPDH_TAA_len41_fa0_ta20_fm6_tm14*128*c,0,288,0,0,288,0.0,128,2824@TOP@human_GAPDH_TAA_len41_fa0_ta20_fm6_tm14,c
2824@TOP@human_GAPDH_TAA_len41_fa0_ta20_fm6_tm14*129*c,0,286,0,0,286,0.0,129,2824@TOP@human_GAPDH_TAA_len41_fa0_ta20_fm6_tm14,c
2824@TOP@human_GAPDH_TAA_len41_fa0_ta20_fm6_tm14*130*c,1,288,0,0,289,0.0,130,2824@TOP@human_GAPDH_TAA_len41_fa0_ta20_fm6_tm14,c
2824@TOP@human_GAPDH_TAA_len41_fa0_ta20_fm6_tm14*131*c,0,290,0,0,290,0.0,131,2824@TOP@human_GAPDH_TAA_len41_fa0_ta20_fm6_tm14,c
2824@TOP@human_GAPDH_TAA_len41_fa0_ta20_fm6_tm14*132*t,0,0,0,283,283,0.0,132,2824@TOP@human_GAPDH_TAA_len41_fa0_ta20_fm6_tm14,t
2824@TOP@human_GAPDH_TAA_len41_fa0_ta20_fm6_tm14*133*g,2,0,285,0,287,0.993,133,2824@TOP@human_GAPDH_TAA_len41_fa0_ta20_fm6_tm14,g
2824@TOP@human_GAPDH_TAA_len41_fa0_ta20_fm6_tm14*134*g,0,0,280,0,280,1.0,134,2824@TOP@human_GAPDH_TAA_len41_fa0_ta20_fm6_tm14,g
2825@TOP@human_GAPDH_TAA_len41_fa0_ta20_fm6_tm14*114*t,0,2,0,7446,7448,0.0,114,2825@TOP@human_GAPDH_TAA_len41_fa0_ta20_fm6_tm14,t
2825@TOP@human_GAPDH_TAA_len41_fa0_ta20_fm6_tm14*115*c,0,7481,0,1,7482,0.0,115,2825@TOP@human_GAPDH_TAA_len41_fa0_ta20_fm6_tm14,c
2825@TOP@human_GAPDH_TAA_len41_fa0_ta20_fm6_tm14*116*c,0,7464,0,0,7464,0.0,116,2825@TOP@human_GAPDH_TAA_len41_fa0_ta20_fm6_tm14,c
2825@TOP@human_GAPDH_TAA_len41_fa0_ta20_fm6_tm14*117*a,7429,0,21,0,7450,0.003,117,2825@TOP@human_GAPDH_TAA_len41_fa0_ta20_fm6_tm14,a
2825@TOP@human_GAPDH_TAA_len41_fa0_ta20_fm6_tm14*118*a,7254,0,155,0,7409,0.021,118,2825@TOP@human_GAPDH_TAA_len41_fa0_ta20_fm6_tm14,a
2825@TOP@human_GAPDH_TAA_len41_fa0_ta20_fm6_tm14*119*g,1,0,7394,0,7395,1.0,119,2825@TOP@human_GAPDH_TAA_len41_fa0_ta20_fm6_tm14,g
2825@TOP@human_GAPDH_TAA_len41_fa0_ta20_fm6_tm14*120*g,0,0,7374,0,7374,1.0,120,2825@TOP@human_GAPDH_TAA_len41_fa0_ta20_fm6_tm14,g
2825@TOP@human_GAPDH_TAA_len41_fa0_ta20_fm6_tm14*121*a,7425,0,11,0,7436,0.001,121,2825@TOP@human_GAPDH_TAA_len41_fa0_ta20_fm6_tm14,a
2825@TOP@human_GAPDH_TAA_len41_fa0_ta20_fm6_tm14*122*g,0,0,7462,1,7463,1.0,122,2825@TOP@human_GAPDH_TAA_len41_fa0_ta20_fm6_tm14,g
2825@TOP@human_GAPDH_TAA_len41_fa0_ta20_fm6_tm14*123*t,1,0,0,7364,7365,0.0,123,2825@TOP@human_GAPDH_TAA_len41_fa0_ta20_fm6_tm14,t
2825@TOP@human_GAPDH_TAA_len41_fa0_ta20_fm6_tm14*124*a,5417,1,1904,0,7322,0.26,124,2825@TOP@human_GAPDH_TAA_len41_fa0_ta20_fm6_tm14,a
2825@TOP@human_GAPDH_TAA_len41_fa0_ta20_fm6_tm14*125*a,4225,1,3111,1,7338,0.424,125,2825@TOP@human_GAPDH_TAA_len41_fa0_ta20_fm6_tm14,a
2825@TOP@human_GAPDH_TAA_len41_fa0_ta20_fm6_tm14*126*g,1,1,7373,0,7375,1.0,126,2825@TOP@human_GAPDH_TAA_len41_fa0_ta20_fm6_tm14,g
2825@TOP@human_GAPDH_TAA_len41_fa0_ta20_fm6_tm14*127*a,7220,0,230,1,7451,0.031,127,2825@TOP@human_GAPDH_TAA_len41_fa0_ta20_fm6_tm14,a
2825@TOP@human_GAPDH_TAA_len41_fa0_ta20_fm6_tm14*128*c,0,7470,0,0,7470,0.0,128,2825@TOP@human_GAPDH_TAA_len41_fa0_ta20_fm6_tm14,c
2825@TOP@human_GAPDH_TAA_len41_fa0_ta20_fm6_tm14*129*c,0,7427,0,3,7430,0.0,129,2825@TOP@human_GAPDH_TAA_len41_fa0_ta20_fm6_tm14,c
2825@TOP@human_GAPDH_TAA_len41_fa0_ta20_fm6_tm14*130*c,0,7455,0,0,7455,0.0,130,2825@TOP@human_GAPDH_TAA_len41_fa0_ta20_fm6_tm14,c
2825@TOP@human_GAPDH_TAA_len41_fa0_ta20_fm6_tm14*131*c,2,7473,0,2,7477,0.0,131,2825@TOP@human_GAPDH_TAA_len41_fa0_ta20_fm6_tm14,c
2825@TOP@human_GAPDH_TAA_len41_fa0_ta20_fm6_tm14*132*t,2,2,0,7362,7366,0.0,132,2825@TOP@human_GAPDH_TAA_len41_fa0_ta20_fm6_tm14,t
2825@TOP@human_GAPDH_TAA_len41_fa0_ta20_fm6_tm14*133*g,0,0,7379,0,7379,1.0,133,2825@TOP@human_GAPDH_TAA_len41_fa0_ta20_fm6_tm14,g
2825@TOP@human_GAPDH_TAA_len41_fa0_ta20_fm6_tm14*134*g,0,1,7409,0,7410,1.0,134,2825@TOP@human_GAPDH_TAA_len41_fa0_ta20_fm6_tm14,g
2826@TOP@human_GAPDH_TAA_len41_fa0_ta20_fm6_tm14*114*t,2,5,0,16230,16237,0.0,114,2826@TOP@human_GAPDH_TAA_len41_fa0_ta20_fm6_tm14,t
2826@TOP@human_GAPDH_TAA_len41_fa0_ta20_fm6_tm14*115*c,1,16331,0,0,16332,0.0,115,2826@TOP@human_GAPDH_TAA_len41_fa0_ta20_fm6_tm14,c
2826@TOP@human_GAPDH_TAA_len41_fa0_ta20_fm6_tm14*116*c,0,16278,0,0,16278,0.0,116,2826@TOP@human_GAPDH_TAA_len41_fa0_ta20_fm6_tm14,c
2826@TOP@human_GAPDH_TAA_len41_fa0_ta20_fm6_tm14*117*a,16237,0,26,1,16264,0.002,117,2826@TOP@human_GAPDH_TAA_len41_fa0_ta20_fm6_tm14,a
2826@TOP@human_GAPDH_TAA_len41_fa0_ta20_fm6_tm14*118*a,15958,0,222,0,16180,0.014,118,2826@TOP@human_GAPDH_TAA_len41_fa0_ta20_fm6_tm14,a
2826@TOP@human_GAPDH_TAA_len41_fa0_ta20_fm6_tm14*119*g,0,0,16159,0,16159,1.0,119,2826@TOP@human_GAPDH_TAA_len41_fa0_ta20_fm6_tm14,g
2826@TOP@human_GAPDH_TAA_len41_fa0_ta20_fm6_tm14*120*g,1,0,16111,0,16112,1.0,120,2826@TOP@human_GAPDH_TAA_len41_fa0_ta20_fm6_tm14,g
2826@TOP@human_GAPDH_TAA_len41_fa0_ta20_fm6_tm14*121*a,16210,0,37,0,16247,0.002,121,2826@TOP@human_GAPDH_TAA_len41_fa0_ta20_fm6_tm14,a
2826@TOP@human_GAPDH_TAA_len41_fa0_ta20_fm6_tm14*122*g,0,0,16271,0,16271,1.0,122,2826@TOP@human_GAPDH_TAA_len41_fa0_ta20_fm6_tm14,g
2826@TOP@human_GAPDH_TAA_len41_fa0_ta20_fm6_tm14*123*t,0,4,2,16066,16072,0.0,123,2826@TOP@human_GAPDH_TAA_len41_fa0_ta20_fm6_tm14,t
2826@TOP@human_GAPDH_TAA_len41_fa0_ta20_fm6_tm14*124*a,10102,1,5955,0,16058,0.371,124,2826@TOP@human_GAPDH_TAA_len41_fa0_ta20_fm6_tm14,a
2826@TOP@human_GAPDH_TAA_len41_fa0_ta20_fm6_tm14*125*a,13869,2,2188,1,16060,0.136,125,2826@TOP@human_GAPDH_TAA_len41_fa0_ta20_fm6_tm14,a
2826@TOP@human_GAPDH_TAA_len41_fa0_ta20_fm6_tm14*126*g,3,0,16112,0,16115,1.0,126,2826@TOP@human_GAPDH_TAA_len41_fa0_ta20_fm6_tm14,g
2826@TOP@human_GAPDH_TAA_len41_fa0_ta20_fm6_tm14*127*a,16064,0,156,0,16220,0.01,127,2826@TOP@human_GAPDH_TAA_len41_fa0_ta20_fm6_tm14,a
2826@TOP@human_GAPDH_TAA_len41_fa0_ta20_fm6_tm14*128*c,0,16296,1,1,16298,0.0,128,2826@TOP@human_GAPDH_TAA_len41_fa0_ta20_fm6_tm14,c
2826@TOP@human_GAPDH_TAA_len41_fa0_ta20_fm6_tm14*129*c,1,16205,0,0,16206,0.0,129,2826@TOP@human_GAPDH_TAA_len41_fa0_ta20_fm6_tm14,c
2826@TOP@human_GAPDH_TAA_len41_fa0_ta20_fm6_tm14*130*c,0,16291,0,1,16292,0.0,130,2826@TOP@human_GAPDH_TAA_len41_fa0_ta20_fm6_tm14,c
2826@TOP@human_GAPDH_TAA_len41_fa0_ta20_fm6_tm14*131*c,2,16294,0,0,16296,0.0,131,2826@TOP@human_GAPDH_TAA_len41_fa0_ta20_fm6_tm14,c
2826@TOP@human_GAPDH_TAA_len41_fa0_ta20_fm6_tm14*132*t,2,2,2,16086,16092,0.0,132,2826@TOP@human_GAPDH_TAA_len41_fa0_ta20_fm6_tm14,t
2826@TOP@human_GAPDH_TAA_len41_fa0_ta20_fm6_tm14*133*g,0,0,16069,2,16071,1.0,133,2826@TOP@human_GAPDH_TAA_len41_fa0_ta20_fm6_tm14,g
2826@TOP@human_GAPDH_TAA_len41_fa0_ta20_fm6_tm14*134*g,2,4,16129,2,16137,1.0,134,2826@TOP@human_GAPDH_TAA_len41_fa0_ta20_fm6_tm14,g
2827@TOP@human_GAPDH_TAA_len41_fa0_ta20_fm6_tm14*114*t,0,0,0,650,650,0.0,114,2827@TOP@human_GAPDH_TAA_len41_fa0_ta20_fm6_tm14,t
2827@TOP@human_GAPDH_TAA_len41_fa0_ta20_fm6_tm14*115*c,0,653,0,0,653,0.0,115,2827@TOP@human_GAPDH_TAA_len41_fa0_ta20_fm6_tm14,c
2827@TOP@human_GAPDH_TAA_len41_fa0_ta20_fm6_tm14*116*c,0,649,0,0,649,0.0,116,2827@TOP@human_GAPDH_TAA_len41_fa0_ta20_fm6_tm14,c
2827@TOP@human_GAPDH_TAA_len41_fa0_ta20_fm6_tm14*117*a,645,0,5,0,650,0.008,117,2827@TOP@human_GAPDH_TAA_len41_fa0_ta20_fm6_tm14,a
2827@TOP@human_GAPDH_TAA_len41_fa0_ta20_fm6_tm14*118*a,630,0,14,0,644,0.022,118,2827@TOP@human_GAPDH_TAA_len41_fa0_ta20_fm6_tm14,a
2827@TOP@human_GAPDH_TAA_len41_fa0_ta20_fm6_tm14*119*g,0,0,639,0,639,1.0,119,2827@TOP@human_GAPDH_TAA_len41_fa0_ta20_fm6_tm14,g
2827@TOP@human_GAPDH_TAA_len41_fa0_ta20_fm6_tm14*120*g,0,0,636,0,636,1.0,120,2827@TOP@human_GAPDH_TAA_len41_fa0_ta20_fm6_tm14,g
2827@TOP@human_GAPDH_TAA_len41_fa0_ta20_fm6_tm14*121*a,645,0,0,0,645,0.0,121,2827@TOP@human_GAPDH_TAA_len41_fa0_ta20_fm6_tm14,a
2827@TOP@human_GAPDH_TAA_len41_fa0_ta20_fm6_tm14*122*g,0,0,645,0,645,1.0,122,2827@TOP@human_GAPDH_TAA_len41_fa0_ta20_fm6_tm14,g
2827@TOP@human_GAPDH_TAA_len41_fa0_ta20_fm6_tm14*123*t,0,0,0,643,643,0.0,123,2827@TOP@human_GAPDH_TAA_len41_fa0_ta20_fm6_tm14,t
2827@TOP@human_GAPDH_TAA_len41_fa0_ta20_fm6_tm14*124*a,538,0,93,0,631,0.147,124,2827@TOP@human_GAPDH_TAA_len41_fa0_ta20_fm6_tm14,a
2827@TOP@human_GAPDH_TAA_len41_fa0_ta20_fm6_tm14*125*a,537,0,100,0,637,0.157,125,2827@TOP@human_GAPDH_TAA_len41_fa0_ta20_fm6_tm14,a
2827@TOP@human_GAPDH_TAA_len41_fa0_ta20_fm6_tm14*126*g,0,0,638,0,638,1.0,126,2827@TOP@human_GAPDH_TAA_len41_fa0_ta20_fm6_tm14,g
2827@TOP@human_GAPDH_TAA_len41_fa0_ta20_fm6_tm14*127*a,643,0,3,0,646,0.005,127,2827@TOP@human_GAPDH_TAA_len41_fa0_ta20_fm6_tm14,a
2827@TOP@human_GAPDH_TAA_len41_fa0_ta20_fm6_tm14*128*c,0,652,0,0,652,0.0,128,2827@TOP@human_GAPDH_TAA_len41_fa0_ta20_fm6_tm14,c
2827@TOP@human_GAPDH_TAA_len41_fa0_ta20_fm6_tm14*129*c,0,645,0,0,645,0.0,129,2827@TOP@human_GAPDH_TAA_len41_fa0_ta20_fm6_tm14,c
2827@TOP@human_GAPDH_TAA_len41_fa0_ta20_fm6_tm14*130*c,0,647,0,0,647,0.0,130,2827@TOP@human_GAPDH_TAA_len41_fa0_ta20_fm6_tm14,c
2827@TOP@human_GAPDH_TAA_len41_fa0_ta20_fm6_tm14*131*c,0,653,0,0,653,0.0,131,2827@TOP@human_GAPDH_TAA_len41_fa0_ta20_fm6_tm14,c
2827@TOP@human_GAPDH_TAA_len41_fa0_ta20_fm6_tm14*132*t,0,0,0,638,638,0.0,132,2827@TOP@human_GAPDH_TAA_len41_fa0_ta20_fm6_tm14,t
2827@TOP@human_GAPDH_TAA_len41_fa0_ta20_fm6_tm14*133*g,0,0,639,0,639,1.0,133,2827@TOP@human_GAPDH_TAA_len41_fa0_ta20_fm6_tm14,g
2827@TOP@human_GAPDH_TAA_len41_fa0_ta20_fm6_tm14*134*g,0,0,643,0,643,1.0,134,2827@TOP@human_GAPDH_TAA_len41_fa0_ta20_fm6_tm14,g
2828@TOP@human_GAPDH_TAA_len41_fa0_ta20_fm6_tm14*114*t,0,0,0,718,718,0.0,114,2828@TOP@human_GAPDH_TAA_len41_fa0_ta20_fm6_tm14,t
2828@TOP@human_GAPDH_TAA_len41_fa0_ta20_fm6_tm14*115*c,0,721,0,0,721,0.0,115,2828@TOP@human_GAPDH_TAA_len41_fa0_ta20_fm6_tm14,c
2828@TOP@human_GAPDH_TAA_len41_fa0_ta20_fm6_tm14*116*c,0,718,0,0,718,0.0,116,2828@TOP@human_GAPDH_TAA_len41_fa0_ta20_fm6_tm14,c
2828@TOP@human_GAPDH_TAA_len41_fa0_ta20_fm6_tm14*117*a,714,0,0,0,714,0.0,117,2828@TOP@human_GAPDH_TAA_len41_fa0_ta20_fm6_tm14,a
2828@TOP@human_GAPDH_TAA_len41_fa0_ta20_fm6_tm14*118*a,699,0,17,0,716,0.024,118,2828@TOP@human_GAPDH_TAA_len41_fa0_ta20_fm6_tm14,a
2828@TOP@human_GAPDH_TAA_len41_fa0_ta20_fm6_tm14*119*g,0,0,713,0,713,1.0,119,2828@TOP@human_GAPDH_TAA_len41_fa0_ta20_fm6_tm14,g
2828@TOP@human_GAPDH_TAA_len41_fa0_ta20_fm6_tm14*120*g,0,0,698,0,698,1.0,120,2828@TOP@human_GAPDH_TAA_len41_fa0_ta20_fm6_tm14,g
2828@TOP@human_GAPDH_TAA_len41_fa0_ta20_fm6_tm14*121*a,718,0,1,0,719,0.001,121,2828@TOP@human_GAPDH_TAA_len41_fa0_ta20_fm6_tm14,a
2828@TOP@human_GAPDH_TAA_len41_fa0_ta20_fm6_tm14*122*g,0,0,716,0,716,1.0,122,2828@TOP@human_GAPDH_TAA_len41_fa0_ta20_fm6_tm14,g
2828@TOP@human_GAPDH_TAA_len41_fa0_ta20_fm6_tm14*123*t,0,0,0,707,707,0.0,123,2828@TOP@human_GAPDH_TAA_len41_fa0_ta20_fm6_tm14,t
2828@TOP@human_GAPDH_TAA_len41_fa0_ta20_fm6_tm14*124*a,575,0,130,0,705,0.184,124,2828@TOP@human_GAPDH_TAA_len41_fa0_ta20_fm6_tm14,a
2828@TOP@human_GAPDH_TAA_len41_fa0_ta20_fm6_tm14*125*a,652,0,51,0,703,0.073,125,2828@TOP@human_GAPDH_TAA_len41_fa0_ta20_fm6_tm14,a
2828@TOP@human_GAPDH_TAA_len41_fa0_ta20_fm6_tm14*126*g,0,0,692,2,694,0.997,126,2828@TOP@human_GAPDH_TAA_len41_fa0_ta20_fm6_tm14,g
2828@TOP@human_GAPDH_TAA_len41_fa0_ta20_fm6_tm14*127*a,713,0,0,0,713,0.0,127,2828@TOP@human_GAPDH_TAA_len41_fa0_ta20_fm6_tm14,a
2828@TOP@human_GAPDH_TAA_len41_fa0_ta20_fm6_tm14*128*c,0,720,0,0,720,0.0,128,2828@TOP@human_GAPDH_TAA_len41_fa0_ta20_fm6_tm14,c
2828@TOP@human_GAPDH_TAA_len41_fa0_ta20_fm6_tm14*129*c,0,706,0,0,706,0.0,129,2828@TOP@human_GAPDH_TAA_len41_fa0_ta20_fm6_tm14,c
2828@TOP@human_GAPDH_TAA_len41_fa0_ta20_fm6_tm14*130*c,0,716,0,0,716,0.0,130,2828@TOP@human_GAPDH_TAA_len41_fa0_ta20_fm6_tm14,c
2828@TOP@human_GAPDH_TAA_len41_fa0_ta20_fm6_tm14*131*c,0,719,0,0,719,0.0,131,2828@TOP@human_GAPDH_TAA_len41_fa0_ta20_fm6_tm14,c
2828@TOP@human_GAPDH_TAA_len41_fa0_ta20_fm6_tm14*132*t,0,0,0,709,709,0.0,132,2828@TOP@human_GAPDH_TAA_len41_fa0_ta20_fm6_tm14,t
2828@TOP@human_GAPDH_TAA_len41_fa0_ta20_fm6_tm14*133*g,0,0,705,0,705,1.0,133,2828@TOP@human_GAPDH_TAA_len41_fa0_ta20_fm6_tm14,g
2828@TOP@human_GAPDH_TAA_len41_fa0_ta20_fm6_tm14*134*g,0,0,704,0,704,1.0,134,2828@TOP@human_GAPDH_TAA_len41_fa0_ta20_fm6_tm14,g
2829@TOP@human_GAPDH_TAA_len41_fa0_ta20_fm6_tm14*114*t,0,4,0,14477,14481,0.0,114,2829@TOP@human_GAPDH_TAA_len41_fa0_ta20_fm6_tm14,t
2829@TOP@human_GAPDH_TAA_len41_fa0_ta20_fm6_tm14*115*c,1,14565,0,0,14566,0.0,115,2829@TOP@human_GAPDH_TAA_len41_fa0_ta20_fm6_tm14,c
2829@TOP@human_GAPDH_TAA_len41_fa0_ta20_fm6_tm14*116*c,0,14498,0,0,14498,0.0,116,2829@TOP@human_GAPDH_TAA_len41_fa0_ta20_fm6_tm14,c
2829@TOP@human_GAPDH_TAA_len41_fa0_ta20_fm6_tm14*117*a,14488,0,15,0,14503,0.001,117,2829@TOP@human_GAPDH_TAA_len41_fa0_ta20_fm6_tm14,a
2829@TOP@human_GAPDH_TAA_len41_fa0_ta20_fm6_tm14*118*a,14236,1,178,0,14415,0.012,118,2829@TOP@human_GAPDH_TAA_len41_fa0_ta20_fm6_tm14,a
2829@TOP@human_GAPDH_TAA_len41_fa0_ta20_fm6_tm14*119*g,2,0,14397,0,14399,1.0,119,2829@TOP@human_GAPDH_TAA_len41_fa0_ta20_fm6_tm14,g
2829@TOP@human_GAPDH_TAA_len41_fa0_ta20_fm6_tm14*120*g,0,0,14338,0,14338,1.0,120,2829@TOP@human_GAPDH_TAA_len41_fa0_ta20_fm6_tm14,g
2829@TOP@human_GAPDH_TAA_len41_fa0_ta20_fm6_tm14*121*a,14458,0,16,0,14474,0.001,121,2829@TOP@human_GAPDH_TAA_len41_fa0_ta20_fm6_tm14,a
2829@TOP@human_GAPDH_TAA_len41_fa0_ta20_fm6_tm14*122*g,2,0,14512,0,14514,1.0,122,2829@TOP@human_GAPDH_TAA_len41_fa0_ta20_fm6_tm14,g
2829@TOP@human_GAPDH_TAA_len41_fa0_ta20_fm6_tm14*123*t,0,4,1,14331,14336,0.0,123,2829@TOP@human_GAPDH_TAA_len41_fa0_ta20_fm6_tm14,t
2829@TOP@human_GAPDH_TAA_len41_fa0_ta20_fm6_tm14*124*a,9764,0,4524,0,14288,0.317,124,2829@TOP@human_GAPDH_TAA_len41_fa0_ta20_fm6_tm14,a
2829@TOP@human_GAPDH_TAA_len41_fa0_ta20_fm6_tm14*125*a,11414,1,2883,0,14298,0.202,125,2829@TOP@human_GAPDH_TAA_len41_fa0_ta20_fm6_tm14,a
2829@TOP@human_GAPDH_TAA_len41_fa0_ta20_fm6_tm14*126*g,0,1,14305,3,14309,1.0,126,2829@TOP@human_GAPDH_TAA_len41_fa0_ta20_fm6_tm14,g
2829@TOP@human_GAPDH_TAA_len41_fa0_ta20_fm6_tm14*127*a,14458,1,15,0,14474,0.001,127,2829@TOP@human_GAPDH_TAA_len41_fa0_ta20_fm6_tm14,a
2829@TOP@human_GAPDH_TAA_len41_fa0_ta20_fm6_tm14*128*c,1,14517,0,0,14518,0.0,128,2829@TOP@human_GAPDH_TAA_len41_fa0_ta20_fm6_tm14,c
2829@TOP@human_GAPDH_TAA_len41_fa0_ta20_fm6_tm14*129*c,3,14449,0,1,14453,0.0,129,2829@TOP@human_GAPDH_TAA_len41_fa0_ta20_fm6_tm14,c
2829@TOP@human_GAPDH_TAA_len41_fa0_ta20_fm6_tm14*130*c,0,14513,0,0,14513,0.0,130,2829@TOP@human_GAPDH_TAA_len41_fa0_ta20_fm6_tm14,c
2829@TOP@human_GAPDH_TAA_len41_fa0_ta20_fm6_tm14*131*c,2,14556,0,0,14558,0.0,131,2829@TOP@human_GAPDH_TAA_len41_fa0_ta20_fm6_tm14,c
2829@TOP@human_GAPDH_TAA_len41_fa0_ta20_fm6_tm14*132*t,3,9,0,14330,14342,0.0,132,2829@TOP@human_GAPDH_TAA_len41_fa0_ta20_fm6_tm14,t
2829@TOP@human_GAPDH_TAA_len41_fa0_ta20_fm6_tm14*133*g,4,0,14317,3,14324,1.0,133,2829@TOP@human_GAPDH_TAA_len41_fa0_ta20_fm6_tm14,g
2829@TOP@human_GAPDH_TAA_len41_fa0_ta20_fm6_tm14*134*g,1,3,14389,0,14393,1.0,134,2829@TOP@human_GAPDH_TAA_len41_fa0_ta20_fm6_tm14,g
2830@TOP@human_GAPDH_TAA_len41_fa0_ta20_fm6_tm14*114*t,1,5,0,15636,15642,0.0,114,2830@TOP@human_GAPDH_TAA_len41_fa0_ta20_fm6_tm14,t
2830@TOP@human_GAPDH_TAA_len41_fa0_ta20_fm6_tm14*115*c,0,15742,0,0,15742,0.0,115,2830@TOP@human_GAPDH_TAA_len41_fa0_ta20_fm6_tm14,c
2830@TOP@human_GAPDH_TAA_len41_fa0_ta20_fm6_tm14*116*c,0,15661,0,0,15661,0.0,116,2830@TOP@human_GAPDH_TAA_len41_fa0_ta20_fm6_tm14,c
2830@TOP@human_GAPDH_TAA_len41_fa0_ta20_fm6_tm14*117*a,15606,1,21,0,15628,0.001,117,2830@TOP@human_GAPDH_TAA_len41_fa0_ta20_fm6_tm14,a
2830@TOP@human_GAPDH_TAA_len41_fa0_ta20_fm6_tm14*118*a,15352,0,159,1,15512,0.01,118,2830@TOP@human_GAPDH_TAA_len41_fa0_ta20_fm6_tm14,a
2830@TOP@human_GAPDH_TAA_len41_fa0_ta20_fm6_tm14*119*g,0,0,15522,1,15523,1.0,119,2830@TOP@human_GAPDH_TAA_len41_fa0_ta20_fm6_tm14,g
2830@TOP@human_GAPDH_TAA_len41_fa0_ta20_fm6_tm14*120*g,0,1,15429,2,15432,1.0,120,2830@TOP@human_GAPDH_TAA_len41_fa0_ta20_fm6_tm14,g
2830@TOP@human_GAPDH_TAA_len41_fa0_ta20_fm6_tm14*121*a,15591,0,3,0,15594,0.0,121,2830@TOP@human_GAPDH_TAA_len41_fa0_ta20_fm6_tm14,a
2830@TOP@human_GAPDH_TAA_len41_fa0_ta20_fm6_tm14*122*g,1,0,15657,0,15658,1.0,122,2830@TOP@human_GAPDH_TAA_len41_fa0_ta20_fm6_tm14,g
2830@TOP@human_GAPDH_TAA_len41_fa0_ta20_fm6_tm14*123*t,1,2,1,15438,15442,0.0,123,2830@TOP@human_GAPDH_TAA_len41_fa0_ta20_fm6_tm14,t
2830@TOP@human_GAPDH_TAA_len41_fa0_ta20_fm6_tm14*124*a,14398,1,898,0,15297,0.059,124,2830@TOP@human_GAPDH_TAA_len41_fa0_ta20_fm6_tm14,a
2830@TOP@human_GAPDH_TAA_len41_fa0_ta20_fm6_tm14*125*a,14624,0,635,0,15259,0.042,125,2830@TOP@human_GAPDH_TAA_len41_fa0_ta20_fm6_tm14,a
2830@TOP@human_GAPDH_TAA_len41_fa0_ta20_fm6_tm14*126*g,0,0,15439,0,15439,1.0,126,2830@TOP@human_GAPDH_TAA_len41_fa0_ta20_fm6_tm14,g
2830@TOP@human_GAPDH_TAA_len41_fa0_ta20_fm6_tm14*127*a,15544,0,14,1,15559,0.001,127,2830@TOP@human_GAPDH_TAA_len41_fa0_ta20_fm6_tm14,a
2830@TOP@human_GAPDH_TAA_len41_fa0_ta20_fm6_tm14*128*c,0,15679,2,1,15682,0.0,128,2830@TOP@human_GAPDH_TAA_len41_fa0_ta20_fm6_tm14,c
2830@TOP@human_GAPDH_TAA_len41_fa0_ta20_fm6_tm14*129*c,0,15565,0,1,15566,0.0,129,2830@TOP@human_GAPDH_TAA_len41_fa0_ta20_fm6_tm14,c
2830@TOP@human_GAPDH_TAA_len41_fa0_ta20_fm6_tm14*130*c,0,15673,1,1,15675,0.0,130,2830@TOP@human_GAPDH_TAA_len41_fa0_ta20_fm6_tm14,c
2830@TOP@human_GAPDH_TAA_len41_fa0_ta20_fm6_tm14*131*c,0,15708,0,1,15709,0.0,131,2830@TOP@human_GAPDH_TAA_len41_fa0_ta20_fm6_tm14,c
2830@TOP@human_GAPDH_TAA_len41_fa0_ta20_fm6_tm14*132*t,1,1,0,15445,15447,0.0,132,2830@TOP@human_GAPDH_TAA_len41_fa0_ta20_fm6_tm14,t
2830@TOP@human_GAPDH_TAA_len41_fa0_ta20_fm6_tm14*133*g,0,1,15411,0,15412,1.0,133,2830@TOP@human_GAPDH_TAA_len41_fa0_ta20_fm6_tm14,g
2830@TOP@human_GAPDH_TAA_len41_fa0_ta20_fm6_tm14*134*g,4,3,15514,2,15523,0.999,134,2830@TOP@human_GAPDH_TAA_len41_fa0_ta20_fm6_tm14,g
2831@TOP@human_GAPDH_TAA_len41_fa0_ta20_fm6_tm14*114*t,1,6,0,17379,17386,0.0,114,2831@TOP@human_GAPDH_TAA_len41_fa0_ta20_fm6_tm14,t
2831@TOP@human_GAPDH_TAA_len41_fa0_ta20_fm6_tm14*115*c,1,17468,0,0,17469,0.0,115,2831@TOP@human_GAPDH_TAA_len41_fa0_ta20_fm6_tm14,c
2831@TOP@human_GAPDH_TAA_len41_fa0_ta20_fm6_tm14*116*c,0,17389,0,1,17390,0.0,116,2831@TOP@human_GAPDH_TAA_len41_fa0_ta20_fm6_tm14,c
2831@TOP@human_GAPDH_TAA_len41_fa0_ta20_fm6_tm14*117*a,17362,0,22,1,17385,0.001,117,2831@TOP@human_GAPDH_TAA_len41_fa0_ta20_fm6_tm14,a
2831@TOP@human_GAPDH_TAA_len41_fa0_ta20_fm6_tm14*118*a,17076,0,220,2,17298,0.013,118,2831@TOP@human_GAPDH_TAA_len41_fa0_ta20_fm6_tm14,a
2831@TOP@human_GAPDH_TAA_len41_fa0_ta20_fm6_tm14*119*g,0,0,17266,0,17266,1.0,119,2831@TOP@human_GAPDH_TAA_len41_fa0_ta20_fm6_tm14,g
2831@TOP@human_GAPDH_TAA_len41_fa0_ta20_fm6_tm14*120*g,0,0,17199,0,17199,1.0,120,2831@TOP@human_GAPDH_TAA_len41_fa0_ta20_fm6_tm14,g
2831@TOP@human_GAPDH_TAA_len41_fa0_ta20_fm6_tm14*121*a,17369,1,15,0,17385,0.001,121,2831@TOP@human_GAPDH_TAA_len41_fa0_ta20_fm6_tm14,a
2831@TOP@human_GAPDH_TAA_len41_fa0_ta20_fm6_tm14*122*g,1,0,17409,1,17411,1.0,122,2831@TOP@human_GAPDH_TAA_len41_fa0_ta20_fm6_tm14,g
2831@TOP@human_GAPDH_TAA_len41_fa0_ta20_fm6_tm14*123*t,2,3,3,17188,17196,0.0,123,2831@TOP@human_GAPDH_TAA_len41_fa0_ta20_fm6_tm14,t
2831@TOP@human_GAPDH_TAA_len41_fa0_ta20_fm6_tm14*124*a,7852,0,9352,1,17205,0.544,124,2831@TOP@human_GAPDH_TAA_len41_fa0_ta20_fm6_tm14,a
2831@TOP@human_GAPDH_TAA_len41_fa0_ta20_fm6_tm14*125*a,12269,1,4929,1,17200,0.287,125,2831@TOP@human_GAPDH_TAA_len41_fa0_ta20_fm6_tm14,a
2831@TOP@human_GAPDH_TAA_len41_fa0_ta20_fm6_tm14*126*g,0,1,17256,2,17259,1.0,126,2831@TOP@human_GAPDH_TAA_len41_fa0_ta20_fm6_tm14,g
2831@TOP@human_GAPDH_TAA_len41_fa0_ta20_fm6_tm14*127*a,17342,1,33,0,17376,0.002,127,2831@TOP@human_GAPDH_TAA_len41_fa0_ta20_fm6_tm14,a
2831@TOP@human_GAPDH_TAA_len41_fa0_ta20_fm6_tm14*128*c,2,17403,0,1,17406,0.0,128,2831@TOP@human_GAPDH_TAA_len41_fa0_ta20_fm6_tm14,c
2831@TOP@human_GAPDH_TAA_len41_fa0_ta20_fm6_tm14*129*c,1,17347,0,2,17350,0.0,129,2831@TOP@human_GAPDH_TAA_len41_fa0_ta20_fm6_tm14,c
2831@TOP@human_GAPDH_TAA_len41_fa0_ta20_fm6_tm14*130*c,2,17389,0,1,17392,0.0,130,2831@TOP@human_GAPDH_TAA_len41_fa0_ta20_fm6_tm14,c
2831@TOP@human_GAPDH_TAA_len41_fa0_ta20_fm6_tm14*131*c,1,17441,0,0,17442,0.0,131,2831@TOP@human_GAPDH_TAA_len41_fa0_ta20_fm6_tm14,c
2831@TOP@human_GAPDH_TAA_len41_fa0_ta20_fm6_tm14*132*t,3,4,1,17221,17229,0.0,132,2831@TOP@human_GAPDH_TAA_len41_fa0_ta20_fm6_tm14,t
2831@TOP@human_GAPDH_TAA_len41_fa0_ta20_fm6_tm14*133*g,2,0,17188,0,17190,1.0,133,2831@TOP@human_GAPDH_TAA_len41_fa0_ta20_fm6_tm14,g
2831@TOP@human_GAPDH_TAA_len41_fa0_ta20_fm6_tm14*134*g,0,0,17282,0,17282,1.0,134,2831@TOP@human_GAPDH_TAA_len41_fa0_ta20_fm6_tm14,g
2832@TOP@human_GAPDH_TAA_len41_fa0_ta20_fm6_tm14*114*t,1,9,0,13376,13386,0.0,114,2832@TOP@human_GAPDH_TAA_len41_fa0_ta20_fm6_tm14,t
2832@TOP@human_GAPDH_TAA_len41_fa0_ta20_fm6_tm14*115*c,0,13465,0,0,13465,0.0,115,2832@TOP@human_GAPDH_TAA_len41_fa0_ta20_fm6_tm14,c
2832@TOP@human_GAPDH_TAA_len41_fa0_ta20_fm6_tm14*116*c,0,13386,0,4,13390,0.0,116,2832@TOP@human_GAPDH_TAA_len41_fa0_ta20_fm6_tm14,c
2832@TOP@human_GAPDH_TAA_len41_fa0_ta20_fm6_tm14*117*a,13360,1,21,0,13382,0.002,117,2832@TOP@human_GAPDH_TAA_len41_fa0_ta20_fm6_tm14,a
2832@TOP@human_GAPDH_TAA_len41_fa0_ta20_fm6_tm14*118*a,13149,0,179,0,13328,0.013,118,2832@TOP@human_GAPDH_TAA_len41_fa0_ta20_fm6_tm14,a
2832@TOP@human_GAPDH_TAA_len41_fa0_ta20_fm6_tm14*119*g,1,0,13316,1,13318,1.0,119,2832@TOP@human_GAPDH_TAA_len41_fa0_ta20_fm6_tm14,g
2832@TOP@human_GAPDH_TAA_len41_fa0_ta20_fm6_tm14*120*g,3,0,13241,0,13244,1.0,120,2832@TOP@human_GAPDH_TAA_len41_fa0_ta20_fm6_tm14,g
2832@TOP@human_GAPDH_TAA_len41_fa0_ta20_fm6_tm14*121*a,13388,0,8,0,13396,0.001,121,2832@TOP@human_GAPDH_TAA_len41_fa0_ta20_fm6_tm14,a
2832@TOP@human_GAPDH_TAA_len41_fa0_ta20_fm6_tm14*122*g,0,0,13418,0,13418,1.0,122,2832@TOP@human_GAPDH_TAA_len41_fa0_ta20_fm6_tm14,g
2832@TOP@human_GAPDH_TAA_len41_fa0_ta20_fm6_tm14*123*t,1,1,2,13253,13257,0.0,123,2832@TOP@human_GAPDH_TAA_len41_fa0_ta20_fm6_tm14,t
2832@TOP@human_GAPDH_TAA_len41_fa0_ta20_fm6_tm14*124*a,6098,0,7169,0,13267,0.54,124,2832@TOP@human_GAPDH_TAA_len41_fa0_ta20_fm6_tm14,a
2832@TOP@human_GAPDH_TAA_len41_fa0_ta20_fm6_tm14*125*a,8840,0,4405,1,13246,0.333,125,2832@TOP@human_GAPDH_TAA_len41_fa0_ta20_fm6_tm14,a
2832@TOP@human_GAPDH_TAA_len41_fa0_ta20_fm6_tm14*126*g,1,0,13303,0,13304,1.0,126,2832@TOP@human_GAPDH_TAA_len41_fa0_ta20_fm6_tm14,g
2832@TOP@human_GAPDH_TAA_len41_fa0_ta20_fm6_tm14*127*a,13311,4,51,1,13367,0.004,127,2832@TOP@human_GAPDH_TAA_len41_fa0_ta20_fm6_tm14,a
2832@TOP@human_GAPDH_TAA_len41_fa0_ta20_fm6_tm14*128*c,0,13420,1,0,13421,0.0,128,2832@TOP@human_GAPDH_TAA_len41_fa0_ta20_fm6_tm14,c
2832@TOP@human_GAPDH_TAA_len41_fa0_ta20_fm6_tm14*129*c,0,13384,0,0,13384,0.0,129,2832@TOP@human_GAPDH_TAA_len41_fa0_ta20_fm6_tm14,c
2832@TOP@human_GAPDH_TAA_len41_fa0_ta20_fm6_tm14*130*c,0,13414,0,4,13418,0.0,130,2832@TOP@human_GAPDH_TAA_len41_fa0_ta20_fm6_tm14,c
2832@TOP@human_GAPDH_TAA_len41_fa0_ta20_fm6_tm14*131*c,0,13442,0,1,13443,0.0,131,2832@TOP@human_GAPDH_TAA_len41_fa0_ta20_fm6_tm14,c
2832@TOP@human_GAPDH_TAA_len41_fa0_ta20_fm6_tm14*132*t,3,2,0,13275,13280,0.0,132,2832@TOP@human_GAPDH_TAA_len41_fa0_ta20_fm6_tm14,t
2832@TOP@human_GAPDH_TAA_len41_fa0_ta20_fm6_tm14*133*g,3,0,13261,0,13264,1.0,133,2832@TOP@human_GAPDH_TAA_len41_fa0_ta20_fm6_tm14,g
2832@TOP@human_GAPDH_TAA_len41_fa0_ta20_fm6_tm14*134*g,0,0,13332,0,13332,1.0,134,2832@TOP@human_GAPDH_TAA_len41_fa0_ta20_fm6_tm14,g
2833@TOP@human_GAPDH_TAA_len41_fa0_ta20_fm6_tm14*114*t,0,2,0,1057,1059,0.0,114,2833@TOP@human_GAPDH_TAA_len41_fa0_ta20_fm6_tm14,t
2833@TOP@human_GAPDH_TAA_len41_fa0_ta20_fm6_tm14*115*c,0,1065,0,0,1065,0.0,115,2833@TOP@human_GAPDH_TAA_len41_fa0_ta20_fm6_tm14,c
2833@TOP@human_GAPDH_TAA_len41_fa0_ta20_fm6_tm14*116*c,0,1062,0,0,1062,0.0,116,2833@TOP@human_GAPDH_TAA_len41_fa0_ta20_fm6_tm14,c
2833@TOP@human_GAPDH_TAA_len41_fa0_ta20_fm6_tm14*117*a,1060,0,2,0,1062,0.002,117,2833@TOP@human_GAPDH_TAA_len41_fa0_ta20_fm6_tm14,a
2833@TOP@human_GAPDH_TAA_len41_fa0_ta20_fm6_tm14*118*a,1024,0,24,0,1048,0.023,118,2833@TOP@human_GAPDH_TAA_len41_fa0_ta20_fm6_tm14,a
2833@TOP@human_GAPDH_TAA_len41_fa0_ta20_fm6_tm14*119*g,0,0,1059,0,1059,1.0,119,2833@TOP@human_GAPDH_TAA_len41_fa0_ta20_fm6_tm14,g
2833@TOP@human_GAPDH_TAA_len41_fa0_ta20_fm6_tm14*120*g,0,0,1041,0,1041,1.0,120,2833@TOP@human_GAPDH_TAA_len41_fa0_ta20_fm6_tm14,g
2833@TOP@human_GAPDH_TAA_len41_fa0_ta20_fm6_tm14*121*a,1061,0,0,0,1061,0.0,121,2833@TOP@human_GAPDH_TAA_len41_fa0_ta20_fm6_tm14,a
2833@TOP@human_GAPDH_TAA_len41_fa0_ta20_fm6_tm14*122*g,0,0,1058,0,1058,1.0,122,2833@TOP@human_GAPDH_TAA_len41_fa0_ta20_fm6_tm14,g
2833@TOP@human_GAPDH_TAA_len41_fa0_ta20_fm6_tm14*123*t,0,0,1,1039,1040,0.001,123,2833@TOP@human_GAPDH_TAA_len41_fa0_ta20_fm6_tm14,t
2833@TOP@human_GAPDH_TAA_len41_fa0_ta20_fm6_tm14*124*a,861,0,182,0,1043,0.174,124,2833@TOP@human_GAPDH_TAA_len41_fa0_ta20_fm6_tm14,a
2833@TOP@human_GAPDH_TAA_len41_fa0_ta20_fm6_tm14*125*a,966,0,77,0,1043,0.074,125,2833@TOP@human_GAPDH_TAA_len41_fa0_ta20_fm6_tm14,a
2833@TOP@human_GAPDH_TAA_len41_fa0_ta20_fm6_tm14*126*g,0,0,1047,0,1047,1.0,126,2833@TOP@human_GAPDH_TAA_len41_fa0_ta20_fm6_tm14,g
2833@TOP@human_GAPDH_TAA_len41_fa0_ta20_fm6_tm14*127*a,1057,0,3,0,1060,0.003,127,2833@TOP@human_GAPDH_TAA_len41_fa0_ta20_fm6_tm14,a
2833@TOP@human_GAPDH_TAA_len41_fa0_ta20_fm6_tm14*128*c,0,1059,0,0,1059,0.0,128,2833@TOP@human_GAPDH_TAA_len41_fa0_ta20_fm6_tm14,c
2833@TOP@human_GAPDH_TAA_len41_fa0_ta20_fm6_tm14*129*c,0,1054,0,0,1054,0.0,129,2833@TOP@human_GAPDH_TAA_len41_fa0_ta20_fm6_tm14,c
2833@TOP@human_GAPDH_TAA_len41_fa0_ta20_fm6_tm14*130*c,0,1058,0,0,1058,0.0,130,2833@TOP@human_GAPDH_TAA_len41_fa0_ta20_fm6_tm14,c
2833@TOP@human_GAPDH_TAA_len41_fa0_ta20_fm6_tm14*131*c,0,1062,0,0,1062,0.0,131,2833@TOP@human_GAPDH_TAA_len41_fa0_ta20_fm6_tm14,c
2833@TOP@human_GAPDH_TAA_len41_fa0_ta20_fm6_tm14*132*t,0,0,0,1046,1046,0.0,132,2833@TOP@human_GAPDH_TAA_len41_fa0_ta20_fm6_tm14,t
2833@TOP@human_GAPDH_TAA_len41_fa0_ta20_fm6_tm14*133*g,2,0,1037,0,1039,0.998,133,2833@TOP@human_GAPDH_TAA_len41_fa0_ta20_fm6_tm14,g
2833@TOP@human_GAPDH_TAA_len41_fa0_ta20_fm6_tm14*134*g,0,0,1051,0,1051,1.0,134,2833@TOP@human_GAPDH_TAA_len41_fa0_ta20_fm6_tm14,g
2834@TOP@human_GAPDH_TAA_len41_fa0_ta20_fm6_tm14*114*t,0,5,0,13863,13868,0.0,114,2834@TOP@human_GAPDH_TAA_len41_fa0_ta20_fm6_tm14,t
2834@TOP@human_GAPDH_TAA_len41_fa0_ta20_fm6_tm14*115*c,2,13950,0,0,13952,0.0,115,2834@TOP@human_GAPDH_TAA_len41_fa0_ta20_fm6_tm14,c
2834@TOP@human_GAPDH_TAA_len41_fa0_ta20_fm6_tm14*116*c,1,13901,0,1,13903,0.0,116,2834@TOP@human_GAPDH_TAA_len41_fa0_ta20_fm6_tm14,c
2834@TOP@human_GAPDH_TAA_len41_fa0_ta20_fm6_tm14*117*a,13871,0,22,0,13893,0.002,117,2834@TOP@human_GAPDH_TAA_len41_fa0_ta20_fm6_tm14,a
2834@TOP@human_GAPDH_TAA_len41_fa0_ta20_fm6_tm14*118*a,13609,1,174,1,13785,0.013,118,2834@TOP@human_GAPDH_TAA_len41_fa0_ta20_fm6_tm14,a
2834@TOP@human_GAPDH_TAA_len41_fa0_ta20_fm6_tm14*119*g,1,1,13782,0,13784,1.0,119,2834@TOP@human_GAPDH_TAA_len41_fa0_ta20_fm6_tm14,g
2834@TOP@human_GAPDH_TAA_len41_fa0_ta20_fm6_tm14*120*g,0,0,13717,1,13718,1.0,120,2834@TOP@human_GAPDH_TAA_len41_fa0_ta20_fm6_tm14,g
2834@TOP@human_GAPDH_TAA_len41_fa0_ta20_fm6_tm14*121*a,13878,1,6,0,13885,0.0,121,2834@TOP@human_GAPDH_TAA_len41_fa0_ta20_fm6_tm14,a
2834@TOP@human_GAPDH_TAA_len41_fa0_ta20_fm6_tm14*122*g,0,0,13888,1,13889,1.0,122,2834@TOP@human_GAPDH_TAA_len41_fa0_ta20_fm6_tm14,g
2834@TOP@human_GAPDH_TAA_len41_fa0_ta20_fm6_tm14*123*t,6,2,4,13676,13688,0.0,123,2834@TOP@human_GAPDH_TAA_len41_fa0_ta20_fm6_tm14,t
2834@TOP@human_GAPDH_TAA_len41_fa0_ta20_fm6_tm14*124*a,13178,1,447,0,13626,0.033,124,2834@TOP@human_GAPDH_TAA_len41_fa0_ta20_fm6_tm14,a
2834@TOP@human_GAPDH_TAA_len41_fa0_ta20_fm6_tm14*125*a,13319,0,286,3,13608,0.021,125,2834@TOP@human_GAPDH_TAA_len41_fa0_ta20_fm6_tm14,a
2834@TOP@human_GAPDH_TAA_len41_fa0_ta20_fm6_tm14*126*g,0,0,13735,0,13735,1.0,126,2834@TOP@human_GAPDH_TAA_len41_fa0_ta20_fm6_tm14,g
2834@TOP@human_GAPDH_TAA_len41_fa0_ta20_fm6_tm14*127*a,13790,0,26,0,13816,0.002,127,2834@TOP@human_GAPDH_TAA_len41_fa0_ta20_fm6_tm14,a
2834@TOP@human_GAPDH_TAA_len41_fa0_ta20_fm6_tm14*128*c,0,13915,0,1,13916,0.0,128,2834@TOP@human_GAPDH_TAA_len41_fa0_ta20_fm6_tm14,c
2834@TOP@human_GAPDH_TAA_len41_fa0_ta20_fm6_tm14*129*c,0,13803,0,1,13804,0.0,129,2834@TOP@human_GAPDH_TAA_len41_fa0_ta20_fm6_tm14,c
2834@TOP@human_GAPDH_TAA_len41_fa0_ta20_fm6_tm14*130*c,1,13884,0,0,13885,0.0,130,2834@TOP@human_GAPDH_TAA_len41_fa0_ta20_fm6_tm14,c
2834@TOP@human_GAPDH_TAA_len41_fa0_ta20_fm6_tm14*131*c,1,13923,0,6,13930,0.0,131,2834@TOP@human_GAPDH_TAA_len41_fa0_ta20_fm6_tm14,c
2834@TOP@human_GAPDH_TAA_len41_fa0_ta20_fm6_tm14*132*t,5,4,3,13714,13726,0.0,132,2834@TOP@human_GAPDH_TAA_len41_fa0_ta20_fm6_tm14,t
2834@TOP@human_GAPDH_TAA_len41_fa0_ta20_fm6_tm14*133*g,0,0,13719,0,13719,1.0,133,2834@TOP@human_GAPDH_TAA_len41_fa0_ta20_fm6_tm14,g
2834@TOP@human_GAPDH_TAA_len41_fa0_ta20_fm6_tm14*134*g,1,1,13788,2,13792,1.0,134,2834@TOP@human_GAPDH_TAA_len41_fa0_ta20_fm6_tm14,g
2835@TOP@human_GAPDH_TAA_len41_fa0_ta20_fm6_tm14*114*t,4,2,0,11618,11624,0.0,114,2835@TOP@human_GAPDH_TAA_len41_fa0_ta20_fm6_tm14,t
2835@TOP@human_GAPDH_TAA_len41_fa0_ta20_fm6_tm14*115*c,0,11690,0,3,11693,0.0,115,2835@TOP@human_GAPDH_TAA_len41_fa0_ta20_fm6_tm14,c
2835@TOP@human_GAPDH_TAA_len41_fa0_ta20_fm6_tm14*116*c,0,11654,0,0,11654,0.0,116,2835@TOP@human_GAPDH_TAA_len41_fa0_ta20_fm6_tm14,c
2835@TOP@human_GAPDH_TAA_len41_fa0_ta20_fm6_tm14*117*a,11648,1,7,0,11656,0.001,117,2835@TOP@human_GAPDH_TAA_len41_fa0_ta20_fm6_tm14,a
2835@TOP@human_GAPDH_TAA_len41_fa0_ta20_fm6_tm14*118*a,11429,0,136,0,11565,0.012,118,2835@TOP@human_GAPDH_TAA_len41_fa0_ta20_fm6_tm14,a
2835@TOP@human_GAPDH_TAA_len41_fa0_ta20_fm6_tm14*119*g,2,0,11561,0,11563,1.0,119,2835@TOP@human_GAPDH_TAA_len41_fa0_ta20_fm6_tm14,g
2835@TOP@human_GAPDH_TAA_len41_fa0_ta20_fm6_tm14*120*g,0,0,11508,0,11508,1.0,120,2835@TOP@human_GAPDH_TAA_len41_fa0_ta20_fm6_tm14,g
2835@TOP@human_GAPDH_TAA_len41_fa0_ta20_fm6_tm14*121*a,11625,0,2,0,11627,0.0,121,2835@TOP@human_GAPDH_TAA_len41_fa0_ta20_fm6_tm14,a
2835@TOP@human_GAPDH_TAA_len41_fa0_ta20_fm6_tm14*122*g,3,0,11638,0,11641,1.0,122,2835@TOP@human_GAPDH_TAA_len41_fa0_ta20_fm6_tm14,g
2835@TOP@human_GAPDH_TAA_len41_fa0_ta20_fm6_tm14*123*t,1,2,0,11492,11495,0.0,123,2835@TOP@human_GAPDH_TAA_len41_fa0_ta20_fm6_tm14,t
2835@TOP@human_GAPDH_TAA_len41_fa0_ta20_fm6_tm14*124*a,11108,1,299,0,11408,0.026,124,2835@TOP@human_GAPDH_TAA_len41_fa0_ta20_fm6_tm14,a
2835@TOP@human_GAPDH_TAA_len41_fa0_ta20_fm6_tm14*125*a,9118,1,2339,1,11459,0.204,125,2835@TOP@human_GAPDH_TAA_len41_fa0_ta20_fm6_tm14,a
2835@TOP@human_GAPDH_TAA_len41_fa0_ta20_fm6_tm14*126*g,1,0,11502,0,11503,1.0,126,2835@TOP@human_GAPDH_TAA_len41_fa0_ta20_fm6_tm14,g
2835@TOP@human_GAPDH_TAA_len41_fa0_ta20_fm6_tm14*127*a,11542,0,73,0,11615,0.006,127,2835@TOP@human_GAPDH_TAA_len41_fa0_ta20_fm6_tm14,a
2835@TOP@human_GAPDH_TAA_len41_fa0_ta20_fm6_tm14*128*c,0,11662,1,0,11663,0.0,128,2835@TOP@human_GAPDH_TAA_len41_fa0_ta20_fm6_tm14,c
2835@TOP@human_GAPDH_TAA_len41_fa0_ta20_fm6_tm14*129*c,1,11588,0,1,11590,0.0,129,2835@TOP@human_GAPDH_TAA_len41_fa0_ta20_fm6_tm14,c
2835@TOP@human_GAPDH_TAA_len41_fa0_ta20_fm6_tm14*130*c,2,11644,0,0,11646,0.0,130,2835@TOP@human_GAPDH_TAA_len41_fa0_ta20_fm6_tm14,c
2835@TOP@human_GAPDH_TAA_len41_fa0_ta20_fm6_tm14*131*c,0,11683,0,0,11683,0.0,131,2835@TOP@human_GAPDH_TAA_len41_fa0_ta20_fm6_tm14,c
2835@TOP@human_GAPDH_TAA_len41_fa0_ta20_fm6_tm14*132*t,0,4,0,11506,11510,0.0,132,2835@TOP@human_GAPDH_TAA_len41_fa0_ta20_fm6_tm14,t
2835@TOP@human_GAPDH_TAA_len41_fa0_ta20_fm6_tm14*133*g,0,0,11512,2,11514,1.0,133,2835@TOP@human_GAPDH_TAA_len41_fa0_ta20_fm6_tm14,g
2835@TOP@human_GAPDH_TAA_len41_fa0_ta20_fm6_tm14*134*g,1,0,11560,0,11561,1.0,134,2835@TOP@human_GAPDH_TAA_len41_fa0_ta20_fm6_tm14,g
2836@TOP@human_GAPDH_TAA_len41_fa0_ta20_fm6_tm14*114*t,2,6,0,24477,24485,0.0,114,2836@TOP@human_GAPDH_TAA_len41_fa0_ta20_fm6_tm14,t
2836@TOP@human_GAPDH_TAA_len41_fa0_ta20_fm6_tm14*115*c,1,24622,0,1,24624,0.0,115,2836@TOP@human_GAPDH_TAA_len41_fa0_ta20_fm6_tm14,c
2836@TOP@human_GAPDH_TAA_len41_fa0_ta20_fm6_tm14*116*c,2,24525,1,0,24528,0.0,116,2836@TOP@human_GAPDH_TAA_len41_fa0_ta20_fm6_tm14,c
2836@TOP@human_GAPDH_TAA_len41_fa0_ta20_fm6_tm14*117*a,24513,0,31,0,24544,0.001,117,2836@TOP@human_GAPDH_TAA_len41_fa0_ta20_fm6_tm14,a
2836@TOP@human_GAPDH_TAA_len41_fa0_ta20_fm6_tm14*118*a,24093,0,287,1,24381,0.012,118,2836@TOP@human_GAPDH_TAA_len41_fa0_ta20_fm6_tm14,a
2836@TOP@human_GAPDH_TAA_len41_fa0_ta20_fm6_tm14*119*g,1,0,24326,0,24327,1.0,119,2836@TOP@human_GAPDH_TAA_len41_fa0_ta20_fm6_tm14,g
2836@TOP@human_GAPDH_TAA_len41_fa0_ta20_fm6_tm14*120*g,3,1,24231,0,24235,1.0,120,2836@TOP@human_GAPDH_TAA_len41_fa0_ta20_fm6_tm14,g
2836@TOP@human_GAPDH_TAA_len41_fa0_ta20_fm6_tm14*121*a,24517,0,4,0,24521,0.0,121,2836@TOP@human_GAPDH_TAA_len41_fa0_ta20_fm6_tm14,a
2836@TOP@human_GAPDH_TAA_len41_fa0_ta20_fm6_tm14*122*g,0,0,24533,1,24534,1.0,122,2836@TOP@human_GAPDH_TAA_len41_fa0_ta20_fm6_tm14,g
2836@TOP@human_GAPDH_TAA_len41_fa0_ta20_fm6_tm14*123*t,4,1,5,24207,24217,0.0,123,2836@TOP@human_GAPDH_TAA_len41_fa0_ta20_fm6_tm14,t
2836@TOP@human_GAPDH_TAA_len41_fa0_ta20_fm6_tm14*124*a,23399,0,702,1,24102,0.029,124,2836@TOP@human_GAPDH_TAA_len41_fa0_ta20_fm6_tm14,a
2836@TOP@human_GAPDH_TAA_len41_fa0_ta20_fm6_tm14*125*a,23616,1,497,0,24114,0.021,125,2836@TOP@human_GAPDH_TAA_len41_fa0_ta20_fm6_tm14,a
2836@TOP@human_GAPDH_TAA_len41_fa0_ta20_fm6_tm14*126*g,0,0,24227,2,24229,1.0,126,2836@TOP@human_GAPDH_TAA_len41_fa0_ta20_fm6_tm14,g
2836@TOP@human_GAPDH_TAA_len41_fa0_ta20_fm6_tm14*127*a,24409,3,22,3,24437,0.001,127,2836@TOP@human_GAPDH_TAA_len41_fa0_ta20_fm6_tm14,a
2836@TOP@human_GAPDH_TAA_len41_fa0_ta20_fm6_tm14*128*c,0,24568,1,2,24571,0.0,128,2836@TOP@human_GAPDH_TAA_len41_fa0_ta20_fm6_tm14,c
2836@TOP@human_GAPDH_TAA_len41_fa0_ta20_fm6_tm14*129*c,0,24380,0,1,24381,0.0,129,2836@TOP@human_GAPDH_TAA_len41_fa0_ta20_fm6_tm14,c
2836@TOP@human_GAPDH_TAA_len41_fa0_ta20_fm6_tm14*130*c,0,24528,0,3,24531,0.0,130,2836@TOP@human_GAPDH_TAA_len41_fa0_ta20_fm6_tm14,c
2836@TOP@human_GAPDH_TAA_len41_fa0_ta20_fm6_tm14*131*c,2,24586,0,2,24590,0.0,131,2836@TOP@human_GAPDH_TAA_len41_fa0_ta20_fm6_tm14,c
2836@TOP@human_GAPDH_TAA_len41_fa0_ta20_fm6_tm14*132*t,2,2,0,24236,24240,0.0,132,2836@TOP@human_GAPDH_TAA_len41_fa0_ta20_fm6_tm14,t
2836@TOP@human_GAPDH_TAA_len41_fa0_ta20_fm6_tm14*133*g,6,0,24203,0,24209,1.0,133,2836@TOP@human_GAPDH_TAA_len41_fa0_ta20_fm6_tm14,g
2836@TOP@human_GAPDH_TAA_len41_fa0_ta20_fm6_tm14*134*g,1,5,24329,1,24336,1.0,134,2836@TOP@human_GAPDH_TAA_len41_fa0_ta20_fm6_tm14,g
2837@TOP@human_GAPDH_TAA_len41_fa0_ta20_fm6_tm14*114*t,0,0,0,5025,5025,0.0,114,2837@TOP@human_GAPDH_TAA_len41_fa0_ta20_fm6_tm14,t
2837@TOP@human_GAPDH_TAA_len41_fa0_ta20_fm6_tm14*115*c,1,5056,0,0,5057,0.0,115,2837@TOP@human_GAPDH_TAA_len41_fa0_ta20_fm6_tm14,c
2837@TOP@human_GAPDH_TAA_len41_fa0_ta20_fm6_tm14*116*c,0,5034,0,0,5034,0.0,116,2837@TOP@human_GAPDH_TAA_len41_fa0_ta20_fm6_tm14,c
2837@TOP@human_GAPDH_TAA_len41_fa0_ta20_fm6_tm14*117*a,5033,0,3,1,5037,0.001,117,2837@TOP@human_GAPDH_TAA_len41_fa0_ta20_fm6_tm14,a
2837@TOP@human_GAPDH_TAA_len41_fa0_ta20_fm6_tm14*118*a,4859,2,144,1,5006,0.029,118,2837@TOP@human_GAPDH_TAA_len41_fa0_ta20_fm6_tm14,a
2837@TOP@human_GAPDH_TAA_len41_fa0_ta20_fm6_tm14*119*g,0,0,4992,1,4993,1.0,119,2837@TOP@human_GAPDH_TAA_len41_fa0_ta20_fm6_tm14,g
2837@TOP@human_GAPDH_TAA_len41_fa0_ta20_fm6_tm14*120*g,1,0,4964,1,4966,1.0,120,2837@TOP@human_GAPDH_TAA_len41_fa0_ta20_fm6_tm14,g
2837@TOP@human_GAPDH_TAA_len41_fa0_ta20_fm6_tm14*121*a,5027,0,0,0,5027,0.0,121,2837@TOP@human_GAPDH_TAA_len41_fa0_ta20_fm6_tm14,a
2837@TOP@human_GAPDH_TAA_len41_fa0_ta20_fm6_tm14*122*g,0,0,5026,0,5026,1.0,122,2837@TOP@human_GAPDH_TAA_len41_fa0_ta20_fm6_tm14,g
2837@TOP@human_GAPDH_TAA_len41_fa0_ta20_fm6_tm14*123*t,0,0,1,4966,4967,0.0,123,2837@TOP@human_GAPDH_TAA_len41_fa0_ta20_fm6_tm14,t
2837@TOP@human_GAPDH_TAA_len41_fa0_ta20_fm6_tm14*124*a,3390,0,1578,0,4968,0.318,124,2837@TOP@human_GAPDH_TAA_len41_fa0_ta20_fm6_tm14,a
2837@TOP@human_GAPDH_TAA_len41_fa0_ta20_fm6_tm14*125*a,4223,1,725,0,4949,0.146,125,2837@TOP@human_GAPDH_TAA_len41_fa0_ta20_fm6_tm14,a
2837@TOP@human_GAPDH_TAA_len41_fa0_ta20_fm6_tm14*126*g,0,0,4983,0,4983,1.0,126,2837@TOP@human_GAPDH_TAA_len41_fa0_ta20_fm6_tm14,g
2837@TOP@human_GAPDH_TAA_len41_fa0_ta20_fm6_tm14*127*a,4999,1,8,0,5008,0.002,127,2837@TOP@human_GAPDH_TAA_len41_fa0_ta20_fm6_tm14,a
2837@TOP@human_GAPDH_TAA_len41_fa0_ta20_fm6_tm14*128*c,0,5044,0,0,5044,0.0,128,2837@TOP@human_GAPDH_TAA_len41_fa0_ta20_fm6_tm14,c
2837@TOP@human_GAPDH_TAA_len41_fa0_ta20_fm6_tm14*129*c,0,5002,0,2,5004,0.0,129,2837@TOP@human_GAPDH_TAA_len41_fa0_ta20_fm6_tm14,c
2837@TOP@human_GAPDH_TAA_len41_fa0_ta20_fm6_tm14*130*c,0,5032,0,0,5032,0.0,130,2837@TOP@human_GAPDH_TAA_len41_fa0_ta20_fm6_tm14,c
2837@TOP@human_GAPDH_TAA_len41_fa0_ta20_fm6_tm14*131*c,0,5050,0,4,5054,0.0,131,2837@TOP@human_GAPDH_TAA_len41_fa0_ta20_fm6_tm14,c
2837@TOP@human_GAPDH_TAA_len41_fa0_ta20_fm6_tm14*132*t,1,0,2,4961,4964,0.0,132,2837@TOP@human_GAPDH_TAA_len41_fa0_ta20_fm6_tm14,t
2837@TOP@human_GAPDH_TAA_len41_fa0_ta20_fm6_tm14*133*g,0,0,4946,0,4946,1.0,133,2837@TOP@human_GAPDH_TAA_len41_fa0_ta20_fm6_tm14,g
2837@TOP@human_GAPDH_TAA_len41_fa0_ta20_fm6_tm14*134*g,0,0,4984,0,4984,1.0,134,2837@TOP@human_GAPDH_TAA_len41_fa0_ta20_fm6_tm14,g
2838@TOP@human_GAPDH_TAA_len41_fa0_ta20_fm6_tm14*114*t,0,0,0,896,896,0.0,114,2838@TOP@human_GAPDH_TAA_len41_fa0_ta20_fm6_tm14,t
2838@TOP@human_GAPDH_TAA_len41_fa0_ta20_fm6_tm14*115*c,0,903,0,0,903,0.0,115,2838@TOP@human_GAPDH_TAA_len41_fa0_ta20_fm6_tm14,c
2838@TOP@human_GAPDH_TAA_len41_fa0_ta20_fm6_tm14*116*c,0,902,0,0,902,0.0,116,2838@TOP@human_GAPDH_TAA_len41_fa0_ta20_fm6_tm14,c
2838@TOP@human_GAPDH_TAA_len41_fa0_ta20_fm6_tm14*117*a,891,0,4,0,895,0.004,117,2838@TOP@human_GAPDH_TAA_len41_fa0_ta20_fm6_tm14,a
2838@TOP@human_GAPDH_TAA_len41_fa0_ta20_fm6_tm14*118*a,875,0,20,0,895,0.022,118,2838@TOP@human_GAPDH_TAA_len41_fa0_ta20_fm6_tm14,a
2838@TOP@human_GAPDH_TAA_len41_fa0_ta20_fm6_tm14*119*g,0,0,883,0,883,1.0,119,2838@TOP@human_GAPDH_TAA_len41_fa0_ta20_fm6_tm14,g
2838@TOP@human_GAPDH_TAA_len41_fa0_ta20_fm6_tm14*120*g,0,0,886,0,886,1.0,120,2838@TOP@human_GAPDH_TAA_len41_fa0_ta20_fm6_tm14,g
2838@TOP@human_GAPDH_TAA_len41_fa0_ta20_fm6_tm14*121*a,895,0,4,0,899,0.004,121,2838@TOP@human_GAPDH_TAA_len41_fa0_ta20_fm6_tm14,a
2838@TOP@human_GAPDH_TAA_len41_fa0_ta20_fm6_tm14*122*g,0,0,899,0,899,1.0,122,2838@TOP@human_GAPDH_TAA_len41_fa0_ta20_fm6_tm14,g
2838@TOP@human_GAPDH_TAA_len41_fa0_ta20_fm6_tm14*123*t,0,0,0,884,884,0.0,123,2838@TOP@human_GAPDH_TAA_len41_fa0_ta20_fm6_tm14,t
2838@TOP@human_GAPDH_TAA_len41_fa0_ta20_fm6_tm14*124*a,781,0,104,0,885,0.118,124,2838@TOP@human_GAPDH_TAA_len41_fa0_ta20_fm6_tm14,a
2838@TOP@human_GAPDH_TAA_len41_fa0_ta20_fm6_tm14*125*a,691,0,194,0,885,0.219,125,2838@TOP@human_GAPDH_TAA_len41_fa0_ta20_fm6_tm14,a
2838@TOP@human_GAPDH_TAA_len41_fa0_ta20_fm6_tm14*126*g,0,0,882,0,882,1.0,126,2838@TOP@human_GAPDH_TAA_len41_fa0_ta20_fm6_tm14,g
2838@TOP@human_GAPDH_TAA_len41_fa0_ta20_fm6_tm14*127*a,895,0,1,0,896,0.001,127,2838@TOP@human_GAPDH_TAA_len41_fa0_ta20_fm6_tm14,a
2838@TOP@human_GAPDH_TAA_len41_fa0_ta20_fm6_tm14*128*c,0,900,0,0,900,0.0,128,2838@TOP@human_GAPDH_TAA_len41_fa0_ta20_fm6_tm14,c
2838@TOP@human_GAPDH_TAA_len41_fa0_ta20_fm6_tm14*129*c,0,891,0,0,891,0.0,129,2838@TOP@human_GAPDH_TAA_len41_fa0_ta20_fm6_tm14,c
2838@TOP@human_GAPDH_TAA_len41_fa0_ta20_fm6_tm14*130*c,0,898,0,0,898,0.0,130,2838@TOP@human_GAPDH_TAA_len41_fa0_ta20_fm6_tm14,c
2838@TOP@human_GAPDH_TAA_len41_fa0_ta20_fm6_tm14*131*c,0,901,0,0,901,0.0,131,2838@TOP@human_GAPDH_TAA_len41_fa0_ta20_fm6_tm14,c
2838@TOP@human_GAPDH_TAA_len41_fa0_ta20_fm6_tm14*132*t,1,1,0,872,874,0.0,132,2838@TOP@human_GAPDH_TAA_len41_fa0_ta20_fm6_tm14,t
2838@TOP@human_GAPDH_TAA_len41_fa0_ta20_fm6_tm14*133*g,0,0,890,0,890,1.0,133,2838@TOP@human_GAPDH_TAA_len41_fa0_ta20_fm6_tm14,g
2838@TOP@human_GAPDH_TAA_len41_fa0_ta20_fm6_tm14*134*g,0,0,894,0,894,1.0,134,2838@TOP@human_GAPDH_TAA_len41_fa0_ta20_fm6_tm14,g
2839@TOP@human_GAPDH_TAA_len41_fa0_ta20_fm6_tm14*114*t,3,4,1,22513,22521,0.0,114,2839@TOP@human_GAPDH_TAA_len41_fa0_ta20_fm6_tm14,t
2839@TOP@human_GAPDH_TAA_len41_fa0_ta20_fm6_tm14*115*c,3,22643,0,2,22648,0.0,115,2839@TOP@human_GAPDH_TAA_len41_fa0_ta20_fm6_tm14,c
2839@TOP@human_GAPDH_TAA_len41_fa0_ta20_fm6_tm14*116*c,1,22554,0,6,22561,0.0,116,2839@TOP@human_GAPDH_TAA_len41_fa0_ta20_fm6_tm14,c
2839@TOP@human_GAPDH_TAA_len41_fa0_ta20_fm6_tm14*117*a,22526,0,21,1,22548,0.001,117,2839@TOP@human_GAPDH_TAA_len41_fa0_ta20_fm6_tm14,a
2839@TOP@human_GAPDH_TAA_len41_fa0_ta20_fm6_tm14*118*a,22162,1,282,0,22445,0.013,118,2839@TOP@human_GAPDH_TAA_len41_fa0_ta20_fm6_tm14,a
2839@TOP@human_GAPDH_TAA_len41_fa0_ta20_fm6_tm14*119*g,1,0,22393,4,22398,1.0,119,2839@TOP@human_GAPDH_TAA_len41_fa0_ta20_fm6_tm14,g
2839@TOP@human_GAPDH_TAA_len41_fa0_ta20_fm6_tm14*120*g,2,0,22308,1,22311,1.0,120,2839@TOP@human_GAPDH_TAA_len41_fa0_ta20_fm6_tm14,g
2839@TOP@human_GAPDH_TAA_len41_fa0_ta20_fm6_tm14*121*a,22522,1,12,0,22535,0.001,121,2839@TOP@human_GAPDH_TAA_len41_fa0_ta20_fm6_tm14,a
2839@TOP@human_GAPDH_TAA_len41_fa0_ta20_fm6_tm14*122*g,0,0,22555,0,22555,1.0,122,2839@TOP@human_GAPDH_TAA_len41_fa0_ta20_fm6_tm14,g
2839@TOP@human_GAPDH_TAA_len41_fa0_ta20_fm6_tm14*123*t,4,1,2,22214,22221,0.0,123,2839@TOP@human_GAPDH_TAA_len41_fa0_ta20_fm6_tm14,t
2839@TOP@human_GAPDH_TAA_len41_fa0_ta20_fm6_tm14*124*a,21097,0,1091,0,22188,0.049,124,2839@TOP@human_GAPDH_TAA_len41_fa0_ta20_fm6_tm14,a
2839@TOP@human_GAPDH_TAA_len41_fa0_ta20_fm6_tm14*125*a,21656,1,499,1,22157,0.023,125,2839@TOP@human_GAPDH_TAA_len41_fa0_ta20_fm6_tm14,a
2839@TOP@human_GAPDH_TAA_len41_fa0_ta20_fm6_tm14*126*g,1,0,22226,0,22227,1.0,126,2839@TOP@human_GAPDH_TAA_len41_fa0_ta20_fm6_tm14,g
2839@TOP@human_GAPDH_TAA_len41_fa0_ta20_fm6_tm14*127*a,22458,3,16,0,22477,0.001,127,2839@TOP@human_GAPDH_TAA_len41_fa0_ta20_fm6_tm14,a
2839@TOP@human_GAPDH_TAA_len41_fa0_ta20_fm6_tm14*128*c,0,22592,1,1,22594,0.0,128,2839@TOP@human_GAPDH_TAA_len41_fa0_ta20_fm6_tm14,c
2839@TOP@human_GAPDH_TAA_len41_fa0_ta20_fm6_tm14*129*c,0,22434,0,0,22434,0.0,129,2839@TOP@human_GAPDH_TAA_len41_fa0_ta20_fm6_tm14,c
2839@TOP@human_GAPDH_TAA_len41_fa0_ta20_fm6_tm14*130*c,0,22540,0,3,22543,0.0,130,2839@TOP@human_GAPDH_TAA_len41_fa0_ta20_fm6_tm14,c
2839@TOP@human_GAPDH_TAA_len41_fa0_ta20_fm6_tm14*131*c,2,22589,0,2,22593,0.0,131,2839@TOP@human_GAPDH_TAA_len41_fa0_ta20_fm6_tm14,c
2839@TOP@human_GAPDH_TAA_len41_fa0_ta20_fm6_tm14*132*t,1,2,0,22274,22277,0.0,132,2839@TOP@human_GAPDH_TAA_len41_fa0_ta20_fm6_tm14,t
2839@TOP@human_GAPDH_TAA_len41_fa0_ta20_fm6_tm14*133*g,1,1,22283,1,22286,1.0,133,2839@TOP@human_GAPDH_TAA_len41_fa0_ta20_fm6_tm14,g
2839@TOP@human_GAPDH_TAA_len41_fa0_ta20_fm6_tm14*134*g,1,2,22352,2,22357,1.0,134,2839@TOP@human_GAPDH_TAA_len41_fa0_ta20_fm6_tm14,g
2840@TOP@human_GAPDH_TAA_len41_fa0_ta20_fm6_tm14*114*t,4,6,0,20134,20144,0.0,114,2840@TOP@human_GAPDH_TAA_len41_fa0_ta20_fm6_tm14,t
2840@TOP@human_GAPDH_TAA_len41_fa0_ta20_fm6_tm14*115*c,4,20249,0,0,20253,0.0,115,2840@TOP@human_GAPDH_TAA_len41_fa0_ta20_fm6_tm14,c
2840@TOP@human_GAPDH_TAA_len41_fa0_ta20_fm6_tm14*116*c,1,20167,0,4,20172,0.0,116,2840@TOP@human_GAPDH_TAA_len41_fa0_ta20_fm6_tm14,c
2840@TOP@human_GAPDH_TAA_len41_fa0_ta20_fm6_tm14*117*a,20082,0,34,0,20116,0.002,117,2840@TOP@human_GAPDH_TAA_len41_fa0_ta20_fm6_tm14,a
2840@TOP@human_GAPDH_TAA_len41_fa0_ta20_fm6_tm14*118*a,19723,0,279,1,20003,0.014,118,2840@TOP@human_GAPDH_TAA_len41_fa0_ta20_fm6_tm14,a
2840@TOP@human_GAPDH_TAA_len41_fa0_ta20_fm6_tm14*119*g,1,0,19982,1,19984,1.0,119,2840@TOP@human_GAPDH_TAA_len41_fa0_ta20_fm6_tm14,g
2840@TOP@human_GAPDH_TAA_len41_fa0_ta20_fm6_tm14*120*g,1,0,19912,1,19914,1.0,120,2840@TOP@human_GAPDH_TAA_len41_fa0_ta20_fm6_tm14,g
2840@TOP@human_GAPDH_TAA_len41_fa0_ta20_fm6_tm14*121*a,20108,0,8,0,20116,0.0,121,2840@TOP@human_GAPDH_TAA_len41_fa0_ta20_fm6_tm14,a
2840@TOP@human_GAPDH_TAA_len41_fa0_ta20_fm6_tm14*122*g,1,1,20162,0,20164,1.0,122,2840@TOP@human_GAPDH_TAA_len41_fa0_ta20_fm6_tm14,g
2840@TOP@human_GAPDH_TAA_len41_fa0_ta20_fm6_tm14*123*t,1,4,2,19866,19873,0.0,123,2840@TOP@human_GAPDH_TAA_len41_fa0_ta20_fm6_tm14,t
2840@TOP@human_GAPDH_TAA_len41_fa0_ta20_fm6_tm14*124*a,12114,0,7735,1,19850,0.39,124,2840@TOP@human_GAPDH_TAA_len41_fa0_ta20_fm6_tm14,a
2840@TOP@human_GAPDH_TAA_len41_fa0_ta20_fm6_tm14*125*a,16981,0,2858,1,19840,0.144,125,2840@TOP@human_GAPDH_TAA_len41_fa0_ta20_fm6_tm14,a
2840@TOP@human_GAPDH_TAA_len41_fa0_ta20_fm6_tm14*126*g,4,0,19934,1,19939,1.0,126,2840@TOP@human_GAPDH_TAA_len41_fa0_ta20_fm6_tm14,g
2840@TOP@human_GAPDH_TAA_len41_fa0_ta20_fm6_tm14*127*a,20015,0,72,0,20087,0.004,127,2840@TOP@human_GAPDH_TAA_len41_fa0_ta20_fm6_tm14,a
2840@TOP@human_GAPDH_TAA_len41_fa0_ta20_fm6_tm14*128*c,0,20184,1,0,20185,0.0,128,2840@TOP@human_GAPDH_TAA_len41_fa0_ta20_fm6_tm14,c
2840@TOP@human_GAPDH_TAA_len41_fa0_ta20_fm6_tm14*129*c,0,20057,0,1,20058,0.0,129,2840@TOP@human_GAPDH_TAA_len41_fa0_ta20_fm6_tm14,c
2840@TOP@human_GAPDH_TAA_len41_fa0_ta20_fm6_tm14*130*c,1,20154,1,2,20158,0.0,130,2840@TOP@human_GAPDH_TAA_len41_fa0_ta20_fm6_tm14,c
2840@TOP@human_GAPDH_TAA_len41_fa0_ta20_fm6_tm14*131*c,1,20211,0,1,20213,0.0,131,2840@TOP@human_GAPDH_TAA_len41_fa0_ta20_fm6_tm14,c
2840@TOP@human_GAPDH_TAA_len41_fa0_ta20_fm6_tm14*132*t,1,6,4,19904,19915,0.0,132,2840@TOP@human_GAPDH_TAA_len41_fa0_ta20_fm6_tm14,t
2840@TOP@human_GAPDH_TAA_len41_fa0_ta20_fm6_tm14*133*g,2,1,19891,0,19894,1.0,133,2840@TOP@human_GAPDH_TAA_len41_fa0_ta20_fm6_tm14,g
2840@TOP@human_GAPDH_TAA_len41_fa0_ta20_fm6_tm14*134*g,0,1,20001,3,20005,1.0,134,2840@TOP@human_GAPDH_TAA_len41_fa0_ta20_fm6_tm14,g
2841@TOP@human_GAPDH_TAA_len41_fa0_ta20_fm6_tm14*114*t,2,1,0,9679,9682,0.0,114,2841@TOP@human_GAPDH_TAA_len41_fa0_ta20_fm6_tm14,t
2841@TOP@human_GAPDH_TAA_len41_fa0_ta20_fm6_tm14*115*c,3,9741,0,2,9746,0.0,115,2841@TOP@human_GAPDH_TAA_len41_fa0_ta20_fm6_tm14,c
2841@TOP@human_GAPDH_TAA_len41_fa0_ta20_fm6_tm14*116*c,1,9700,0,0,9701,0.0,116,2841@TOP@human_GAPDH_TAA_len41_fa0_ta20_fm6_tm14,c
2841@TOP@human_GAPDH_TAA_len41_fa0_ta20_fm6_tm14*117*a,9676,0,27,1,9704,0.003,117,2841@TOP@human_GAPDH_TAA_len41_fa0_ta20_fm6_tm14,a
2841@TOP@human_GAPDH_TAA_len41_fa0_ta20_fm6_tm14*118*a,9505,3,145,0,9653,0.015,118,2841@TOP@human_GAPDH_TAA_len41_fa0_ta20_fm6_tm14,a
2841@TOP@human_GAPDH_TAA_len41_fa0_ta20_fm6_tm14*119*g,2,1,9623,0,9626,1.0,119,2841@TOP@human_GAPDH_TAA_len41_fa0_ta20_fm6_tm14,g
2841@TOP@human_GAPDH_TAA_len41_fa0_ta20_fm6_tm14*120*g,0,1,9586,0,9587,1.0,120,2841@TOP@human_GAPDH_TAA_len41_fa0_ta20_fm6_tm14,g
2841@TOP@human_GAPDH_TAA_len41_fa0_ta20_fm6_tm14*121*a,9675,0,8,1,9684,0.001,121,2841@TOP@human_GAPDH_TAA_len41_fa0_ta20_fm6_tm14,a
2841@TOP@human_GAPDH_TAA_len41_fa0_ta20_fm6_tm14*122*g,0,0,9704,0,9704,1.0,122,2841@TOP@human_GAPDH_TAA_len41_fa0_ta20_fm6_tm14,g
2841@TOP@human_GAPDH_TAA_len41_fa0_ta20_fm6_tm14*123*t,0,0,0,9596,9596,0.0,123,2841@TOP@human_GAPDH_TAA_len41_fa0_ta20_fm6_tm14,t
2841@TOP@human_GAPDH_TAA_len41_fa0_ta20_fm6_tm14*124*a,6686,0,2860,0,9546,0.3,124,2841@TOP@human_GAPDH_TAA_len41_fa0_ta20_fm6_tm14,a
2841@TOP@human_GAPDH_TAA_len41_fa0_ta20_fm6_tm14*125*a,8514,0,1051,2,9567,0.11,125,2841@TOP@human_GAPDH_TAA_len41_fa0_ta20_fm6_tm14,a
2841@TOP@human_GAPDH_TAA_len41_fa0_ta20_fm6_tm14*126*g,2,0,9584,0,9586,1.0,126,2841@TOP@human_GAPDH_TAA_len41_fa0_ta20_fm6_tm14,g
2841@TOP@human_GAPDH_TAA_len41_fa0_ta20_fm6_tm14*127*a,9624,0,47,0,9671,0.005,127,2841@TOP@human_GAPDH_TAA_len41_fa0_ta20_fm6_tm14,a
2841@TOP@human_GAPDH_TAA_len41_fa0_ta20_fm6_tm14*128*c,0,9725,2,0,9727,0.0,128,2841@TOP@human_GAPDH_TAA_len41_fa0_ta20_fm6_tm14,c
2841@TOP@human_GAPDH_TAA_len41_fa0_ta20_fm6_tm14*129*c,0,9641,0,0,9641,0.0,129,2841@TOP@human_GAPDH_TAA_len41_fa0_ta20_fm6_tm14,c
2841@TOP@human_GAPDH_TAA_len41_fa0_ta20_fm6_tm14*130*c,1,9705,0,0,9706,0.0,130,2841@TOP@human_GAPDH_TAA_len41_fa0_ta20_fm6_tm14,c
2841@TOP@human_GAPDH_TAA_len41_fa0_ta20_fm6_tm14*131*c,0,9728,0,0,9728,0.0,131,2841@TOP@human_GAPDH_TAA_len41_fa0_ta20_fm6_tm14,c
2841@TOP@human_GAPDH_TAA_len41_fa0_ta20_fm6_tm14*132*t,1,1,0,9566,9568,0.0,132,2841@TOP@human_GAPDH_TAA_len41_fa0_ta20_fm6_tm14,t
2841@TOP@human_GAPDH_TAA_len41_fa0_ta20_fm6_tm14*133*g,1,0,9588,0,9589,1.0,133,2841@TOP@human_GAPDH_TAA_len41_fa0_ta20_fm6_tm14,g
2841@TOP@human_GAPDH_TAA_len41_fa0_ta20_fm6_tm14*134*g,0,0,9622,0,9622,1.0,134,2841@TOP@human_GAPDH_TAA_len41_fa0_ta20_fm6_tm14,g
2842@TOP@human_GAPDH_TAA_len41_fa0_ta20_fm6_tm14*114*t,0,0,0,1201,1201,0.0,114,2842@TOP@human_GAPDH_TAA_len41_fa0_ta20_fm6_tm14,t
2842@TOP@human_GAPDH_TAA_len41_fa0_ta20_fm6_tm14*115*c,0,1211,0,0,1211,0.0,115,2842@TOP@human_GAPDH_TAA_len41_fa0_ta20_fm6_tm14,c
2842@TOP@human_GAPDH_TAA_len41_fa0_ta20_fm6_tm14*116*c,0,1202,0,0,1202,0.0,116,2842@TOP@human_GAPDH_TAA_len41_fa0_ta20_fm6_tm14,c
2842@TOP@human_GAPDH_TAA_len41_fa0_ta20_fm6_tm14*117*a,1201,0,4,0,1205,0.003,117,2842@TOP@human_GAPDH_TAA_len41_fa0_ta20_fm6_tm14,a
2842@TOP@human_GAPDH_TAA_len41_fa0_ta20_fm6_tm14*118*a,1157,0,33,1,1191,0.028,118,2842@TOP@human_GAPDH_TAA_len41_fa0_ta20_fm6_tm14,a
2842@TOP@human_GAPDH_TAA_len41_fa0_ta20_fm6_tm14*119*g,0,0,1192,0,1192,1.0,119,2842@TOP@human_GAPDH_TAA_len41_fa0_ta20_fm6_tm14,g
2842@TOP@human_GAPDH_TAA_len41_fa0_ta20_fm6_tm14*120*g,0,0,1183,0,1183,1.0,120,2842@TOP@human_GAPDH_TAA_len41_fa0_ta20_fm6_tm14,g
2842@TOP@human_GAPDH_TAA_len41_fa0_ta20_fm6_tm14*121*a,1194,0,2,0,1196,0.002,121,2842@TOP@human_GAPDH_TAA_len41_fa0_ta20_fm6_tm14,a
2842@TOP@human_GAPDH_TAA_len41_fa0_ta20_fm6_tm14*122*g,0,0,1202,0,1202,1.0,122,2842@TOP@human_GAPDH_TAA_len41_fa0_ta20_fm6_tm14,g
2842@TOP@human_GAPDH_TAA_len41_fa0_ta20_fm6_tm14*123*t,0,0,0,1186,1186,0.0,123,2842@TOP@human_GAPDH_TAA_len41_fa0_ta20_fm6_tm14,t
2842@TOP@human_GAPDH_TAA_len41_fa0_ta20_fm6_tm14*124*a,898,0,274,0,1172,0.234,124,2842@TOP@human_GAPDH_TAA_len41_fa0_ta20_fm6_tm14,a
2842@TOP@human_GAPDH_TAA_len41_fa0_ta20_fm6_tm14*125*a,894,0,283,0,1177,0.24,125,2842@TOP@human_GAPDH_TAA_len41_fa0_ta20_fm6_tm14,a
2842@TOP@human_GAPDH_TAA_len41_fa0_ta20_fm6_tm14*126*g,0,0,1186,0,1186,1.0,126,2842@TOP@human_GAPDH_TAA_len41_fa0_ta20_fm6_tm14,g
2842@TOP@human_GAPDH_TAA_len41_fa0_ta20_fm6_tm14*127*a,1176,0,20,0,1196,0.017,127,2842@TOP@human_GAPDH_TAA_len41_fa0_ta20_fm6_tm14,a
2842@TOP@human_GAPDH_TAA_len41_fa0_ta20_fm6_tm14*128*c,1,1208,1,0,1210,0.001,128,2842@TOP@human_GAPDH_TAA_len41_fa0_ta20_fm6_tm14,c
2842@TOP@human_GAPDH_TAA_len41_fa0_ta20_fm6_tm14*129*c,0,1197,0,0,1197,0.0,129,2842@TOP@human_GAPDH_TAA_len41_fa0_ta20_fm6_tm14,c
2842@TOP@human_GAPDH_TAA_len41_fa0_ta20_fm6_tm14*130*c,0,1205,0,0,1205,0.0,130,2842@TOP@human_GAPDH_TAA_len41_fa0_ta20_fm6_tm14,c
2842@TOP@human_GAPDH_TAA_len41_fa0_ta20_fm6_tm14*131*c,1,1205,0,0,1206,0.0,131,2842@TOP@human_GAPDH_TAA_len41_fa0_ta20_fm6_tm14,c
2842@TOP@human_GAPDH_TAA_len41_fa0_ta20_fm6_tm14*132*t,1,0,0,1178,1179,0.0,132,2842@TOP@human_GAPDH_TAA_len41_fa0_ta20_fm6_tm14,t
2842@TOP@human_GAPDH_TAA_len41_fa0_ta20_fm6_tm14*133*g,1,0,1187,0,1188,0.999,133,2842@TOP@human_GAPDH_TAA_len41_fa0_ta20_fm6_tm14,g
2842@TOP@human_GAPDH_TAA_len41_fa0_ta20_fm6_tm14*134*g,0,0,1189,0,1189,1.0,134,2842@TOP@human_GAPDH_TAA_len41_fa0_ta20_fm6_tm14,g
2843@TOP@human_GAPDH_TAA_len41_fa0_ta20_fm6_tm14*114*t,0,0,0,925,925,0.0,114,2843@TOP@human_GAPDH_TAA_len41_fa0_ta20_fm6_tm14,t
2843@TOP@human_GAPDH_TAA_len41_fa0_ta20_fm6_tm14*115*c,0,929,0,0,929,0.0,115,2843@TOP@human_GAPDH_TAA_len41_fa0_ta20_fm6_tm14,c
2843@TOP@human_GAPDH_TAA_len41_fa0_ta20_fm6_tm14*116*c,0,926,0,0,926,0.0,116,2843@TOP@human_GAPDH_TAA_len41_fa0_ta20_fm6_tm14,c
2843@TOP@human_GAPDH_TAA_len41_fa0_ta20_fm6_tm14*117*a,921,0,1,0,922,0.001,117,2843@TOP@human_GAPDH_TAA_len41_fa0_ta20_fm6_tm14,a
2843@TOP@human_GAPDH_TAA_len41_fa0_ta20_fm6_tm14*118*a,884,0,36,0,920,0.039,118,2843@TOP@human_GAPDH_TAA_len41_fa0_ta20_fm6_tm14,a
2843@TOP@human_GAPDH_TAA_len41_fa0_ta20_fm6_tm14*119*g,0,0,916,0,916,1.0,119,2843@TOP@human_GAPDH_TAA_len41_fa0_ta20_fm6_tm14,g
2843@TOP@human_GAPDH_TAA_len41_fa0_ta20_fm6_tm14*120*g,0,0,908,0,908,1.0,120,2843@TOP@human_GAPDH_TAA_len41_fa0_ta20_fm6_tm14,g
2843@TOP@human_GAPDH_TAA_len41_fa0_ta20_fm6_tm14*121*a,924,0,0,0,924,0.0,121,2843@TOP@human_GAPDH_TAA_len41_fa0_ta20_fm6_tm14,a
2843@TOP@human_GAPDH_TAA_len41_fa0_ta20_fm6_tm14*122*g,0,0,921,0,921,1.0,122,2843@TOP@human_GAPDH_TAA_len41_fa0_ta20_fm6_tm14,g
2843@TOP@human_GAPDH_TAA_len41_fa0_ta20_fm6_tm14*123*t,0,0,0,911,911,0.0,123,2843@TOP@human_GAPDH_TAA_len41_fa0_ta20_fm6_tm14,t
2843@TOP@human_GAPDH_TAA_len41_fa0_ta20_fm6_tm14*124*a,706,0,204,0,910,0.224,124,2843@TOP@human_GAPDH_TAA_len41_fa0_ta20_fm6_tm14,a
2843@TOP@human_GAPDH_TAA_len41_fa0_ta20_fm6_tm14*125*a,835,0,77,0,912,0.084,125,2843@TOP@human_GAPDH_TAA_len41_fa0_ta20_fm6_tm14,a
2843@TOP@human_GAPDH_TAA_len41_fa0_ta20_fm6_tm14*126*g,0,0,912,0,912,1.0,126,2843@TOP@human_GAPDH_TAA_len41_fa0_ta20_fm6_tm14,g
2843@TOP@human_GAPDH_TAA_len41_fa0_ta20_fm6_tm14*127*a,909,0,12,0,921,0.013,127,2843@TOP@human_GAPDH_TAA_len41_fa0_ta20_fm6_tm14,a
2843@TOP@human_GAPDH_TAA_len41_fa0_ta20_fm6_tm14*128*c,0,926,0,0,926,0.0,128,2843@TOP@human_GAPDH_TAA_len41_fa0_ta20_fm6_tm14,c
2843@TOP@human_GAPDH_TAA_len41_fa0_ta20_fm6_tm14*129*c,0,916,0,1,917,0.0,129,2843@TOP@human_GAPDH_TAA_len41_fa0_ta20_fm6_tm14,c
2843@TOP@human_GAPDH_TAA_len41_fa0_ta20_fm6_tm14*130*c,0,924,0,0,924,0.0,130,2843@TOP@human_GAPDH_TAA_len41_fa0_ta20_fm6_tm14,c
2843@TOP@human_GAPDH_TAA_len41_fa0_ta20_fm6_tm14*131*c,0,926,0,1,927,0.0,131,2843@TOP@human_GAPDH_TAA_len41_fa0_ta20_fm6_tm14,c
2843@TOP@human_GAPDH_TAA_len41_fa0_ta20_fm6_tm14*132*t,0,0,0,912,912,0.0,132,2843@TOP@human_GAPDH_TAA_len41_fa0_ta20_fm6_tm14,t
2843@TOP@human_GAPDH_TAA_len41_fa0_ta20_fm6_tm14*133*g,0,0,915,0,915,1.0,133,2843@TOP@human_GAPDH_TAA_len41_fa0_ta20_fm6_tm14,g
2843@TOP@human_GAPDH_TAA_len41_fa0_ta20_fm6_tm14*134*g,0,0,913,1,914,0.999,134,2843@TOP@human_GAPDH_TAA_len41_fa0_ta20_fm6_tm14,g
2844@TOP@human_GAPDH_TAA_len41_fa0_ta20_fm6_tm14*114*t,0,0,0,99,99,0.0,114,2844@TOP@human_GAPDH_TAA_len41_fa0_ta20_fm6_tm14,t
2844@TOP@human_GAPDH_TAA_len41_fa0_ta20_fm6_tm14*115*c,0,100,0,0,100,0.0,115,2844@TOP@human_GAPDH_TAA_len41_fa0_ta20_fm6_tm14,c
2844@TOP@human_GAPDH_TAA_len41_fa0_ta20_fm6_tm14*116*c,0,100,0,0,100,0.0,116,2844@TOP@human_GAPDH_TAA_len41_fa0_ta20_fm6_tm14,c
2844@TOP@human_GAPDH_TAA_len41_fa0_ta20_fm6_tm14*117*a,98,0,1,0,99,0.01,117,2844@TOP@human_GAPDH_TAA_len41_fa0_ta20_fm6_tm14,a
2844@TOP@human_GAPDH_TAA_len41_fa0_ta20_fm6_tm14*118*a,96,0,4,0,100,0.04,118,2844@TOP@human_GAPDH_TAA_len41_fa0_ta20_fm6_tm14,a
2844@TOP@human_GAPDH_TAA_len41_fa0_ta20_fm6_tm14*119*g,0,0,96,0,96,1.0,119,2844@TOP@human_GAPDH_TAA_len41_fa0_ta20_fm6_tm14,g
2844@TOP@human_GAPDH_TAA_len41_fa0_ta20_fm6_tm14*120*g,0,0,97,0,97,1.0,120,2844@TOP@human_GAPDH_TAA_len41_fa0_ta20_fm6_tm14,g
2844@TOP@human_GAPDH_TAA_len41_fa0_ta20_fm6_tm14*121*a,98,0,0,0,98,0.0,121,2844@TOP@human_GAPDH_TAA_len41_fa0_ta20_fm6_tm14,a
2844@TOP@human_GAPDH_TAA_len41_fa0_ta20_fm6_tm14*122*g,0,0,98,0,98,1.0,122,2844@TOP@human_GAPDH_TAA_len41_fa0_ta20_fm6_tm14,g
2844@TOP@human_GAPDH_TAA_len41_fa0_ta20_fm6_tm14*123*t,0,0,0,99,99,0.0,123,2844@TOP@human_GAPDH_TAA_len41_fa0_ta20_fm6_tm14,t
2844@TOP@human_GAPDH_TAA_len41_fa0_ta20_fm6_tm14*124*a,86,0,8,0,94,0.085,124,2844@TOP@human_GAPDH_TAA_len41_fa0_ta20_fm6_tm14,a
2844@TOP@human_GAPDH_TAA_len41_fa0_ta20_fm6_tm14*125*a,80,0,15,0,95,0.158,125,2844@TOP@human_GAPDH_TAA_len41_fa0_ta20_fm6_tm14,a
2844@TOP@human_GAPDH_TAA_len41_fa0_ta20_fm6_tm14*126*g,0,0,98,0,98,1.0,126,2844@TOP@human_GAPDH_TAA_len41_fa0_ta20_fm6_tm14,g
2844@TOP@human_GAPDH_TAA_len41_fa0_ta20_fm6_tm14*127*a,100,0,0,0,100,0.0,127,2844@TOP@human_GAPDH_TAA_len41_fa0_ta20_fm6_tm14,a
2844@TOP@human_GAPDH_TAA_len41_fa0_ta20_fm6_tm14*128*c,0,100,0,0,100,0.0,128,2844@TOP@human_GAPDH_TAA_len41_fa0_ta20_fm6_tm14,c
2844@TOP@human_GAPDH_TAA_len41_fa0_ta20_fm6_tm14*129*c,0,99,0,0,99,0.0,129,2844@TOP@human_GAPDH_TAA_len41_fa0_ta20_fm6_tm14,c
2844@TOP@human_GAPDH_TAA_len41_fa0_ta20_fm6_tm14*130*c,0,97,0,0,97,0.0,130,2844@TOP@human_GAPDH_TAA_len41_fa0_ta20_fm6_tm14,c
2844@TOP@human_GAPDH_TAA_len41_fa0_ta20_fm6_tm14*131*c,0,100,0,0,100,0.0,131,2844@TOP@human_GAPDH_TAA_len41_fa0_ta20_fm6_tm14,c
2844@TOP@human_GAPDH_TAA_len41_fa0_ta20_fm6_tm14*132*t,0,0,0,96,96,0.0,132,2844@TOP@human_GAPDH_TAA_len41_fa0_ta20_fm6_tm14,t
2844@TOP@human_GAPDH_TAA_len41_fa0_ta20_fm6_tm14*133*g,0,0,97,0,97,1.0,133,2844@TOP@human_GAPDH_TAA_len41_fa0_ta20_fm6_tm14,g
2844@TOP@human_GAPDH_TAA_len41_fa0_ta20_fm6_tm14*134*g,0,4,94,0,98,0.959,134,2844@TOP@human_GAPDH_TAA_len41_fa0_ta20_fm6_tm14,g
2845@TOP@human_GAPDH_TAA_len41_fa0_ta20_fm6_tm14*114*t,0,0,0,1278,1278,0.0,114,2845@TOP@human_GAPDH_TAA_len41_fa0_ta20_fm6_tm14,t
2845@TOP@human_GAPDH_TAA_len41_fa0_ta20_fm6_tm14*115*c,1,1284,0,0,1285,0.0,115,2845@TOP@human_GAPDH_TAA_len41_fa0_ta20_fm6_tm14,c
2845@TOP@human_GAPDH_TAA_len41_fa0_ta20_fm6_tm14*116*c,0,1277,0,0,1277,0.0,116,2845@TOP@human_GAPDH_TAA_len41_fa0_ta20_fm6_tm14,c
2845@TOP@human_GAPDH_TAA_len41_fa0_ta20_fm6_tm14*117*a,1277,0,3,0,1280,0.002,117,2845@TOP@human_GAPDH_TAA_len41_fa0_ta20_fm6_tm14,a
2845@TOP@human_GAPDH_TAA_len41_fa0_ta20_fm6_tm14*118*a,1193,0,78,0,1271,0.061,118,2845@TOP@human_GAPDH_TAA_len41_fa0_ta20_fm6_tm14,a
2845@TOP@human_GAPDH_TAA_len41_fa0_ta20_fm6_tm14*119*g,0,0,1268,0,1268,1.0,119,2845@TOP@human_GAPDH_TAA_len41_fa0_ta20_fm6_tm14,g
2845@TOP@human_GAPDH_TAA_len41_fa0_ta20_fm6_tm14*120*g,0,0,1266,0,1266,1.0,120,2845@TOP@human_GAPDH_TAA_len41_fa0_ta20_fm6_tm14,g
2845@TOP@human_GAPDH_TAA_len41_fa0_ta20_fm6_tm14*121*a,1273,0,4,0,1277,0.003,121,2845@TOP@human_GAPDH_TAA_len41_fa0_ta20_fm6_tm14,a
2845@TOP@human_GAPDH_TAA_len41_fa0_ta20_fm6_tm14*122*g,0,0,1281,0,1281,1.0,122,2845@TOP@human_GAPDH_TAA_len41_fa0_ta20_fm6_tm14,g
2845@TOP@human_GAPDH_TAA_len41_fa0_ta20_fm6_tm14*123*t,0,0,0,1257,1257,0.0,123,2845@TOP@human_GAPDH_TAA_len41_fa0_ta20_fm6_tm14,t
2845@TOP@human_GAPDH_TAA_len41_fa0_ta20_fm6_tm14*124*a,1072,0,187,0,1259,0.149,124,2845@TOP@human_GAPDH_TAA_len41_fa0_ta20_fm6_tm14,a
2845@TOP@human_GAPDH_TAA_len41_fa0_ta20_fm6_tm14*125*a,1141,0,116,0,1257,0.092,125,2845@TOP@human_GAPDH_TAA_len41_fa0_ta20_fm6_tm14,a
2845@TOP@human_GAPDH_TAA_len41_fa0_ta20_fm6_tm14*126*g,1,0,1263,0,1264,0.999,126,2845@TOP@human_GAPDH_TAA_len41_fa0_ta20_fm6_tm14,g
2845@TOP@human_GAPDH_TAA_len41_fa0_ta20_fm6_tm14*127*a,1264,0,6,0,1270,0.005,127,2845@TOP@human_GAPDH_TAA_len41_fa0_ta20_fm6_tm14,a
2845@TOP@human_GAPDH_TAA_len41_fa0_ta20_fm6_tm14*128*c,0,1280,0,0,1280,0.0,128,2845@TOP@human_GAPDH_TAA_len41_fa0_ta20_fm6_tm14,c
2845@TOP@human_GAPDH_TAA_len41_fa0_ta20_fm6_tm14*129*c,0,1268,0,0,1268,0.0,129,2845@TOP@human_GAPDH_TAA_len41_fa0_ta20_fm6_tm14,c
2845@TOP@human_GAPDH_TAA_len41_fa0_ta20_fm6_tm14*130*c,0,1273,0,0,1273,0.0,130,2845@TOP@human_GAPDH_TAA_len41_fa0_ta20_fm6_tm14,c
2845@TOP@human_GAPDH_TAA_len41_fa0_ta20_fm6_tm14*131*c,0,1283,0,0,1283,0.0,131,2845@TOP@human_GAPDH_TAA_len41_fa0_ta20_fm6_tm14,c
2845@TOP@human_GAPDH_TAA_len41_fa0_ta20_fm6_tm14*132*t,0,0,1,1259,1260,0.001,132,2845@TOP@human_GAPDH_TAA_len41_fa0_ta20_fm6_tm14,t
2845@TOP@human_GAPDH_TAA_len41_fa0_ta20_fm6_tm14*133*g,0,0,1249,0,1249,1.0,133,2845@TOP@human_GAPDH_TAA_len41_fa0_ta20_fm6_tm14,g
2845@TOP@human_GAPDH_TAA_len41_fa0_ta20_fm6_tm14*134*g,0,0,1264,0,1264,1.0,134,2845@TOP@human_GAPDH_TAA_len41_fa0_ta20_fm6_tm14,g
2846@TOP@human_GAPDH_TAA_len41_fa0_ta20_fm6_tm14*114*t,2,5,0,11741,11748,0.0,114,2846@TOP@human_GAPDH_TAA_len41_fa0_ta20_fm6_tm14,t
2846@TOP@human_GAPDH_TAA_len41_fa0_ta20_fm6_tm14*115*c,4,11804,0,0,11808,0.0,115,2846@TOP@human_GAPDH_TAA_len41_fa0_ta20_fm6_tm14,c
2846@TOP@human_GAPDH_TAA_len41_fa0_ta20_fm6_tm14*116*c,1,11761,0,0,11762,0.0,116,2846@TOP@human_GAPDH_TAA_len41_fa0_ta20_fm6_tm14,c
2846@TOP@human_GAPDH_TAA_len41_fa0_ta20_fm6_tm14*117*a,11729,0,14,1,11744,0.001,117,2846@TOP@human_GAPDH_TAA_len41_fa0_ta20_fm6_tm14,a
2846@TOP@human_GAPDH_TAA_len41_fa0_ta20_fm6_tm14*118*a,11559,0,143,0,11702,0.012,118,2846@TOP@human_GAPDH_TAA_len41_fa0_ta20_fm6_tm14,a
2846@TOP@human_GAPDH_TAA_len41_fa0_ta20_fm6_tm14*119*g,0,0,11676,0,11676,1.0,119,2846@TOP@human_GAPDH_TAA_len41_fa0_ta20_fm6_tm14,g
2846@TOP@human_GAPDH_TAA_len41_fa0_ta20_fm6_tm14*120*g,0,0,11662,0,11662,1.0,120,2846@TOP@human_GAPDH_TAA_len41_fa0_ta20_fm6_tm14,g
2846@TOP@human_GAPDH_TAA_len41_fa0_ta20_fm6_tm14*121*a,11767,0,1,0,11768,0.0,121,2846@TOP@human_GAPDH_TAA_len41_fa0_ta20_fm6_tm14,a
2846@TOP@human_GAPDH_TAA_len41_fa0_ta20_fm6_tm14*122*g,0,0,11749,0,11749,1.0,122,2846@TOP@human_GAPDH_TAA_len41_fa0_ta20_fm6_tm14,g
2846@TOP@human_GAPDH_TAA_len41_fa0_ta20_fm6_tm14*123*t,1,0,0,11648,11649,0.0,123,2846@TOP@human_GAPDH_TAA_len41_fa0_ta20_fm6_tm14,t
2846@TOP@human_GAPDH_TAA_len41_fa0_ta20_fm6_tm14*124*a,4935,1,6713,0,11649,0.576,124,2846@TOP@human_GAPDH_TAA_len41_fa0_ta20_fm6_tm14,a
2846@TOP@human_GAPDH_TAA_len41_fa0_ta20_fm6_tm14*125*a,6429,0,5177,0,11606,0.446,125,2846@TOP@human_GAPDH_TAA_len41_fa0_ta20_fm6_tm14,a
2846@TOP@human_GAPDH_TAA_len41_fa0_ta20_fm6_tm14*126*g,0,0,11661,2,11663,1.0,126,2846@TOP@human_GAPDH_TAA_len41_fa0_ta20_fm6_tm14,g
2846@TOP@human_GAPDH_TAA_len41_fa0_ta20_fm6_tm14*127*a,11378,6,347,0,11731,0.03,127,2846@TOP@human_GAPDH_TAA_len41_fa0_ta20_fm6_tm14,a
2846@TOP@human_GAPDH_TAA_len41_fa0_ta20_fm6_tm14*128*c,0,11777,1,0,11778,0.0,128,2846@TOP@human_GAPDH_TAA_len41_fa0_ta20_fm6_tm14,c
2846@TOP@human_GAPDH_TAA_len41_fa0_ta20_fm6_tm14*129*c,0,11723,0,0,11723,0.0,129,2846@TOP@human_GAPDH_TAA_len41_fa0_ta20_fm6_tm14,c
2846@TOP@human_GAPDH_TAA_len41_fa0_ta20_fm6_tm14*130*c,1,11758,0,0,11759,0.0,130,2846@TOP@human_GAPDH_TAA_len41_fa0_ta20_fm6_tm14,c
2846@TOP@human_GAPDH_TAA_len41_fa0_ta20_fm6_tm14*131*c,3,11792,0,0,11795,0.0,131,2846@TOP@human_GAPDH_TAA_len41_fa0_ta20_fm6_tm14,c
2846@TOP@human_GAPDH_TAA_len41_fa0_ta20_fm6_tm14*132*t,2,2,4,11662,11670,0.0,132,2846@TOP@human_GAPDH_TAA_len41_fa0_ta20_fm6_tm14,t
2846@TOP@human_GAPDH_TAA_len41_fa0_ta20_fm6_tm14*133*g,0,0,11638,1,11639,1.0,133,2846@TOP@human_GAPDH_TAA_len41_fa0_ta20_fm6_tm14,g
2846@TOP@human_GAPDH_TAA_len41_fa0_ta20_fm6_tm14*134*g,1,0,11671,0,11672,1.0,134,2846@TOP@human_GAPDH_TAA_len41_fa0_ta20_fm6_tm14,g
2847@TOP@human_GAPDH_TAA_len41_fa0_ta20_fm6_tm14*114*t,0,0,0,362,362,0.0,114,2847@TOP@human_GAPDH_TAA_len41_fa0_ta20_fm6_tm14,t
2847@TOP@human_GAPDH_TAA_len41_fa0_ta20_fm6_tm14*115*c,0,363,0,0,363,0.0,115,2847@TOP@human_GAPDH_TAA_len41_fa0_ta20_fm6_tm14,c
2847@TOP@human_GAPDH_TAA_len41_fa0_ta20_fm6_tm14*116*c,0,360,0,0,360,0.0,116,2847@TOP@human_GAPDH_TAA_len41_fa0_ta20_fm6_tm14,c
2847@TOP@human_GAPDH_TAA_len41_fa0_ta20_fm6_tm14*117*a,360,0,0,0,360,0.0,117,2847@TOP@human_GAPDH_TAA_len41_fa0_ta20_fm6_tm14,a
2847@TOP@human_GAPDH_TAA_len41_fa0_ta20_fm6_tm14*118*a,351,0,9,0,360,0.025,118,2847@TOP@human_GAPDH_TAA_len41_fa0_ta20_fm6_tm14,a
2847@TOP@human_GAPDH_TAA_len41_fa0_ta20_fm6_tm14*119*g,0,0,360,0,360,1.0,119,2847@TOP@human_GAPDH_TAA_len41_fa0_ta20_fm6_tm14,g
2847@TOP@human_GAPDH_TAA_len41_fa0_ta20_fm6_tm14*120*g,0,0,352,0,352,1.0,120,2847@TOP@human_GAPDH_TAA_len41_fa0_ta20_fm6_tm14,g
2847@TOP@human_GAPDH_TAA_len41_fa0_ta20_fm6_tm14*121*a,362,0,1,0,363,0.003,121,2847@TOP@human_GAPDH_TAA_len41_fa0_ta20_fm6_tm14,a
2847@TOP@human_GAPDH_TAA_len41_fa0_ta20_fm6_tm14*122*g,0,0,356,0,356,1.0,122,2847@TOP@human_GAPDH_TAA_len41_fa0_ta20_fm6_tm14,g
2847@TOP@human_GAPDH_TAA_len41_fa0_ta20_fm6_tm14*123*t,0,0,0,352,352,0.0,123,2847@TOP@human_GAPDH_TAA_len41_fa0_ta20_fm6_tm14,t
2847@TOP@human_GAPDH_TAA_len41_fa0_ta20_fm6_tm14*124*a,257,0,99,0,356,0.278,124,2847@TOP@human_GAPDH_TAA_len41_fa0_ta20_fm6_tm14,a
2847@TOP@human_GAPDH_TAA_len41_fa0_ta20_fm6_tm14*125*a,305,0,49,0,354,0.138,125,2847@TOP@human_GAPDH_TAA_len41_fa0_ta20_fm6_tm14,a
2847@TOP@human_GAPDH_TAA_len41_fa0_ta20_fm6_tm14*126*g,0,0,354,0,354,1.0,126,2847@TOP@human_GAPDH_TAA_len41_fa0_ta20_fm6_tm14,g
2847@TOP@human_GAPDH_TAA_len41_fa0_ta20_fm6_tm14*127*a,357,0,4,0,361,0.011,127,2847@TOP@human_GAPDH_TAA_len41_fa0_ta20_fm6_tm14,a
2847@TOP@human_GAPDH_TAA_len41_fa0_ta20_fm6_tm14*128*c,0,363,0,0,363,0.0,128,2847@TOP@human_GAPDH_TAA_len41_fa0_ta20_fm6_tm14,c
2847@TOP@human_GAPDH_TAA_len41_fa0_ta20_fm6_tm14*129*c,0,357,0,0,357,0.0,129,2847@TOP@human_GAPDH_TAA_len41_fa0_ta20_fm6_tm14,c
2847@TOP@human_GAPDH_TAA_len41_fa0_ta20_fm6_tm14*130*c,0,360,0,0,360,0.0,130,2847@TOP@human_GAPDH_TAA_len41_fa0_ta20_fm6_tm14,c
2847@TOP@human_GAPDH_TAA_len41_fa0_ta20_fm6_tm14*131*c,0,362,0,0,362,0.0,131,2847@TOP@human_GAPDH_TAA_len41_fa0_ta20_fm6_tm14,c
2847@TOP@human_GAPDH_TAA_len41_fa0_ta20_fm6_tm14*132*t,0,0,0,358,358,0.0,132,2847@TOP@human_GAPDH_TAA_len41_fa0_ta20_fm6_tm14,t
2847@TOP@human_GAPDH_TAA_len41_fa0_ta20_fm6_tm14*133*g,0,0,358,0,358,1.0,133,2847@TOP@human_GAPDH_TAA_len41_fa0_ta20_fm6_tm14,g
2847@TOP@human_GAPDH_TAA_len41_fa0_ta20_fm6_tm14*134*g,0,0,357,0,357,1.0,134,2847@TOP@human_GAPDH_TAA_len41_fa0_ta20_fm6_tm14,g
2848@TOP@human_GAPDH_TAA_len41_fa0_ta20_fm6_tm14*114*t,0,0,0,206,206,0.0,114,2848@TOP@human_GAPDH_TAA_len41_fa0_ta20_fm6_tm14,t
2848@TOP@human_GAPDH_TAA_len41_fa0_ta20_fm6_tm14*115*c,0,208,0,0,208,0.0,115,2848@TOP@human_GAPDH_TAA_len41_fa0_ta20_fm6_tm14,c
2848@TOP@human_GAPDH_TAA_len41_fa0_ta20_fm6_tm14*116*c,0,207,0,0,207,0.0,116,2848@TOP@human_GAPDH_TAA_len41_fa0_ta20_fm6_tm14,c
2848@TOP@human_GAPDH_TAA_len41_fa0_ta20_fm6_tm14*117*a,209,0,0,0,209,0.0,117,2848@TOP@human_GAPDH_TAA_len41_fa0_ta20_fm6_tm14,a
2848@TOP@human_GAPDH_TAA_len41_fa0_ta20_fm6_tm14*118*a,202,0,2,0,204,0.01,118,2848@TOP@human_GAPDH_TAA_len41_fa0_ta20_fm6_tm14,a
2848@TOP@human_GAPDH_TAA_len41_fa0_ta20_fm6_tm14*119*g,0,0,203,0,203,1.0,119,2848@TOP@human_GAPDH_TAA_len41_fa0_ta20_fm6_tm14,g
2848@TOP@human_GAPDH_TAA_len41_fa0_ta20_fm6_tm14*120*g,0,0,201,0,201,1.0,120,2848@TOP@human_GAPDH_TAA_len41_fa0_ta20_fm6_tm14,g
2848@TOP@human_GAPDH_TAA_len41_fa0_ta20_fm6_tm14*121*a,208,0,0,0,208,0.0,121,2848@TOP@human_GAPDH_TAA_len41_fa0_ta20_fm6_tm14,a
2848@TOP@human_GAPDH_TAA_len41_fa0_ta20_fm6_tm14*122*g,0,0,206,0,206,1.0,122,2848@TOP@human_GAPDH_TAA_len41_fa0_ta20_fm6_tm14,g
2848@TOP@human_GAPDH_TAA_len41_fa0_ta20_fm6_tm14*123*t,0,0,0,202,202,0.0,123,2848@TOP@human_GAPDH_TAA_len41_fa0_ta20_fm6_tm14,t
2848@TOP@human_GAPDH_TAA_len41_fa0_ta20_fm6_tm14*124*a,168,0,36,0,204,0.176,124,2848@TOP@human_GAPDH_TAA_len41_fa0_ta20_fm6_tm14,a
2848@TOP@human_GAPDH_TAA_len41_fa0_ta20_fm6_tm14*125*a,186,0,17,0,203,0.084,125,2848@TOP@human_GAPDH_TAA_len41_fa0_ta20_fm6_tm14,a
2848@TOP@human_GAPDH_TAA_len41_fa0_ta20_fm6_tm14*126*g,1,0,200,0,201,0.995,126,2848@TOP@human_GAPDH_TAA_len41_fa0_ta20_fm6_tm14,g
2848@TOP@human_GAPDH_TAA_len41_fa0_ta20_fm6_tm14*127*a,208,0,0,0,208,0.0,127,2848@TOP@human_GAPDH_TAA_len41_fa0_ta20_fm6_tm14,a
2848@TOP@human_GAPDH_TAA_len41_fa0_ta20_fm6_tm14*128*c,0,206,0,1,207,0.0,128,2848@TOP@human_GAPDH_TAA_len41_fa0_ta20_fm6_tm14,c
2848@TOP@human_GAPDH_TAA_len41_fa0_ta20_fm6_tm14*129*c,0,199,0,0,199,0.0,129,2848@TOP@human_GAPDH_TAA_len41_fa0_ta20_fm6_tm14,c
2848@TOP@human_GAPDH_TAA_len41_fa0_ta20_fm6_tm14*130*c,0,203,0,0,203,0.0,130,2848@TOP@human_GAPDH_TAA_len41_fa0_ta20_fm6_tm14,c
2848@TOP@human_GAPDH_TAA_len41_fa0_ta20_fm6_tm14*131*c,0,208,0,0,208,0.0,131,2848@TOP@human_GAPDH_TAA_len41_fa0_ta20_fm6_tm14,c
2848@TOP@human_GAPDH_TAA_len41_fa0_ta20_fm6_tm14*132*t,0,0,0,204,204,0.0,132,2848@TOP@human_GAPDH_TAA_len41_fa0_ta20_fm6_tm14,t
2848@TOP@human_GAPDH_TAA_len41_fa0_ta20_fm6_tm14*133*g,0,0,200,1,201,0.995,133,2848@TOP@human_GAPDH_TAA_len41_fa0_ta20_fm6_tm14,g
2848@TOP@human_GAPDH_TAA_len41_fa0_ta20_fm6_tm14*134*g,0,0,202,0,202,1.0,134,2848@TOP@human_GAPDH_TAA_len41_fa0_ta20_fm6_tm14,g
2849@TOP@human_GAPDH_TAA_len41_fa0_ta20_fm6_tm14*114*t,0,0,0,679,679,0.0,114,2849@TOP@human_GAPDH_TAA_len41_fa0_ta20_fm6_tm14,t
2849@TOP@human_GAPDH_TAA_len41_fa0_ta20_fm6_tm14*115*c,0,679,0,0,679,0.0,115,2849@TOP@human_GAPDH_TAA_len41_fa0_ta20_fm6_tm14,c
2849@TOP@human_GAPDH_TAA_len41_fa0_ta20_fm6_tm14*116*c,0,679,0,0,679,0.0,116,2849@TOP@human_GAPDH_TAA_len41_fa0_ta20_fm6_tm14,c
2849@TOP@human_GAPDH_TAA_len41_fa0_ta20_fm6_tm14*117*a,674,0,0,0,674,0.0,117,2849@TOP@human_GAPDH_TAA_len41_fa0_ta20_fm6_tm14,a
2849@TOP@human_GAPDH_TAA_len41_fa0_ta20_fm6_tm14*118*a,649,4,18,0,671,0.027,118,2849@TOP@human_GAPDH_TAA_len41_fa0_ta20_fm6_tm14,a
2849@TOP@human_GAPDH_TAA_len41_fa0_ta20_fm6_tm14*119*g,0,0,670,0,670,1.0,119,2849@TOP@human_GAPDH_TAA_len41_fa0_ta20_fm6_tm14,g
2849@TOP@human_GAPDH_TAA_len41_fa0_ta20_fm6_tm14*120*g,0,0,673,0,673,1.0,120,2849@TOP@human_GAPDH_TAA_len41_fa0_ta20_fm6_tm14,g
2849@TOP@human_GAPDH_TAA_len41_fa0_ta20_fm6_tm14*121*a,678,0,0,0,678,0.0,121,2849@TOP@human_GAPDH_TAA_len41_fa0_ta20_fm6_tm14,a
2849@TOP@human_GAPDH_TAA_len41_fa0_ta20_fm6_tm14*122*g,1,0,678,0,679,0.999,122,2849@TOP@human_GAPDH_TAA_len41_fa0_ta20_fm6_tm14,g
2849@TOP@human_GAPDH_TAA_len41_fa0_ta20_fm6_tm14*123*t,0,0,0,666,666,0.0,123,2849@TOP@human_GAPDH_TAA_len41_fa0_ta20_fm6_tm14,t
2849@TOP@human_GAPDH_TAA_len41_fa0_ta20_fm6_tm14*124*a,476,0,191,0,667,0.286,124,2849@TOP@human_GAPDH_TAA_len41_fa0_ta20_fm6_tm14,a
2849@TOP@human_GAPDH_TAA_len41_fa0_ta20_fm6_tm14*125*a,503,0,164,0,667,0.246,125,2849@TOP@human_GAPDH_TAA_len41_fa0_ta20_fm6_tm14,a
2849@TOP@human_GAPDH_TAA_len41_fa0_ta20_fm6_tm14*126*g,0,0,672,0,672,1.0,126,2849@TOP@human_GAPDH_TAA_len41_fa0_ta20_fm6_tm14,g
2849@TOP@human_GAPDH_TAA_len41_fa0_ta20_fm6_tm14*127*a,657,0,18,0,675,0.027,127,2849@TOP@human_GAPDH_TAA_len41_fa0_ta20_fm6_tm14,a
2849@TOP@human_GAPDH_TAA_len41_fa0_ta20_fm6_tm14*128*c,0,679,0,0,679,0.0,128,2849@TOP@human_GAPDH_TAA_len41_fa0_ta20_fm6_tm14,c
2849@TOP@human_GAPDH_TAA_len41_fa0_ta20_fm6_tm14*129*c,0,674,0,0,674,0.0,129,2849@TOP@human_GAPDH_TAA_len41_fa0_ta20_fm6_tm14,c
2849@TOP@human_GAPDH_TAA_len41_fa0_ta20_fm6_tm14*130*c,0,679,0,0,679,0.0,130,2849@TOP@human_GAPDH_TAA_len41_fa0_ta20_fm6_tm14,c
2849@TOP@human_GAPDH_TAA_len41_fa0_ta20_fm6_tm14*131*c,0,680,0,0,680,0.0,131,2849@TOP@human_GAPDH_TAA_len41_fa0_ta20_fm6_tm14,c
2849@TOP@human_GAPDH_TAA_len41_fa0_ta20_fm6_tm14*132*t,0,0,0,674,674,0.0,132,2849@TOP@human_GAPDH_TAA_len41_fa0_ta20_fm6_tm14,t
2849@TOP@human_GAPDH_TAA_len41_fa0_ta20_fm6_tm14*133*g,0,0,674,0,674,1.0,133,2849@TOP@human_GAPDH_TAA_len41_fa0_ta20_fm6_tm14,g
2849@TOP@human_GAPDH_TAA_len41_fa0_ta20_fm6_tm14*134*g,0,0,671,0,671,1.0,134,2849@TOP@human_GAPDH_TAA_len41_fa0_ta20_fm6_tm14,g
2850@TOP@human_GAPDH_TAA_len41_fa0_ta20_fm6_tm14*114*t,0,0,0,373,373,0.0,114,2850@TOP@human_GAPDH_TAA_len41_fa0_ta20_fm6_tm14,t
2850@TOP@human_GAPDH_TAA_len41_fa0_ta20_fm6_tm14*115*c,0,378,0,0,378,0.0,115,2850@TOP@human_GAPDH_TAA_len41_fa0_ta20_fm6_tm14,c
2850@TOP@human_GAPDH_TAA_len41_fa0_ta20_fm6_tm14*116*c,0,374,0,0,374,0.0,116,2850@TOP@human_GAPDH_TAA_len41_fa0_ta20_fm6_tm14,c
2850@TOP@human_GAPDH_TAA_len41_fa0_ta20_fm6_tm14*117*a,377,0,0,0,377,0.0,117,2850@TOP@human_GAPDH_TAA_len41_fa0_ta20_fm6_tm14,a
2850@TOP@human_GAPDH_TAA_len41_fa0_ta20_fm6_tm14*118*a,366,0,6,0,372,0.016,118,2850@TOP@human_GAPDH_TAA_len41_fa0_ta20_fm6_tm14,a
2850@TOP@human_GAPDH_TAA_len41_fa0_ta20_fm6_tm14*119*g,0,0,369,0,369,1.0,119,2850@TOP@human_GAPDH_TAA_len41_fa0_ta20_fm6_tm14,g
2850@TOP@human_GAPDH_TAA_len41_fa0_ta20_fm6_tm14*120*g,0,0,370,0,370,1.0,120,2850@TOP@human_GAPDH_TAA_len41_fa0_ta20_fm6_tm14,g
2850@TOP@human_GAPDH_TAA_len41_fa0_ta20_fm6_tm14*121*a,373,0,0,0,373,0.0,121,2850@TOP@human_GAPDH_TAA_len41_fa0_ta20_fm6_tm14,a
2850@TOP@human_GAPDH_TAA_len41_fa0_ta20_fm6_tm14*122*g,0,0,376,0,376,1.0,122,2850@TOP@human_GAPDH_TAA_len41_fa0_ta20_fm6_tm14,g
2850@TOP@human_GAPDH_TAA_len41_fa0_ta20_fm6_tm14*123*t,0,0,0,365,365,0.0,123,2850@TOP@human_GAPDH_TAA_len41_fa0_ta20_fm6_tm14,t
2850@TOP@human_GAPDH_TAA_len41_fa0_ta20_fm6_tm14*124*a,306,0,67,0,373,0.18,124,2850@TOP@human_GAPDH_TAA_len41_fa0_ta20_fm6_tm14,a
2850@TOP@human_GAPDH_TAA_len41_fa0_ta20_fm6_tm14*125*a,346,0,21,0,367,0.057,125,2850@TOP@human_GAPDH_TAA_len41_fa0_ta20_fm6_tm14,a
2850@TOP@human_GAPDH_TAA_len41_fa0_ta20_fm6_tm14*126*g,0,0,365,0,365,1.0,126,2850@TOP@human_GAPDH_TAA_len41_fa0_ta20_fm6_tm14,g
2850@TOP@human_GAPDH_TAA_len41_fa0_ta20_fm6_tm14*127*a,373,0,0,0,373,0.0,127,2850@TOP@human_GAPDH_TAA_len41_fa0_ta20_fm6_tm14,a
2850@TOP@human_GAPDH_TAA_len41_fa0_ta20_fm6_tm14*128*c,0,376,0,0,376,0.0,128,2850@TOP@human_GAPDH_TAA_len41_fa0_ta20_fm6_tm14,c
2850@TOP@human_GAPDH_TAA_len41_fa0_ta20_fm6_tm14*129*c,0,374,0,0,374,0.0,129,2850@TOP@human_GAPDH_TAA_len41_fa0_ta20_fm6_tm14,c
2850@TOP@human_GAPDH_TAA_len41_fa0_ta20_fm6_tm14*130*c,0,373,0,0,373,0.0,130,2850@TOP@human_GAPDH_TAA_len41_fa0_ta20_fm6_tm14,c
2850@TOP@human_GAPDH_TAA_len41_fa0_ta20_fm6_tm14*131*c,0,376,0,0,376,0.0,131,2850@TOP@human_GAPDH_TAA_len41_fa0_ta20_fm6_tm14,c
2850@TOP@human_GAPDH_TAA_len41_fa0_ta20_fm6_tm14*132*t,0,0,0,368,368,0.0,132,2850@TOP@human_GAPDH_TAA_len41_fa0_ta20_fm6_tm14,t
2850@TOP@human_GAPDH_TAA_len41_fa0_ta20_fm6_tm14*133*g,0,0,365,0,365,1.0,133,2850@TOP@human_GAPDH_TAA_len41_fa0_ta20_fm6_tm14,g
2850@TOP@human_GAPDH_TAA_len41_fa0_ta20_fm6_tm14*134*g,0,0,374,0,374,1.0,134,2850@TOP@human_GAPDH_TAA_len41_fa0_ta20_fm6_tm14,g
2851@TOP@human_GAPDH_TAA_len41_fa0_ta20_fm6_tm14*114*t,0,0,0,5193,5193,0.0,114,2851@TOP@human_GAPDH_TAA_len41_fa0_ta20_fm6_tm14,t
2851@TOP@human_GAPDH_TAA_len41_fa0_ta20_fm6_tm14*115*c,0,5216,0,0,5216,0.0,115,2851@TOP@human_GAPDH_TAA_len41_fa0_ta20_fm6_tm14,c
2851@TOP@human_GAPDH_TAA_len41_fa0_ta20_fm6_tm14*116*c,0,5197,0,0,5197,0.0,116,2851@TOP@human_GAPDH_TAA_len41_fa0_ta20_fm6_tm14,c
2851@TOP@human_GAPDH_TAA_len41_fa0_ta20_fm6_tm14*117*a,5196,0,4,0,5200,0.001,117,2851@TOP@human_GAPDH_TAA_len41_fa0_ta20_fm6_tm14,a
2851@TOP@human_GAPDH_TAA_len41_fa0_ta20_fm6_tm14*118*a,5059,0,116,0,5175,0.022,118,2851@TOP@human_GAPDH_TAA_len41_fa0_ta20_fm6_tm14,a
2851@TOP@human_GAPDH_TAA_len41_fa0_ta20_fm6_tm14*119*g,0,0,5155,0,5155,1.0,119,2851@TOP@human_GAPDH_TAA_len41_fa0_ta20_fm6_tm14,g
2851@TOP@human_GAPDH_TAA_len41_fa0_ta20_fm6_tm14*120*g,0,0,5148,0,5148,1.0,120,2851@TOP@human_GAPDH_TAA_len41_fa0_ta20_fm6_tm14,g
2851@TOP@human_GAPDH_TAA_len41_fa0_ta20_fm6_tm14*121*a,5174,0,7,0,5181,0.001,121,2851@TOP@human_GAPDH_TAA_len41_fa0_ta20_fm6_tm14,a
2851@TOP@human_GAPDH_TAA_len41_fa0_ta20_fm6_tm14*122*g,0,0,5200,0,5200,1.0,122,2851@TOP@human_GAPDH_TAA_len41_fa0_ta20_fm6_tm14,g
2851@TOP@human_GAPDH_TAA_len41_fa0_ta20_fm6_tm14*123*t,1,0,0,5137,5138,0.0,123,2851@TOP@human_GAPDH_TAA_len41_fa0_ta20_fm6_tm14,t
2851@TOP@human_GAPDH_TAA_len41_fa0_ta20_fm6_tm14*124*a,4869,0,213,0,5082,0.042,124,2851@TOP@human_GAPDH_TAA_len41_fa0_ta20_fm6_tm14,a
2851@TOP@human_GAPDH_TAA_len41_fa0_ta20_fm6_tm14*125*a,4672,1,437,0,5110,0.086,125,2851@TOP@human_GAPDH_TAA_len41_fa0_ta20_fm6_tm14,a
2851@TOP@human_GAPDH_TAA_len41_fa0_ta20_fm6_tm14*126*g,0,0,5116,0,5116,1.0,126,2851@TOP@human_GAPDH_TAA_len41_fa0_ta20_fm6_tm14,g
2851@TOP@human_GAPDH_TAA_len41_fa0_ta20_fm6_tm14*127*a,5054,0,121,0,5175,0.023,127,2851@TOP@human_GAPDH_TAA_len41_fa0_ta20_fm6_tm14,a
2851@TOP@human_GAPDH_TAA_len41_fa0_ta20_fm6_tm14*128*c,0,5197,1,0,5198,0.0,128,2851@TOP@human_GAPDH_TAA_len41_fa0_ta20_fm6_tm14,c
2851@TOP@human_GAPDH_TAA_len41_fa0_ta20_fm6_tm14*129*c,0,5155,0,0,5155,0.0,129,2851@TOP@human_GAPDH_TAA_len41_fa0_ta20_fm6_tm14,c
2851@TOP@human_GAPDH_TAA_len41_fa0_ta20_fm6_tm14*130*c,0,5187,0,1,5188,0.0,130,2851@TOP@human_GAPDH_TAA_len41_fa0_ta20_fm6_tm14,c
2851@TOP@human_GAPDH_TAA_len41_fa0_ta20_fm6_tm14*131*c,0,5210,0,0,5210,0.0,131,2851@TOP@human_GAPDH_TAA_len41_fa0_ta20_fm6_tm14,c
2851@TOP@human_GAPDH_TAA_len41_fa0_ta20_fm6_tm14*132*t,1,1,0,5131,5133,0.0,132,2851@TOP@human_GAPDH_TAA_len41_fa0_ta20_fm6_tm14,t
2851@TOP@human_GAPDH_TAA_len41_fa0_ta20_fm6_tm14*133*g,0,0,5130,0,5130,1.0,133,2851@TOP@human_GAPDH_TAA_len41_fa0_ta20_fm6_tm14,g
2851@TOP@human_GAPDH_TAA_len41_fa0_ta20_fm6_tm14*134*g,0,1,5149,1,5151,1.0,134,2851@TOP@human_GAPDH_TAA_len41_fa0_ta20_fm6_tm14,g
2852@TOP@human_GAPDH_TAA_len41_fa0_ta20_fm6_tm14*114*t,1,1,0,3258,3260,0.0,114,2852@TOP@human_GAPDH_TAA_len41_fa0_ta20_fm6_tm14,t
2852@TOP@human_GAPDH_TAA_len41_fa0_ta20_fm6_tm14*115*c,0,3276,0,0,3276,0.0,115,2852@TOP@human_GAPDH_TAA_len41_fa0_ta20_fm6_tm14,c
2852@TOP@human_GAPDH_TAA_len41_fa0_ta20_fm6_tm14*116*c,0,3266,0,0,3266,0.0,116,2852@TOP@human_GAPDH_TAA_len41_fa0_ta20_fm6_tm14,c
2852@TOP@human_GAPDH_TAA_len41_fa0_ta20_fm6_tm14*117*a,3254,0,5,0,3259,0.002,117,2852@TOP@human_GAPDH_TAA_len41_fa0_ta20_fm6_tm14,a
2852@TOP@human_GAPDH_TAA_len41_fa0_ta20_fm6_tm14*118*a,3178,0,68,0,3246,0.021,118,2852@TOP@human_GAPDH_TAA_len41_fa0_ta20_fm6_tm14,a
2852@TOP@human_GAPDH_TAA_len41_fa0_ta20_fm6_tm14*119*g,0,0,3235,1,3236,1.0,119,2852@TOP@human_GAPDH_TAA_len41_fa0_ta20_fm6_tm14,g
2852@TOP@human_GAPDH_TAA_len41_fa0_ta20_fm6_tm14*120*g,0,0,3227,0,3227,1.0,120,2852@TOP@human_GAPDH_TAA_len41_fa0_ta20_fm6_tm14,g
2852@TOP@human_GAPDH_TAA_len41_fa0_ta20_fm6_tm14*121*a,3264,0,9,0,3273,0.003,121,2852@TOP@human_GAPDH_TAA_len41_fa0_ta20_fm6_tm14,a
2852@TOP@human_GAPDH_TAA_len41_fa0_ta20_fm6_tm14*122*g,1,0,3263,0,3264,1.0,122,2852@TOP@human_GAPDH_TAA_len41_fa0_ta20_fm6_tm14,g
2852@TOP@human_GAPDH_TAA_len41_fa0_ta20_fm6_tm14*123*t,0,0,0,3211,3211,0.0,123,2852@TOP@human_GAPDH_TAA_len41_fa0_ta20_fm6_tm14,t
2852@TOP@human_GAPDH_TAA_len41_fa0_ta20_fm6_tm14*124*a,3056,0,156,0,3212,0.049,124,2852@TOP@human_GAPDH_TAA_len41_fa0_ta20_fm6_tm14,a
2852@TOP@human_GAPDH_TAA_len41_fa0_ta20_fm6_tm14*125*a,2788,1,419,0,3208,0.131,125,2852@TOP@human_GAPDH_TAA_len41_fa0_ta20_fm6_tm14,a
2852@TOP@human_GAPDH_TAA_len41_fa0_ta20_fm6_tm14*126*g,0,0,3236,0,3236,1.0,126,2852@TOP@human_GAPDH_TAA_len41_fa0_ta20_fm6_tm14,g
2852@TOP@human_GAPDH_TAA_len41_fa0_ta20_fm6_tm14*127*a,3147,2,103,0,3252,0.032,127,2852@TOP@human_GAPDH_TAA_len41_fa0_ta20_fm6_tm14,a
2852@TOP@human_GAPDH_TAA_len41_fa0_ta20_fm6_tm14*128*c,0,3271,0,0,3271,0.0,128,2852@TOP@human_GAPDH_TAA_len41_fa0_ta20_fm6_tm14,c
2852@TOP@human_GAPDH_TAA_len41_fa0_ta20_fm6_tm14*129*c,0,3244,0,0,3244,0.0,129,2852@TOP@human_GAPDH_TAA_len41_fa0_ta20_fm6_tm14,c
2852@TOP@human_GAPDH_TAA_len41_fa0_ta20_fm6_tm14*130*c,1,3265,0,0,3266,0.0,130,2852@TOP@human_GAPDH_TAA_len41_fa0_ta20_fm6_tm14,c
2852@TOP@human_GAPDH_TAA_len41_fa0_ta20_fm6_tm14*131*c,1,3274,0,0,3275,0.0,131,2852@TOP@human_GAPDH_TAA_len41_fa0_ta20_fm6_tm14,c
2852@TOP@human_GAPDH_TAA_len41_fa0_ta20_fm6_tm14*132*t,0,0,0,3222,3222,0.0,132,2852@TOP@human_GAPDH_TAA_len41_fa0_ta20_fm6_tm14,t
2852@TOP@human_GAPDH_TAA_len41_fa0_ta20_fm6_tm14*133*g,1,0,3215,1,3217,0.999,133,2852@TOP@human_GAPDH_TAA_len41_fa0_ta20_fm6_tm14,g
2852@TOP@human_GAPDH_TAA_len41_fa0_ta20_fm6_tm14*134*g,0,0,3233,0,3233,1.0,134,2852@TOP@human_GAPDH_TAA_len41_fa0_ta20_fm6_tm14,g
2853@TOP@human_GAPDH_TAA_len41_fa0_ta20_fm6_tm14*114*t,1,3,0,12641,12645,0.0,114,2853@TOP@human_GAPDH_TAA_len41_fa0_ta20_fm6_tm14,t
2853@TOP@human_GAPDH_TAA_len41_fa0_ta20_fm6_tm14*115*c,0,12721,0,0,12721,0.0,115,2853@TOP@human_GAPDH_TAA_len41_fa0_ta20_fm6_tm14,c
2853@TOP@human_GAPDH_TAA_len41_fa0_ta20_fm6_tm14*116*c,0,12685,0,0,12685,0.0,116,2853@TOP@human_GAPDH_TAA_len41_fa0_ta20_fm6_tm14,c
2853@TOP@human_GAPDH_TAA_len41_fa0_ta20_fm6_tm14*117*a,12637,0,15,0,12652,0.001,117,2853@TOP@human_GAPDH_TAA_len41_fa0_ta20_fm6_tm14,a
2853@TOP@human_GAPDH_TAA_len41_fa0_ta20_fm6_tm14*118*a,12475,1,136,0,12612,0.011,118,2853@TOP@human_GAPDH_TAA_len41_fa0_ta20_fm6_tm14,a
2853@TOP@human_GAPDH_TAA_len41_fa0_ta20_fm6_tm14*119*g,1,0,12582,4,12587,1.0,119,2853@TOP@human_GAPDH_TAA_len41_fa0_ta20_fm6_tm14,g
2853@TOP@human_GAPDH_TAA_len41_fa0_ta20_fm6_tm14*120*g,1,0,12517,0,12518,1.0,120,2853@TOP@human_GAPDH_TAA_len41_fa0_ta20_fm6_tm14,g
2853@TOP@human_GAPDH_TAA_len41_fa0_ta20_fm6_tm14*121*a,12653,0,3,0,12656,0.0,121,2853@TOP@human_GAPDH_TAA_len41_fa0_ta20_fm6_tm14,a
2853@TOP@human_GAPDH_TAA_len41_fa0_ta20_fm6_tm14*122*g,2,0,12663,0,12665,1.0,122,2853@TOP@human_GAPDH_TAA_len41_fa0_ta20_fm6_tm14,g
2853@TOP@human_GAPDH_TAA_len41_fa0_ta20_fm6_tm14*123*t,0,1,1,12533,12535,0.0,123,2853@TOP@human_GAPDH_TAA_len41_fa0_ta20_fm6_tm14,t
2853@TOP@human_GAPDH_TAA_len41_fa0_ta20_fm6_tm14*124*a,6047,0,6513,0,12560,0.519,124,2853@TOP@human_GAPDH_TAA_len41_fa0_ta20_fm6_tm14,a
2853@TOP@human_GAPDH_TAA_len41_fa0_ta20_fm6_tm14*125*a,7987,0,4500,0,12487,0.36,125,2853@TOP@human_GAPDH_TAA_len41_fa0_ta20_fm6_tm14,a
2853@TOP@human_GAPDH_TAA_len41_fa0_ta20_fm6_tm14*126*g,3,0,12540,0,12543,1.0,126,2853@TOP@human_GAPDH_TAA_len41_fa0_ta20_fm6_tm14,g
2853@TOP@human_GAPDH_TAA_len41_fa0_ta20_fm6_tm14*127*a,12183,2,463,0,12648,0.037,127,2853@TOP@human_GAPDH_TAA_len41_fa0_ta20_fm6_tm14,a
2853@TOP@human_GAPDH_TAA_len41_fa0_ta20_fm6_tm14*128*c,0,12692,0,3,12695,0.0,128,2853@TOP@human_GAPDH_TAA_len41_fa0_ta20_fm6_tm14,c
2853@TOP@human_GAPDH_TAA_len41_fa0_ta20_fm6_tm14*129*c,0,12614,0,4,12618,0.0,129,2853@TOP@human_GAPDH_TAA_len41_fa0_ta20_fm6_tm14,c
2853@TOP@human_GAPDH_TAA_len41_fa0_ta20_fm6_tm14*130*c,4,12677,0,0,12681,0.0,130,2853@TOP@human_GAPDH_TAA_len41_fa0_ta20_fm6_tm14,c
2853@TOP@human_GAPDH_TAA_len41_fa0_ta20_fm6_tm14*131*c,3,12701,0,0,12704,0.0,131,2853@TOP@human_GAPDH_TAA_len41_fa0_ta20_fm6_tm14,c
2853@TOP@human_GAPDH_TAA_len41_fa0_ta20_fm6_tm14*132*t,1,2,4,12562,12569,0.0,132,2853@TOP@human_GAPDH_TAA_len41_fa0_ta20_fm6_tm14,t
2853@TOP@human_GAPDH_TAA_len41_fa0_ta20_fm6_tm14*133*g,3,0,12522,0,12525,1.0,133,2853@TOP@human_GAPDH_TAA_len41_fa0_ta20_fm6_tm14,g
2853@TOP@human_GAPDH_TAA_len41_fa0_ta20_fm6_tm14*134*g,0,1,12577,0,12578,1.0,134,2853@TOP@human_GAPDH_TAA_len41_fa0_ta20_fm6_tm14,g
2854@TOP@human_GAPDH_TAA_len41_fa0_ta20_fm6_tm14*114*t,0,0,0,291,291,0.0,114,2854@TOP@human_GAPDH_TAA_len41_fa0_ta20_fm6_tm14,t
2854@TOP@human_GAPDH_TAA_len41_fa0_ta20_fm6_tm14*115*c,0,294,0,0,294,0.0,115,2854@TOP@human_GAPDH_TAA_len41_fa0_ta20_fm6_tm14,c
2854@TOP@human_GAPDH_TAA_len41_fa0_ta20_fm6_tm14*116*c,0,294,0,0,294,0.0,116,2854@TOP@human_GAPDH_TAA_len41_fa0_ta20_fm6_tm14,c
2854@TOP@human_GAPDH_TAA_len41_fa0_ta20_fm6_tm14*117*a,293,0,1,0,294,0.003,117,2854@TOP@human_GAPDH_TAA_len41_fa0_ta20_fm6_tm14,a
2854@TOP@human_GAPDH_TAA_len41_fa0_ta20_fm6_tm14*118*a,284,0,10,0,294,0.034,118,2854@TOP@human_GAPDH_TAA_len41_fa0_ta20_fm6_tm14,a
2854@TOP@human_GAPDH_TAA_len41_fa0_ta20_fm6_tm14*119*g,0,0,286,0,286,1.0,119,2854@TOP@human_GAPDH_TAA_len41_fa0_ta20_fm6_tm14,g
2854@TOP@human_GAPDH_TAA_len41_fa0_ta20_fm6_tm14*120*g,0,0,286,0,286,1.0,120,2854@TOP@human_GAPDH_TAA_len41_fa0_ta20_fm6_tm14,g
2854@TOP@human_GAPDH_TAA_len41_fa0_ta20_fm6_tm14*121*a,295,0,1,0,296,0.003,121,2854@TOP@human_GAPDH_TAA_len41_fa0_ta20_fm6_tm14,a
2854@TOP@human_GAPDH_TAA_len41_fa0_ta20_fm6_tm14*122*g,0,0,296,0,296,1.0,122,2854@TOP@human_GAPDH_TAA_len41_fa0_ta20_fm6_tm14,g
2854@TOP@human_GAPDH_TAA_len41_fa0_ta20_fm6_tm14*123*t,0,0,0,286,286,0.0,123,2854@TOP@human_GAPDH_TAA_len41_fa0_ta20_fm6_tm14,t
2854@TOP@human_GAPDH_TAA_len41_fa0_ta20_fm6_tm14*124*a,243,0,46,0,289,0.159,124,2854@TOP@human_GAPDH_TAA_len41_fa0_ta20_fm6_tm14,a
2854@TOP@human_GAPDH_TAA_len41_fa0_ta20_fm6_tm14*125*a,241,0,51,0,292,0.175,125,2854@TOP@human_GAPDH_TAA_len41_fa0_ta20_fm6_tm14,a
2854@TOP@human_GAPDH_TAA_len41_fa0_ta20_fm6_tm14*126*g,0,0,289,0,289,1.0,126,2854@TOP@human_GAPDH_TAA_len41_fa0_ta20_fm6_tm14,g
2854@TOP@human_GAPDH_TAA_len41_fa0_ta20_fm6_tm14*127*a,291,0,2,0,293,0.007,127,2854@TOP@human_GAPDH_TAA_len41_fa0_ta20_fm6_tm14,a
2854@TOP@human_GAPDH_TAA_len41_fa0_ta20_fm6_tm14*128*c,0,296,0,0,296,0.0,128,2854@TOP@human_GAPDH_TAA_len41_fa0_ta20_fm6_tm14,c
2854@TOP@human_GAPDH_TAA_len41_fa0_ta20_fm6_tm14*129*c,0,290,0,0,290,0.0,129,2854@TOP@human_GAPDH_TAA_len41_fa0_ta20_fm6_tm14,c
2854@TOP@human_GAPDH_TAA_len41_fa0_ta20_fm6_tm14*130*c,0,294,0,0,294,0.0,130,2854@TOP@human_GAPDH_TAA_len41_fa0_ta20_fm6_tm14,c
2854@TOP@human_GAPDH_TAA_len41_fa0_ta20_fm6_tm14*131*c,0,296,0,0,296,0.0,131,2854@TOP@human_GAPDH_TAA_len41_fa0_ta20_fm6_tm14,c
2854@TOP@human_GAPDH_TAA_len41_fa0_ta20_fm6_tm14*132*t,0,0,0,290,290,0.0,132,2854@TOP@human_GAPDH_TAA_len41_fa0_ta20_fm6_tm14,t
2854@TOP@human_GAPDH_TAA_len41_fa0_ta20_fm6_tm14*133*g,0,0,288,0,288,1.0,133,2854@TOP@human_GAPDH_TAA_len41_fa0_ta20_fm6_tm14,g
2854@TOP@human_GAPDH_TAA_len41_fa0_ta20_fm6_tm14*134*g,0,0,292,0,292,1.0,134,2854@TOP@human_GAPDH_TAA_len41_fa0_ta20_fm6_tm14,g
2855@TOP@human_GAPDH_TAA_len41_fa0_ta20_fm6_tm14*114*t,0,0,0,1202,1202,0.0,114,2855@TOP@human_GAPDH_TAA_len41_fa0_ta20_fm6_tm14,t
2855@TOP@human_GAPDH_TAA_len41_fa0_ta20_fm6_tm14*115*c,0,1212,0,0,1212,0.0,115,2855@TOP@human_GAPDH_TAA_len41_fa0_ta20_fm6_tm14,c
2855@TOP@human_GAPDH_TAA_len41_fa0_ta20_fm6_tm14*116*c,0,1203,0,0,1203,0.0,116,2855@TOP@human_GAPDH_TAA_len41_fa0_ta20_fm6_tm14,c
2855@TOP@human_GAPDH_TAA_len41_fa0_ta20_fm6_tm14*117*a,1198,0,2,0,1200,0.002,117,2855@TOP@human_GAPDH_TAA_len41_fa0_ta20_fm6_tm14,a
2855@TOP@human_GAPDH_TAA_len41_fa0_ta20_fm6_tm14*118*a,1152,0,49,0,1201,0.041,118,2855@TOP@human_GAPDH_TAA_len41_fa0_ta20_fm6_tm14,a
2855@TOP@human_GAPDH_TAA_len41_fa0_ta20_fm6_tm14*119*g,0,0,1192,0,1192,1.0,119,2855@TOP@human_GAPDH_TAA_len41_fa0_ta20_fm6_tm14,g
2855@TOP@human_GAPDH_TAA_len41_fa0_ta20_fm6_tm14*120*g,0,0,1186,0,1186,1.0,120,2855@TOP@human_GAPDH_TAA_len41_fa0_ta20_fm6_tm14,g
2855@TOP@human_GAPDH_TAA_len41_fa0_ta20_fm6_tm14*121*a,1206,0,1,0,1207,0.001,121,2855@TOP@human_GAPDH_TAA_len41_fa0_ta20_fm6_tm14,a
2855@TOP@human_GAPDH_TAA_len41_fa0_ta20_fm6_tm14*122*g,0,0,1198,0,1198,1.0,122,2855@TOP@human_GAPDH_TAA_len41_fa0_ta20_fm6_tm14,g
2855@TOP@human_GAPDH_TAA_len41_fa0_ta20_fm6_tm14*123*t,0,0,1,1185,1186,0.001,123,2855@TOP@human_GAPDH_TAA_len41_fa0_ta20_fm6_tm14,t
2855@TOP@human_GAPDH_TAA_len41_fa0_ta20_fm6_tm14*124*a,808,1,375,0,1184,0.317,124,2855@TOP@human_GAPDH_TAA_len41_fa0_ta20_fm6_tm14,a
2855@TOP@human_GAPDH_TAA_len41_fa0_ta20_fm6_tm14*125*a,1011,0,177,0,1188,0.149,125,2855@TOP@human_GAPDH_TAA_len41_fa0_ta20_fm6_tm14,a
2855@TOP@human_GAPDH_TAA_len41_fa0_ta20_fm6_tm14*126*g,0,0,1190,0,1190,1.0,126,2855@TOP@human_GAPDH_TAA_len41_fa0_ta20_fm6_tm14,g
2855@TOP@human_GAPDH_TAA_len41_fa0_ta20_fm6_tm14*127*a,1201,0,5,1,1207,0.004,127,2855@TOP@human_GAPDH_TAA_len41_fa0_ta20_fm6_tm14,a
2855@TOP@human_GAPDH_TAA_len41_fa0_ta20_fm6_tm14*128*c,0,1212,0,0,1212,0.0,128,2855@TOP@human_GAPDH_TAA_len41_fa0_ta20_fm6_tm14,c
2855@TOP@human_GAPDH_TAA_len41_fa0_ta20_fm6_tm14*129*c,2,1202,0,0,1204,0.0,129,2855@TOP@human_GAPDH_TAA_len41_fa0_ta20_fm6_tm14,c
2855@TOP@human_GAPDH_TAA_len41_fa0_ta20_fm6_tm14*130*c,3,1204,0,0,1207,0.0,130,2855@TOP@human_GAPDH_TAA_len41_fa0_ta20_fm6_tm14,c
2855@TOP@human_GAPDH_TAA_len41_fa0_ta20_fm6_tm14*131*c,0,1207,0,0,1207,0.0,131,2855@TOP@human_GAPDH_TAA_len41_fa0_ta20_fm6_tm14,c
2855@TOP@human_GAPDH_TAA_len41_fa0_ta20_fm6_tm14*132*t,0,0,0,1184,1184,0.0,132,2855@TOP@human_GAPDH_TAA_len41_fa0_ta20_fm6_tm14,t
2855@TOP@human_GAPDH_TAA_len41_fa0_ta20_fm6_tm14*133*g,0,0,1191,0,1191,1.0,133,2855@TOP@human_GAPDH_TAA_len41_fa0_ta20_fm6_tm14,g
2855@TOP@human_GAPDH_TAA_len41_fa0_ta20_fm6_tm14*134*g,0,0,1199,0,1199,1.0,134,2855@TOP@human_GAPDH_TAA_len41_fa0_ta20_fm6_tm14,g
2856@TOP@human_GAPDH_TAA_len41_fa0_ta20_fm6_tm14*114*t,0,0,0,519,519,0.0,114,2856@TOP@human_GAPDH_TAA_len41_fa0_ta20_fm6_tm14,t
2856@TOP@human_GAPDH_TAA_len41_fa0_ta20_fm6_tm14*115*c,0,528,0,0,528,0.0,115,2856@TOP@human_GAPDH_TAA_len41_fa0_ta20_fm6_tm14,c
2856@TOP@human_GAPDH_TAA_len41_fa0_ta20_fm6_tm14*116*c,0,522,0,0,522,0.0,116,2856@TOP@human_GAPDH_TAA_len41_fa0_ta20_fm6_tm14,c
2856@TOP@human_GAPDH_TAA_len41_fa0_ta20_fm6_tm14*117*a,526,0,1,0,527,0.002,117,2856@TOP@human_GAPDH_TAA_len41_fa0_ta20_fm6_tm14,a
2856@TOP@human_GAPDH_TAA_len41_fa0_ta20_fm6_tm14*118*a,514,0,7,0,521,0.013,118,2856@TOP@human_GAPDH_TAA_len41_fa0_ta20_fm6_tm14,a
2856@TOP@human_GAPDH_TAA_len41_fa0_ta20_fm6_tm14*119*g,0,0,521,0,521,1.0,119,2856@TOP@human_GAPDH_TAA_len41_fa0_ta20_fm6_tm14,g
2856@TOP@human_GAPDH_TAA_len41_fa0_ta20_fm6_tm14*120*g,0,0,506,0,506,1.0,120,2856@TOP@human_GAPDH_TAA_len41_fa0_ta20_fm6_tm14,g
2856@TOP@human_GAPDH_TAA_len41_fa0_ta20_fm6_tm14*121*a,526,0,0,0,526,0.0,121,2856@TOP@human_GAPDH_TAA_len41_fa0_ta20_fm6_tm14,a
2856@TOP@human_GAPDH_TAA_len41_fa0_ta20_fm6_tm14*122*g,0,0,527,0,527,1.0,122,2856@TOP@human_GAPDH_TAA_len41_fa0_ta20_fm6_tm14,g
2856@TOP@human_GAPDH_TAA_len41_fa0_ta20_fm6_tm14*123*t,2,0,0,503,505,0.0,123,2856@TOP@human_GAPDH_TAA_len41_fa0_ta20_fm6_tm14,t
2856@TOP@human_GAPDH_TAA_len41_fa0_ta20_fm6_tm14*124*a,391,0,128,0,519,0.247,124,2856@TOP@human_GAPDH_TAA_len41_fa0_ta20_fm6_tm14,a
2856@TOP@human_GAPDH_TAA_len41_fa0_ta20_fm6_tm14*125*a,441,0,76,0,517,0.147,125,2856@TOP@human_GAPDH_TAA_len41_fa0_ta20_fm6_tm14,a
2856@TOP@human_GAPDH_TAA_len41_fa0_ta20_fm6_tm14*126*g,0,0,514,0,514,1.0,126,2856@TOP@human_GAPDH_TAA_len41_fa0_ta20_fm6_tm14,g
2856@TOP@human_GAPDH_TAA_len41_fa0_ta20_fm6_tm14*127*a,519,0,6,0,525,0.011,127,2856@TOP@human_GAPDH_TAA_len41_fa0_ta20_fm6_tm14,a
2856@TOP@human_GAPDH_TAA_len41_fa0_ta20_fm6_tm14*128*c,0,528,0,0,528,0.0,128,2856@TOP@human_GAPDH_TAA_len41_fa0_ta20_fm6_tm14,c
2856@TOP@human_GAPDH_TAA_len41_fa0_ta20_fm6_tm14*129*c,0,521,0,0,521,0.0,129,2856@TOP@human_GAPDH_TAA_len41_fa0_ta20_fm6_tm14,c
2856@TOP@human_GAPDH_TAA_len41_fa0_ta20_fm6_tm14*130*c,0,521,0,0,521,0.0,130,2856@TOP@human_GAPDH_TAA_len41_fa0_ta20_fm6_tm14,c
2856@TOP@human_GAPDH_TAA_len41_fa0_ta20_fm6_tm14*131*c,0,527,0,0,527,0.0,131,2856@TOP@human_GAPDH_TAA_len41_fa0_ta20_fm6_tm14,c
2856@TOP@human_GAPDH_TAA_len41_fa0_ta20_fm6_tm14*132*t,0,0,0,514,514,0.0,132,2856@TOP@human_GAPDH_TAA_len41_fa0_ta20_fm6_tm14,t
2856@TOP@human_GAPDH_TAA_len41_fa0_ta20_fm6_tm14*133*g,0,0,516,0,516,1.0,133,2856@TOP@human_GAPDH_TAA_len41_fa0_ta20_fm6_tm14,g
2856@TOP@human_GAPDH_TAA_len41_fa0_ta20_fm6_tm14*134*g,0,0,524,0,524,1.0,134,2856@TOP@human_GAPDH_TAA_len41_fa0_ta20_fm6_tm14,g
2857@TOP@human_GAPDH_TAA_len41_fa0_ta20_fm6_tm14*114*t,0,0,0,2572,2572,0.0,114,2857@TOP@human_GAPDH_TAA_len41_fa0_ta20_fm6_tm14,t
2857@TOP@human_GAPDH_TAA_len41_fa0_ta20_fm6_tm14*115*c,0,2587,0,0,2587,0.0,115,2857@TOP@human_GAPDH_TAA_len41_fa0_ta20_fm6_tm14,c
2857@TOP@human_GAPDH_TAA_len41_fa0_ta20_fm6_tm14*116*c,0,2583,0,0,2583,0.0,116,2857@TOP@human_GAPDH_TAA_len41_fa0_ta20_fm6_tm14,c
2857@TOP@human_GAPDH_TAA_len41_fa0_ta20_fm6_tm14*117*a,2570,0,3,0,2573,0.001,117,2857@TOP@human_GAPDH_TAA_len41_fa0_ta20_fm6_tm14,a
2857@TOP@human_GAPDH_TAA_len41_fa0_ta20_fm6_tm14*118*a,2499,0,59,0,2558,0.023,118,2857@TOP@human_GAPDH_TAA_len41_fa0_ta20_fm6_tm14,a
2857@TOP@human_GAPDH_TAA_len41_fa0_ta20_fm6_tm14*119*g,0,0,2563,0,2563,1.0,119,2857@TOP@human_GAPDH_TAA_len41_fa0_ta20_fm6_tm14,g
2857@TOP@human_GAPDH_TAA_len41_fa0_ta20_fm6_tm14*120*g,0,1,2550,0,2551,1.0,120,2857@TOP@human_GAPDH_TAA_len41_fa0_ta20_fm6_tm14,g
2857@TOP@human_GAPDH_TAA_len41_fa0_ta20_fm6_tm14*121*a,2567,0,5,1,2573,0.002,121,2857@TOP@human_GAPDH_TAA_len41_fa0_ta20_fm6_tm14,a
2857@TOP@human_GAPDH_TAA_len41_fa0_ta20_fm6_tm14*122*g,0,0,2580,0,2580,1.0,122,2857@TOP@human_GAPDH_TAA_len41_fa0_ta20_fm6_tm14,g
2857@TOP@human_GAPDH_TAA_len41_fa0_ta20_fm6_tm14*123*t,0,0,0,2554,2554,0.0,123,2857@TOP@human_GAPDH_TAA_len41_fa0_ta20_fm6_tm14,t
2857@TOP@human_GAPDH_TAA_len41_fa0_ta20_fm6_tm14*124*a,1503,0,1046,0,2549,0.41,124,2857@TOP@human_GAPDH_TAA_len41_fa0_ta20_fm6_tm14,a
2857@TOP@human_GAPDH_TAA_len41_fa0_ta20_fm6_tm14*125*a,1980,0,553,1,2534,0.218,125,2857@TOP@human_GAPDH_TAA_len41_fa0_ta20_fm6_tm14,a
2857@TOP@human_GAPDH_TAA_len41_fa0_ta20_fm6_tm14*126*g,0,0,2534,0,2534,1.0,126,2857@TOP@human_GAPDH_TAA_len41_fa0_ta20_fm6_tm14,g
2857@TOP@human_GAPDH_TAA_len41_fa0_ta20_fm6_tm14*127*a,2558,0,5,0,2563,0.002,127,2857@TOP@human_GAPDH_TAA_len41_fa0_ta20_fm6_tm14,a
2857@TOP@human_GAPDH_TAA_len41_fa0_ta20_fm6_tm14*128*c,0,2573,0,9,2582,0.0,128,2857@TOP@human_GAPDH_TAA_len41_fa0_ta20_fm6_tm14,c
2857@TOP@human_GAPDH_TAA_len41_fa0_ta20_fm6_tm14*129*c,0,2573,0,0,2573,0.0,129,2857@TOP@human_GAPDH_TAA_len41_fa0_ta20_fm6_tm14,c
2857@TOP@human_GAPDH_TAA_len41_fa0_ta20_fm6_tm14*130*c,0,2578,0,1,2579,0.0,130,2857@TOP@human_GAPDH_TAA_len41_fa0_ta20_fm6_tm14,c
2857@TOP@human_GAPDH_TAA_len41_fa0_ta20_fm6_tm14*131*c,1,2583,0,0,2584,0.0,131,2857@TOP@human_GAPDH_TAA_len41_fa0_ta20_fm6_tm14,c
2857@TOP@human_GAPDH_TAA_len41_fa0_ta20_fm6_tm14*132*t,0,0,0,2540,2540,0.0,132,2857@TOP@human_GAPDH_TAA_len41_fa0_ta20_fm6_tm14,t
2857@TOP@human_GAPDH_TAA_len41_fa0_ta20_fm6_tm14*133*g,0,0,2544,0,2544,1.0,133,2857@TOP@human_GAPDH_TAA_len41_fa0_ta20_fm6_tm14,g
2857@TOP@human_GAPDH_TAA_len41_fa0_ta20_fm6_tm14*134*g,0,0,2565,0,2565,1.0,134,2857@TOP@human_GAPDH_TAA_len41_fa0_ta20_fm6_tm14,g
2858@TOP@human_GAPDH_TAA_len41_fa0_ta20_fm6_tm14*114*t,0,0,0,1251,1251,0.0,114,2858@TOP@human_GAPDH_TAA_len41_fa0_ta20_fm6_tm14,t
2858@TOP@human_GAPDH_TAA_len41_fa0_ta20_fm6_tm14*115*c,0,1259,0,0,1259,0.0,115,2858@TOP@human_GAPDH_TAA_len41_fa0_ta20_fm6_tm14,c
2858@TOP@human_GAPDH_TAA_len41_fa0_ta20_fm6_tm14*116*c,0,1255,0,0,1255,0.0,116,2858@TOP@human_GAPDH_TAA_len41_fa0_ta20_fm6_tm14,c
2858@TOP@human_GAPDH_TAA_len41_fa0_ta20_fm6_tm14*117*a,1246,0,8,0,1254,0.006,117,2858@TOP@human_GAPDH_TAA_len41_fa0_ta20_fm6_tm14,a
2858@TOP@human_GAPDH_TAA_len41_fa0_ta20_fm6_tm14*118*a,1183,0,55,0,1238,0.044,118,2858@TOP@human_GAPDH_TAA_len41_fa0_ta20_fm6_tm14,a
2858@TOP@human_GAPDH_TAA_len41_fa0_ta20_fm6_tm14*119*g,0,0,1234,0,1234,1.0,119,2858@TOP@human_GAPDH_TAA_len41_fa0_ta20_fm6_tm14,g
2858@TOP@human_GAPDH_TAA_len41_fa0_ta20_fm6_tm14*120*g,0,0,1235,0,1235,1.0,120,2858@TOP@human_GAPDH_TAA_len41_fa0_ta20_fm6_tm14,g
2858@TOP@human_GAPDH_TAA_len41_fa0_ta20_fm6_tm14*121*a,1241,0,2,0,1243,0.002,121,2858@TOP@human_GAPDH_TAA_len41_fa0_ta20_fm6_tm14,a
2858@TOP@human_GAPDH_TAA_len41_fa0_ta20_fm6_tm14*122*g,0,0,1252,0,1252,1.0,122,2858@TOP@human_GAPDH_TAA_len41_fa0_ta20_fm6_tm14,g
2858@TOP@human_GAPDH_TAA_len41_fa0_ta20_fm6_tm14*123*t,0,0,0,1234,1234,0.0,123,2858@TOP@human_GAPDH_TAA_len41_fa0_ta20_fm6_tm14,t
2858@TOP@human_GAPDH_TAA_len41_fa0_ta20_fm6_tm14*124*a,893,0,333,0,1226,0.272,124,2858@TOP@human_GAPDH_TAA_len41_fa0_ta20_fm6_tm14,a
2858@TOP@human_GAPDH_TAA_len41_fa0_ta20_fm6_tm14*125*a,1084,0,130,0,1214,0.107,125,2858@TOP@human_GAPDH_TAA_len41_fa0_ta20_fm6_tm14,a
2858@TOP@human_GAPDH_TAA_len41_fa0_ta20_fm6_tm14*126*g,0,0,1233,0,1233,1.0,126,2858@TOP@human_GAPDH_TAA_len41_fa0_ta20_fm6_tm14,g
2858@TOP@human_GAPDH_TAA_len41_fa0_ta20_fm6_tm14*127*a,1239,0,2,0,1241,0.002,127,2858@TOP@human_GAPDH_TAA_len41_fa0_ta20_fm6_tm14,a
2858@TOP@human_GAPDH_TAA_len41_fa0_ta20_fm6_tm14*128*c,0,1257,0,0,1257,0.0,128,2858@TOP@human_GAPDH_TAA_len41_fa0_ta20_fm6_tm14,c
2858@TOP@human_GAPDH_TAA_len41_fa0_ta20_fm6_tm14*129*c,0,1236,0,1,1237,0.0,129,2858@TOP@human_GAPDH_TAA_len41_fa0_ta20_fm6_tm14,c
2858@TOP@human_GAPDH_TAA_len41_fa0_ta20_fm6_tm14*130*c,0,1253,0,0,1253,0.0,130,2858@TOP@human_GAPDH_TAA_len41_fa0_ta20_fm6_tm14,c
2858@TOP@human_GAPDH_TAA_len41_fa0_ta20_fm6_tm14*131*c,0,1255,0,0,1255,0.0,131,2858@TOP@human_GAPDH_TAA_len41_fa0_ta20_fm6_tm14,c
2858@TOP@human_GAPDH_TAA_len41_fa0_ta20_fm6_tm14*132*t,0,0,0,1236,1236,0.0,132,2858@TOP@human_GAPDH_TAA_len41_fa0_ta20_fm6_tm14,t
2858@TOP@human_GAPDH_TAA_len41_fa0_ta20_fm6_tm14*133*g,0,0,1241,0,1241,1.0,133,2858@TOP@human_GAPDH_TAA_len41_fa0_ta20_fm6_tm14,g
2858@TOP@human_GAPDH_TAA_len41_fa0_ta20_fm6_tm14*134*g,0,0,1240,0,1240,1.0,134,2858@TOP@human_GAPDH_TAA_len41_fa0_ta20_fm6_tm14,g
2859@TOP@human_GAPDH_TAA_len41_fa0_ta20_fm6_tm14*114*t,0,0,0,7689,7689,0.0,114,2859@TOP@human_GAPDH_TAA_len41_fa0_ta20_fm6_tm14,t
2859@TOP@human_GAPDH_TAA_len41_fa0_ta20_fm6_tm14*115*c,1,7719,0,1,7721,0.0,115,2859@TOP@human_GAPDH_TAA_len41_fa0_ta20_fm6_tm14,c
2859@TOP@human_GAPDH_TAA_len41_fa0_ta20_fm6_tm14*116*c,0,7691,0,0,7691,0.0,116,2859@TOP@human_GAPDH_TAA_len41_fa0_ta20_fm6_tm14,c
2859@TOP@human_GAPDH_TAA_len41_fa0_ta20_fm6_tm14*117*a,7688,0,3,0,7691,0.0,117,2859@TOP@human_GAPDH_TAA_len41_fa0_ta20_fm6_tm14,a
2859@TOP@human_GAPDH_TAA_len41_fa0_ta20_fm6_tm14*118*a,7545,0,107,0,7652,0.014,118,2859@TOP@human_GAPDH_TAA_len41_fa0_ta20_fm6_tm14,a
2859@TOP@human_GAPDH_TAA_len41_fa0_ta20_fm6_tm14*119*g,1,0,7645,0,7646,1.0,119,2859@TOP@human_GAPDH_TAA_len41_fa0_ta20_fm6_tm14,g
2859@TOP@human_GAPDH_TAA_len41_fa0_ta20_fm6_tm14*120*g,1,0,7571,0,7572,1.0,120,2859@TOP@human_GAPDH_TAA_len41_fa0_ta20_fm6_tm14,g
2859@TOP@human_GAPDH_TAA_len41_fa0_ta20_fm6_tm14*121*a,7685,0,4,0,7689,0.001,121,2859@TOP@human_GAPDH_TAA_len41_fa0_ta20_fm6_tm14,a
2859@TOP@human_GAPDH_TAA_len41_fa0_ta20_fm6_tm14*122*g,0,0,7695,0,7695,1.0,122,2859@TOP@human_GAPDH_TAA_len41_fa0_ta20_fm6_tm14,g
2859@TOP@human_GAPDH_TAA_len41_fa0_ta20_fm6_tm14*123*t,1,6,0,7592,7599,0.0,123,2859@TOP@human_GAPDH_TAA_len41_fa0_ta20_fm6_tm14,t
2859@TOP@human_GAPDH_TAA_len41_fa0_ta20_fm6_tm14*124*a,7339,0,195,0,7534,0.026,124,2859@TOP@human_GAPDH_TAA_len41_fa0_ta20_fm6_tm14,a
2859@TOP@human_GAPDH_TAA_len41_fa0_ta20_fm6_tm14*125*a,7065,0,479,0,7544,0.063,125,2859@TOP@human_GAPDH_TAA_len41_fa0_ta20_fm6_tm14,a
2859@TOP@human_GAPDH_TAA_len41_fa0_ta20_fm6_tm14*126*g,0,0,7585,0,7585,1.0,126,2859@TOP@human_GAPDH_TAA_len41_fa0_ta20_fm6_tm14,g
2859@TOP@human_GAPDH_TAA_len41_fa0_ta20_fm6_tm14*127*a,7505,2,160,0,7667,0.021,127,2859@TOP@human_GAPDH_TAA_len41_fa0_ta20_fm6_tm14,a
2859@TOP@human_GAPDH_TAA_len41_fa0_ta20_fm6_tm14*128*c,0,7705,2,0,7707,0.0,128,2859@TOP@human_GAPDH_TAA_len41_fa0_ta20_fm6_tm14,c
2859@TOP@human_GAPDH_TAA_len41_fa0_ta20_fm6_tm14*129*c,1,7656,0,0,7657,0.0,129,2859@TOP@human_GAPDH_TAA_len41_fa0_ta20_fm6_tm14,c
2859@TOP@human_GAPDH_TAA_len41_fa0_ta20_fm6_tm14*130*c,2,7688,0,0,7690,0.0,130,2859@TOP@human_GAPDH_TAA_len41_fa0_ta20_fm6_tm14,c
2859@TOP@human_GAPDH_TAA_len41_fa0_ta20_fm6_tm14*131*c,0,7701,0,2,7703,0.0,131,2859@TOP@human_GAPDH_TAA_len41_fa0_ta20_fm6_tm14,c
2859@TOP@human_GAPDH_TAA_len41_fa0_ta20_fm6_tm14*132*t,1,1,0,7598,7600,0.0,132,2859@TOP@human_GAPDH_TAA_len41_fa0_ta20_fm6_tm14,t
2859@TOP@human_GAPDH_TAA_len41_fa0_ta20_fm6_tm14*133*g,2,0,7591,0,7593,1.0,133,2859@TOP@human_GAPDH_TAA_len41_fa0_ta20_fm6_tm14,g
2859@TOP@human_GAPDH_TAA_len41_fa0_ta20_fm6_tm14*134*g,0,3,7620,0,7623,1.0,134,2859@TOP@human_GAPDH_TAA_len41_fa0_ta20_fm6_tm14,g
2860@TOP@human_GAPDH_TAA_len41_fa10_ta10_fm10_tm10*114*t,0,8,0,13260,13268,0.0,114,2860@TOP@human_GAPDH_TAA_len41_fa10_ta10_fm10_tm10,t
2860@TOP@human_GAPDH_TAA_len41_fa10_ta10_fm10_tm10*115*c,1,13354,0,0,13355,0.0,115,2860@TOP@human_GAPDH_TAA_len41_fa10_ta10_fm10_tm10,c
2860@TOP@human_GAPDH_TAA_len41_fa10_ta10_fm10_tm10*116*c,0,13293,0,0,13293,0.0,116,2860@TOP@human_GAPDH_TAA_len41_fa10_ta10_fm10_tm10,c
2860@TOP@human_GAPDH_TAA_len41_fa10_ta10_fm10_tm10*117*a,13267,0,21,0,13288,0.002,117,2860@TOP@human_GAPDH_TAA_len41_fa10_ta10_fm10_tm10,a
2860@TOP@human_GAPDH_TAA_len41_fa10_ta10_fm10_tm10*118*a,13059,0,138,0,13197,0.01,118,2860@TOP@human_GAPDH_TAA_len41_fa10_ta10_fm10_tm10,a
2860@TOP@human_GAPDH_TAA_len41_fa10_ta10_fm10_tm10*119*g,0,0,13207,0,13207,1.0,119,2860@TOP@human_GAPDH_TAA_len41_fa10_ta10_fm10_tm10,g
2860@TOP@human_GAPDH_TAA_len41_fa10_ta10_fm10_tm10*120*g,1,0,13160,0,13161,1.0,120,2860@TOP@human_GAPDH_TAA_len41_fa10_ta10_fm10_tm10,g
2860@TOP@human_GAPDH_TAA_len41_fa10_ta10_fm10_tm10*121*a,13232,0,30,0,13262,0.002,121,2860@TOP@human_GAPDH_TAA_len41_fa10_ta10_fm10_tm10,a
2860@TOP@human_GAPDH_TAA_len41_fa10_ta10_fm10_tm10*122*g,1,0,13308,0,13309,1.0,122,2860@TOP@human_GAPDH_TAA_len41_fa10_ta10_fm10_tm10,g
2860@TOP@human_GAPDH_TAA_len41_fa10_ta10_fm10_tm10*123*t,0,0,0,13102,13102,0.0,123,2860@TOP@human_GAPDH_TAA_len41_fa10_ta10_fm10_tm10,t
2860@TOP@human_GAPDH_TAA_len41_fa10_ta10_fm10_tm10*124*a,10781,0,2285,2,13068,0.175,124,2860@TOP@human_GAPDH_TAA_len41_fa10_ta10_fm10_tm10,a
2860@TOP@human_GAPDH_TAA_len41_fa10_ta10_fm10_tm10*125*a,12077,1,964,2,13044,0.074,125,2860@TOP@human_GAPDH_TAA_len41_fa10_ta10_fm10_tm10,a
2860@TOP@human_GAPDH_TAA_len41_fa10_ta10_fm10_tm10*126*g,1,0,13111,0,13112,1.0,126,2860@TOP@human_GAPDH_TAA_len41_fa10_ta10_fm10_tm10,g
2860@TOP@human_GAPDH_TAA_len41_fa10_ta10_fm10_tm10*127*a,13230,0,11,0,13241,0.001,127,2860@TOP@human_GAPDH_TAA_len41_fa10_ta10_fm10_tm10,a
2860@TOP@human_GAPDH_TAA_len41_fa10_ta10_fm10_tm10*128*c,0,13332,1,0,13333,0.0,128,2860@TOP@human_GAPDH_TAA_len41_fa10_ta10_fm10_tm10,c
2860@TOP@human_GAPDH_TAA_len41_fa10_ta10_fm10_tm10*129*c,0,13233,0,0,13233,0.0,129,2860@TOP@human_GAPDH_TAA_len41_fa10_ta10_fm10_tm10,c
2860@TOP@human_GAPDH_TAA_len41_fa10_ta10_fm10_tm10*130*c,1,13298,0,0,13299,0.0,130,2860@TOP@human_GAPDH_TAA_len41_fa10_ta10_fm10_tm10,c
2860@TOP@human_GAPDH_TAA_len41_fa10_ta10_fm10_tm10*131*c,1,13333,0,0,13334,0.0,131,2860@TOP@human_GAPDH_TAA_len41_fa10_ta10_fm10_tm10,c
2860@TOP@human_GAPDH_TAA_len41_fa10_ta10_fm10_tm10*132*t,2,6,2,13137,13147,0.0,132,2860@TOP@human_GAPDH_TAA_len41_fa10_ta10_fm10_tm10,t
2860@TOP@human_GAPDH_TAA_len41_fa10_ta10_fm10_tm10*133*g,2,0,13110,2,13114,1.0,133,2860@TOP@human_GAPDH_TAA_len41_fa10_ta10_fm10_tm10,g
2860@TOP@human_GAPDH_TAA_len41_fa10_ta10_fm10_tm10*134*g,1,11,13158,0,13170,0.999,134,2860@TOP@human_GAPDH_TAA_len41_fa10_ta10_fm10_tm10,g
2861@TOP@human_GAPDH_TAA_len41_fa10_ta10_fm10_tm10*114*t,1,0,0,2175,2176,0.0,114,2861@TOP@human_GAPDH_TAA_len41_fa10_ta10_fm10_tm10,t
2861@TOP@human_GAPDH_TAA_len41_fa10_ta10_fm10_tm10*115*c,0,2186,0,0,2186,0.0,115,2861@TOP@human_GAPDH_TAA_len41_fa10_ta10_fm10_tm10,c
2861@TOP@human_GAPDH_TAA_len41_fa10_ta10_fm10_tm10*116*c,0,2181,0,0,2181,0.0,116,2861@TOP@human_GAPDH_TAA_len41_fa10_ta10_fm10_tm10,c
2861@TOP@human_GAPDH_TAA_len41_fa10_ta10_fm10_tm10*117*a,2076,0,96,0,2172,0.044,117,2861@TOP@human_GAPDH_TAA_len41_fa10_ta10_fm10_tm10,a
2861@TOP@human_GAPDH_TAA_len41_fa10_ta10_fm10_tm10*118*a,1433,0,725,0,2158,0.336,118,2861@TOP@human_GAPDH_TAA_len41_fa10_ta10_fm10_tm10,a
2861@TOP@human_GAPDH_TAA_len41_fa10_ta10_fm10_tm10*119*g,0,0,2141,0,2141,1.0,119,2861@TOP@human_GAPDH_TAA_len41_fa10_ta10_fm10_tm10,g
2861@TOP@human_GAPDH_TAA_len41_fa10_ta10_fm10_tm10*120*g,0,0,2158,0,2158,1.0,120,2861@TOP@human_GAPDH_TAA_len41_fa10_ta10_fm10_tm10,g
2861@TOP@human_GAPDH_TAA_len41_fa10_ta10_fm10_tm10*121*a,2160,0,4,0,2164,0.002,121,2861@TOP@human_GAPDH_TAA_len41_fa10_ta10_fm10_tm10,a
2861@TOP@human_GAPDH_TAA_len41_fa10_ta10_fm10_tm10*122*g,0,0,2175,0,2175,1.0,122,2861@TOP@human_GAPDH_TAA_len41_fa10_ta10_fm10_tm10,g
2861@TOP@human_GAPDH_TAA_len41_fa10_ta10_fm10_tm10*123*t,1,3,0,2135,2139,0.0,123,2861@TOP@human_GAPDH_TAA_len41_fa10_ta10_fm10_tm10,t
2861@TOP@human_GAPDH_TAA_len41_fa10_ta10_fm10_tm10*124*a,1379,0,766,0,2145,0.357,124,2861@TOP@human_GAPDH_TAA_len41_fa10_ta10_fm10_tm10,a
2861@TOP@human_GAPDH_TAA_len41_fa10_ta10_fm10_tm10*125*a,1611,0,534,0,2145,0.249,125,2861@TOP@human_GAPDH_TAA_len41_fa10_ta10_fm10_tm10,a
2861@TOP@human_GAPDH_TAA_len41_fa10_ta10_fm10_tm10*126*g,0,0,2152,0,2152,1.0,126,2861@TOP@human_GAPDH_TAA_len41_fa10_ta10_fm10_tm10,g
2861@TOP@human_GAPDH_TAA_len41_fa10_ta10_fm10_tm10*127*a,2173,0,2,0,2175,0.001,127,2861@TOP@human_GAPDH_TAA_len41_fa10_ta10_fm10_tm10,a
2861@TOP@human_GAPDH_TAA_len41_fa10_ta10_fm10_tm10*128*c,0,2182,0,0,2182,0.0,128,2861@TOP@human_GAPDH_TAA_len41_fa10_ta10_fm10_tm10,c
2861@TOP@human_GAPDH_TAA_len41_fa10_ta10_fm10_tm10*129*c,1,2173,0,0,2174,0.0,129,2861@TOP@human_GAPDH_TAA_len41_fa10_ta10_fm10_tm10,c
2861@TOP@human_GAPDH_TAA_len41_fa10_ta10_fm10_tm10*130*c,0,2181,0,0,2181,0.0,130,2861@TOP@human_GAPDH_TAA_len41_fa10_ta10_fm10_tm10,c
2861@TOP@human_GAPDH_TAA_len41_fa10_ta10_fm10_tm10*131*c,1,2182,0,0,2183,0.0,131,2861@TOP@human_GAPDH_TAA_len41_fa10_ta10_fm10_tm10,c
2861@TOP@human_GAPDH_TAA_len41_fa10_ta10_fm10_tm10*132*t,0,0,0,2154,2154,0.0,132,2861@TOP@human_GAPDH_TAA_len41_fa10_ta10_fm10_tm10,t
2861@TOP@human_GAPDH_TAA_len41_fa10_ta10_fm10_tm10*133*g,1,0,2142,0,2143,1.0,133,2861@TOP@human_GAPDH_TAA_len41_fa10_ta10_fm10_tm10,g
2861@TOP@human_GAPDH_TAA_len41_fa10_ta10_fm10_tm10*134*g,0,0,2151,0,2151,1.0,134,2861@TOP@human_GAPDH_TAA_len41_fa10_ta10_fm10_tm10,g
2862@TOP@human_GAPDH_TAA_len41_fa10_ta10_fm10_tm10*114*t,4,3,0,7695,7702,0.0,114,2862@TOP@human_GAPDH_TAA_len41_fa10_ta10_fm10_tm10,t
2862@TOP@human_GAPDH_TAA_len41_fa10_ta10_fm10_tm10*115*c,0,7755,0,0,7755,0.0,115,2862@TOP@human_GAPDH_TAA_len41_fa10_ta10_fm10_tm10,c
2862@TOP@human_GAPDH_TAA_len41_fa10_ta10_fm10_tm10*116*c,0,7728,0,0,7728,0.0,116,2862@TOP@human_GAPDH_TAA_len41_fa10_ta10_fm10_tm10,c
2862@TOP@human_GAPDH_TAA_len41_fa10_ta10_fm10_tm10*117*a,7564,1,141,0,7706,0.018,117,2862@TOP@human_GAPDH_TAA_len41_fa10_ta10_fm10_tm10,a
2862@TOP@human_GAPDH_TAA_len41_fa10_ta10_fm10_tm10*118*a,6633,0,1040,0,7673,0.136,118,2862@TOP@human_GAPDH_TAA_len41_fa10_ta10_fm10_tm10,a
2862@TOP@human_GAPDH_TAA_len41_fa10_ta10_fm10_tm10*119*g,0,0,7652,4,7656,0.999,119,2862@TOP@human_GAPDH_TAA_len41_fa10_ta10_fm10_tm10,g
2862@TOP@human_GAPDH_TAA_len41_fa10_ta10_fm10_tm10*120*g,0,0,7632,0,7632,1.0,120,2862@TOP@human_GAPDH_TAA_len41_fa10_ta10_fm10_tm10,g
2862@TOP@human_GAPDH_TAA_len41_fa10_ta10_fm10_tm10*121*a,7689,0,7,0,7696,0.001,121,2862@TOP@human_GAPDH_TAA_len41_fa10_ta10_fm10_tm10,a
2862@TOP@human_GAPDH_TAA_len41_fa10_ta10_fm10_tm10*122*g,0,0,7721,0,7721,1.0,122,2862@TOP@human_GAPDH_TAA_len41_fa10_ta10_fm10_tm10,g
2862@TOP@human_GAPDH_TAA_len41_fa10_ta10_fm10_tm10*123*t,2,4,0,7582,7588,0.0,123,2862@TOP@human_GAPDH_TAA_len41_fa10_ta10_fm10_tm10,t
2862@TOP@human_GAPDH_TAA_len41_fa10_ta10_fm10_tm10*124*a,6305,0,1290,0,7595,0.17,124,2862@TOP@human_GAPDH_TAA_len41_fa10_ta10_fm10_tm10,a
2862@TOP@human_GAPDH_TAA_len41_fa10_ta10_fm10_tm10*125*a,6970,2,627,0,7599,0.083,125,2862@TOP@human_GAPDH_TAA_len41_fa10_ta10_fm10_tm10,a
2862@TOP@human_GAPDH_TAA_len41_fa10_ta10_fm10_tm10*126*g,0,0,7653,0,7653,1.0,126,2862@TOP@human_GAPDH_TAA_len41_fa10_ta10_fm10_tm10,g
2862@TOP@human_GAPDH_TAA_len41_fa10_ta10_fm10_tm10*127*a,7690,0,3,0,7693,0.0,127,2862@TOP@human_GAPDH_TAA_len41_fa10_ta10_fm10_tm10,a
2862@TOP@human_GAPDH_TAA_len41_fa10_ta10_fm10_tm10*128*c,0,7741,1,1,7743,0.0,128,2862@TOP@human_GAPDH_TAA_len41_fa10_ta10_fm10_tm10,c
2862@TOP@human_GAPDH_TAA_len41_fa10_ta10_fm10_tm10*129*c,0,7682,0,0,7682,0.0,129,2862@TOP@human_GAPDH_TAA_len41_fa10_ta10_fm10_tm10,c
2862@TOP@human_GAPDH_TAA_len41_fa10_ta10_fm10_tm10*130*c,0,7727,0,0,7727,0.0,130,2862@TOP@human_GAPDH_TAA_len41_fa10_ta10_fm10_tm10,c
2862@TOP@human_GAPDH_TAA_len41_fa10_ta10_fm10_tm10*131*c,0,7741,0,0,7741,0.0,131,2862@TOP@human_GAPDH_TAA_len41_fa10_ta10_fm10_tm10,c
2862@TOP@human_GAPDH_TAA_len41_fa10_ta10_fm10_tm10*132*t,1,0,1,7619,7621,0.0,132,2862@TOP@human_GAPDH_TAA_len41_fa10_ta10_fm10_tm10,t
2862@TOP@human_GAPDH_TAA_len41_fa10_ta10_fm10_tm10*133*g,1,0,7608,0,7609,1.0,133,2862@TOP@human_GAPDH_TAA_len41_fa10_ta10_fm10_tm10,g
2862@TOP@human_GAPDH_TAA_len41_fa10_ta10_fm10_tm10*134*g,0,3,7650,1,7654,0.999,134,2862@TOP@human_GAPDH_TAA_len41_fa10_ta10_fm10_tm10,g
2863@TOP@human_GAPDH_TAA_len41_fa10_ta10_fm10_tm10*114*t,0,3,0,3508,3511,0.0,114,2863@TOP@human_GAPDH_TAA_len41_fa10_ta10_fm10_tm10,t
2863@TOP@human_GAPDH_TAA_len41_fa10_ta10_fm10_tm10*115*c,0,3534,0,0,3534,0.0,115,2863@TOP@human_GAPDH_TAA_len41_fa10_ta10_fm10_tm10,c
2863@TOP@human_GAPDH_TAA_len41_fa10_ta10_fm10_tm10*116*c,0,3520,0,0,3520,0.0,116,2863@TOP@human_GAPDH_TAA_len41_fa10_ta10_fm10_tm10,c
2863@TOP@human_GAPDH_TAA_len41_fa10_ta10_fm10_tm10*117*a,3488,0,33,0,3521,0.009,117,2863@TOP@human_GAPDH_TAA_len41_fa10_ta10_fm10_tm10,a
2863@TOP@human_GAPDH_TAA_len41_fa10_ta10_fm10_tm10*118*a,3305,0,195,0,3500,0.056,118,2863@TOP@human_GAPDH_TAA_len41_fa10_ta10_fm10_tm10,a
2863@TOP@human_GAPDH_TAA_len41_fa10_ta10_fm10_tm10*119*g,0,0,3495,0,3495,1.0,119,2863@TOP@human_GAPDH_TAA_len41_fa10_ta10_fm10_tm10,g
2863@TOP@human_GAPDH_TAA_len41_fa10_ta10_fm10_tm10*120*g,1,0,3473,1,3475,0.999,120,2863@TOP@human_GAPDH_TAA_len41_fa10_ta10_fm10_tm10,g
2863@TOP@human_GAPDH_TAA_len41_fa10_ta10_fm10_tm10*121*a,3511,0,1,0,3512,0.0,121,2863@TOP@human_GAPDH_TAA_len41_fa10_ta10_fm10_tm10,a
2863@TOP@human_GAPDH_TAA_len41_fa10_ta10_fm10_tm10*122*g,0,0,3518,0,3518,1.0,122,2863@TOP@human_GAPDH_TAA_len41_fa10_ta10_fm10_tm10,g
2863@TOP@human_GAPDH_TAA_len41_fa10_ta10_fm10_tm10*123*t,3,5,0,3456,3464,0.0,123,2863@TOP@human_GAPDH_TAA_len41_fa10_ta10_fm10_tm10,t
2863@TOP@human_GAPDH_TAA_len41_fa10_ta10_fm10_tm10*124*a,3253,0,212,0,3465,0.061,124,2863@TOP@human_GAPDH_TAA_len41_fa10_ta10_fm10_tm10,a
2863@TOP@human_GAPDH_TAA_len41_fa10_ta10_fm10_tm10*125*a,3298,0,156,0,3454,0.045,125,2863@TOP@human_GAPDH_TAA_len41_fa10_ta10_fm10_tm10,a
2863@TOP@human_GAPDH_TAA_len41_fa10_ta10_fm10_tm10*126*g,3,0,3467,0,3470,0.999,126,2863@TOP@human_GAPDH_TAA_len41_fa10_ta10_fm10_tm10,g
2863@TOP@human_GAPDH_TAA_len41_fa10_ta10_fm10_tm10*127*a,3511,0,3,0,3514,0.001,127,2863@TOP@human_GAPDH_TAA_len41_fa10_ta10_fm10_tm10,a
2863@TOP@human_GAPDH_TAA_len41_fa10_ta10_fm10_tm10*128*c,0,3527,1,1,3529,0.0,128,2863@TOP@human_GAPDH_TAA_len41_fa10_ta10_fm10_tm10,c
2863@TOP@human_GAPDH_TAA_len41_fa10_ta10_fm10_tm10*129*c,0,3496,0,3,3499,0.0,129,2863@TOP@human_GAPDH_TAA_len41_fa10_ta10_fm10_tm10,c
2863@TOP@human_GAPDH_TAA_len41_fa10_ta10_fm10_tm10*130*c,0,3522,0,0,3522,0.0,130,2863@TOP@human_GAPDH_TAA_len41_fa10_ta10_fm10_tm10,c
2863@TOP@human_GAPDH_TAA_len41_fa10_ta10_fm10_tm10*131*c,0,3532,0,0,3532,0.0,131,2863@TOP@human_GAPDH_TAA_len41_fa10_ta10_fm10_tm10,c
2863@TOP@human_GAPDH_TAA_len41_fa10_ta10_fm10_tm10*132*t,0,1,2,3476,3479,0.001,132,2863@TOP@human_GAPDH_TAA_len41_fa10_ta10_fm10_tm10,t
2863@TOP@human_GAPDH_TAA_len41_fa10_ta10_fm10_tm10*133*g,0,0,3466,1,3467,1.0,133,2863@TOP@human_GAPDH_TAA_len41_fa10_ta10_fm10_tm10,g
2863@TOP@human_GAPDH_TAA_len41_fa10_ta10_fm10_tm10*134*g,0,0,3478,2,3480,0.999,134,2863@TOP@human_GAPDH_TAA_len41_fa10_ta10_fm10_tm10,g
2864@TOP@human_GAPDH_TAA_len41_fa10_ta10_fm10_tm10*114*t,0,2,1,26387,26390,0.0,114,2864@TOP@human_GAPDH_TAA_len41_fa10_ta10_fm10_tm10,t
2864@TOP@human_GAPDH_TAA_len41_fa10_ta10_fm10_tm10*115*c,0,26540,0,0,26540,0.0,115,2864@TOP@human_GAPDH_TAA_len41_fa10_ta10_fm10_tm10,c
2864@TOP@human_GAPDH_TAA_len41_fa10_ta10_fm10_tm10*116*c,1,26425,0,5,26431,0.0,116,2864@TOP@human_GAPDH_TAA_len41_fa10_ta10_fm10_tm10,c
2864@TOP@human_GAPDH_TAA_len41_fa10_ta10_fm10_tm10*117*a,26392,2,41,2,26437,0.002,117,2864@TOP@human_GAPDH_TAA_len41_fa10_ta10_fm10_tm10,a
2864@TOP@human_GAPDH_TAA_len41_fa10_ta10_fm10_tm10*118*a,25765,1,514,0,26280,0.02,118,2864@TOP@human_GAPDH_TAA_len41_fa10_ta10_fm10_tm10,a
2864@TOP@human_GAPDH_TAA_len41_fa10_ta10_fm10_tm10*119*g,0,0,26173,0,26173,1.0,119,2864@TOP@human_GAPDH_TAA_len41_fa10_ta10_fm10_tm10,g
2864@TOP@human_GAPDH_TAA_len41_fa10_ta10_fm10_tm10*120*g,1,1,26121,3,26126,1.0,120,2864@TOP@human_GAPDH_TAA_len41_fa10_ta10_fm10_tm10,g
2864@TOP@human_GAPDH_TAA_len41_fa10_ta10_fm10_tm10*121*a,26409,0,12,0,26421,0.0,121,2864@TOP@human_GAPDH_TAA_len41_fa10_ta10_fm10_tm10,a
2864@TOP@human_GAPDH_TAA_len41_fa10_ta10_fm10_tm10*122*g,3,0,26450,0,26453,1.0,122,2864@TOP@human_GAPDH_TAA_len41_fa10_ta10_fm10_tm10,g
2864@TOP@human_GAPDH_TAA_len41_fa10_ta10_fm10_tm10*123*t,6,2,0,26104,26112,0.0,123,2864@TOP@human_GAPDH_TAA_len41_fa10_ta10_fm10_tm10,t
2864@TOP@human_GAPDH_TAA_len41_fa10_ta10_fm10_tm10*124*a,24651,0,1374,0,26025,0.053,124,2864@TOP@human_GAPDH_TAA_len41_fa10_ta10_fm10_tm10,a
2864@TOP@human_GAPDH_TAA_len41_fa10_ta10_fm10_tm10*125*a,25577,0,430,3,26010,0.017,125,2864@TOP@human_GAPDH_TAA_len41_fa10_ta10_fm10_tm10,a
2864@TOP@human_GAPDH_TAA_len41_fa10_ta10_fm10_tm10*126*g,1,0,26077,1,26079,1.0,126,2864@TOP@human_GAPDH_TAA_len41_fa10_ta10_fm10_tm10,g
2864@TOP@human_GAPDH_TAA_len41_fa10_ta10_fm10_tm10*127*a,26339,8,14,1,26362,0.001,127,2864@TOP@human_GAPDH_TAA_len41_fa10_ta10_fm10_tm10,a
2864@TOP@human_GAPDH_TAA_len41_fa10_ta10_fm10_tm10*128*c,0,26469,4,2,26475,0.0,128,2864@TOP@human_GAPDH_TAA_len41_fa10_ta10_fm10_tm10,c
2864@TOP@human_GAPDH_TAA_len41_fa10_ta10_fm10_tm10*129*c,2,26271,2,2,26277,0.0,129,2864@TOP@human_GAPDH_TAA_len41_fa10_ta10_fm10_tm10,c
2864@TOP@human_GAPDH_TAA_len41_fa10_ta10_fm10_tm10*130*c,2,26427,1,1,26431,0.0,130,2864@TOP@human_GAPDH_TAA_len41_fa10_ta10_fm10_tm10,c
2864@TOP@human_GAPDH_TAA_len41_fa10_ta10_fm10_tm10*131*c,3,26483,0,2,26488,0.0,131,2864@TOP@human_GAPDH_TAA_len41_fa10_ta10_fm10_tm10,c
2864@TOP@human_GAPDH_TAA_len41_fa10_ta10_fm10_tm10*132*t,1,1,5,26112,26119,0.0,132,2864@TOP@human_GAPDH_TAA_len41_fa10_ta10_fm10_tm10,t
2864@TOP@human_GAPDH_TAA_len41_fa10_ta10_fm10_tm10*133*g,1,0,26018,2,26021,1.0,133,2864@TOP@human_GAPDH_TAA_len41_fa10_ta10_fm10_tm10,g
2864@TOP@human_GAPDH_TAA_len41_fa10_ta10_fm10_tm10*134*g,0,5,26201,2,26208,1.0,134,2864@TOP@human_GAPDH_TAA_len41_fa10_ta10_fm10_tm10,g
2865@TOP@human_GAPDH_TAA_len41_fa10_ta10_fm10_tm10*114*t,0,0,0,637,637,0.0,114,2865@TOP@human_GAPDH_TAA_len41_fa10_ta10_fm10_tm10,t
2865@TOP@human_GAPDH_TAA_len41_fa10_ta10_fm10_tm10*115*c,0,646,0,0,646,0.0,115,2865@TOP@human_GAPDH_TAA_len41_fa10_ta10_fm10_tm10,c
2865@TOP@human_GAPDH_TAA_len41_fa10_ta10_fm10_tm10*116*c,0,639,0,0,639,0.0,116,2865@TOP@human_GAPDH_TAA_len41_fa10_ta10_fm10_tm10,c
2865@TOP@human_GAPDH_TAA_len41_fa10_ta10_fm10_tm10*117*a,639,0,3,0,642,0.005,117,2865@TOP@human_GAPDH_TAA_len41_fa10_ta10_fm10_tm10,a
2865@TOP@human_GAPDH_TAA_len41_fa10_ta10_fm10_tm10*118*a,602,0,34,0,636,0.053,118,2865@TOP@human_GAPDH_TAA_len41_fa10_ta10_fm10_tm10,a
2865@TOP@human_GAPDH_TAA_len41_fa10_ta10_fm10_tm10*119*g,0,0,639,0,639,1.0,119,2865@TOP@human_GAPDH_TAA_len41_fa10_ta10_fm10_tm10,g
2865@TOP@human_GAPDH_TAA_len41_fa10_ta10_fm10_tm10*120*g,0,0,628,0,628,1.0,120,2865@TOP@human_GAPDH_TAA_len41_fa10_ta10_fm10_tm10,g
2865@TOP@human_GAPDH_TAA_len41_fa10_ta10_fm10_tm10*121*a,640,0,0,0,640,0.0,121,2865@TOP@human_GAPDH_TAA_len41_fa10_ta10_fm10_tm10,a
2865@TOP@human_GAPDH_TAA_len41_fa10_ta10_fm10_tm10*122*g,0,0,638,0,638,1.0,122,2865@TOP@human_GAPDH_TAA_len41_fa10_ta10_fm10_tm10,g
2865@TOP@human_GAPDH_TAA_len41_fa10_ta10_fm10_tm10*123*t,0,0,1,631,632,0.002,123,2865@TOP@human_GAPDH_TAA_len41_fa10_ta10_fm10_tm10,t
2865@TOP@human_GAPDH_TAA_len41_fa10_ta10_fm10_tm10*124*a,540,0,88,0,628,0.14,124,2865@TOP@human_GAPDH_TAA_len41_fa10_ta10_fm10_tm10,a
2865@TOP@human_GAPDH_TAA_len41_fa10_ta10_fm10_tm10*125*a,567,0,54,0,621,0.087,125,2865@TOP@human_GAPDH_TAA_len41_fa10_ta10_fm10_tm10,a
2865@TOP@human_GAPDH_TAA_len41_fa10_ta10_fm10_tm10*126*g,0,2,628,0,630,0.997,126,2865@TOP@human_GAPDH_TAA_len41_fa10_ta10_fm10_tm10,g
2865@TOP@human_GAPDH_TAA_len41_fa10_ta10_fm10_tm10*127*a,635,0,1,0,636,0.002,127,2865@TOP@human_GAPDH_TAA_len41_fa10_ta10_fm10_tm10,a
2865@TOP@human_GAPDH_TAA_len41_fa10_ta10_fm10_tm10*128*c,0,642,0,0,642,0.0,128,2865@TOP@human_GAPDH_TAA_len41_fa10_ta10_fm10_tm10,c
2865@TOP@human_GAPDH_TAA_len41_fa10_ta10_fm10_tm10*129*c,0,638,0,0,638,0.0,129,2865@TOP@human_GAPDH_TAA_len41_fa10_ta10_fm10_tm10,c
2865@TOP@human_GAPDH_TAA_len41_fa10_ta10_fm10_tm10*130*c,0,639,0,0,639,0.0,130,2865@TOP@human_GAPDH_TAA_len41_fa10_ta10_fm10_tm10,c
2865@TOP@human_GAPDH_TAA_len41_fa10_ta10_fm10_tm10*131*c,0,643,0,0,643,0.0,131,2865@TOP@human_GAPDH_TAA_len41_fa10_ta10_fm10_tm10,c
2865@TOP@human_GAPDH_TAA_len41_fa10_ta10_fm10_tm10*132*t,0,0,63,573,636,0.099,132,2865@TOP@human_GAPDH_TAA_len41_fa10_ta10_fm10_tm10,t
2865@TOP@human_GAPDH_TAA_len41_fa10_ta10_fm10_tm10*133*g,0,0,569,63,632,0.9,133,2865@TOP@human_GAPDH_TAA_len41_fa10_ta10_fm10_tm10,g
2865@TOP@human_GAPDH_TAA_len41_fa10_ta10_fm10_tm10*134*g,0,0,635,2,637,0.997,134,2865@TOP@human_GAPDH_TAA_len41_fa10_ta10_fm10_tm10,g
2866@TOP@human_GAPDH_TAA_len41_fa10_ta10_fm10_tm10*114*t,1,3,0,9563,9567,0.0,114,2866@TOP@human_GAPDH_TAA_len41_fa10_ta10_fm10_tm10,t
2866@TOP@human_GAPDH_TAA_len41_fa10_ta10_fm10_tm10*115*c,0,9626,0,0,9626,0.0,115,2866@TOP@human_GAPDH_TAA_len41_fa10_ta10_fm10_tm10,c
2866@TOP@human_GAPDH_TAA_len41_fa10_ta10_fm10_tm10*116*c,0,9577,0,0,9577,0.0,116,2866@TOP@human_GAPDH_TAA_len41_fa10_ta10_fm10_tm10,c
2866@TOP@human_GAPDH_TAA_len41_fa10_ta10_fm10_tm10*117*a,9551,0,35,0,9586,0.004,117,2866@TOP@human_GAPDH_TAA_len41_fa10_ta10_fm10_tm10,a
2866@TOP@human_GAPDH_TAA_len41_fa10_ta10_fm10_tm10*118*a,9165,0,369,2,9536,0.039,118,2866@TOP@human_GAPDH_TAA_len41_fa10_ta10_fm10_tm10,a
2866@TOP@human_GAPDH_TAA_len41_fa10_ta10_fm10_tm10*119*g,0,0,9510,1,9511,1.0,119,2866@TOP@human_GAPDH_TAA_len41_fa10_ta10_fm10_tm10,g
2866@TOP@human_GAPDH_TAA_len41_fa10_ta10_fm10_tm10*120*g,1,1,9450,0,9452,1.0,120,2866@TOP@human_GAPDH_TAA_len41_fa10_ta10_fm10_tm10,g
2866@TOP@human_GAPDH_TAA_len41_fa10_ta10_fm10_tm10*121*a,9559,0,5,0,9564,0.001,121,2866@TOP@human_GAPDH_TAA_len41_fa10_ta10_fm10_tm10,a
2866@TOP@human_GAPDH_TAA_len41_fa10_ta10_fm10_tm10*122*g,0,0,9579,0,9579,1.0,122,2866@TOP@human_GAPDH_TAA_len41_fa10_ta10_fm10_tm10,g
2866@TOP@human_GAPDH_TAA_len41_fa10_ta10_fm10_tm10*123*t,0,3,1,9453,9457,0.0,123,2866@TOP@human_GAPDH_TAA_len41_fa10_ta10_fm10_tm10,t
2866@TOP@human_GAPDH_TAA_len41_fa10_ta10_fm10_tm10*124*a,8594,2,836,0,9432,0.089,124,2866@TOP@human_GAPDH_TAA_len41_fa10_ta10_fm10_tm10,a
2866@TOP@human_GAPDH_TAA_len41_fa10_ta10_fm10_tm10*125*a,9083,1,322,0,9406,0.034,125,2866@TOP@human_GAPDH_TAA_len41_fa10_ta10_fm10_tm10,a
2866@TOP@human_GAPDH_TAA_len41_fa10_ta10_fm10_tm10*126*g,0,0,9444,0,9444,1.0,126,2866@TOP@human_GAPDH_TAA_len41_fa10_ta10_fm10_tm10,g
2866@TOP@human_GAPDH_TAA_len41_fa10_ta10_fm10_tm10*127*a,9520,0,31,1,9552,0.003,127,2866@TOP@human_GAPDH_TAA_len41_fa10_ta10_fm10_tm10,a
2866@TOP@human_GAPDH_TAA_len41_fa10_ta10_fm10_tm10*128*c,0,9589,1,0,9590,0.0,128,2866@TOP@human_GAPDH_TAA_len41_fa10_ta10_fm10_tm10,c
2866@TOP@human_GAPDH_TAA_len41_fa10_ta10_fm10_tm10*129*c,1,9528,0,0,9529,0.0,129,2866@TOP@human_GAPDH_TAA_len41_fa10_ta10_fm10_tm10,c
2866@TOP@human_GAPDH_TAA_len41_fa10_ta10_fm10_tm10*130*c,0,9582,0,1,9583,0.0,130,2866@TOP@human_GAPDH_TAA_len41_fa10_ta10_fm10_tm10,c
2866@TOP@human_GAPDH_TAA_len41_fa10_ta10_fm10_tm10*131*c,0,9606,0,1,9607,0.0,131,2866@TOP@human_GAPDH_TAA_len41_fa10_ta10_fm10_tm10,c
2866@TOP@human_GAPDH_TAA_len41_fa10_ta10_fm10_tm10*132*t,1,7,1,9466,9475,0.0,132,2866@TOP@human_GAPDH_TAA_len41_fa10_ta10_fm10_tm10,t
2866@TOP@human_GAPDH_TAA_len41_fa10_ta10_fm10_tm10*133*g,1,0,9441,0,9442,1.0,133,2866@TOP@human_GAPDH_TAA_len41_fa10_ta10_fm10_tm10,g
2866@TOP@human_GAPDH_TAA_len41_fa10_ta10_fm10_tm10*134*g,3,15,9482,0,9500,0.998,134,2866@TOP@human_GAPDH_TAA_len41_fa10_ta10_fm10_tm10,g
2867@TOP@human_GAPDH_TAA_len41_fa10_ta10_fm10_tm10*114*t,1,0,0,503,504,0.0,114,2867@TOP@human_GAPDH_TAA_len41_fa10_ta10_fm10_tm10,t
2867@TOP@human_GAPDH_TAA_len41_fa10_ta10_fm10_tm10*115*c,0,510,0,0,510,0.0,115,2867@TOP@human_GAPDH_TAA_len41_fa10_ta10_fm10_tm10,c
2867@TOP@human_GAPDH_TAA_len41_fa10_ta10_fm10_tm10*116*c,0,502,0,0,502,0.0,116,2867@TOP@human_GAPDH_TAA_len41_fa10_ta10_fm10_tm10,c
2867@TOP@human_GAPDH_TAA_len41_fa10_ta10_fm10_tm10*117*a,508,0,0,0,508,0.0,117,2867@TOP@human_GAPDH_TAA_len41_fa10_ta10_fm10_tm10,a
2867@TOP@human_GAPDH_TAA_len41_fa10_ta10_fm10_tm10*118*a,402,1,98,0,501,0.196,118,2867@TOP@human_GAPDH_TAA_len41_fa10_ta10_fm10_tm10,a
2867@TOP@human_GAPDH_TAA_len41_fa10_ta10_fm10_tm10*119*g,0,0,495,0,495,1.0,119,2867@TOP@human_GAPDH_TAA_len41_fa10_ta10_fm10_tm10,g
2867@TOP@human_GAPDH_TAA_len41_fa10_ta10_fm10_tm10*120*g,0,0,494,0,494,1.0,120,2867@TOP@human_GAPDH_TAA_len41_fa10_ta10_fm10_tm10,g
2867@TOP@human_GAPDH_TAA_len41_fa10_ta10_fm10_tm10*121*a,505,0,0,0,505,0.0,121,2867@TOP@human_GAPDH_TAA_len41_fa10_ta10_fm10_tm10,a
2867@TOP@human_GAPDH_TAA_len41_fa10_ta10_fm10_tm10*122*g,0,0,503,0,503,1.0,122,2867@TOP@human_GAPDH_TAA_len41_fa10_ta10_fm10_tm10,g
2867@TOP@human_GAPDH_TAA_len41_fa10_ta10_fm10_tm10*123*t,0,0,0,490,490,0.0,123,2867@TOP@human_GAPDH_TAA_len41_fa10_ta10_fm10_tm10,t
2867@TOP@human_GAPDH_TAA_len41_fa10_ta10_fm10_tm10*124*a,430,0,66,0,496,0.133,124,2867@TOP@human_GAPDH_TAA_len41_fa10_ta10_fm10_tm10,a
2867@TOP@human_GAPDH_TAA_len41_fa10_ta10_fm10_tm10*125*a,459,0,38,0,497,0.076,125,2867@TOP@human_GAPDH_TAA_len41_fa10_ta10_fm10_tm10,a
2867@TOP@human_GAPDH_TAA_len41_fa10_ta10_fm10_tm10*126*g,0,0,493,0,493,1.0,126,2867@TOP@human_GAPDH_TAA_len41_fa10_ta10_fm10_tm10,g
2867@TOP@human_GAPDH_TAA_len41_fa10_ta10_fm10_tm10*127*a,504,0,1,0,505,0.002,127,2867@TOP@human_GAPDH_TAA_len41_fa10_ta10_fm10_tm10,a
2867@TOP@human_GAPDH_TAA_len41_fa10_ta10_fm10_tm10*128*c,0,504,0,0,504,0.0,128,2867@TOP@human_GAPDH_TAA_len41_fa10_ta10_fm10_tm10,c
2867@TOP@human_GAPDH_TAA_len41_fa10_ta10_fm10_tm10*129*c,0,498,0,0,498,0.0,129,2867@TOP@human_GAPDH_TAA_len41_fa10_ta10_fm10_tm10,c
2867@TOP@human_GAPDH_TAA_len41_fa10_ta10_fm10_tm10*130*c,0,504,0,0,504,0.0,130,2867@TOP@human_GAPDH_TAA_len41_fa10_ta10_fm10_tm10,c
2867@TOP@human_GAPDH_TAA_len41_fa10_ta10_fm10_tm10*131*c,0,505,0,1,506,0.0,131,2867@TOP@human_GAPDH_TAA_len41_fa10_ta10_fm10_tm10,c
2867@TOP@human_GAPDH_TAA_len41_fa10_ta10_fm10_tm10*132*t,0,0,0,503,503,0.0,132,2867@TOP@human_GAPDH_TAA_len41_fa10_ta10_fm10_tm10,t
2867@TOP@human_GAPDH_TAA_len41_fa10_ta10_fm10_tm10*133*g,0,0,496,0,496,1.0,133,2867@TOP@human_GAPDH_TAA_len41_fa10_ta10_fm10_tm10,g
2867@TOP@human_GAPDH_TAA_len41_fa10_ta10_fm10_tm10*134*g,0,0,502,0,502,1.0,134,2867@TOP@human_GAPDH_TAA_len41_fa10_ta10_fm10_tm10,g
2868@TOP@human_GAPDH_TAA_len41_fa10_ta10_fm10_tm10*114*t,0,2,0,2593,2595,0.0,114,2868@TOP@human_GAPDH_TAA_len41_fa10_ta10_fm10_tm10,t
2868@TOP@human_GAPDH_TAA_len41_fa10_ta10_fm10_tm10*115*c,0,2625,0,0,2625,0.0,115,2868@TOP@human_GAPDH_TAA_len41_fa10_ta10_fm10_tm10,c
2868@TOP@human_GAPDH_TAA_len41_fa10_ta10_fm10_tm10*116*c,0,2610,0,0,2610,0.0,116,2868@TOP@human_GAPDH_TAA_len41_fa10_ta10_fm10_tm10,c
2868@TOP@human_GAPDH_TAA_len41_fa10_ta10_fm10_tm10*117*a,2585,0,10,0,2595,0.004,117,2868@TOP@human_GAPDH_TAA_len41_fa10_ta10_fm10_tm10,a
2868@TOP@human_GAPDH_TAA_len41_fa10_ta10_fm10_tm10*118*a,2128,0,451,0,2579,0.175,118,2868@TOP@human_GAPDH_TAA_len41_fa10_ta10_fm10_tm10,a
2868@TOP@human_GAPDH_TAA_len41_fa10_ta10_fm10_tm10*119*g,0,0,2581,0,2581,1.0,119,2868@TOP@human_GAPDH_TAA_len41_fa10_ta10_fm10_tm10,g
2868@TOP@human_GAPDH_TAA_len41_fa10_ta10_fm10_tm10*120*g,0,0,2591,0,2591,1.0,120,2868@TOP@human_GAPDH_TAA_len41_fa10_ta10_fm10_tm10,g
2868@TOP@human_GAPDH_TAA_len41_fa10_ta10_fm10_tm10*121*a,2600,0,0,0,2600,0.0,121,2868@TOP@human_GAPDH_TAA_len41_fa10_ta10_fm10_tm10,a
2868@TOP@human_GAPDH_TAA_len41_fa10_ta10_fm10_tm10*122*g,1,0,2616,0,2617,1.0,122,2868@TOP@human_GAPDH_TAA_len41_fa10_ta10_fm10_tm10,g
2868@TOP@human_GAPDH_TAA_len41_fa10_ta10_fm10_tm10*123*t,1,0,0,2565,2566,0.0,123,2868@TOP@human_GAPDH_TAA_len41_fa10_ta10_fm10_tm10,t
2868@TOP@human_GAPDH_TAA_len41_fa10_ta10_fm10_tm10*124*a,2120,0,448,0,2568,0.174,124,2868@TOP@human_GAPDH_TAA_len41_fa10_ta10_fm10_tm10,a
2868@TOP@human_GAPDH_TAA_len41_fa10_ta10_fm10_tm10*125*a,2432,1,124,0,2557,0.048,125,2868@TOP@human_GAPDH_TAA_len41_fa10_ta10_fm10_tm10,a
2868@TOP@human_GAPDH_TAA_len41_fa10_ta10_fm10_tm10*126*g,0,0,2581,0,2581,1.0,126,2868@TOP@human_GAPDH_TAA_len41_fa10_ta10_fm10_tm10,g
2868@TOP@human_GAPDH_TAA_len41_fa10_ta10_fm10_tm10*127*a,2596,1,2,0,2599,0.001,127,2868@TOP@human_GAPDH_TAA_len41_fa10_ta10_fm10_tm10,a
2868@TOP@human_GAPDH_TAA_len41_fa10_ta10_fm10_tm10*128*c,0,2612,1,2,2615,0.0,128,2868@TOP@human_GAPDH_TAA_len41_fa10_ta10_fm10_tm10,c
2868@TOP@human_GAPDH_TAA_len41_fa10_ta10_fm10_tm10*129*c,0,2592,0,0,2592,0.0,129,2868@TOP@human_GAPDH_TAA_len41_fa10_ta10_fm10_tm10,c
2868@TOP@human_GAPDH_TAA_len41_fa10_ta10_fm10_tm10*130*c,0,2614,0,2,2616,0.0,130,2868@TOP@human_GAPDH_TAA_len41_fa10_ta10_fm10_tm10,c
2868@TOP@human_GAPDH_TAA_len41_fa10_ta10_fm10_tm10*131*c,0,2616,0,0,2616,0.0,131,2868@TOP@human_GAPDH_TAA_len41_fa10_ta10_fm10_tm10,c
2868@TOP@human_GAPDH_TAA_len41_fa10_ta10_fm10_tm10*132*t,0,4,0,2567,2571,0.0,132,2868@TOP@human_GAPDH_TAA_len41_fa10_ta10_fm10_tm10,t
2868@TOP@human_GAPDH_TAA_len41_fa10_ta10_fm10_tm10*133*g,0,0,2570,0,2570,1.0,133,2868@TOP@human_GAPDH_TAA_len41_fa10_ta10_fm10_tm10,g
2868@TOP@human_GAPDH_TAA_len41_fa10_ta10_fm10_tm10*134*g,0,0,2584,0,2584,1.0,134,2868@TOP@human_GAPDH_TAA_len41_fa10_ta10_fm10_tm10,g
2869@TOP@human_GAPDH_TAA_len41_fa10_ta10_fm10_tm10*114*t,6,1,0,18119,18126,0.0,114,2869@TOP@human_GAPDH_TAA_len41_fa10_ta10_fm10_tm10,t
2869@TOP@human_GAPDH_TAA_len41_fa10_ta10_fm10_tm10*115*c,0,18225,0,2,18227,0.0,115,2869@TOP@human_GAPDH_TAA_len41_fa10_ta10_fm10_tm10,c
2869@TOP@human_GAPDH_TAA_len41_fa10_ta10_fm10_tm10*116*c,1,18156,0,2,18159,0.0,116,2869@TOP@human_GAPDH_TAA_len41_fa10_ta10_fm10_tm10,c
2869@TOP@human_GAPDH_TAA_len41_fa10_ta10_fm10_tm10*117*a,18131,1,18,0,18150,0.001,117,2869@TOP@human_GAPDH_TAA_len41_fa10_ta10_fm10_tm10,a
2869@TOP@human_GAPDH_TAA_len41_fa10_ta10_fm10_tm10*118*a,17487,1,567,3,18058,0.031,118,2869@TOP@human_GAPDH_TAA_len41_fa10_ta10_fm10_tm10,a
2869@TOP@human_GAPDH_TAA_len41_fa10_ta10_fm10_tm10*119*g,5,0,18006,2,18013,1.0,119,2869@TOP@human_GAPDH_TAA_len41_fa10_ta10_fm10_tm10,g
2869@TOP@human_GAPDH_TAA_len41_fa10_ta10_fm10_tm10*120*g,1,0,17938,1,17940,1.0,120,2869@TOP@human_GAPDH_TAA_len41_fa10_ta10_fm10_tm10,g
2869@TOP@human_GAPDH_TAA_len41_fa10_ta10_fm10_tm10*121*a,18120,0,9,0,18129,0.0,121,2869@TOP@human_GAPDH_TAA_len41_fa10_ta10_fm10_tm10,a
2869@TOP@human_GAPDH_TAA_len41_fa10_ta10_fm10_tm10*122*g,1,1,18154,1,18157,1.0,122,2869@TOP@human_GAPDH_TAA_len41_fa10_ta10_fm10_tm10,g
2869@TOP@human_GAPDH_TAA_len41_fa10_ta10_fm10_tm10*123*t,2,4,6,17915,17927,0.0,123,2869@TOP@human_GAPDH_TAA_len41_fa10_ta10_fm10_tm10,t
2869@TOP@human_GAPDH_TAA_len41_fa10_ta10_fm10_tm10*124*a,16969,4,888,2,17863,0.05,124,2869@TOP@human_GAPDH_TAA_len41_fa10_ta10_fm10_tm10,a
2869@TOP@human_GAPDH_TAA_len41_fa10_ta10_fm10_tm10*125*a,16306,3,1513,1,17823,0.085,125,2869@TOP@human_GAPDH_TAA_len41_fa10_ta10_fm10_tm10,a
2869@TOP@human_GAPDH_TAA_len41_fa10_ta10_fm10_tm10*126*g,0,3,17906,3,17912,1.0,126,2869@TOP@human_GAPDH_TAA_len41_fa10_ta10_fm10_tm10,g
2869@TOP@human_GAPDH_TAA_len41_fa10_ta10_fm10_tm10*127*a,17992,0,71,0,18063,0.004,127,2869@TOP@human_GAPDH_TAA_len41_fa10_ta10_fm10_tm10,a
2869@TOP@human_GAPDH_TAA_len41_fa10_ta10_fm10_tm10*128*c,0,18191,0,0,18191,0.0,128,2869@TOP@human_GAPDH_TAA_len41_fa10_ta10_fm10_tm10,c
2869@TOP@human_GAPDH_TAA_len41_fa10_ta10_fm10_tm10*129*c,1,18062,0,0,18063,0.0,129,2869@TOP@human_GAPDH_TAA_len41_fa10_ta10_fm10_tm10,c
2869@TOP@human_GAPDH_TAA_len41_fa10_ta10_fm10_tm10*130*c,0,18151,1,2,18154,0.0,130,2869@TOP@human_GAPDH_TAA_len41_fa10_ta10_fm10_tm10,c
2869@TOP@human_GAPDH_TAA_len41_fa10_ta10_fm10_tm10*131*c,1,18193,0,0,18194,0.0,131,2869@TOP@human_GAPDH_TAA_len41_fa10_ta10_fm10_tm10,c
2869@TOP@human_GAPDH_TAA_len41_fa10_ta10_fm10_tm10*132*t,1,12,2,17960,17975,0.0,132,2869@TOP@human_GAPDH_TAA_len41_fa10_ta10_fm10_tm10,t
2869@TOP@human_GAPDH_TAA_len41_fa10_ta10_fm10_tm10*133*g,0,0,17923,1,17924,1.0,133,2869@TOP@human_GAPDH_TAA_len41_fa10_ta10_fm10_tm10,g
2869@TOP@human_GAPDH_TAA_len41_fa10_ta10_fm10_tm10*134*g,1,5,17998,0,18004,1.0,134,2869@TOP@human_GAPDH_TAA_len41_fa10_ta10_fm10_tm10,g
2870@TOP@human_GAPDH_TAA_len41_fa10_ta10_fm10_tm10*114*t,2,7,0,25606,25615,0.0,114,2870@TOP@human_GAPDH_TAA_len41_fa10_ta10_fm10_tm10,t
2870@TOP@human_GAPDH_TAA_len41_fa10_ta10_fm10_tm10*115*c,1,25782,0,2,25785,0.0,115,2870@TOP@human_GAPDH_TAA_len41_fa10_ta10_fm10_tm10,c
2870@TOP@human_GAPDH_TAA_len41_fa10_ta10_fm10_tm10*116*c,0,25674,0,1,25675,0.0,116,2870@TOP@human_GAPDH_TAA_len41_fa10_ta10_fm10_tm10,c
2870@TOP@human_GAPDH_TAA_len41_fa10_ta10_fm10_tm10*117*a,25637,0,27,1,25665,0.001,117,2870@TOP@human_GAPDH_TAA_len41_fa10_ta10_fm10_tm10,a
2870@TOP@human_GAPDH_TAA_len41_fa10_ta10_fm10_tm10*118*a,25060,2,436,1,25499,0.017,118,2870@TOP@human_GAPDH_TAA_len41_fa10_ta10_fm10_tm10,a
2870@TOP@human_GAPDH_TAA_len41_fa10_ta10_fm10_tm10*119*g,0,0,25485,1,25486,1.0,119,2870@TOP@human_GAPDH_TAA_len41_fa10_ta10_fm10_tm10,g
2870@TOP@human_GAPDH_TAA_len41_fa10_ta10_fm10_tm10*120*g,1,0,25368,1,25370,1.0,120,2870@TOP@human_GAPDH_TAA_len41_fa10_ta10_fm10_tm10,g
2870@TOP@human_GAPDH_TAA_len41_fa10_ta10_fm10_tm10*121*a,25646,0,9,0,25655,0.0,121,2870@TOP@human_GAPDH_TAA_len41_fa10_ta10_fm10_tm10,a
2870@TOP@human_GAPDH_TAA_len41_fa10_ta10_fm10_tm10*122*g,1,0,25674,1,25676,1.0,122,2870@TOP@human_GAPDH_TAA_len41_fa10_ta10_fm10_tm10,g
2870@TOP@human_GAPDH_TAA_len41_fa10_ta10_fm10_tm10*123*t,1,4,3,25324,25332,0.0,123,2870@TOP@human_GAPDH_TAA_len41_fa10_ta10_fm10_tm10,t
2870@TOP@human_GAPDH_TAA_len41_fa10_ta10_fm10_tm10*124*a,21993,0,3253,0,25246,0.129,124,2870@TOP@human_GAPDH_TAA_len41_fa10_ta10_fm10_tm10,a
2870@TOP@human_GAPDH_TAA_len41_fa10_ta10_fm10_tm10*125*a,24548,3,696,1,25248,0.028,125,2870@TOP@human_GAPDH_TAA_len41_fa10_ta10_fm10_tm10,a
2870@TOP@human_GAPDH_TAA_len41_fa10_ta10_fm10_tm10*126*g,1,0,25379,1,25381,1.0,126,2870@TOP@human_GAPDH_TAA_len41_fa10_ta10_fm10_tm10,g
2870@TOP@human_GAPDH_TAA_len41_fa10_ta10_fm10_tm10*127*a,25523,0,57,0,25580,0.002,127,2870@TOP@human_GAPDH_TAA_len41_fa10_ta10_fm10_tm10,a
2870@TOP@human_GAPDH_TAA_len41_fa10_ta10_fm10_tm10*128*c,2,25712,5,1,25720,0.0,128,2870@TOP@human_GAPDH_TAA_len41_fa10_ta10_fm10_tm10,c
2870@TOP@human_GAPDH_TAA_len41_fa10_ta10_fm10_tm10*129*c,0,25552,0,1,25553,0.0,129,2870@TOP@human_GAPDH_TAA_len41_fa10_ta10_fm10_tm10,c
2870@TOP@human_GAPDH_TAA_len41_fa10_ta10_fm10_tm10*130*c,1,25694,0,5,25700,0.0,130,2870@TOP@human_GAPDH_TAA_len41_fa10_ta10_fm10_tm10,c
2870@TOP@human_GAPDH_TAA_len41_fa10_ta10_fm10_tm10*131*c,1,25724,0,4,25729,0.0,131,2870@TOP@human_GAPDH_TAA_len41_fa10_ta10_fm10_tm10,c
2870@TOP@human_GAPDH_TAA_len41_fa10_ta10_fm10_tm10*132*t,1,16,0,25346,25363,0.0,132,2870@TOP@human_GAPDH_TAA_len41_fa10_ta10_fm10_tm10,t
2870@TOP@human_GAPDH_TAA_len41_fa10_ta10_fm10_tm10*133*g,1,1,25307,0,25309,1.0,133,2870@TOP@human_GAPDH_TAA_len41_fa10_ta10_fm10_tm10,g
2870@TOP@human_GAPDH_TAA_len41_fa10_ta10_fm10_tm10*134*g,1,6,25445,1,25453,1.0,134,2870@TOP@human_GAPDH_TAA_len41_fa10_ta10_fm10_tm10,g
2871@TOP@human_GAPDH_TAA_len41_fa10_ta10_fm10_tm10*114*t,0,0,0,3883,3883,0.0,114,2871@TOP@human_GAPDH_TAA_len41_fa10_ta10_fm10_tm10,t
2871@TOP@human_GAPDH_TAA_len41_fa10_ta10_fm10_tm10*115*c,0,3895,1,0,3896,0.0,115,2871@TOP@human_GAPDH_TAA_len41_fa10_ta10_fm10_tm10,c
2871@TOP@human_GAPDH_TAA_len41_fa10_ta10_fm10_tm10*116*c,0,3889,0,1,3890,0.0,116,2871@TOP@human_GAPDH_TAA_len41_fa10_ta10_fm10_tm10,c
2871@TOP@human_GAPDH_TAA_len41_fa10_ta10_fm10_tm10*117*a,3848,2,15,0,3865,0.004,117,2871@TOP@human_GAPDH_TAA_len41_fa10_ta10_fm10_tm10,a
2871@TOP@human_GAPDH_TAA_len41_fa10_ta10_fm10_tm10*118*a,3000,0,857,0,3857,0.222,118,2871@TOP@human_GAPDH_TAA_len41_fa10_ta10_fm10_tm10,a
2871@TOP@human_GAPDH_TAA_len41_fa10_ta10_fm10_tm10*119*g,0,0,3850,0,3850,1.0,119,2871@TOP@human_GAPDH_TAA_len41_fa10_ta10_fm10_tm10,g
2871@TOP@human_GAPDH_TAA_len41_fa10_ta10_fm10_tm10*120*g,0,0,3848,0,3848,1.0,120,2871@TOP@human_GAPDH_TAA_len41_fa10_ta10_fm10_tm10,g
2871@TOP@human_GAPDH_TAA_len41_fa10_ta10_fm10_tm10*121*a,3859,0,4,0,3863,0.001,121,2871@TOP@human_GAPDH_TAA_len41_fa10_ta10_fm10_tm10,a
2871@TOP@human_GAPDH_TAA_len41_fa10_ta10_fm10_tm10*122*g,0,0,3891,0,3891,1.0,122,2871@TOP@human_GAPDH_TAA_len41_fa10_ta10_fm10_tm10,g
2871@TOP@human_GAPDH_TAA_len41_fa10_ta10_fm10_tm10*123*t,0,0,1,3831,3832,0.0,123,2871@TOP@human_GAPDH_TAA_len41_fa10_ta10_fm10_tm10,t
2871@TOP@human_GAPDH_TAA_len41_fa10_ta10_fm10_tm10*124*a,3241,0,582,0,3823,0.152,124,2871@TOP@human_GAPDH_TAA_len41_fa10_ta10_fm10_tm10,a
2871@TOP@human_GAPDH_TAA_len41_fa10_ta10_fm10_tm10*125*a,3531,1,280,1,3813,0.073,125,2871@TOP@human_GAPDH_TAA_len41_fa10_ta10_fm10_tm10,a
2871@TOP@human_GAPDH_TAA_len41_fa10_ta10_fm10_tm10*126*g,1,0,3831,0,3832,1.0,126,2871@TOP@human_GAPDH_TAA_len41_fa10_ta10_fm10_tm10,g
2871@TOP@human_GAPDH_TAA_len41_fa10_ta10_fm10_tm10*127*a,3858,0,12,0,3870,0.003,127,2871@TOP@human_GAPDH_TAA_len41_fa10_ta10_fm10_tm10,a
2871@TOP@human_GAPDH_TAA_len41_fa10_ta10_fm10_tm10*128*c,0,3891,0,0,3891,0.0,128,2871@TOP@human_GAPDH_TAA_len41_fa10_ta10_fm10_tm10,c
2871@TOP@human_GAPDH_TAA_len41_fa10_ta10_fm10_tm10*129*c,0,3869,0,0,3869,0.0,129,2871@TOP@human_GAPDH_TAA_len41_fa10_ta10_fm10_tm10,c
2871@TOP@human_GAPDH_TAA_len41_fa10_ta10_fm10_tm10*130*c,3,3879,0,0,3882,0.0,130,2871@TOP@human_GAPDH_TAA_len41_fa10_ta10_fm10_tm10,c
2871@TOP@human_GAPDH_TAA_len41_fa10_ta10_fm10_tm10*131*c,3,3889,0,0,3892,0.0,131,2871@TOP@human_GAPDH_TAA_len41_fa10_ta10_fm10_tm10,c
2871@TOP@human_GAPDH_TAA_len41_fa10_ta10_fm10_tm10*132*t,0,0,0,3847,3847,0.0,132,2871@TOP@human_GAPDH_TAA_len41_fa10_ta10_fm10_tm10,t
2871@TOP@human_GAPDH_TAA_len41_fa10_ta10_fm10_tm10*133*g,1,1,3834,0,3836,0.999,133,2871@TOP@human_GAPDH_TAA_len41_fa10_ta10_fm10_tm10,g
2871@TOP@human_GAPDH_TAA_len41_fa10_ta10_fm10_tm10*134*g,0,0,3846,0,3846,1.0,134,2871@TOP@human_GAPDH_TAA_len41_fa10_ta10_fm10_tm10,g
2872@TOP@human_GAPDH_TAA_len41_fa10_ta10_fm10_tm10*114*t,0,1,0,9962,9963,0.0,114,2872@TOP@human_GAPDH_TAA_len41_fa10_ta10_fm10_tm10,t
2872@TOP@human_GAPDH_TAA_len41_fa10_ta10_fm10_tm10*115*c,0,10010,0,0,10010,0.0,115,2872@TOP@human_GAPDH_TAA_len41_fa10_ta10_fm10_tm10,c
2872@TOP@human_GAPDH_TAA_len41_fa10_ta10_fm10_tm10*116*c,0,9963,0,0,9963,0.0,116,2872@TOP@human_GAPDH_TAA_len41_fa10_ta10_fm10_tm10,c
2872@TOP@human_GAPDH_TAA_len41_fa10_ta10_fm10_tm10*117*a,9951,0,10,0,9961,0.001,117,2872@TOP@human_GAPDH_TAA_len41_fa10_ta10_fm10_tm10,a
2872@TOP@human_GAPDH_TAA_len41_fa10_ta10_fm10_tm10*118*a,9674,0,252,0,9926,0.025,118,2872@TOP@human_GAPDH_TAA_len41_fa10_ta10_fm10_tm10,a
2872@TOP@human_GAPDH_TAA_len41_fa10_ta10_fm10_tm10*119*g,0,1,9917,0,9918,1.0,119,2872@TOP@human_GAPDH_TAA_len41_fa10_ta10_fm10_tm10,g
2872@TOP@human_GAPDH_TAA_len41_fa10_ta10_fm10_tm10*120*g,0,0,9846,0,9846,1.0,120,2872@TOP@human_GAPDH_TAA_len41_fa10_ta10_fm10_tm10,g
2872@TOP@human_GAPDH_TAA_len41_fa10_ta10_fm10_tm10*121*a,9951,0,4,0,9955,0.0,121,2872@TOP@human_GAPDH_TAA_len41_fa10_ta10_fm10_tm10,a
2872@TOP@human_GAPDH_TAA_len41_fa10_ta10_fm10_tm10*122*g,1,0,9963,0,9964,1.0,122,2872@TOP@human_GAPDH_TAA_len41_fa10_ta10_fm10_tm10,g
2872@TOP@human_GAPDH_TAA_len41_fa10_ta10_fm10_tm10*123*t,1,1,3,9826,9831,0.0,123,2872@TOP@human_GAPDH_TAA_len41_fa10_ta10_fm10_tm10,t
2872@TOP@human_GAPDH_TAA_len41_fa10_ta10_fm10_tm10*124*a,9481,0,339,0,9820,0.035,124,2872@TOP@human_GAPDH_TAA_len41_fa10_ta10_fm10_tm10,a
2872@TOP@human_GAPDH_TAA_len41_fa10_ta10_fm10_tm10*125*a,9635,0,163,0,9798,0.017,125,2872@TOP@human_GAPDH_TAA_len41_fa10_ta10_fm10_tm10,a
2872@TOP@human_GAPDH_TAA_len41_fa10_ta10_fm10_tm10*126*g,0,0,9808,1,9809,1.0,126,2872@TOP@human_GAPDH_TAA_len41_fa10_ta10_fm10_tm10,g
2872@TOP@human_GAPDH_TAA_len41_fa10_ta10_fm10_tm10*127*a,9948,2,5,1,9956,0.001,127,2872@TOP@human_GAPDH_TAA_len41_fa10_ta10_fm10_tm10,a
2872@TOP@human_GAPDH_TAA_len41_fa10_ta10_fm10_tm10*128*c,0,9988,1,0,9989,0.0,128,2872@TOP@human_GAPDH_TAA_len41_fa10_ta10_fm10_tm10,c
2872@TOP@human_GAPDH_TAA_len41_fa10_ta10_fm10_tm10*129*c,0,9888,0,1,9889,0.0,129,2872@TOP@human_GAPDH_TAA_len41_fa10_ta10_fm10_tm10,c
2872@TOP@human_GAPDH_TAA_len41_fa10_ta10_fm10_tm10*130*c,4,9958,0,1,9963,0.0,130,2872@TOP@human_GAPDH_TAA_len41_fa10_ta10_fm10_tm10,c
2872@TOP@human_GAPDH_TAA_len41_fa10_ta10_fm10_tm10*131*c,4,9998,0,0,10002,0.0,131,2872@TOP@human_GAPDH_TAA_len41_fa10_ta10_fm10_tm10,c
2872@TOP@human_GAPDH_TAA_len41_fa10_ta10_fm10_tm10*132*t,2,1,1,9873,9877,0.0,132,2872@TOP@human_GAPDH_TAA_len41_fa10_ta10_fm10_tm10,t
2872@TOP@human_GAPDH_TAA_len41_fa10_ta10_fm10_tm10*133*g,1,0,9862,0,9863,1.0,133,2872@TOP@human_GAPDH_TAA_len41_fa10_ta10_fm10_tm10,g
2872@TOP@human_GAPDH_TAA_len41_fa10_ta10_fm10_tm10*134*g,0,5,9882,0,9887,0.999,134,2872@TOP@human_GAPDH_TAA_len41_fa10_ta10_fm10_tm10,g
2873@TOP@human_GAPDH_TAA_len41_fa10_ta10_fm10_tm10*114*t,0,2,0,1067,1069,0.0,114,2873@TOP@human_GAPDH_TAA_len41_fa10_ta10_fm10_tm10,t
2873@TOP@human_GAPDH_TAA_len41_fa10_ta10_fm10_tm10*115*c,0,1077,0,0,1077,0.0,115,2873@TOP@human_GAPDH_TAA_len41_fa10_ta10_fm10_tm10,c
2873@TOP@human_GAPDH_TAA_len41_fa10_ta10_fm10_tm10*116*c,0,1075,0,0,1075,0.0,116,2873@TOP@human_GAPDH_TAA_len41_fa10_ta10_fm10_tm10,c
2873@TOP@human_GAPDH_TAA_len41_fa10_ta10_fm10_tm10*117*a,1068,0,1,0,1069,0.001,117,2873@TOP@human_GAPDH_TAA_len41_fa10_ta10_fm10_tm10,a
2873@TOP@human_GAPDH_TAA_len41_fa10_ta10_fm10_tm10*118*a,1003,0,64,0,1067,0.06,118,2873@TOP@human_GAPDH_TAA_len41_fa10_ta10_fm10_tm10,a
2873@TOP@human_GAPDH_TAA_len41_fa10_ta10_fm10_tm10*119*g,0,0,1058,0,1058,1.0,119,2873@TOP@human_GAPDH_TAA_len41_fa10_ta10_fm10_tm10,g
2873@TOP@human_GAPDH_TAA_len41_fa10_ta10_fm10_tm10*120*g,0,0,1054,0,1054,1.0,120,2873@TOP@human_GAPDH_TAA_len41_fa10_ta10_fm10_tm10,g
2873@TOP@human_GAPDH_TAA_len41_fa10_ta10_fm10_tm10*121*a,1070,0,0,0,1070,0.0,121,2873@TOP@human_GAPDH_TAA_len41_fa10_ta10_fm10_tm10,a
2873@TOP@human_GAPDH_TAA_len41_fa10_ta10_fm10_tm10*122*g,0,0,1075,0,1075,1.0,122,2873@TOP@human_GAPDH_TAA_len41_fa10_ta10_fm10_tm10,g
2873@TOP@human_GAPDH_TAA_len41_fa10_ta10_fm10_tm10*123*t,0,0,0,1052,1052,0.0,123,2873@TOP@human_GAPDH_TAA_len41_fa10_ta10_fm10_tm10,t
2873@TOP@human_GAPDH_TAA_len41_fa10_ta10_fm10_tm10*124*a,979,0,71,0,1050,0.068,124,2873@TOP@human_GAPDH_TAA_len41_fa10_ta10_fm10_tm10,a
2873@TOP@human_GAPDH_TAA_len41_fa10_ta10_fm10_tm10*125*a,1008,0,43,0,1051,0.041,125,2873@TOP@human_GAPDH_TAA_len41_fa10_ta10_fm10_tm10,a
2873@TOP@human_GAPDH_TAA_len41_fa10_ta10_fm10_tm10*126*g,0,0,1053,0,1053,1.0,126,2873@TOP@human_GAPDH_TAA_len41_fa10_ta10_fm10_tm10,g
2873@TOP@human_GAPDH_TAA_len41_fa10_ta10_fm10_tm10*127*a,1073,0,0,0,1073,0.0,127,2873@TOP@human_GAPDH_TAA_len41_fa10_ta10_fm10_tm10,a
2873@TOP@human_GAPDH_TAA_len41_fa10_ta10_fm10_tm10*128*c,0,1070,0,0,1070,0.0,128,2873@TOP@human_GAPDH_TAA_len41_fa10_ta10_fm10_tm10,c
2873@TOP@human_GAPDH_TAA_len41_fa10_ta10_fm10_tm10*129*c,0,1070,0,0,1070,0.0,129,2873@TOP@human_GAPDH_TAA_len41_fa10_ta10_fm10_tm10,c
2873@TOP@human_GAPDH_TAA_len41_fa10_ta10_fm10_tm10*130*c,0,1072,0,0,1072,0.0,130,2873@TOP@human_GAPDH_TAA_len41_fa10_ta10_fm10_tm10,c
2873@TOP@human_GAPDH_TAA_len41_fa10_ta10_fm10_tm10*131*c,0,1077,0,0,1077,0.0,131,2873@TOP@human_GAPDH_TAA_len41_fa10_ta10_fm10_tm10,c
2873@TOP@human_GAPDH_TAA_len41_fa10_ta10_fm10_tm10*132*t,0,0,0,1056,1056,0.0,132,2873@TOP@human_GAPDH_TAA_len41_fa10_ta10_fm10_tm10,t
2873@TOP@human_GAPDH_TAA_len41_fa10_ta10_fm10_tm10*133*g,0,0,1063,0,1063,1.0,133,2873@TOP@human_GAPDH_TAA_len41_fa10_ta10_fm10_tm10,g
2873@TOP@human_GAPDH_TAA_len41_fa10_ta10_fm10_tm10*134*g,0,0,1058,0,1058,1.0,134,2873@TOP@human_GAPDH_TAA_len41_fa10_ta10_fm10_tm10,g
2874@TOP@human_GAPDH_TAA_len41_fa10_ta10_fm10_tm10*114*t,0,0,0,741,741,0.0,114,2874@TOP@human_GAPDH_TAA_len41_fa10_ta10_fm10_tm10,t
2874@TOP@human_GAPDH_TAA_len41_fa10_ta10_fm10_tm10*115*c,0,746,0,0,746,0.0,115,2874@TOP@human_GAPDH_TAA_len41_fa10_ta10_fm10_tm10,c
2874@TOP@human_GAPDH_TAA_len41_fa10_ta10_fm10_tm10*116*c,0,741,0,0,741,0.0,116,2874@TOP@human_GAPDH_TAA_len41_fa10_ta10_fm10_tm10,c
2874@TOP@human_GAPDH_TAA_len41_fa10_ta10_fm10_tm10*117*a,731,0,10,0,741,0.013,117,2874@TOP@human_GAPDH_TAA_len41_fa10_ta10_fm10_tm10,a
2874@TOP@human_GAPDH_TAA_len41_fa10_ta10_fm10_tm10*118*a,584,0,156,0,740,0.211,118,2874@TOP@human_GAPDH_TAA_len41_fa10_ta10_fm10_tm10,a
2874@TOP@human_GAPDH_TAA_len41_fa10_ta10_fm10_tm10*119*g,0,0,736,0,736,1.0,119,2874@TOP@human_GAPDH_TAA_len41_fa10_ta10_fm10_tm10,g
2874@TOP@human_GAPDH_TAA_len41_fa10_ta10_fm10_tm10*120*g,0,0,740,0,740,1.0,120,2874@TOP@human_GAPDH_TAA_len41_fa10_ta10_fm10_tm10,g
2874@TOP@human_GAPDH_TAA_len41_fa10_ta10_fm10_tm10*121*a,741,0,2,0,743,0.003,121,2874@TOP@human_GAPDH_TAA_len41_fa10_ta10_fm10_tm10,a
2874@TOP@human_GAPDH_TAA_len41_fa10_ta10_fm10_tm10*122*g,0,0,744,0,744,1.0,122,2874@TOP@human_GAPDH_TAA_len41_fa10_ta10_fm10_tm10,g
2874@TOP@human_GAPDH_TAA_len41_fa10_ta10_fm10_tm10*123*t,0,0,1,733,734,0.001,123,2874@TOP@human_GAPDH_TAA_len41_fa10_ta10_fm10_tm10,t
2874@TOP@human_GAPDH_TAA_len41_fa10_ta10_fm10_tm10*124*a,634,0,97,0,731,0.133,124,2874@TOP@human_GAPDH_TAA_len41_fa10_ta10_fm10_tm10,a
2874@TOP@human_GAPDH_TAA_len41_fa10_ta10_fm10_tm10*125*a,690,0,42,0,732,0.057,125,2874@TOP@human_GAPDH_TAA_len41_fa10_ta10_fm10_tm10,a
2874@TOP@human_GAPDH_TAA_len41_fa10_ta10_fm10_tm10*126*g,0,0,729,0,729,1.0,126,2874@TOP@human_GAPDH_TAA_len41_fa10_ta10_fm10_tm10,g
2874@TOP@human_GAPDH_TAA_len41_fa10_ta10_fm10_tm10*127*a,743,0,0,0,743,0.0,127,2874@TOP@human_GAPDH_TAA_len41_fa10_ta10_fm10_tm10,a
2874@TOP@human_GAPDH_TAA_len41_fa10_ta10_fm10_tm10*128*c,0,744,0,0,744,0.0,128,2874@TOP@human_GAPDH_TAA_len41_fa10_ta10_fm10_tm10,c
2874@TOP@human_GAPDH_TAA_len41_fa10_ta10_fm10_tm10*129*c,0,731,0,0,731,0.0,129,2874@TOP@human_GAPDH_TAA_len41_fa10_ta10_fm10_tm10,c
2874@TOP@human_GAPDH_TAA_len41_fa10_ta10_fm10_tm10*130*c,0,740,0,0,740,0.0,130,2874@TOP@human_GAPDH_TAA_len41_fa10_ta10_fm10_tm10,c
2874@TOP@human_GAPDH_TAA_len41_fa10_ta10_fm10_tm10*131*c,0,744,0,0,744,0.0,131,2874@TOP@human_GAPDH_TAA_len41_fa10_ta10_fm10_tm10,c
2874@TOP@human_GAPDH_TAA_len41_fa10_ta10_fm10_tm10*132*t,0,0,0,736,736,0.0,132,2874@TOP@human_GAPDH_TAA_len41_fa10_ta10_fm10_tm10,t
2874@TOP@human_GAPDH_TAA_len41_fa10_ta10_fm10_tm10*133*g,1,0,732,0,733,0.999,133,2874@TOP@human_GAPDH_TAA_len41_fa10_ta10_fm10_tm10,g
2874@TOP@human_GAPDH_TAA_len41_fa10_ta10_fm10_tm10*134*g,0,0,735,0,735,1.0,134,2874@TOP@human_GAPDH_TAA_len41_fa10_ta10_fm10_tm10,g
2875@TOP@human_GAPDH_TAA_len41_fa10_ta10_fm10_tm10*114*t,2,6,0,31458,31466,0.0,114,2875@TOP@human_GAPDH_TAA_len41_fa10_ta10_fm10_tm10,t
2875@TOP@human_GAPDH_TAA_len41_fa10_ta10_fm10_tm10*115*c,0,31654,0,1,31655,0.0,115,2875@TOP@human_GAPDH_TAA_len41_fa10_ta10_fm10_tm10,c
2875@TOP@human_GAPDH_TAA_len41_fa10_ta10_fm10_tm10*116*c,0,31531,0,4,31535,0.0,116,2875@TOP@human_GAPDH_TAA_len41_fa10_ta10_fm10_tm10,c
2875@TOP@human_GAPDH_TAA_len41_fa10_ta10_fm10_tm10*117*a,31503,1,32,0,31536,0.001,117,2875@TOP@human_GAPDH_TAA_len41_fa10_ta10_fm10_tm10,a
2875@TOP@human_GAPDH_TAA_len41_fa10_ta10_fm10_tm10*118*a,31038,0,303,2,31343,0.01,118,2875@TOP@human_GAPDH_TAA_len41_fa10_ta10_fm10_tm10,a
2875@TOP@human_GAPDH_TAA_len41_fa10_ta10_fm10_tm10*119*g,0,0,31295,0,31295,1.0,119,2875@TOP@human_GAPDH_TAA_len41_fa10_ta10_fm10_tm10,g
2875@TOP@human_GAPDH_TAA_len41_fa10_ta10_fm10_tm10*120*g,2,0,31160,1,31163,1.0,120,2875@TOP@human_GAPDH_TAA_len41_fa10_ta10_fm10_tm10,g
2875@TOP@human_GAPDH_TAA_len41_fa10_ta10_fm10_tm10*121*a,31424,0,68,2,31494,0.002,121,2875@TOP@human_GAPDH_TAA_len41_fa10_ta10_fm10_tm10,a
2875@TOP@human_GAPDH_TAA_len41_fa10_ta10_fm10_tm10*122*g,4,0,31517,0,31521,1.0,122,2875@TOP@human_GAPDH_TAA_len41_fa10_ta10_fm10_tm10,g
2875@TOP@human_GAPDH_TAA_len41_fa10_ta10_fm10_tm10*123*t,6,6,3,31112,31127,0.0,123,2875@TOP@human_GAPDH_TAA_len41_fa10_ta10_fm10_tm10,t
2875@TOP@human_GAPDH_TAA_len41_fa10_ta10_fm10_tm10*124*a,27395,0,3629,0,31024,0.117,124,2875@TOP@human_GAPDH_TAA_len41_fa10_ta10_fm10_tm10,a
2875@TOP@human_GAPDH_TAA_len41_fa10_ta10_fm10_tm10*125*a,30395,0,581,0,30976,0.019,125,2875@TOP@human_GAPDH_TAA_len41_fa10_ta10_fm10_tm10,a
2875@TOP@human_GAPDH_TAA_len41_fa10_ta10_fm10_tm10*126*g,4,1,31167,1,31173,1.0,126,2875@TOP@human_GAPDH_TAA_len41_fa10_ta10_fm10_tm10,g
2875@TOP@human_GAPDH_TAA_len41_fa10_ta10_fm10_tm10*127*a,31409,1,12,2,31424,0.0,127,2875@TOP@human_GAPDH_TAA_len41_fa10_ta10_fm10_tm10,a
2875@TOP@human_GAPDH_TAA_len41_fa10_ta10_fm10_tm10*128*c,2,31582,2,0,31586,0.0,128,2875@TOP@human_GAPDH_TAA_len41_fa10_ta10_fm10_tm10,c
2875@TOP@human_GAPDH_TAA_len41_fa10_ta10_fm10_tm10*129*c,2,31331,0,1,31334,0.0,129,2875@TOP@human_GAPDH_TAA_len41_fa10_ta10_fm10_tm10,c
2875@TOP@human_GAPDH_TAA_len41_fa10_ta10_fm10_tm10*130*c,2,31518,0,6,31526,0.0,130,2875@TOP@human_GAPDH_TAA_len41_fa10_ta10_fm10_tm10,c
2875@TOP@human_GAPDH_TAA_len41_fa10_ta10_fm10_tm10*131*c,5,31575,0,2,31582,0.0,131,2875@TOP@human_GAPDH_TAA_len41_fa10_ta10_fm10_tm10,c
2875@TOP@human_GAPDH_TAA_len41_fa10_ta10_fm10_tm10*132*t,6,5,1,31178,31190,0.0,132,2875@TOP@human_GAPDH_TAA_len41_fa10_ta10_fm10_tm10,t
2875@TOP@human_GAPDH_TAA_len41_fa10_ta10_fm10_tm10*133*g,5,3,31111,3,31122,1.0,133,2875@TOP@human_GAPDH_TAA_len41_fa10_ta10_fm10_tm10,g
2875@TOP@human_GAPDH_TAA_len41_fa10_ta10_fm10_tm10*134*g,2,4,31242,0,31248,1.0,134,2875@TOP@human_GAPDH_TAA_len41_fa10_ta10_fm10_tm10,g
2876@TOP@human_GAPDH_TAA_len41_fa10_ta10_fm10_tm10*114*t,0,0,0,1185,1185,0.0,114,2876@TOP@human_GAPDH_TAA_len41_fa10_ta10_fm10_tm10,t
2876@TOP@human_GAPDH_TAA_len41_fa10_ta10_fm10_tm10*115*c,0,1191,0,0,1191,0.0,115,2876@TOP@human_GAPDH_TAA_len41_fa10_ta10_fm10_tm10,c
2876@TOP@human_GAPDH_TAA_len41_fa10_ta10_fm10_tm10*116*c,0,1182,1,0,1183,0.001,116,2876@TOP@human_GAPDH_TAA_len41_fa10_ta10_fm10_tm10,c
2876@TOP@human_GAPDH_TAA_len41_fa10_ta10_fm10_tm10*117*a,1176,0,10,0,1186,0.008,117,2876@TOP@human_GAPDH_TAA_len41_fa10_ta10_fm10_tm10,a
2876@TOP@human_GAPDH_TAA_len41_fa10_ta10_fm10_tm10*118*a,1059,0,123,0,1182,0.104,118,2876@TOP@human_GAPDH_TAA_len41_fa10_ta10_fm10_tm10,a
2876@TOP@human_GAPDH_TAA_len41_fa10_ta10_fm10_tm10*119*g,0,0,1177,1,1178,0.999,119,2876@TOP@human_GAPDH_TAA_len41_fa10_ta10_fm10_tm10,g
2876@TOP@human_GAPDH_TAA_len41_fa10_ta10_fm10_tm10*120*g,0,0,1177,1,1178,0.999,120,2876@TOP@human_GAPDH_TAA_len41_fa10_ta10_fm10_tm10,g
2876@TOP@human_GAPDH_TAA_len41_fa10_ta10_fm10_tm10*121*a,1185,0,2,0,1187,0.002,121,2876@TOP@human_GAPDH_TAA_len41_fa10_ta10_fm10_tm10,a
2876@TOP@human_GAPDH_TAA_len41_fa10_ta10_fm10_tm10*122*g,0,0,1185,0,1185,1.0,122,2876@TOP@human_GAPDH_TAA_len41_fa10_ta10_fm10_tm10,g
2876@TOP@human_GAPDH_TAA_len41_fa10_ta10_fm10_tm10*123*t,0,3,0,1161,1164,0.0,123,2876@TOP@human_GAPDH_TAA_len41_fa10_ta10_fm10_tm10,t
2876@TOP@human_GAPDH_TAA_len41_fa10_ta10_fm10_tm10*124*a,1025,0,149,0,1174,0.127,124,2876@TOP@human_GAPDH_TAA_len41_fa10_ta10_fm10_tm10,a
2876@TOP@human_GAPDH_TAA_len41_fa10_ta10_fm10_tm10*125*a,1089,0,86,0,1175,0.073,125,2876@TOP@human_GAPDH_TAA_len41_fa10_ta10_fm10_tm10,a
2876@TOP@human_GAPDH_TAA_len41_fa10_ta10_fm10_tm10*126*g,0,0,1168,0,1168,1.0,126,2876@TOP@human_GAPDH_TAA_len41_fa10_ta10_fm10_tm10,g
2876@TOP@human_GAPDH_TAA_len41_fa10_ta10_fm10_tm10*127*a,1185,1,0,0,1186,0.0,127,2876@TOP@human_GAPDH_TAA_len41_fa10_ta10_fm10_tm10,a
2876@TOP@human_GAPDH_TAA_len41_fa10_ta10_fm10_tm10*128*c,1,1185,0,0,1186,0.0,128,2876@TOP@human_GAPDH_TAA_len41_fa10_ta10_fm10_tm10,c
2876@TOP@human_GAPDH_TAA_len41_fa10_ta10_fm10_tm10*129*c,0,1180,0,0,1180,0.0,129,2876@TOP@human_GAPDH_TAA_len41_fa10_ta10_fm10_tm10,c
2876@TOP@human_GAPDH_TAA_len41_fa10_ta10_fm10_tm10*130*c,0,1188,0,0,1188,0.0,130,2876@TOP@human_GAPDH_TAA_len41_fa10_ta10_fm10_tm10,c
2876@TOP@human_GAPDH_TAA_len41_fa10_ta10_fm10_tm10*131*c,1,1191,0,0,1192,0.0,131,2876@TOP@human_GAPDH_TAA_len41_fa10_ta10_fm10_tm10,c
2876@TOP@human_GAPDH_TAA_len41_fa10_ta10_fm10_tm10*132*t,0,3,0,1173,1176,0.0,132,2876@TOP@human_GAPDH_TAA_len41_fa10_ta10_fm10_tm10,t
2876@TOP@human_GAPDH_TAA_len41_fa10_ta10_fm10_tm10*133*g,0,0,1168,0,1168,1.0,133,2876@TOP@human_GAPDH_TAA_len41_fa10_ta10_fm10_tm10,g
2876@TOP@human_GAPDH_TAA_len41_fa10_ta10_fm10_tm10*134*g,3,0,1170,0,1173,0.997,134,2876@TOP@human_GAPDH_TAA_len41_fa10_ta10_fm10_tm10,g
2877@TOP@human_GAPDH_TAA_len41_fa10_ta10_fm10_tm10*114*t,0,1,0,1918,1919,0.0,114,2877@TOP@human_GAPDH_TAA_len41_fa10_ta10_fm10_tm10,t
2877@TOP@human_GAPDH_TAA_len41_fa10_ta10_fm10_tm10*115*c,0,1937,0,0,1937,0.0,115,2877@TOP@human_GAPDH_TAA_len41_fa10_ta10_fm10_tm10,c
2877@TOP@human_GAPDH_TAA_len41_fa10_ta10_fm10_tm10*116*c,0,1929,0,0,1929,0.0,116,2877@TOP@human_GAPDH_TAA_len41_fa10_ta10_fm10_tm10,c
2877@TOP@human_GAPDH_TAA_len41_fa10_ta10_fm10_tm10*117*a,1917,0,5,0,1922,0.003,117,2877@TOP@human_GAPDH_TAA_len41_fa10_ta10_fm10_tm10,a
2877@TOP@human_GAPDH_TAA_len41_fa10_ta10_fm10_tm10*118*a,1428,0,485,0,1913,0.254,118,2877@TOP@human_GAPDH_TAA_len41_fa10_ta10_fm10_tm10,a
2877@TOP@human_GAPDH_TAA_len41_fa10_ta10_fm10_tm10*119*g,0,0,1907,0,1907,1.0,119,2877@TOP@human_GAPDH_TAA_len41_fa10_ta10_fm10_tm10,g
2877@TOP@human_GAPDH_TAA_len41_fa10_ta10_fm10_tm10*120*g,0,0,1896,0,1896,1.0,120,2877@TOP@human_GAPDH_TAA_len41_fa10_ta10_fm10_tm10,g
2877@TOP@human_GAPDH_TAA_len41_fa10_ta10_fm10_tm10*121*a,1913,0,1,0,1914,0.001,121,2877@TOP@human_GAPDH_TAA_len41_fa10_ta10_fm10_tm10,a
2877@TOP@human_GAPDH_TAA_len41_fa10_ta10_fm10_tm10*122*g,0,0,1926,1,1927,0.999,122,2877@TOP@human_GAPDH_TAA_len41_fa10_ta10_fm10_tm10,g
2877@TOP@human_GAPDH_TAA_len41_fa10_ta10_fm10_tm10*123*t,0,1,0,1895,1896,0.0,123,2877@TOP@human_GAPDH_TAA_len41_fa10_ta10_fm10_tm10,t
2877@TOP@human_GAPDH_TAA_len41_fa10_ta10_fm10_tm10*124*a,1581,0,309,0,1890,0.163,124,2877@TOP@human_GAPDH_TAA_len41_fa10_ta10_fm10_tm10,a
2877@TOP@human_GAPDH_TAA_len41_fa10_ta10_fm10_tm10*125*a,1728,0,157,0,1885,0.083,125,2877@TOP@human_GAPDH_TAA_len41_fa10_ta10_fm10_tm10,a
2877@TOP@human_GAPDH_TAA_len41_fa10_ta10_fm10_tm10*126*g,0,0,1896,0,1896,1.0,126,2877@TOP@human_GAPDH_TAA_len41_fa10_ta10_fm10_tm10,g
2877@TOP@human_GAPDH_TAA_len41_fa10_ta10_fm10_tm10*127*a,1907,0,8,0,1915,0.004,127,2877@TOP@human_GAPDH_TAA_len41_fa10_ta10_fm10_tm10,a
2877@TOP@human_GAPDH_TAA_len41_fa10_ta10_fm10_tm10*128*c,0,1933,0,0,1933,0.0,128,2877@TOP@human_GAPDH_TAA_len41_fa10_ta10_fm10_tm10,c
2877@TOP@human_GAPDH_TAA_len41_fa10_ta10_fm10_tm10*129*c,0,1917,0,0,1917,0.0,129,2877@TOP@human_GAPDH_TAA_len41_fa10_ta10_fm10_tm10,c
2877@TOP@human_GAPDH_TAA_len41_fa10_ta10_fm10_tm10*130*c,0,1925,0,0,1925,0.0,130,2877@TOP@human_GAPDH_TAA_len41_fa10_ta10_fm10_tm10,c
2877@TOP@human_GAPDH_TAA_len41_fa10_ta10_fm10_tm10*131*c,0,1929,0,0,1929,0.0,131,2877@TOP@human_GAPDH_TAA_len41_fa10_ta10_fm10_tm10,c
2877@TOP@human_GAPDH_TAA_len41_fa10_ta10_fm10_tm10*132*t,0,1,0,1890,1891,0.0,132,2877@TOP@human_GAPDH_TAA_len41_fa10_ta10_fm10_tm10,t
2877@TOP@human_GAPDH_TAA_len41_fa10_ta10_fm10_tm10*133*g,2,0,1891,1,1894,0.998,133,2877@TOP@human_GAPDH_TAA_len41_fa10_ta10_fm10_tm10,g
2877@TOP@human_GAPDH_TAA_len41_fa10_ta10_fm10_tm10*134*g,0,0,1917,0,1917,1.0,134,2877@TOP@human_GAPDH_TAA_len41_fa10_ta10_fm10_tm10,g
2878@TOP@human_GAPDH_TAA_len41_fa10_ta10_fm10_tm10*114*t,2,1,0,4580,4583,0.0,114,2878@TOP@human_GAPDH_TAA_len41_fa10_ta10_fm10_tm10,t
2878@TOP@human_GAPDH_TAA_len41_fa10_ta10_fm10_tm10*115*c,0,4619,0,1,4620,0.0,115,2878@TOP@human_GAPDH_TAA_len41_fa10_ta10_fm10_tm10,c
2878@TOP@human_GAPDH_TAA_len41_fa10_ta10_fm10_tm10*116*c,0,4604,0,0,4604,0.0,116,2878@TOP@human_GAPDH_TAA_len41_fa10_ta10_fm10_tm10,c
2878@TOP@human_GAPDH_TAA_len41_fa10_ta10_fm10_tm10*117*a,4470,0,125,0,4595,0.027,117,2878@TOP@human_GAPDH_TAA_len41_fa10_ta10_fm10_tm10,a
2878@TOP@human_GAPDH_TAA_len41_fa10_ta10_fm10_tm10*118*a,3676,0,898,1,4575,0.196,118,2878@TOP@human_GAPDH_TAA_len41_fa10_ta10_fm10_tm10,a
2878@TOP@human_GAPDH_TAA_len41_fa10_ta10_fm10_tm10*119*g,0,0,4549,0,4549,1.0,119,2878@TOP@human_GAPDH_TAA_len41_fa10_ta10_fm10_tm10,g
2878@TOP@human_GAPDH_TAA_len41_fa10_ta10_fm10_tm10*120*g,0,0,4542,0,4542,1.0,120,2878@TOP@human_GAPDH_TAA_len41_fa10_ta10_fm10_tm10,g
2878@TOP@human_GAPDH_TAA_len41_fa10_ta10_fm10_tm10*121*a,4555,0,11,0,4566,0.002,121,2878@TOP@human_GAPDH_TAA_len41_fa10_ta10_fm10_tm10,a
2878@TOP@human_GAPDH_TAA_len41_fa10_ta10_fm10_tm10*122*g,0,0,4598,0,4598,1.0,122,2878@TOP@human_GAPDH_TAA_len41_fa10_ta10_fm10_tm10,g
2878@TOP@human_GAPDH_TAA_len41_fa10_ta10_fm10_tm10*123*t,3,0,1,4509,4513,0.0,123,2878@TOP@human_GAPDH_TAA_len41_fa10_ta10_fm10_tm10,t
2878@TOP@human_GAPDH_TAA_len41_fa10_ta10_fm10_tm10*124*a,3431,1,1083,0,4515,0.24,124,2878@TOP@human_GAPDH_TAA_len41_fa10_ta10_fm10_tm10,a
2878@TOP@human_GAPDH_TAA_len41_fa10_ta10_fm10_tm10*125*a,3830,1,691,1,4523,0.153,125,2878@TOP@human_GAPDH_TAA_len41_fa10_ta10_fm10_tm10,a
2878@TOP@human_GAPDH_TAA_len41_fa10_ta10_fm10_tm10*126*g,0,0,4534,0,4534,1.0,126,2878@TOP@human_GAPDH_TAA_len41_fa10_ta10_fm10_tm10,g
2878@TOP@human_GAPDH_TAA_len41_fa10_ta10_fm10_tm10*127*a,4568,1,8,1,4578,0.002,127,2878@TOP@human_GAPDH_TAA_len41_fa10_ta10_fm10_tm10,a
2878@TOP@human_GAPDH_TAA_len41_fa10_ta10_fm10_tm10*128*c,1,4600,1,0,4602,0.0,128,2878@TOP@human_GAPDH_TAA_len41_fa10_ta10_fm10_tm10,c
2878@TOP@human_GAPDH_TAA_len41_fa10_ta10_fm10_tm10*129*c,0,4575,0,0,4575,0.0,129,2878@TOP@human_GAPDH_TAA_len41_fa10_ta10_fm10_tm10,c
2878@TOP@human_GAPDH_TAA_len41_fa10_ta10_fm10_tm10*130*c,0,4600,0,1,4601,0.0,130,2878@TOP@human_GAPDH_TAA_len41_fa10_ta10_fm10_tm10,c
2878@TOP@human_GAPDH_TAA_len41_fa10_ta10_fm10_tm10*131*c,0,4610,0,0,4610,0.0,131,2878@TOP@human_GAPDH_TAA_len41_fa10_ta10_fm10_tm10,c
2878@TOP@human_GAPDH_TAA_len41_fa10_ta10_fm10_tm10*132*t,0,0,0,4544,4544,0.0,132,2878@TOP@human_GAPDH_TAA_len41_fa10_ta10_fm10_tm10,t
2878@TOP@human_GAPDH_TAA_len41_fa10_ta10_fm10_tm10*133*g,0,0,4534,1,4535,1.0,133,2878@TOP@human_GAPDH_TAA_len41_fa10_ta10_fm10_tm10,g
2878@TOP@human_GAPDH_TAA_len41_fa10_ta10_fm10_tm10*134*g,1,2,4548,0,4551,0.999,134,2878@TOP@human_GAPDH_TAA_len41_fa10_ta10_fm10_tm10,g
2879@TOP@human_GAPDH_TAA_len41_fa10_ta10_fm10_tm10*114*t,0,0,0,719,719,0.0,114,2879@TOP@human_GAPDH_TAA_len41_fa10_ta10_fm10_tm10,t
2879@TOP@human_GAPDH_TAA_len41_fa10_ta10_fm10_tm10*115*c,0,724,0,0,724,0.0,115,2879@TOP@human_GAPDH_TAA_len41_fa10_ta10_fm10_tm10,c
2879@TOP@human_GAPDH_TAA_len41_fa10_ta10_fm10_tm10*116*c,0,720,0,0,720,0.0,116,2879@TOP@human_GAPDH_TAA_len41_fa10_ta10_fm10_tm10,c
2879@TOP@human_GAPDH_TAA_len41_fa10_ta10_fm10_tm10*117*a,654,0,65,0,719,0.09,117,2879@TOP@human_GAPDH_TAA_len41_fa10_ta10_fm10_tm10,a
2879@TOP@human_GAPDH_TAA_len41_fa10_ta10_fm10_tm10*118*a,508,0,201,0,709,0.283,118,2879@TOP@human_GAPDH_TAA_len41_fa10_ta10_fm10_tm10,a
2879@TOP@human_GAPDH_TAA_len41_fa10_ta10_fm10_tm10*119*g,0,0,716,0,716,1.0,119,2879@TOP@human_GAPDH_TAA_len41_fa10_ta10_fm10_tm10,g
2879@TOP@human_GAPDH_TAA_len41_fa10_ta10_fm10_tm10*120*g,0,0,715,0,715,1.0,120,2879@TOP@human_GAPDH_TAA_len41_fa10_ta10_fm10_tm10,g
2879@TOP@human_GAPDH_TAA_len41_fa10_ta10_fm10_tm10*121*a,716,0,0,0,716,0.0,121,2879@TOP@human_GAPDH_TAA_len41_fa10_ta10_fm10_tm10,a
2879@TOP@human_GAPDH_TAA_len41_fa10_ta10_fm10_tm10*122*g,0,0,723,0,723,1.0,122,2879@TOP@human_GAPDH_TAA_len41_fa10_ta10_fm10_tm10,g
2879@TOP@human_GAPDH_TAA_len41_fa10_ta10_fm10_tm10*123*t,0,0,0,706,706,0.0,123,2879@TOP@human_GAPDH_TAA_len41_fa10_ta10_fm10_tm10,t
2879@TOP@human_GAPDH_TAA_len41_fa10_ta10_fm10_tm10*124*a,607,0,98,0,705,0.139,124,2879@TOP@human_GAPDH_TAA_len41_fa10_ta10_fm10_tm10,a
2879@TOP@human_GAPDH_TAA_len41_fa10_ta10_fm10_tm10*125*a,660,0,44,0,704,0.062,125,2879@TOP@human_GAPDH_TAA_len41_fa10_ta10_fm10_tm10,a
2879@TOP@human_GAPDH_TAA_len41_fa10_ta10_fm10_tm10*126*g,0,0,712,0,712,1.0,126,2879@TOP@human_GAPDH_TAA_len41_fa10_ta10_fm10_tm10,g
2879@TOP@human_GAPDH_TAA_len41_fa10_ta10_fm10_tm10*127*a,715,1,0,0,716,0.0,127,2879@TOP@human_GAPDH_TAA_len41_fa10_ta10_fm10_tm10,a
2879@TOP@human_GAPDH_TAA_len41_fa10_ta10_fm10_tm10*128*c,0,722,0,0,722,0.0,128,2879@TOP@human_GAPDH_TAA_len41_fa10_ta10_fm10_tm10,c
2879@TOP@human_GAPDH_TAA_len41_fa10_ta10_fm10_tm10*129*c,0,717,0,0,717,0.0,129,2879@TOP@human_GAPDH_TAA_len41_fa10_ta10_fm10_tm10,c
2879@TOP@human_GAPDH_TAA_len41_fa10_ta10_fm10_tm10*130*c,0,716,0,0,716,0.0,130,2879@TOP@human_GAPDH_TAA_len41_fa10_ta10_fm10_tm10,c
2879@TOP@human_GAPDH_TAA_len41_fa10_ta10_fm10_tm10*131*c,0,722,0,0,722,0.0,131,2879@TOP@human_GAPDH_TAA_len41_fa10_ta10_fm10_tm10,c
2879@TOP@human_GAPDH_TAA_len41_fa10_ta10_fm10_tm10*132*t,0,0,0,710,710,0.0,132,2879@TOP@human_GAPDH_TAA_len41_fa10_ta10_fm10_tm10,t
2879@TOP@human_GAPDH_TAA_len41_fa10_ta10_fm10_tm10*133*g,0,0,705,0,705,1.0,133,2879@TOP@human_GAPDH_TAA_len41_fa10_ta10_fm10_tm10,g
2879@TOP@human_GAPDH_TAA_len41_fa10_ta10_fm10_tm10*134*g,0,0,713,0,713,1.0,134,2879@TOP@human_GAPDH_TAA_len41_fa10_ta10_fm10_tm10,g
2880@TOP@human_GAPDH_TAA_len41_fa10_ta10_fm10_tm10*114*t,1,2,0,26182,26185,0.0,114,2880@TOP@human_GAPDH_TAA_len41_fa10_ta10_fm10_tm10,t
2880@TOP@human_GAPDH_TAA_len41_fa10_ta10_fm10_tm10*115*c,0,26330,0,4,26334,0.0,115,2880@TOP@human_GAPDH_TAA_len41_fa10_ta10_fm10_tm10,c
2880@TOP@human_GAPDH_TAA_len41_fa10_ta10_fm10_tm10*116*c,1,26249,0,3,26253,0.0,116,2880@TOP@human_GAPDH_TAA_len41_fa10_ta10_fm10_tm10,c
2880@TOP@human_GAPDH_TAA_len41_fa10_ta10_fm10_tm10*117*a,24905,1,1299,0,26205,0.05,117,2880@TOP@human_GAPDH_TAA_len41_fa10_ta10_fm10_tm10,a
2880@TOP@human_GAPDH_TAA_len41_fa10_ta10_fm10_tm10*118*a,20640,1,5413,3,26057,0.208,118,2880@TOP@human_GAPDH_TAA_len41_fa10_ta10_fm10_tm10,a
2880@TOP@human_GAPDH_TAA_len41_fa10_ta10_fm10_tm10*119*g,5,0,26011,0,26016,1.0,119,2880@TOP@human_GAPDH_TAA_len41_fa10_ta10_fm10_tm10,g
2880@TOP@human_GAPDH_TAA_len41_fa10_ta10_fm10_tm10*120*g,4,1,25975,0,25980,1.0,120,2880@TOP@human_GAPDH_TAA_len41_fa10_ta10_fm10_tm10,g
2880@TOP@human_GAPDH_TAA_len41_fa10_ta10_fm10_tm10*121*a,26111,0,14,0,26125,0.001,121,2880@TOP@human_GAPDH_TAA_len41_fa10_ta10_fm10_tm10,a
2880@TOP@human_GAPDH_TAA_len41_fa10_ta10_fm10_tm10*122*g,1,1,26236,2,26240,1.0,122,2880@TOP@human_GAPDH_TAA_len41_fa10_ta10_fm10_tm10,g
2880@TOP@human_GAPDH_TAA_len41_fa10_ta10_fm10_tm10*123*t,5,6,5,25851,25867,0.0,123,2880@TOP@human_GAPDH_TAA_len41_fa10_ta10_fm10_tm10,t
2880@TOP@human_GAPDH_TAA_len41_fa10_ta10_fm10_tm10*124*a,21273,0,4535,0,25808,0.176,124,2880@TOP@human_GAPDH_TAA_len41_fa10_ta10_fm10_tm10,a
2880@TOP@human_GAPDH_TAA_len41_fa10_ta10_fm10_tm10*125*a,24290,0,1509,0,25799,0.058,125,2880@TOP@human_GAPDH_TAA_len41_fa10_ta10_fm10_tm10,a
2880@TOP@human_GAPDH_TAA_len41_fa10_ta10_fm10_tm10*126*g,2,0,25921,0,25923,1.0,126,2880@TOP@human_GAPDH_TAA_len41_fa10_ta10_fm10_tm10,g
2880@TOP@human_GAPDH_TAA_len41_fa10_ta10_fm10_tm10*127*a,26111,0,18,0,26129,0.001,127,2880@TOP@human_GAPDH_TAA_len41_fa10_ta10_fm10_tm10,a
2880@TOP@human_GAPDH_TAA_len41_fa10_ta10_fm10_tm10*128*c,0,26281,0,1,26282,0.0,128,2880@TOP@human_GAPDH_TAA_len41_fa10_ta10_fm10_tm10,c
2880@TOP@human_GAPDH_TAA_len41_fa10_ta10_fm10_tm10*129*c,1,26088,0,2,26091,0.0,129,2880@TOP@human_GAPDH_TAA_len41_fa10_ta10_fm10_tm10,c
2880@TOP@human_GAPDH_TAA_len41_fa10_ta10_fm10_tm10*130*c,3,26234,0,0,26237,0.0,130,2880@TOP@human_GAPDH_TAA_len41_fa10_ta10_fm10_tm10,c
2880@TOP@human_GAPDH_TAA_len41_fa10_ta10_fm10_tm10*131*c,1,26290,0,2,26293,0.0,131,2880@TOP@human_GAPDH_TAA_len41_fa10_ta10_fm10_tm10,c
2880@TOP@human_GAPDH_TAA_len41_fa10_ta10_fm10_tm10*132*t,2,1,4,25927,25934,0.0,132,2880@TOP@human_GAPDH_TAA_len41_fa10_ta10_fm10_tm10,t
2880@TOP@human_GAPDH_TAA_len41_fa10_ta10_fm10_tm10*133*g,4,1,25842,0,25847,1.0,133,2880@TOP@human_GAPDH_TAA_len41_fa10_ta10_fm10_tm10,g
2880@TOP@human_GAPDH_TAA_len41_fa10_ta10_fm10_tm10*134*g,1,4,26026,0,26031,1.0,134,2880@TOP@human_GAPDH_TAA_len41_fa10_ta10_fm10_tm10,g
2881@TOP@human_GAPDH_TAA_len41_fa10_ta10_fm10_tm10*114*t,1,1,0,9974,9976,0.0,114,2881@TOP@human_GAPDH_TAA_len41_fa10_ta10_fm10_tm10,t
2881@TOP@human_GAPDH_TAA_len41_fa10_ta10_fm10_tm10*115*c,0,10033,0,0,10033,0.0,115,2881@TOP@human_GAPDH_TAA_len41_fa10_ta10_fm10_tm10,c
2881@TOP@human_GAPDH_TAA_len41_fa10_ta10_fm10_tm10*116*c,1,9984,0,0,9985,0.0,116,2881@TOP@human_GAPDH_TAA_len41_fa10_ta10_fm10_tm10,c
2881@TOP@human_GAPDH_TAA_len41_fa10_ta10_fm10_tm10*117*a,9695,0,275,1,9971,0.028,117,2881@TOP@human_GAPDH_TAA_len41_fa10_ta10_fm10_tm10,a
2881@TOP@human_GAPDH_TAA_len41_fa10_ta10_fm10_tm10*118*a,6302,0,3613,0,9915,0.364,118,2881@TOP@human_GAPDH_TAA_len41_fa10_ta10_fm10_tm10,a
2881@TOP@human_GAPDH_TAA_len41_fa10_ta10_fm10_tm10*119*g,0,0,9898,1,9899,1.0,119,2881@TOP@human_GAPDH_TAA_len41_fa10_ta10_fm10_tm10,g
2881@TOP@human_GAPDH_TAA_len41_fa10_ta10_fm10_tm10*120*g,0,0,9896,0,9896,1.0,120,2881@TOP@human_GAPDH_TAA_len41_fa10_ta10_fm10_tm10,g
2881@TOP@human_GAPDH_TAA_len41_fa10_ta10_fm10_tm10*121*a,9915,0,7,0,9922,0.001,121,2881@TOP@human_GAPDH_TAA_len41_fa10_ta10_fm10_tm10,a
2881@TOP@human_GAPDH_TAA_len41_fa10_ta10_fm10_tm10*122*g,0,0,10001,0,10001,1.0,122,2881@TOP@human_GAPDH_TAA_len41_fa10_ta10_fm10_tm10,g
2881@TOP@human_GAPDH_TAA_len41_fa10_ta10_fm10_tm10*123*t,1,0,2,9869,9872,0.0,123,2881@TOP@human_GAPDH_TAA_len41_fa10_ta10_fm10_tm10,t
2881@TOP@human_GAPDH_TAA_len41_fa10_ta10_fm10_tm10*124*a,9434,2,357,0,9793,0.036,124,2881@TOP@human_GAPDH_TAA_len41_fa10_ta10_fm10_tm10,a
2881@TOP@human_GAPDH_TAA_len41_fa10_ta10_fm10_tm10*125*a,9296,0,466,0,9762,0.048,125,2881@TOP@human_GAPDH_TAA_len41_fa10_ta10_fm10_tm10,a
2881@TOP@human_GAPDH_TAA_len41_fa10_ta10_fm10_tm10*126*g,0,0,9865,0,9865,1.0,126,2881@TOP@human_GAPDH_TAA_len41_fa10_ta10_fm10_tm10,g
2881@TOP@human_GAPDH_TAA_len41_fa10_ta10_fm10_tm10*127*a,9913,1,35,0,9949,0.004,127,2881@TOP@human_GAPDH_TAA_len41_fa10_ta10_fm10_tm10,a
2881@TOP@human_GAPDH_TAA_len41_fa10_ta10_fm10_tm10*128*c,1,10008,1,0,10010,0.0,128,2881@TOP@human_GAPDH_TAA_len41_fa10_ta10_fm10_tm10,c
2881@TOP@human_GAPDH_TAA_len41_fa10_ta10_fm10_tm10*129*c,2,9935,0,1,9938,0.0,129,2881@TOP@human_GAPDH_TAA_len41_fa10_ta10_fm10_tm10,c
2881@TOP@human_GAPDH_TAA_len41_fa10_ta10_fm10_tm10*130*c,0,9993,0,2,9995,0.0,130,2881@TOP@human_GAPDH_TAA_len41_fa10_ta10_fm10_tm10,c
2881@TOP@human_GAPDH_TAA_len41_fa10_ta10_fm10_tm10*131*c,1,10021,0,0,10022,0.0,131,2881@TOP@human_GAPDH_TAA_len41_fa10_ta10_fm10_tm10,c
2881@TOP@human_GAPDH_TAA_len41_fa10_ta10_fm10_tm10*132*t,3,1,1,9861,9866,0.0,132,2881@TOP@human_GAPDH_TAA_len41_fa10_ta10_fm10_tm10,t
2881@TOP@human_GAPDH_TAA_len41_fa10_ta10_fm10_tm10*133*g,2,0,9849,1,9852,1.0,133,2881@TOP@human_GAPDH_TAA_len41_fa10_ta10_fm10_tm10,g
2881@TOP@human_GAPDH_TAA_len41_fa10_ta10_fm10_tm10*134*g,0,7,9914,0,9921,0.999,134,2881@TOP@human_GAPDH_TAA_len41_fa10_ta10_fm10_tm10,g
2882@TOP@human_GAPDH_TAA_len41_fa10_ta10_fm10_tm10*114*t,0,0,0,4345,4345,0.0,114,2882@TOP@human_GAPDH_TAA_len41_fa10_ta10_fm10_tm10,t
2882@TOP@human_GAPDH_TAA_len41_fa10_ta10_fm10_tm10*115*c,0,4369,0,0,4369,0.0,115,2882@TOP@human_GAPDH_TAA_len41_fa10_ta10_fm10_tm10,c
2882@TOP@human_GAPDH_TAA_len41_fa10_ta10_fm10_tm10*116*c,0,4350,0,4,4354,0.0,116,2882@TOP@human_GAPDH_TAA_len41_fa10_ta10_fm10_tm10,c
2882@TOP@human_GAPDH_TAA_len41_fa10_ta10_fm10_tm10*117*a,3709,0,628,0,4337,0.145,117,2882@TOP@human_GAPDH_TAA_len41_fa10_ta10_fm10_tm10,a
2882@TOP@human_GAPDH_TAA_len41_fa10_ta10_fm10_tm10*118*a,2165,0,2146,0,4311,0.498,118,2882@TOP@human_GAPDH_TAA_len41_fa10_ta10_fm10_tm10,a
2882@TOP@human_GAPDH_TAA_len41_fa10_ta10_fm10_tm10*119*g,2,0,4305,0,4307,1.0,119,2882@TOP@human_GAPDH_TAA_len41_fa10_ta10_fm10_tm10,g
2882@TOP@human_GAPDH_TAA_len41_fa10_ta10_fm10_tm10*120*g,0,0,4309,0,4309,1.0,120,2882@TOP@human_GAPDH_TAA_len41_fa10_ta10_fm10_tm10,g
2882@TOP@human_GAPDH_TAA_len41_fa10_ta10_fm10_tm10*121*a,4329,1,1,0,4331,0.0,121,2882@TOP@human_GAPDH_TAA_len41_fa10_ta10_fm10_tm10,a
2882@TOP@human_GAPDH_TAA_len41_fa10_ta10_fm10_tm10*122*g,1,0,4352,0,4353,1.0,122,2882@TOP@human_GAPDH_TAA_len41_fa10_ta10_fm10_tm10,g
2882@TOP@human_GAPDH_TAA_len41_fa10_ta10_fm10_tm10*123*t,0,0,0,4293,4293,0.0,123,2882@TOP@human_GAPDH_TAA_len41_fa10_ta10_fm10_tm10,t
2882@TOP@human_GAPDH_TAA_len41_fa10_ta10_fm10_tm10*124*a,4122,0,132,0,4254,0.031,124,2882@TOP@human_GAPDH_TAA_len41_fa10_ta10_fm10_tm10,a
2882@TOP@human_GAPDH_TAA_len41_fa10_ta10_fm10_tm10*125*a,4044,1,227,0,4272,0.053,125,2882@TOP@human_GAPDH_TAA_len41_fa10_ta10_fm10_tm10,a
2882@TOP@human_GAPDH_TAA_len41_fa10_ta10_fm10_tm10*126*g,0,0,4279,1,4280,1.0,126,2882@TOP@human_GAPDH_TAA_len41_fa10_ta10_fm10_tm10,g
2882@TOP@human_GAPDH_TAA_len41_fa10_ta10_fm10_tm10*127*a,4309,0,27,0,4336,0.006,127,2882@TOP@human_GAPDH_TAA_len41_fa10_ta10_fm10_tm10,a
2882@TOP@human_GAPDH_TAA_len41_fa10_ta10_fm10_tm10*128*c,1,4360,0,0,4361,0.0,128,2882@TOP@human_GAPDH_TAA_len41_fa10_ta10_fm10_tm10,c
2882@TOP@human_GAPDH_TAA_len41_fa10_ta10_fm10_tm10*129*c,0,4335,0,0,4335,0.0,129,2882@TOP@human_GAPDH_TAA_len41_fa10_ta10_fm10_tm10,c
2882@TOP@human_GAPDH_TAA_len41_fa10_ta10_fm10_tm10*130*c,0,4346,0,0,4346,0.0,130,2882@TOP@human_GAPDH_TAA_len41_fa10_ta10_fm10_tm10,c
2882@TOP@human_GAPDH_TAA_len41_fa10_ta10_fm10_tm10*131*c,0,4357,0,1,4358,0.0,131,2882@TOP@human_GAPDH_TAA_len41_fa10_ta10_fm10_tm10,c
2882@TOP@human_GAPDH_TAA_len41_fa10_ta10_fm10_tm10*132*t,0,0,0,4294,4294,0.0,132,2882@TOP@human_GAPDH_TAA_len41_fa10_ta10_fm10_tm10,t
2882@TOP@human_GAPDH_TAA_len41_fa10_ta10_fm10_tm10*133*g,0,0,4290,1,4291,1.0,133,2882@TOP@human_GAPDH_TAA_len41_fa10_ta10_fm10_tm10,g
2882@TOP@human_GAPDH_TAA_len41_fa10_ta10_fm10_tm10*134*g,0,1,4314,0,4315,1.0,134,2882@TOP@human_GAPDH_TAA_len41_fa10_ta10_fm10_tm10,g
2883@TOP@human_GAPDH_TAA_len41_fa10_ta10_fm10_tm10*114*t,1,1,0,14751,14753,0.0,114,2883@TOP@human_GAPDH_TAA_len41_fa10_ta10_fm10_tm10,t
2883@TOP@human_GAPDH_TAA_len41_fa10_ta10_fm10_tm10*115*c,1,14826,0,0,14827,0.0,115,2883@TOP@human_GAPDH_TAA_len41_fa10_ta10_fm10_tm10,c
2883@TOP@human_GAPDH_TAA_len41_fa10_ta10_fm10_tm10*116*c,2,14771,0,2,14775,0.0,116,2883@TOP@human_GAPDH_TAA_len41_fa10_ta10_fm10_tm10,c
2883@TOP@human_GAPDH_TAA_len41_fa10_ta10_fm10_tm10*117*a,14547,0,212,0,14759,0.014,117,2883@TOP@human_GAPDH_TAA_len41_fa10_ta10_fm10_tm10,a
2883@TOP@human_GAPDH_TAA_len41_fa10_ta10_fm10_tm10*118*a,11995,0,2680,0,14675,0.183,118,2883@TOP@human_GAPDH_TAA_len41_fa10_ta10_fm10_tm10,a
2883@TOP@human_GAPDH_TAA_len41_fa10_ta10_fm10_tm10*119*g,0,1,14654,0,14655,1.0,119,2883@TOP@human_GAPDH_TAA_len41_fa10_ta10_fm10_tm10,g
2883@TOP@human_GAPDH_TAA_len41_fa10_ta10_fm10_tm10*120*g,3,0,14607,3,14613,1.0,120,2883@TOP@human_GAPDH_TAA_len41_fa10_ta10_fm10_tm10,g
2883@TOP@human_GAPDH_TAA_len41_fa10_ta10_fm10_tm10*121*a,14723,1,4,0,14728,0.0,121,2883@TOP@human_GAPDH_TAA_len41_fa10_ta10_fm10_tm10,a
2883@TOP@human_GAPDH_TAA_len41_fa10_ta10_fm10_tm10*122*g,2,0,14760,0,14762,1.0,122,2883@TOP@human_GAPDH_TAA_len41_fa10_ta10_fm10_tm10,g
2883@TOP@human_GAPDH_TAA_len41_fa10_ta10_fm10_tm10*123*t,2,4,0,14568,14574,0.0,123,2883@TOP@human_GAPDH_TAA_len41_fa10_ta10_fm10_tm10,t
2883@TOP@human_GAPDH_TAA_len41_fa10_ta10_fm10_tm10*124*a,11750,0,2789,0,14539,0.192,124,2883@TOP@human_GAPDH_TAA_len41_fa10_ta10_fm10_tm10,a
2883@TOP@human_GAPDH_TAA_len41_fa10_ta10_fm10_tm10*125*a,13527,1,970,1,14499,0.067,125,2883@TOP@human_GAPDH_TAA_len41_fa10_ta10_fm10_tm10,a
2883@TOP@human_GAPDH_TAA_len41_fa10_ta10_fm10_tm10*126*g,0,0,14579,1,14580,1.0,126,2883@TOP@human_GAPDH_TAA_len41_fa10_ta10_fm10_tm10,g
2883@TOP@human_GAPDH_TAA_len41_fa10_ta10_fm10_tm10*127*a,14720,0,10,1,14731,0.001,127,2883@TOP@human_GAPDH_TAA_len41_fa10_ta10_fm10_tm10,a
2883@TOP@human_GAPDH_TAA_len41_fa10_ta10_fm10_tm10*128*c,0,14797,0,0,14797,0.0,128,2883@TOP@human_GAPDH_TAA_len41_fa10_ta10_fm10_tm10,c
2883@TOP@human_GAPDH_TAA_len41_fa10_ta10_fm10_tm10*129*c,0,14687,0,7,14694,0.0,129,2883@TOP@human_GAPDH_TAA_len41_fa10_ta10_fm10_tm10,c
2883@TOP@human_GAPDH_TAA_len41_fa10_ta10_fm10_tm10*130*c,2,14774,0,1,14777,0.0,130,2883@TOP@human_GAPDH_TAA_len41_fa10_ta10_fm10_tm10,c
2883@TOP@human_GAPDH_TAA_len41_fa10_ta10_fm10_tm10*131*c,1,14799,0,1,14801,0.0,131,2883@TOP@human_GAPDH_TAA_len41_fa10_ta10_fm10_tm10,c
2883@TOP@human_GAPDH_TAA_len41_fa10_ta10_fm10_tm10*132*t,2,2,0,14599,14603,0.0,132,2883@TOP@human_GAPDH_TAA_len41_fa10_ta10_fm10_tm10,t
2883@TOP@human_GAPDH_TAA_len41_fa10_ta10_fm10_tm10*133*g,3,0,14563,2,14568,1.0,133,2883@TOP@human_GAPDH_TAA_len41_fa10_ta10_fm10_tm10,g
2883@TOP@human_GAPDH_TAA_len41_fa10_ta10_fm10_tm10*134*g,0,0,14647,0,14647,1.0,134,2883@TOP@human_GAPDH_TAA_len41_fa10_ta10_fm10_tm10,g
2884@TOP@human_GAPDH_TAA_len41_fa10_ta10_fm10_tm10*114*t,1,8,0,20703,20712,0.0,114,2884@TOP@human_GAPDH_TAA_len41_fa10_ta10_fm10_tm10,t
2884@TOP@human_GAPDH_TAA_len41_fa10_ta10_fm10_tm10*115*c,2,20832,2,1,20837,0.0,115,2884@TOP@human_GAPDH_TAA_len41_fa10_ta10_fm10_tm10,c
2884@TOP@human_GAPDH_TAA_len41_fa10_ta10_fm10_tm10*116*c,1,20756,0,0,20757,0.0,116,2884@TOP@human_GAPDH_TAA_len41_fa10_ta10_fm10_tm10,c
2884@TOP@human_GAPDH_TAA_len41_fa10_ta10_fm10_tm10*117*a,20367,0,374,0,20741,0.018,117,2884@TOP@human_GAPDH_TAA_len41_fa10_ta10_fm10_tm10,a
2884@TOP@human_GAPDH_TAA_len41_fa10_ta10_fm10_tm10*118*a,16585,0,4048,6,20639,0.196,118,2884@TOP@human_GAPDH_TAA_len41_fa10_ta10_fm10_tm10,a
2884@TOP@human_GAPDH_TAA_len41_fa10_ta10_fm10_tm10*119*g,1,0,20583,0,20584,1.0,119,2884@TOP@human_GAPDH_TAA_len41_fa10_ta10_fm10_tm10,g
2884@TOP@human_GAPDH_TAA_len41_fa10_ta10_fm10_tm10*120*g,1,1,20526,0,20528,1.0,120,2884@TOP@human_GAPDH_TAA_len41_fa10_ta10_fm10_tm10,g
2884@TOP@human_GAPDH_TAA_len41_fa10_ta10_fm10_tm10*121*a,20699,0,6,0,20705,0.0,121,2884@TOP@human_GAPDH_TAA_len41_fa10_ta10_fm10_tm10,a
2884@TOP@human_GAPDH_TAA_len41_fa10_ta10_fm10_tm10*122*g,1,1,20754,0,20756,1.0,122,2884@TOP@human_GAPDH_TAA_len41_fa10_ta10_fm10_tm10,g
2884@TOP@human_GAPDH_TAA_len41_fa10_ta10_fm10_tm10*123*t,3,2,3,20473,20481,0.0,123,2884@TOP@human_GAPDH_TAA_len41_fa10_ta10_fm10_tm10,t
2884@TOP@human_GAPDH_TAA_len41_fa10_ta10_fm10_tm10*124*a,16182,0,4277,0,20459,0.209,124,2884@TOP@human_GAPDH_TAA_len41_fa10_ta10_fm10_tm10,a
2884@TOP@human_GAPDH_TAA_len41_fa10_ta10_fm10_tm10*125*a,19037,2,1404,1,20444,0.069,125,2884@TOP@human_GAPDH_TAA_len41_fa10_ta10_fm10_tm10,a
2884@TOP@human_GAPDH_TAA_len41_fa10_ta10_fm10_tm10*126*g,0,0,20511,1,20512,1.0,126,2884@TOP@human_GAPDH_TAA_len41_fa10_ta10_fm10_tm10,g
2884@TOP@human_GAPDH_TAA_len41_fa10_ta10_fm10_tm10*127*a,20685,1,10,0,20696,0.0,127,2884@TOP@human_GAPDH_TAA_len41_fa10_ta10_fm10_tm10,a
2884@TOP@human_GAPDH_TAA_len41_fa10_ta10_fm10_tm10*128*c,0,20786,1,2,20789,0.0,128,2884@TOP@human_GAPDH_TAA_len41_fa10_ta10_fm10_tm10,c
2884@TOP@human_GAPDH_TAA_len41_fa10_ta10_fm10_tm10*129*c,0,20639,0,0,20639,0.0,129,2884@TOP@human_GAPDH_TAA_len41_fa10_ta10_fm10_tm10,c
2884@TOP@human_GAPDH_TAA_len41_fa10_ta10_fm10_tm10*130*c,0,20756,0,2,20758,0.0,130,2884@TOP@human_GAPDH_TAA_len41_fa10_ta10_fm10_tm10,c
2884@TOP@human_GAPDH_TAA_len41_fa10_ta10_fm10_tm10*131*c,0,20802,0,3,20805,0.0,131,2884@TOP@human_GAPDH_TAA_len41_fa10_ta10_fm10_tm10,c
2884@TOP@human_GAPDH_TAA_len41_fa10_ta10_fm10_tm10*132*t,5,3,8,20502,20518,0.0,132,2884@TOP@human_GAPDH_TAA_len41_fa10_ta10_fm10_tm10,t
2884@TOP@human_GAPDH_TAA_len41_fa10_ta10_fm10_tm10*133*g,3,0,20453,1,20457,1.0,133,2884@TOP@human_GAPDH_TAA_len41_fa10_ta10_fm10_tm10,g
2884@TOP@human_GAPDH_TAA_len41_fa10_ta10_fm10_tm10*134*g,2,12,20562,1,20577,0.999,134,2884@TOP@human_GAPDH_TAA_len41_fa10_ta10_fm10_tm10,g
2885@TOP@human_GAPDH_TAA_len41_fa10_ta10_fm10_tm10*114*t,1,0,0,3995,3996,0.0,114,2885@TOP@human_GAPDH_TAA_len41_fa10_ta10_fm10_tm10,t
2885@TOP@human_GAPDH_TAA_len41_fa10_ta10_fm10_tm10*115*c,0,4016,0,1,4017,0.0,115,2885@TOP@human_GAPDH_TAA_len41_fa10_ta10_fm10_tm10,c
2885@TOP@human_GAPDH_TAA_len41_fa10_ta10_fm10_tm10*116*c,0,4002,0,0,4002,0.0,116,2885@TOP@human_GAPDH_TAA_len41_fa10_ta10_fm10_tm10,c
2885@TOP@human_GAPDH_TAA_len41_fa10_ta10_fm10_tm10*117*a,3899,0,102,0,4001,0.025,117,2885@TOP@human_GAPDH_TAA_len41_fa10_ta10_fm10_tm10,a
2885@TOP@human_GAPDH_TAA_len41_fa10_ta10_fm10_tm10*118*a,2719,0,1255,0,3974,0.316,118,2885@TOP@human_GAPDH_TAA_len41_fa10_ta10_fm10_tm10,a
2885@TOP@human_GAPDH_TAA_len41_fa10_ta10_fm10_tm10*119*g,0,0,3970,1,3971,1.0,119,2885@TOP@human_GAPDH_TAA_len41_fa10_ta10_fm10_tm10,g
2885@TOP@human_GAPDH_TAA_len41_fa10_ta10_fm10_tm10*120*g,0,0,3952,0,3952,1.0,120,2885@TOP@human_GAPDH_TAA_len41_fa10_ta10_fm10_tm10,g
2885@TOP@human_GAPDH_TAA_len41_fa10_ta10_fm10_tm10*121*a,3983,0,5,0,3988,0.001,121,2885@TOP@human_GAPDH_TAA_len41_fa10_ta10_fm10_tm10,a
2885@TOP@human_GAPDH_TAA_len41_fa10_ta10_fm10_tm10*122*g,2,1,3986,0,3989,0.999,122,2885@TOP@human_GAPDH_TAA_len41_fa10_ta10_fm10_tm10,g
2885@TOP@human_GAPDH_TAA_len41_fa10_ta10_fm10_tm10*123*t,0,6,0,3943,3949,0.0,123,2885@TOP@human_GAPDH_TAA_len41_fa10_ta10_fm10_tm10,t
2885@TOP@human_GAPDH_TAA_len41_fa10_ta10_fm10_tm10*124*a,2733,0,1203,0,3936,0.306,124,2885@TOP@human_GAPDH_TAA_len41_fa10_ta10_fm10_tm10,a
2885@TOP@human_GAPDH_TAA_len41_fa10_ta10_fm10_tm10*125*a,2960,0,974,1,3935,0.248,125,2885@TOP@human_GAPDH_TAA_len41_fa10_ta10_fm10_tm10,a
2885@TOP@human_GAPDH_TAA_len41_fa10_ta10_fm10_tm10*126*g,2,0,3955,0,3957,0.999,126,2885@TOP@human_GAPDH_TAA_len41_fa10_ta10_fm10_tm10,g
2885@TOP@human_GAPDH_TAA_len41_fa10_ta10_fm10_tm10*127*a,3968,0,21,0,3989,0.005,127,2885@TOP@human_GAPDH_TAA_len41_fa10_ta10_fm10_tm10,a
2885@TOP@human_GAPDH_TAA_len41_fa10_ta10_fm10_tm10*128*c,0,4011,0,0,4011,0.0,128,2885@TOP@human_GAPDH_TAA_len41_fa10_ta10_fm10_tm10,c
2885@TOP@human_GAPDH_TAA_len41_fa10_ta10_fm10_tm10*129*c,0,3984,0,1,3985,0.0,129,2885@TOP@human_GAPDH_TAA_len41_fa10_ta10_fm10_tm10,c
2885@TOP@human_GAPDH_TAA_len41_fa10_ta10_fm10_tm10*130*c,0,4004,0,0,4004,0.0,130,2885@TOP@human_GAPDH_TAA_len41_fa10_ta10_fm10_tm10,c
2885@TOP@human_GAPDH_TAA_len41_fa10_ta10_fm10_tm10*131*c,0,4013,0,0,4013,0.0,131,2885@TOP@human_GAPDH_TAA_len41_fa10_ta10_fm10_tm10,c
2885@TOP@human_GAPDH_TAA_len41_fa10_ta10_fm10_tm10*132*t,1,1,0,3957,3959,0.0,132,2885@TOP@human_GAPDH_TAA_len41_fa10_ta10_fm10_tm10,t
2885@TOP@human_GAPDH_TAA_len41_fa10_ta10_fm10_tm10*133*g,0,0,3942,0,3942,1.0,133,2885@TOP@human_GAPDH_TAA_len41_fa10_ta10_fm10_tm10,g
2885@TOP@human_GAPDH_TAA_len41_fa10_ta10_fm10_tm10*134*g,0,0,3978,0,3978,1.0,134,2885@TOP@human_GAPDH_TAA_len41_fa10_ta10_fm10_tm10,g
2886@TOP@human_GAPDH_TAA_len41_fa10_ta10_fm10_tm10*114*t,0,2,0,22718,22720,0.0,114,2886@TOP@human_GAPDH_TAA_len41_fa10_ta10_fm10_tm10,t
2886@TOP@human_GAPDH_TAA_len41_fa10_ta10_fm10_tm10*115*c,0,22846,0,2,22848,0.0,115,2886@TOP@human_GAPDH_TAA_len41_fa10_ta10_fm10_tm10,c
2886@TOP@human_GAPDH_TAA_len41_fa10_ta10_fm10_tm10*116*c,0,22770,0,1,22771,0.0,116,2886@TOP@human_GAPDH_TAA_len41_fa10_ta10_fm10_tm10,c
2886@TOP@human_GAPDH_TAA_len41_fa10_ta10_fm10_tm10*117*a,22555,0,188,0,22743,0.008,117,2886@TOP@human_GAPDH_TAA_len41_fa10_ta10_fm10_tm10,a
2886@TOP@human_GAPDH_TAA_len41_fa10_ta10_fm10_tm10*118*a,20512,0,2161,0,22673,0.095,118,2886@TOP@human_GAPDH_TAA_len41_fa10_ta10_fm10_tm10,a
2886@TOP@human_GAPDH_TAA_len41_fa10_ta10_fm10_tm10*119*g,3,0,22566,0,22569,1.0,119,2886@TOP@human_GAPDH_TAA_len41_fa10_ta10_fm10_tm10,g
2886@TOP@human_GAPDH_TAA_len41_fa10_ta10_fm10_tm10*120*g,0,0,22503,0,22503,1.0,120,2886@TOP@human_GAPDH_TAA_len41_fa10_ta10_fm10_tm10,g
2886@TOP@human_GAPDH_TAA_len41_fa10_ta10_fm10_tm10*121*a,22717,0,14,0,22731,0.001,121,2886@TOP@human_GAPDH_TAA_len41_fa10_ta10_fm10_tm10,a
2886@TOP@human_GAPDH_TAA_len41_fa10_ta10_fm10_tm10*122*g,3,0,22742,0,22745,1.0,122,2886@TOP@human_GAPDH_TAA_len41_fa10_ta10_fm10_tm10,g
2886@TOP@human_GAPDH_TAA_len41_fa10_ta10_fm10_tm10*123*t,4,5,5,22463,22477,0.0,123,2886@TOP@human_GAPDH_TAA_len41_fa10_ta10_fm10_tm10,t
2886@TOP@human_GAPDH_TAA_len41_fa10_ta10_fm10_tm10*124*a,18838,0,3553,2,22393,0.159,124,2886@TOP@human_GAPDH_TAA_len41_fa10_ta10_fm10_tm10,a
2886@TOP@human_GAPDH_TAA_len41_fa10_ta10_fm10_tm10*125*a,21259,0,1109,0,22368,0.05,125,2886@TOP@human_GAPDH_TAA_len41_fa10_ta10_fm10_tm10,a
2886@TOP@human_GAPDH_TAA_len41_fa10_ta10_fm10_tm10*126*g,7,0,22489,2,22498,1.0,126,2886@TOP@human_GAPDH_TAA_len41_fa10_ta10_fm10_tm10,g
2886@TOP@human_GAPDH_TAA_len41_fa10_ta10_fm10_tm10*127*a,22649,3,33,0,22685,0.001,127,2886@TOP@human_GAPDH_TAA_len41_fa10_ta10_fm10_tm10,a
2886@TOP@human_GAPDH_TAA_len41_fa10_ta10_fm10_tm10*128*c,0,22792,2,1,22795,0.0,128,2886@TOP@human_GAPDH_TAA_len41_fa10_ta10_fm10_tm10,c
2886@TOP@human_GAPDH_TAA_len41_fa10_ta10_fm10_tm10*129*c,1,22627,0,0,22628,0.0,129,2886@TOP@human_GAPDH_TAA_len41_fa10_ta10_fm10_tm10,c
2886@TOP@human_GAPDH_TAA_len41_fa10_ta10_fm10_tm10*130*c,1,22743,0,2,22746,0.0,130,2886@TOP@human_GAPDH_TAA_len41_fa10_ta10_fm10_tm10,c
2886@TOP@human_GAPDH_TAA_len41_fa10_ta10_fm10_tm10*131*c,2,22820,0,4,22826,0.0,131,2886@TOP@human_GAPDH_TAA_len41_fa10_ta10_fm10_tm10,c
2886@TOP@human_GAPDH_TAA_len41_fa10_ta10_fm10_tm10*132*t,3,5,7,22493,22508,0.0,132,2886@TOP@human_GAPDH_TAA_len41_fa10_ta10_fm10_tm10,t
2886@TOP@human_GAPDH_TAA_len41_fa10_ta10_fm10_tm10*133*g,5,1,22443,2,22451,1.0,133,2886@TOP@human_GAPDH_TAA_len41_fa10_ta10_fm10_tm10,g
2886@TOP@human_GAPDH_TAA_len41_fa10_ta10_fm10_tm10*134*g,4,4,22565,0,22573,1.0,134,2886@TOP@human_GAPDH_TAA_len41_fa10_ta10_fm10_tm10,g
2887@TOP@human_GAPDH_TAA_len41_fa10_ta10_fm10_tm10*114*t,5,14,0,41335,41354,0.0,114,2887@TOP@human_GAPDH_TAA_len41_fa10_ta10_fm10_tm10,t
2887@TOP@human_GAPDH_TAA_len41_fa10_ta10_fm10_tm10*115*c,2,41612,0,2,41616,0.0,115,2887@TOP@human_GAPDH_TAA_len41_fa10_ta10_fm10_tm10,c
2887@TOP@human_GAPDH_TAA_len41_fa10_ta10_fm10_tm10*116*c,3,41469,0,2,41474,0.0,116,2887@TOP@human_GAPDH_TAA_len41_fa10_ta10_fm10_tm10,c
2887@TOP@human_GAPDH_TAA_len41_fa10_ta10_fm10_tm10*117*a,40967,2,423,3,41395,0.01,117,2887@TOP@human_GAPDH_TAA_len41_fa10_ta10_fm10_tm10,a
2887@TOP@human_GAPDH_TAA_len41_fa10_ta10_fm10_tm10*118*a,27120,1,14038,2,41161,0.341,118,2887@TOP@human_GAPDH_TAA_len41_fa10_ta10_fm10_tm10,a
2887@TOP@human_GAPDH_TAA_len41_fa10_ta10_fm10_tm10*119*g,2,0,41085,0,41087,1.0,119,2887@TOP@human_GAPDH_TAA_len41_fa10_ta10_fm10_tm10,g
2887@TOP@human_GAPDH_TAA_len41_fa10_ta10_fm10_tm10*120*g,2,2,41106,1,41111,1.0,120,2887@TOP@human_GAPDH_TAA_len41_fa10_ta10_fm10_tm10,g
2887@TOP@human_GAPDH_TAA_len41_fa10_ta10_fm10_tm10*121*a,41213,0,40,0,41253,0.001,121,2887@TOP@human_GAPDH_TAA_len41_fa10_ta10_fm10_tm10,a
2887@TOP@human_GAPDH_TAA_len41_fa10_ta10_fm10_tm10*122*g,3,2,41460,1,41466,1.0,122,2887@TOP@human_GAPDH_TAA_len41_fa10_ta10_fm10_tm10,g
2887@TOP@human_GAPDH_TAA_len41_fa10_ta10_fm10_tm10*123*t,5,21,12,40917,40955,0.0,123,2887@TOP@human_GAPDH_TAA_len41_fa10_ta10_fm10_tm10,t
2887@TOP@human_GAPDH_TAA_len41_fa10_ta10_fm10_tm10*124*a,36550,4,4234,0,40788,0.104,124,2887@TOP@human_GAPDH_TAA_len41_fa10_ta10_fm10_tm10,a
2887@TOP@human_GAPDH_TAA_len41_fa10_ta10_fm10_tm10*125*a,37685,7,2832,5,40529,0.07,125,2887@TOP@human_GAPDH_TAA_len41_fa10_ta10_fm10_tm10,a
2887@TOP@human_GAPDH_TAA_len41_fa10_ta10_fm10_tm10*126*g,2,0,40995,3,41000,1.0,126,2887@TOP@human_GAPDH_TAA_len41_fa10_ta10_fm10_tm10,g
2887@TOP@human_GAPDH_TAA_len41_fa10_ta10_fm10_tm10*127*a,41101,5,183,0,41289,0.004,127,2887@TOP@human_GAPDH_TAA_len41_fa10_ta10_fm10_tm10,a
2887@TOP@human_GAPDH_TAA_len41_fa10_ta10_fm10_tm10*128*c,1,41508,4,1,41514,0.0,128,2887@TOP@human_GAPDH_TAA_len41_fa10_ta10_fm10_tm10,c
2887@TOP@human_GAPDH_TAA_len41_fa10_ta10_fm10_tm10*129*c,1,41199,0,3,41203,0.0,129,2887@TOP@human_GAPDH_TAA_len41_fa10_ta10_fm10_tm10,c
2887@TOP@human_GAPDH_TAA_len41_fa10_ta10_fm10_tm10*130*c,3,41433,0,3,41439,0.0,130,2887@TOP@human_GAPDH_TAA_len41_fa10_ta10_fm10_tm10,c
2887@TOP@human_GAPDH_TAA_len41_fa10_ta10_fm10_tm10*131*c,1,41526,0,1,41528,0.0,131,2887@TOP@human_GAPDH_TAA_len41_fa10_ta10_fm10_tm10,c
2887@TOP@human_GAPDH_TAA_len41_fa10_ta10_fm10_tm10*132*t,3,12,2,40955,40972,0.0,132,2887@TOP@human_GAPDH_TAA_len41_fa10_ta10_fm10_tm10,t
2887@TOP@human_GAPDH_TAA_len41_fa10_ta10_fm10_tm10*133*g,4,1,40837,0,40842,1.0,133,2887@TOP@human_GAPDH_TAA_len41_fa10_ta10_fm10_tm10,g
2887@TOP@human_GAPDH_TAA_len41_fa10_ta10_fm10_tm10*134*g,1,3,41100,0,41104,1.0,134,2887@TOP@human_GAPDH_TAA_len41_fa10_ta10_fm10_tm10,g
2888@TOP@human_GAPDH_TAA_len41_fa10_ta10_fm10_tm10*114*t,4,18,1,41276,41299,0.0,114,2888@TOP@human_GAPDH_TAA_len41_fa10_ta10_fm10_tm10,t
2888@TOP@human_GAPDH_TAA_len41_fa10_ta10_fm10_tm10*115*c,1,41520,0,1,41522,0.0,115,2888@TOP@human_GAPDH_TAA_len41_fa10_ta10_fm10_tm10,c
2888@TOP@human_GAPDH_TAA_len41_fa10_ta10_fm10_tm10*116*c,0,41382,0,0,41382,0.0,116,2888@TOP@human_GAPDH_TAA_len41_fa10_ta10_fm10_tm10,c
2888@TOP@human_GAPDH_TAA_len41_fa10_ta10_fm10_tm10*117*a,40987,0,304,0,41291,0.007,117,2888@TOP@human_GAPDH_TAA_len41_fa10_ta10_fm10_tm10,a
2888@TOP@human_GAPDH_TAA_len41_fa10_ta10_fm10_tm10*118*a,30204,0,10893,0,41097,0.265,118,2888@TOP@human_GAPDH_TAA_len41_fa10_ta10_fm10_tm10,a
2888@TOP@human_GAPDH_TAA_len41_fa10_ta10_fm10_tm10*119*g,0,0,41026,2,41028,1.0,119,2888@TOP@human_GAPDH_TAA_len41_fa10_ta10_fm10_tm10,g
2888@TOP@human_GAPDH_TAA_len41_fa10_ta10_fm10_tm10*120*g,1,3,40991,2,40997,1.0,120,2888@TOP@human_GAPDH_TAA_len41_fa10_ta10_fm10_tm10,g
2888@TOP@human_GAPDH_TAA_len41_fa10_ta10_fm10_tm10*121*a,41099,0,58,1,41158,0.001,121,2888@TOP@human_GAPDH_TAA_len41_fa10_ta10_fm10_tm10,a
2888@TOP@human_GAPDH_TAA_len41_fa10_ta10_fm10_tm10*122*g,1,0,41351,0,41352,1.0,122,2888@TOP@human_GAPDH_TAA_len41_fa10_ta10_fm10_tm10,g
2888@TOP@human_GAPDH_TAA_len41_fa10_ta10_fm10_tm10*123*t,4,2,8,40840,40854,0.0,123,2888@TOP@human_GAPDH_TAA_len41_fa10_ta10_fm10_tm10,t
2888@TOP@human_GAPDH_TAA_len41_fa10_ta10_fm10_tm10*124*a,29948,1,10695,1,40645,0.263,124,2888@TOP@human_GAPDH_TAA_len41_fa10_ta10_fm10_tm10,a
2888@TOP@human_GAPDH_TAA_len41_fa10_ta10_fm10_tm10*125*a,38616,2,2034,5,40657,0.05,125,2888@TOP@human_GAPDH_TAA_len41_fa10_ta10_fm10_tm10,a
2888@TOP@human_GAPDH_TAA_len41_fa10_ta10_fm10_tm10*126*g,2,0,40887,0,40889,1.0,126,2888@TOP@human_GAPDH_TAA_len41_fa10_ta10_fm10_tm10,g
2888@TOP@human_GAPDH_TAA_len41_fa10_ta10_fm10_tm10*127*a,41158,1,83,0,41242,0.002,127,2888@TOP@human_GAPDH_TAA_len41_fa10_ta10_fm10_tm10,a
2888@TOP@human_GAPDH_TAA_len41_fa10_ta10_fm10_tm10*128*c,2,41432,7,2,41443,0.0,128,2888@TOP@human_GAPDH_TAA_len41_fa10_ta10_fm10_tm10,c
2888@TOP@human_GAPDH_TAA_len41_fa10_ta10_fm10_tm10*129*c,7,41181,0,3,41191,0.0,129,2888@TOP@human_GAPDH_TAA_len41_fa10_ta10_fm10_tm10,c
2888@TOP@human_GAPDH_TAA_len41_fa10_ta10_fm10_tm10*130*c,2,41373,0,1,41376,0.0,130,2888@TOP@human_GAPDH_TAA_len41_fa10_ta10_fm10_tm10,c
2888@TOP@human_GAPDH_TAA_len41_fa10_ta10_fm10_tm10*131*c,4,41455,0,3,41462,0.0,131,2888@TOP@human_GAPDH_TAA_len41_fa10_ta10_fm10_tm10,c
2888@TOP@human_GAPDH_TAA_len41_fa10_ta10_fm10_tm10*132*t,4,9,3,40831,40847,0.0,132,2888@TOP@human_GAPDH_TAA_len41_fa10_ta10_fm10_tm10,t
2888@TOP@human_GAPDH_TAA_len41_fa10_ta10_fm10_tm10*133*g,2,1,40778,2,40783,1.0,133,2888@TOP@human_GAPDH_TAA_len41_fa10_ta10_fm10_tm10,g
2888@TOP@human_GAPDH_TAA_len41_fa10_ta10_fm10_tm10*134*g,0,7,41018,0,41025,1.0,134,2888@TOP@human_GAPDH_TAA_len41_fa10_ta10_fm10_tm10,g
2889@TOP@human_GAPDH_TAA_len41_fa10_ta10_fm10_tm10*114*t,0,2,0,2417,2419,0.0,114,2889@TOP@human_GAPDH_TAA_len41_fa10_ta10_fm10_tm10,t
2889@TOP@human_GAPDH_TAA_len41_fa10_ta10_fm10_tm10*115*c,0,2432,0,0,2432,0.0,115,2889@TOP@human_GAPDH_TAA_len41_fa10_ta10_fm10_tm10,c
2889@TOP@human_GAPDH_TAA_len41_fa10_ta10_fm10_tm10*116*c,0,2423,0,0,2423,0.0,116,2889@TOP@human_GAPDH_TAA_len41_fa10_ta10_fm10_tm10,c
2889@TOP@human_GAPDH_TAA_len41_fa10_ta10_fm10_tm10*117*a,2366,0,55,0,2421,0.023,117,2889@TOP@human_GAPDH_TAA_len41_fa10_ta10_fm10_tm10,a
2889@TOP@human_GAPDH_TAA_len41_fa10_ta10_fm10_tm10*118*a,2089,1,319,0,2409,0.132,118,2889@TOP@human_GAPDH_TAA_len41_fa10_ta10_fm10_tm10,a
2889@TOP@human_GAPDH_TAA_len41_fa10_ta10_fm10_tm10*119*g,1,0,2401,0,2402,1.0,119,2889@TOP@human_GAPDH_TAA_len41_fa10_ta10_fm10_tm10,g
2889@TOP@human_GAPDH_TAA_len41_fa10_ta10_fm10_tm10*120*g,2,0,2400,0,2402,0.999,120,2889@TOP@human_GAPDH_TAA_len41_fa10_ta10_fm10_tm10,g
2889@TOP@human_GAPDH_TAA_len41_fa10_ta10_fm10_tm10*121*a,2407,0,4,0,2411,0.002,121,2889@TOP@human_GAPDH_TAA_len41_fa10_ta10_fm10_tm10,a
2889@TOP@human_GAPDH_TAA_len41_fa10_ta10_fm10_tm10*122*g,0,0,2417,0,2417,1.0,122,2889@TOP@human_GAPDH_TAA_len41_fa10_ta10_fm10_tm10,g
2889@TOP@human_GAPDH_TAA_len41_fa10_ta10_fm10_tm10*123*t,1,1,0,2389,2391,0.0,123,2889@TOP@human_GAPDH_TAA_len41_fa10_ta10_fm10_tm10,t
2889@TOP@human_GAPDH_TAA_len41_fa10_ta10_fm10_tm10*124*a,2089,0,292,0,2381,0.123,124,2889@TOP@human_GAPDH_TAA_len41_fa10_ta10_fm10_tm10,a
2889@TOP@human_GAPDH_TAA_len41_fa10_ta10_fm10_tm10*125*a,2050,0,335,0,2385,0.14,125,2889@TOP@human_GAPDH_TAA_len41_fa10_ta10_fm10_tm10,a
2889@TOP@human_GAPDH_TAA_len41_fa10_ta10_fm10_tm10*126*g,0,0,2390,0,2390,1.0,126,2889@TOP@human_GAPDH_TAA_len41_fa10_ta10_fm10_tm10,g
2889@TOP@human_GAPDH_TAA_len41_fa10_ta10_fm10_tm10*127*a,2411,0,3,0,2414,0.001,127,2889@TOP@human_GAPDH_TAA_len41_fa10_ta10_fm10_tm10,a
2889@TOP@human_GAPDH_TAA_len41_fa10_ta10_fm10_tm10*128*c,0,2430,0,0,2430,0.0,128,2889@TOP@human_GAPDH_TAA_len41_fa10_ta10_fm10_tm10,c
2889@TOP@human_GAPDH_TAA_len41_fa10_ta10_fm10_tm10*129*c,0,2406,0,0,2406,0.0,129,2889@TOP@human_GAPDH_TAA_len41_fa10_ta10_fm10_tm10,c
2889@TOP@human_GAPDH_TAA_len41_fa10_ta10_fm10_tm10*130*c,0,2428,0,0,2428,0.0,130,2889@TOP@human_GAPDH_TAA_len41_fa10_ta10_fm10_tm10,c
2889@TOP@human_GAPDH_TAA_len41_fa10_ta10_fm10_tm10*131*c,0,2428,0,0,2428,0.0,131,2889@TOP@human_GAPDH_TAA_len41_fa10_ta10_fm10_tm10,c
2889@TOP@human_GAPDH_TAA_len41_fa10_ta10_fm10_tm10*132*t,0,1,0,2400,2401,0.0,132,2889@TOP@human_GAPDH_TAA_len41_fa10_ta10_fm10_tm10,t
2889@TOP@human_GAPDH_TAA_len41_fa10_ta10_fm10_tm10*133*g,0,0,2395,0,2395,1.0,133,2889@TOP@human_GAPDH_TAA_len41_fa10_ta10_fm10_tm10,g
2889@TOP@human_GAPDH_TAA_len41_fa10_ta10_fm10_tm10*134*g,0,1,2405,0,2406,1.0,134,2889@TOP@human_GAPDH_TAA_len41_fa10_ta10_fm10_tm10,g
2890@TOP@human_GAPDH_TAA_len41_fa10_ta10_fm10_tm10*114*t,2,6,0,21416,21424,0.0,114,2890@TOP@human_GAPDH_TAA_len41_fa10_ta10_fm10_tm10,t
2890@TOP@human_GAPDH_TAA_len41_fa10_ta10_fm10_tm10*115*c,0,21536,1,0,21537,0.0,115,2890@TOP@human_GAPDH_TAA_len41_fa10_ta10_fm10_tm10,c
2890@TOP@human_GAPDH_TAA_len41_fa10_ta10_fm10_tm10*116*c,2,21437,0,0,21439,0.0,116,2890@TOP@human_GAPDH_TAA_len41_fa10_ta10_fm10_tm10,c
2890@TOP@human_GAPDH_TAA_len41_fa10_ta10_fm10_tm10*117*a,21292,0,156,7,21455,0.007,117,2890@TOP@human_GAPDH_TAA_len41_fa10_ta10_fm10_tm10,a
2890@TOP@human_GAPDH_TAA_len41_fa10_ta10_fm10_tm10*118*a,19762,2,1567,0,21331,0.073,118,2890@TOP@human_GAPDH_TAA_len41_fa10_ta10_fm10_tm10,a
2890@TOP@human_GAPDH_TAA_len41_fa10_ta10_fm10_tm10*119*g,4,0,21310,0,21314,1.0,119,2890@TOP@human_GAPDH_TAA_len41_fa10_ta10_fm10_tm10,g
2890@TOP@human_GAPDH_TAA_len41_fa10_ta10_fm10_tm10*120*g,2,2,21167,2,21173,1.0,120,2890@TOP@human_GAPDH_TAA_len41_fa10_ta10_fm10_tm10,g
2890@TOP@human_GAPDH_TAA_len41_fa10_ta10_fm10_tm10*121*a,21387,0,22,0,21409,0.001,121,2890@TOP@human_GAPDH_TAA_len41_fa10_ta10_fm10_tm10,a
2890@TOP@human_GAPDH_TAA_len41_fa10_ta10_fm10_tm10*122*g,2,0,21451,2,21455,1.0,122,2890@TOP@human_GAPDH_TAA_len41_fa10_ta10_fm10_tm10,g
2890@TOP@human_GAPDH_TAA_len41_fa10_ta10_fm10_tm10*123*t,0,3,5,21140,21148,0.0,123,2890@TOP@human_GAPDH_TAA_len41_fa10_ta10_fm10_tm10,t
2890@TOP@human_GAPDH_TAA_len41_fa10_ta10_fm10_tm10*124*a,20477,0,641,0,21118,0.03,124,2890@TOP@human_GAPDH_TAA_len41_fa10_ta10_fm10_tm10,a
2890@TOP@human_GAPDH_TAA_len41_fa10_ta10_fm10_tm10*125*a,20487,2,583,1,21073,0.028,125,2890@TOP@human_GAPDH_TAA_len41_fa10_ta10_fm10_tm10,a
2890@TOP@human_GAPDH_TAA_len41_fa10_ta10_fm10_tm10*126*g,1,1,21180,0,21182,1.0,126,2890@TOP@human_GAPDH_TAA_len41_fa10_ta10_fm10_tm10,g
2890@TOP@human_GAPDH_TAA_len41_fa10_ta10_fm10_tm10*127*a,21363,1,21,0,21385,0.001,127,2890@TOP@human_GAPDH_TAA_len41_fa10_ta10_fm10_tm10,a
2890@TOP@human_GAPDH_TAA_len41_fa10_ta10_fm10_tm10*128*c,0,21487,4,1,21492,0.0,128,2890@TOP@human_GAPDH_TAA_len41_fa10_ta10_fm10_tm10,c
2890@TOP@human_GAPDH_TAA_len41_fa10_ta10_fm10_tm10*129*c,2,21330,0,1,21333,0.0,129,2890@TOP@human_GAPDH_TAA_len41_fa10_ta10_fm10_tm10,c
2890@TOP@human_GAPDH_TAA_len41_fa10_ta10_fm10_tm10*130*c,0,21436,1,0,21437,0.0,130,2890@TOP@human_GAPDH_TAA_len41_fa10_ta10_fm10_tm10,c
2890@TOP@human_GAPDH_TAA_len41_fa10_ta10_fm10_tm10*131*c,1,21499,0,2,21502,0.0,131,2890@TOP@human_GAPDH_TAA_len41_fa10_ta10_fm10_tm10,c
2890@TOP@human_GAPDH_TAA_len41_fa10_ta10_fm10_tm10*132*t,2,5,0,21197,21204,0.0,132,2890@TOP@human_GAPDH_TAA_len41_fa10_ta10_fm10_tm10,t
2890@TOP@human_GAPDH_TAA_len41_fa10_ta10_fm10_tm10*133*g,4,2,21143,4,21153,1.0,133,2890@TOP@human_GAPDH_TAA_len41_fa10_ta10_fm10_tm10,g
2890@TOP@human_GAPDH_TAA_len41_fa10_ta10_fm10_tm10*134*g,1,4,21258,1,21264,1.0,134,2890@TOP@human_GAPDH_TAA_len41_fa10_ta10_fm10_tm10,g
2891@TOP@human_GAPDH_TAA_len41_fa10_ta10_fm10_tm10*114*t,0,0,0,768,768,0.0,114,2891@TOP@human_GAPDH_TAA_len41_fa10_ta10_fm10_tm10,t
2891@TOP@human_GAPDH_TAA_len41_fa10_ta10_fm10_tm10*115*c,0,772,0,0,772,0.0,115,2891@TOP@human_GAPDH_TAA_len41_fa10_ta10_fm10_tm10,c
2891@TOP@human_GAPDH_TAA_len41_fa10_ta10_fm10_tm10*116*c,0,767,0,0,767,0.0,116,2891@TOP@human_GAPDH_TAA_len41_fa10_ta10_fm10_tm10,c
2891@TOP@human_GAPDH_TAA_len41_fa10_ta10_fm10_tm10*117*a,745,0,19,0,764,0.025,117,2891@TOP@human_GAPDH_TAA_len41_fa10_ta10_fm10_tm10,a
2891@TOP@human_GAPDH_TAA_len41_fa10_ta10_fm10_tm10*118*a,662,0,99,0,761,0.13,118,2891@TOP@human_GAPDH_TAA_len41_fa10_ta10_fm10_tm10,a
2891@TOP@human_GAPDH_TAA_len41_fa10_ta10_fm10_tm10*119*g,0,0,762,0,762,1.0,119,2891@TOP@human_GAPDH_TAA_len41_fa10_ta10_fm10_tm10,g
2891@TOP@human_GAPDH_TAA_len41_fa10_ta10_fm10_tm10*120*g,0,0,759,0,759,1.0,120,2891@TOP@human_GAPDH_TAA_len41_fa10_ta10_fm10_tm10,g
2891@TOP@human_GAPDH_TAA_len41_fa10_ta10_fm10_tm10*121*a,768,0,2,0,770,0.003,121,2891@TOP@human_GAPDH_TAA_len41_fa10_ta10_fm10_tm10,a
2891@TOP@human_GAPDH_TAA_len41_fa10_ta10_fm10_tm10*122*g,0,0,769,0,769,1.0,122,2891@TOP@human_GAPDH_TAA_len41_fa10_ta10_fm10_tm10,g
2891@TOP@human_GAPDH_TAA_len41_fa10_ta10_fm10_tm10*123*t,0,0,0,757,757,0.0,123,2891@TOP@human_GAPDH_TAA_len41_fa10_ta10_fm10_tm10,t
2891@TOP@human_GAPDH_TAA_len41_fa10_ta10_fm10_tm10*124*a,619,0,140,0,759,0.184,124,2891@TOP@human_GAPDH_TAA_len41_fa10_ta10_fm10_tm10,a
2891@TOP@human_GAPDH_TAA_len41_fa10_ta10_fm10_tm10*125*a,691,0,68,0,759,0.09,125,2891@TOP@human_GAPDH_TAA_len41_fa10_ta10_fm10_tm10,a
2891@TOP@human_GAPDH_TAA_len41_fa10_ta10_fm10_tm10*126*g,0,0,758,0,758,1.0,126,2891@TOP@human_GAPDH_TAA_len41_fa10_ta10_fm10_tm10,g
2891@TOP@human_GAPDH_TAA_len41_fa10_ta10_fm10_tm10*127*a,761,0,4,0,765,0.005,127,2891@TOP@human_GAPDH_TAA_len41_fa10_ta10_fm10_tm10,a
2891@TOP@human_GAPDH_TAA_len41_fa10_ta10_fm10_tm10*128*c,0,766,0,0,766,0.0,128,2891@TOP@human_GAPDH_TAA_len41_fa10_ta10_fm10_tm10,c
2891@TOP@human_GAPDH_TAA_len41_fa10_ta10_fm10_tm10*129*c,0,765,0,0,765,0.0,129,2891@TOP@human_GAPDH_TAA_len41_fa10_ta10_fm10_tm10,c
2891@TOP@human_GAPDH_TAA_len41_fa10_ta10_fm10_tm10*130*c,0,768,0,1,769,0.0,130,2891@TOP@human_GAPDH_TAA_len41_fa10_ta10_fm10_tm10,c
2891@TOP@human_GAPDH_TAA_len41_fa10_ta10_fm10_tm10*131*c,0,767,0,0,767,0.0,131,2891@TOP@human_GAPDH_TAA_len41_fa10_ta10_fm10_tm10,c
2891@TOP@human_GAPDH_TAA_len41_fa10_ta10_fm10_tm10*132*t,0,0,0,758,758,0.0,132,2891@TOP@human_GAPDH_TAA_len41_fa10_ta10_fm10_tm10,t
2891@TOP@human_GAPDH_TAA_len41_fa10_ta10_fm10_tm10*133*g,1,0,761,0,762,0.999,133,2891@TOP@human_GAPDH_TAA_len41_fa10_ta10_fm10_tm10,g
2891@TOP@human_GAPDH_TAA_len41_fa10_ta10_fm10_tm10*134*g,0,0,759,0,759,1.0,134,2891@TOP@human_GAPDH_TAA_len41_fa10_ta10_fm10_tm10,g
2892@TOP@human_GAPDH_TAA_len41_fa10_ta10_fm10_tm10*114*t,0,2,0,2272,2274,0.0,114,2892@TOP@human_GAPDH_TAA_len41_fa10_ta10_fm10_tm10,t
2892@TOP@human_GAPDH_TAA_len41_fa10_ta10_fm10_tm10*115*c,0,2296,0,0,2296,0.0,115,2892@TOP@human_GAPDH_TAA_len41_fa10_ta10_fm10_tm10,c
2892@TOP@human_GAPDH_TAA_len41_fa10_ta10_fm10_tm10*116*c,0,2287,0,0,2287,0.0,116,2892@TOP@human_GAPDH_TAA_len41_fa10_ta10_fm10_tm10,c
2892@TOP@human_GAPDH_TAA_len41_fa10_ta10_fm10_tm10*117*a,2188,0,96,0,2284,0.042,117,2892@TOP@human_GAPDH_TAA_len41_fa10_ta10_fm10_tm10,a
2892@TOP@human_GAPDH_TAA_len41_fa10_ta10_fm10_tm10*118*a,1692,0,574,0,2266,0.253,118,2892@TOP@human_GAPDH_TAA_len41_fa10_ta10_fm10_tm10,a
2892@TOP@human_GAPDH_TAA_len41_fa10_ta10_fm10_tm10*119*g,0,0,2265,0,2265,1.0,119,2892@TOP@human_GAPDH_TAA_len41_fa10_ta10_fm10_tm10,g
2892@TOP@human_GAPDH_TAA_len41_fa10_ta10_fm10_tm10*120*g,1,0,2260,1,2262,0.999,120,2892@TOP@human_GAPDH_TAA_len41_fa10_ta10_fm10_tm10,g
2892@TOP@human_GAPDH_TAA_len41_fa10_ta10_fm10_tm10*121*a,2261,0,5,0,2266,0.002,121,2892@TOP@human_GAPDH_TAA_len41_fa10_ta10_fm10_tm10,a
2892@TOP@human_GAPDH_TAA_len41_fa10_ta10_fm10_tm10*122*g,0,0,2277,0,2277,1.0,122,2892@TOP@human_GAPDH_TAA_len41_fa10_ta10_fm10_tm10,g
2892@TOP@human_GAPDH_TAA_len41_fa10_ta10_fm10_tm10*123*t,0,0,0,2251,2251,0.0,123,2892@TOP@human_GAPDH_TAA_len41_fa10_ta10_fm10_tm10,t
2892@TOP@human_GAPDH_TAA_len41_fa10_ta10_fm10_tm10*124*a,1732,0,513,0,2245,0.229,124,2892@TOP@human_GAPDH_TAA_len41_fa10_ta10_fm10_tm10,a
2892@TOP@human_GAPDH_TAA_len41_fa10_ta10_fm10_tm10*125*a,1947,1,284,1,2233,0.127,125,2892@TOP@human_GAPDH_TAA_len41_fa10_ta10_fm10_tm10,a
2892@TOP@human_GAPDH_TAA_len41_fa10_ta10_fm10_tm10*126*g,0,0,2259,0,2259,1.0,126,2892@TOP@human_GAPDH_TAA_len41_fa10_ta10_fm10_tm10,g
2892@TOP@human_GAPDH_TAA_len41_fa10_ta10_fm10_tm10*127*a,2262,0,6,0,2268,0.003,127,2892@TOP@human_GAPDH_TAA_len41_fa10_ta10_fm10_tm10,a
2892@TOP@human_GAPDH_TAA_len41_fa10_ta10_fm10_tm10*128*c,0,2289,0,0,2289,0.0,128,2892@TOP@human_GAPDH_TAA_len41_fa10_ta10_fm10_tm10,c
2892@TOP@human_GAPDH_TAA_len41_fa10_ta10_fm10_tm10*129*c,0,2277,0,0,2277,0.0,129,2892@TOP@human_GAPDH_TAA_len41_fa10_ta10_fm10_tm10,c
2892@TOP@human_GAPDH_TAA_len41_fa10_ta10_fm10_tm10*130*c,0,2281,0,0,2281,0.0,130,2892@TOP@human_GAPDH_TAA_len41_fa10_ta10_fm10_tm10,c
2892@TOP@human_GAPDH_TAA_len41_fa10_ta10_fm10_tm10*131*c,0,2290,0,1,2291,0.0,131,2892@TOP@human_GAPDH_TAA_len41_fa10_ta10_fm10_tm10,c
2892@TOP@human_GAPDH_TAA_len41_fa10_ta10_fm10_tm10*132*t,0,1,0,2263,2264,0.0,132,2892@TOP@human_GAPDH_TAA_len41_fa10_ta10_fm10_tm10,t
2892@TOP@human_GAPDH_TAA_len41_fa10_ta10_fm10_tm10*133*g,0,1,2247,0,2248,1.0,133,2892@TOP@human_GAPDH_TAA_len41_fa10_ta10_fm10_tm10,g
2892@TOP@human_GAPDH_TAA_len41_fa10_ta10_fm10_tm10*134*g,1,1,2255,0,2257,0.999,134,2892@TOP@human_GAPDH_TAA_len41_fa10_ta10_fm10_tm10,g
2893@TOP@human_GAPDH_TAA_len41_fa10_ta10_fm10_tm10*114*t,2,8,0,33472,33482,0.0,114,2893@TOP@human_GAPDH_TAA_len41_fa10_ta10_fm10_tm10,t
2893@TOP@human_GAPDH_TAA_len41_fa10_ta10_fm10_tm10*115*c,3,33665,0,0,33668,0.0,115,2893@TOP@human_GAPDH_TAA_len41_fa10_ta10_fm10_tm10,c
2893@TOP@human_GAPDH_TAA_len41_fa10_ta10_fm10_tm10*116*c,1,33542,1,5,33549,0.0,116,2893@TOP@human_GAPDH_TAA_len41_fa10_ta10_fm10_tm10,c
2893@TOP@human_GAPDH_TAA_len41_fa10_ta10_fm10_tm10*117*a,32436,0,1035,0,33471,0.031,117,2893@TOP@human_GAPDH_TAA_len41_fa10_ta10_fm10_tm10,a
2893@TOP@human_GAPDH_TAA_len41_fa10_ta10_fm10_tm10*118*a,23025,0,10277,0,33302,0.309,118,2893@TOP@human_GAPDH_TAA_len41_fa10_ta10_fm10_tm10,a
2893@TOP@human_GAPDH_TAA_len41_fa10_ta10_fm10_tm10*119*g,1,0,33264,2,33267,1.0,119,2893@TOP@human_GAPDH_TAA_len41_fa10_ta10_fm10_tm10,g
2893@TOP@human_GAPDH_TAA_len41_fa10_ta10_fm10_tm10*120*g,5,0,33198,2,33205,1.0,120,2893@TOP@human_GAPDH_TAA_len41_fa10_ta10_fm10_tm10,g
2893@TOP@human_GAPDH_TAA_len41_fa10_ta10_fm10_tm10*121*a,33344,0,13,1,33358,0.0,121,2893@TOP@human_GAPDH_TAA_len41_fa10_ta10_fm10_tm10,a
2893@TOP@human_GAPDH_TAA_len41_fa10_ta10_fm10_tm10*122*g,1,2,33531,0,33534,1.0,122,2893@TOP@human_GAPDH_TAA_len41_fa10_ta10_fm10_tm10,g
2893@TOP@human_GAPDH_TAA_len41_fa10_ta10_fm10_tm10*123*t,3,7,4,33100,33114,0.0,123,2893@TOP@human_GAPDH_TAA_len41_fa10_ta10_fm10_tm10,t
2893@TOP@human_GAPDH_TAA_len41_fa10_ta10_fm10_tm10*124*a,28969,2,3941,1,32913,0.12,124,2893@TOP@human_GAPDH_TAA_len41_fa10_ta10_fm10_tm10,a
2893@TOP@human_GAPDH_TAA_len41_fa10_ta10_fm10_tm10*125*a,29150,5,3730,3,32888,0.113,125,2893@TOP@human_GAPDH_TAA_len41_fa10_ta10_fm10_tm10,a
2893@TOP@human_GAPDH_TAA_len41_fa10_ta10_fm10_tm10*126*g,0,0,33120,0,33120,1.0,126,2893@TOP@human_GAPDH_TAA_len41_fa10_ta10_fm10_tm10,g
2893@TOP@human_GAPDH_TAA_len41_fa10_ta10_fm10_tm10*127*a,33326,0,59,1,33386,0.002,127,2893@TOP@human_GAPDH_TAA_len41_fa10_ta10_fm10_tm10,a
2893@TOP@human_GAPDH_TAA_len41_fa10_ta10_fm10_tm10*128*c,1,33603,0,1,33605,0.0,128,2893@TOP@human_GAPDH_TAA_len41_fa10_ta10_fm10_tm10,c
2893@TOP@human_GAPDH_TAA_len41_fa10_ta10_fm10_tm10*129*c,1,33352,0,2,33355,0.0,129,2893@TOP@human_GAPDH_TAA_len41_fa10_ta10_fm10_tm10,c
2893@TOP@human_GAPDH_TAA_len41_fa10_ta10_fm10_tm10*130*c,2,33533,0,2,33537,0.0,130,2893@TOP@human_GAPDH_TAA_len41_fa10_ta10_fm10_tm10,c
2893@TOP@human_GAPDH_TAA_len41_fa10_ta10_fm10_tm10*131*c,2,33604,0,2,33608,0.0,131,2893@TOP@human_GAPDH_TAA_len41_fa10_ta10_fm10_tm10,c
2893@TOP@human_GAPDH_TAA_len41_fa10_ta10_fm10_tm10*132*t,2,8,6,33133,33149,0.0,132,2893@TOP@human_GAPDH_TAA_len41_fa10_ta10_fm10_tm10,t
2893@TOP@human_GAPDH_TAA_len41_fa10_ta10_fm10_tm10*133*g,3,0,33033,3,33039,1.0,133,2893@TOP@human_GAPDH_TAA_len41_fa10_ta10_fm10_tm10,g
2893@TOP@human_GAPDH_TAA_len41_fa10_ta10_fm10_tm10*134*g,1,5,33262,2,33270,1.0,134,2893@TOP@human_GAPDH_TAA_len41_fa10_ta10_fm10_tm10,g
2894@TOP@human_GAPDH_TAA_len41_fa10_ta10_fm10_tm10*114*t,2,5,0,33551,33558,0.0,114,2894@TOP@human_GAPDH_TAA_len41_fa10_ta10_fm10_tm10,t
2894@TOP@human_GAPDH_TAA_len41_fa10_ta10_fm10_tm10*115*c,1,33720,0,2,33723,0.0,115,2894@TOP@human_GAPDH_TAA_len41_fa10_ta10_fm10_tm10,c
2894@TOP@human_GAPDH_TAA_len41_fa10_ta10_fm10_tm10*116*c,0,33609,0,2,33611,0.0,116,2894@TOP@human_GAPDH_TAA_len41_fa10_ta10_fm10_tm10,c
2894@TOP@human_GAPDH_TAA_len41_fa10_ta10_fm10_tm10*117*a,33067,0,521,0,33588,0.016,117,2894@TOP@human_GAPDH_TAA_len41_fa10_ta10_fm10_tm10,a
2894@TOP@human_GAPDH_TAA_len41_fa10_ta10_fm10_tm10*118*a,28051,0,5323,0,33374,0.159,118,2894@TOP@human_GAPDH_TAA_len41_fa10_ta10_fm10_tm10,a
2894@TOP@human_GAPDH_TAA_len41_fa10_ta10_fm10_tm10*119*g,2,0,33302,4,33308,1.0,119,2894@TOP@human_GAPDH_TAA_len41_fa10_ta10_fm10_tm10,g
2894@TOP@human_GAPDH_TAA_len41_fa10_ta10_fm10_tm10*120*g,3,0,33235,0,33238,1.0,120,2894@TOP@human_GAPDH_TAA_len41_fa10_ta10_fm10_tm10,g
2894@TOP@human_GAPDH_TAA_len41_fa10_ta10_fm10_tm10*121*a,33459,0,8,0,33467,0.0,121,2894@TOP@human_GAPDH_TAA_len41_fa10_ta10_fm10_tm10,a
2894@TOP@human_GAPDH_TAA_len41_fa10_ta10_fm10_tm10*122*g,0,0,33583,3,33586,1.0,122,2894@TOP@human_GAPDH_TAA_len41_fa10_ta10_fm10_tm10,g
2894@TOP@human_GAPDH_TAA_len41_fa10_ta10_fm10_tm10*123*t,4,3,4,33140,33151,0.0,123,2894@TOP@human_GAPDH_TAA_len41_fa10_ta10_fm10_tm10,t
2894@TOP@human_GAPDH_TAA_len41_fa10_ta10_fm10_tm10*124*a,25923,1,7201,0,33125,0.217,124,2894@TOP@human_GAPDH_TAA_len41_fa10_ta10_fm10_tm10,a
2894@TOP@human_GAPDH_TAA_len41_fa10_ta10_fm10_tm10*125*a,31103,0,1913,4,33020,0.058,125,2894@TOP@human_GAPDH_TAA_len41_fa10_ta10_fm10_tm10,a
2894@TOP@human_GAPDH_TAA_len41_fa10_ta10_fm10_tm10*126*g,3,0,33187,3,33193,1.0,126,2894@TOP@human_GAPDH_TAA_len41_fa10_ta10_fm10_tm10,g
2894@TOP@human_GAPDH_TAA_len41_fa10_ta10_fm10_tm10*127*a,33474,1,20,0,33495,0.001,127,2894@TOP@human_GAPDH_TAA_len41_fa10_ta10_fm10_tm10,a
2894@TOP@human_GAPDH_TAA_len41_fa10_ta10_fm10_tm10*128*c,7,33652,0,0,33659,0.0,128,2894@TOP@human_GAPDH_TAA_len41_fa10_ta10_fm10_tm10,c
2894@TOP@human_GAPDH_TAA_len41_fa10_ta10_fm10_tm10*129*c,0,33420,0,5,33425,0.0,129,2894@TOP@human_GAPDH_TAA_len41_fa10_ta10_fm10_tm10,c
2894@TOP@human_GAPDH_TAA_len41_fa10_ta10_fm10_tm10*130*c,1,33616,0,3,33620,0.0,130,2894@TOP@human_GAPDH_TAA_len41_fa10_ta10_fm10_tm10,c
2894@TOP@human_GAPDH_TAA_len41_fa10_ta10_fm10_tm10*131*c,4,33676,0,3,33683,0.0,131,2894@TOP@human_GAPDH_TAA_len41_fa10_ta10_fm10_tm10,c
2894@TOP@human_GAPDH_TAA_len41_fa10_ta10_fm10_tm10*132*t,6,3,3,33202,33214,0.0,132,2894@TOP@human_GAPDH_TAA_len41_fa10_ta10_fm10_tm10,t
2894@TOP@human_GAPDH_TAA_len41_fa10_ta10_fm10_tm10*133*g,5,1,33110,3,33119,1.0,133,2894@TOP@human_GAPDH_TAA_len41_fa10_ta10_fm10_tm10,g
2894@TOP@human_GAPDH_TAA_len41_fa10_ta10_fm10_tm10*134*g,2,3,33300,2,33307,1.0,134,2894@TOP@human_GAPDH_TAA_len41_fa10_ta10_fm10_tm10,g
2895@TOP@human_GAPDH_TAA_len41_fa10_ta10_fm10_tm10*114*t,0,0,0,300,300,0.0,114,2895@TOP@human_GAPDH_TAA_len41_fa10_ta10_fm10_tm10,t
2895@TOP@human_GAPDH_TAA_len41_fa10_ta10_fm10_tm10*115*c,0,299,0,0,299,0.0,115,2895@TOP@human_GAPDH_TAA_len41_fa10_ta10_fm10_tm10,c
2895@TOP@human_GAPDH_TAA_len41_fa10_ta10_fm10_tm10*116*c,0,299,0,0,299,0.0,116,2895@TOP@human_GAPDH_TAA_len41_fa10_ta10_fm10_tm10,c
2895@TOP@human_GAPDH_TAA_len41_fa10_ta10_fm10_tm10*117*a,296,0,5,0,301,0.017,117,2895@TOP@human_GAPDH_TAA_len41_fa10_ta10_fm10_tm10,a
2895@TOP@human_GAPDH_TAA_len41_fa10_ta10_fm10_tm10*118*a,253,0,44,0,297,0.148,118,2895@TOP@human_GAPDH_TAA_len41_fa10_ta10_fm10_tm10,a
2895@TOP@human_GAPDH_TAA_len41_fa10_ta10_fm10_tm10*119*g,0,0,295,0,295,1.0,119,2895@TOP@human_GAPDH_TAA_len41_fa10_ta10_fm10_tm10,g
2895@TOP@human_GAPDH_TAA_len41_fa10_ta10_fm10_tm10*120*g,0,0,294,0,294,1.0,120,2895@TOP@human_GAPDH_TAA_len41_fa10_ta10_fm10_tm10,g
2895@TOP@human_GAPDH_TAA_len41_fa10_ta10_fm10_tm10*121*a,297,0,2,0,299,0.007,121,2895@TOP@human_GAPDH_TAA_len41_fa10_ta10_fm10_tm10,a
2895@TOP@human_GAPDH_TAA_len41_fa10_ta10_fm10_tm10*122*g,0,0,297,0,297,1.0,122,2895@TOP@human_GAPDH_TAA_len41_fa10_ta10_fm10_tm10,g
2895@TOP@human_GAPDH_TAA_len41_fa10_ta10_fm10_tm10*123*t,0,0,0,293,293,0.0,123,2895@TOP@human_GAPDH_TAA_len41_fa10_ta10_fm10_tm10,t
2895@TOP@human_GAPDH_TAA_len41_fa10_ta10_fm10_tm10*124*a,241,0,50,0,291,0.172,124,2895@TOP@human_GAPDH_TAA_len41_fa10_ta10_fm10_tm10,a
2895@TOP@human_GAPDH_TAA_len41_fa10_ta10_fm10_tm10*125*a,245,0,45,0,290,0.155,125,2895@TOP@human_GAPDH_TAA_len41_fa10_ta10_fm10_tm10,a
2895@TOP@human_GAPDH_TAA_len41_fa10_ta10_fm10_tm10*126*g,0,0,294,0,294,1.0,126,2895@TOP@human_GAPDH_TAA_len41_fa10_ta10_fm10_tm10,g
2895@TOP@human_GAPDH_TAA_len41_fa10_ta10_fm10_tm10*127*a,296,0,0,0,296,0.0,127,2895@TOP@human_GAPDH_TAA_len41_fa10_ta10_fm10_tm10,a
2895@TOP@human_GAPDH_TAA_len41_fa10_ta10_fm10_tm10*128*c,0,296,0,3,299,0.0,128,2895@TOP@human_GAPDH_TAA_len41_fa10_ta10_fm10_tm10,c
2895@TOP@human_GAPDH_TAA_len41_fa10_ta10_fm10_tm10*129*c,0,295,0,0,295,0.0,129,2895@TOP@human_GAPDH_TAA_len41_fa10_ta10_fm10_tm10,c
2895@TOP@human_GAPDH_TAA_len41_fa10_ta10_fm10_tm10*130*c,0,295,0,0,295,0.0,130,2895@TOP@human_GAPDH_TAA_len41_fa10_ta10_fm10_tm10,c
2895@TOP@human_GAPDH_TAA_len41_fa10_ta10_fm10_tm10*131*c,0,300,0,0,300,0.0,131,2895@TOP@human_GAPDH_TAA_len41_fa10_ta10_fm10_tm10,c
2895@TOP@human_GAPDH_TAA_len41_fa10_ta10_fm10_tm10*132*t,0,1,0,293,294,0.0,132,2895@TOP@human_GAPDH_TAA_len41_fa10_ta10_fm10_tm10,t
2895@TOP@human_GAPDH_TAA_len41_fa10_ta10_fm10_tm10*133*g,0,0,294,0,294,1.0,133,2895@TOP@human_GAPDH_TAA_len41_fa10_ta10_fm10_tm10,g
2895@TOP@human_GAPDH_TAA_len41_fa10_ta10_fm10_tm10*134*g,0,0,294,1,295,0.997,134,2895@TOP@human_GAPDH_TAA_len41_fa10_ta10_fm10_tm10,g
2896@TOP@human_GAPDH_TAA_len41_fa10_ta10_fm10_tm10*114*t,0,0,0,837,837,0.0,114,2896@TOP@human_GAPDH_TAA_len41_fa10_ta10_fm10_tm10,t
2896@TOP@human_GAPDH_TAA_len41_fa10_ta10_fm10_tm10*115*c,0,839,0,0,839,0.0,115,2896@TOP@human_GAPDH_TAA_len41_fa10_ta10_fm10_tm10,c
2896@TOP@human_GAPDH_TAA_len41_fa10_ta10_fm10_tm10*116*c,0,836,0,0,836,0.0,116,2896@TOP@human_GAPDH_TAA_len41_fa10_ta10_fm10_tm10,c
2896@TOP@human_GAPDH_TAA_len41_fa10_ta10_fm10_tm10*117*a,829,0,4,0,833,0.005,117,2896@TOP@human_GAPDH_TAA_len41_fa10_ta10_fm10_tm10,a
2896@TOP@human_GAPDH_TAA_len41_fa10_ta10_fm10_tm10*118*a,751,0,78,0,829,0.094,118,2896@TOP@human_GAPDH_TAA_len41_fa10_ta10_fm10_tm10,a
2896@TOP@human_GAPDH_TAA_len41_fa10_ta10_fm10_tm10*119*g,0,0,825,0,825,1.0,119,2896@TOP@human_GAPDH_TAA_len41_fa10_ta10_fm10_tm10,g
2896@TOP@human_GAPDH_TAA_len41_fa10_ta10_fm10_tm10*120*g,0,0,829,0,829,1.0,120,2896@TOP@human_GAPDH_TAA_len41_fa10_ta10_fm10_tm10,g
2896@TOP@human_GAPDH_TAA_len41_fa10_ta10_fm10_tm10*121*a,835,0,0,0,835,0.0,121,2896@TOP@human_GAPDH_TAA_len41_fa10_ta10_fm10_tm10,a
2896@TOP@human_GAPDH_TAA_len41_fa10_ta10_fm10_tm10*122*g,0,0,837,0,837,1.0,122,2896@TOP@human_GAPDH_TAA_len41_fa10_ta10_fm10_tm10,g
2896@TOP@human_GAPDH_TAA_len41_fa10_ta10_fm10_tm10*123*t,0,0,0,826,826,0.0,123,2896@TOP@human_GAPDH_TAA_len41_fa10_ta10_fm10_tm10,t
2896@TOP@human_GAPDH_TAA_len41_fa10_ta10_fm10_tm10*124*a,703,0,117,0,820,0.143,124,2896@TOP@human_GAPDH_TAA_len41_fa10_ta10_fm10_tm10,a
2896@TOP@human_GAPDH_TAA_len41_fa10_ta10_fm10_tm10*125*a,775,0,47,0,822,0.057,125,2896@TOP@human_GAPDH_TAA_len41_fa10_ta10_fm10_tm10,a
2896@TOP@human_GAPDH_TAA_len41_fa10_ta10_fm10_tm10*126*g,0,0,824,0,824,1.0,126,2896@TOP@human_GAPDH_TAA_len41_fa10_ta10_fm10_tm10,g
2896@TOP@human_GAPDH_TAA_len41_fa10_ta10_fm10_tm10*127*a,833,0,4,0,837,0.005,127,2896@TOP@human_GAPDH_TAA_len41_fa10_ta10_fm10_tm10,a
2896@TOP@human_GAPDH_TAA_len41_fa10_ta10_fm10_tm10*128*c,0,838,0,0,838,0.0,128,2896@TOP@human_GAPDH_TAA_len41_fa10_ta10_fm10_tm10,c
2896@TOP@human_GAPDH_TAA_len41_fa10_ta10_fm10_tm10*129*c,0,833,0,0,833,0.0,129,2896@TOP@human_GAPDH_TAA_len41_fa10_ta10_fm10_tm10,c
2896@TOP@human_GAPDH_TAA_len41_fa10_ta10_fm10_tm10*130*c,0,835,0,0,835,0.0,130,2896@TOP@human_GAPDH_TAA_len41_fa10_ta10_fm10_tm10,c
2896@TOP@human_GAPDH_TAA_len41_fa10_ta10_fm10_tm10*131*c,0,837,0,0,837,0.0,131,2896@TOP@human_GAPDH_TAA_len41_fa10_ta10_fm10_tm10,c
2896@TOP@human_GAPDH_TAA_len41_fa10_ta10_fm10_tm10*132*t,0,0,0,830,830,0.0,132,2896@TOP@human_GAPDH_TAA_len41_fa10_ta10_fm10_tm10,t
2896@TOP@human_GAPDH_TAA_len41_fa10_ta10_fm10_tm10*133*g,0,0,823,0,823,1.0,133,2896@TOP@human_GAPDH_TAA_len41_fa10_ta10_fm10_tm10,g
2896@TOP@human_GAPDH_TAA_len41_fa10_ta10_fm10_tm10*134*g,0,2,831,0,833,0.998,134,2896@TOP@human_GAPDH_TAA_len41_fa10_ta10_fm10_tm10,g
2897@TOP@human_GAPDH_TAA_len41_fa10_ta10_fm10_tm10*114*t,0,2,0,8504,8506,0.0,114,2897@TOP@human_GAPDH_TAA_len41_fa10_ta10_fm10_tm10,t
2897@TOP@human_GAPDH_TAA_len41_fa10_ta10_fm10_tm10*115*c,0,8550,0,0,8550,0.0,115,2897@TOP@human_GAPDH_TAA_len41_fa10_ta10_fm10_tm10,c
2897@TOP@human_GAPDH_TAA_len41_fa10_ta10_fm10_tm10*116*c,0,8521,0,0,8521,0.0,116,2897@TOP@human_GAPDH_TAA_len41_fa10_ta10_fm10_tm10,c
2897@TOP@human_GAPDH_TAA_len41_fa10_ta10_fm10_tm10*117*a,8427,0,99,0,8526,0.012,117,2897@TOP@human_GAPDH_TAA_len41_fa10_ta10_fm10_tm10,a
2897@TOP@human_GAPDH_TAA_len41_fa10_ta10_fm10_tm10*118*a,7667,2,791,0,8460,0.093,118,2897@TOP@human_GAPDH_TAA_len41_fa10_ta10_fm10_tm10,a
2897@TOP@human_GAPDH_TAA_len41_fa10_ta10_fm10_tm10*119*g,0,0,8455,0,8455,1.0,119,2897@TOP@human_GAPDH_TAA_len41_fa10_ta10_fm10_tm10,g
2897@TOP@human_GAPDH_TAA_len41_fa10_ta10_fm10_tm10*120*g,0,0,8422,0,8422,1.0,120,2897@TOP@human_GAPDH_TAA_len41_fa10_ta10_fm10_tm10,g
2897@TOP@human_GAPDH_TAA_len41_fa10_ta10_fm10_tm10*121*a,8502,0,5,0,8507,0.001,121,2897@TOP@human_GAPDH_TAA_len41_fa10_ta10_fm10_tm10,a
2897@TOP@human_GAPDH_TAA_len41_fa10_ta10_fm10_tm10*122*g,0,0,8529,0,8529,1.0,122,2897@TOP@human_GAPDH_TAA_len41_fa10_ta10_fm10_tm10,g
2897@TOP@human_GAPDH_TAA_len41_fa10_ta10_fm10_tm10*123*t,0,1,1,8402,8404,0.0,123,2897@TOP@human_GAPDH_TAA_len41_fa10_ta10_fm10_tm10,t
2897@TOP@human_GAPDH_TAA_len41_fa10_ta10_fm10_tm10*124*a,7444,1,939,0,8384,0.112,124,2897@TOP@human_GAPDH_TAA_len41_fa10_ta10_fm10_tm10,a
2897@TOP@human_GAPDH_TAA_len41_fa10_ta10_fm10_tm10*125*a,7956,0,410,0,8366,0.049,125,2897@TOP@human_GAPDH_TAA_len41_fa10_ta10_fm10_tm10,a
2897@TOP@human_GAPDH_TAA_len41_fa10_ta10_fm10_tm10*126*g,0,0,8421,0,8421,1.0,126,2897@TOP@human_GAPDH_TAA_len41_fa10_ta10_fm10_tm10,g
2897@TOP@human_GAPDH_TAA_len41_fa10_ta10_fm10_tm10*127*a,8450,0,43,0,8493,0.005,127,2897@TOP@human_GAPDH_TAA_len41_fa10_ta10_fm10_tm10,a
2897@TOP@human_GAPDH_TAA_len41_fa10_ta10_fm10_tm10*128*c,0,8531,1,0,8532,0.0,128,2897@TOP@human_GAPDH_TAA_len41_fa10_ta10_fm10_tm10,c
2897@TOP@human_GAPDH_TAA_len41_fa10_ta10_fm10_tm10*129*c,0,8464,0,0,8464,0.0,129,2897@TOP@human_GAPDH_TAA_len41_fa10_ta10_fm10_tm10,c
2897@TOP@human_GAPDH_TAA_len41_fa10_ta10_fm10_tm10*130*c,2,8525,0,0,8527,0.0,130,2897@TOP@human_GAPDH_TAA_len41_fa10_ta10_fm10_tm10,c
2897@TOP@human_GAPDH_TAA_len41_fa10_ta10_fm10_tm10*131*c,1,8530,0,0,8531,0.0,131,2897@TOP@human_GAPDH_TAA_len41_fa10_ta10_fm10_tm10,c
2897@TOP@human_GAPDH_TAA_len41_fa10_ta10_fm10_tm10*132*t,2,4,0,8437,8443,0.0,132,2897@TOP@human_GAPDH_TAA_len41_fa10_ta10_fm10_tm10,t
2897@TOP@human_GAPDH_TAA_len41_fa10_ta10_fm10_tm10*133*g,1,0,8389,0,8390,1.0,133,2897@TOP@human_GAPDH_TAA_len41_fa10_ta10_fm10_tm10,g
2897@TOP@human_GAPDH_TAA_len41_fa10_ta10_fm10_tm10*134*g,2,12,8443,0,8457,0.998,134,2897@TOP@human_GAPDH_TAA_len41_fa10_ta10_fm10_tm10,g
2898@TOP@human_GAPDH_TAA_len41_fa10_ta10_fm10_tm10*114*t,0,0,0,606,606,0.0,114,2898@TOP@human_GAPDH_TAA_len41_fa10_ta10_fm10_tm10,t
2898@TOP@human_GAPDH_TAA_len41_fa10_ta10_fm10_tm10*115*c,0,613,0,0,613,0.0,115,2898@TOP@human_GAPDH_TAA_len41_fa10_ta10_fm10_tm10,c
2898@TOP@human_GAPDH_TAA_len41_fa10_ta10_fm10_tm10*116*c,0,611,0,0,611,0.0,116,2898@TOP@human_GAPDH_TAA_len41_fa10_ta10_fm10_tm10,c
2898@TOP@human_GAPDH_TAA_len41_fa10_ta10_fm10_tm10*117*a,527,0,85,0,612,0.139,117,2898@TOP@human_GAPDH_TAA_len41_fa10_ta10_fm10_tm10,a
2898@TOP@human_GAPDH_TAA_len41_fa10_ta10_fm10_tm10*118*a,378,0,228,0,606,0.376,118,2898@TOP@human_GAPDH_TAA_len41_fa10_ta10_fm10_tm10,a
2898@TOP@human_GAPDH_TAA_len41_fa10_ta10_fm10_tm10*119*g,0,0,600,0,600,1.0,119,2898@TOP@human_GAPDH_TAA_len41_fa10_ta10_fm10_tm10,g
2898@TOP@human_GAPDH_TAA_len41_fa10_ta10_fm10_tm10*120*g,0,0,594,0,594,1.0,120,2898@TOP@human_GAPDH_TAA_len41_fa10_ta10_fm10_tm10,g
2898@TOP@human_GAPDH_TAA_len41_fa10_ta10_fm10_tm10*121*a,608,0,0,0,608,0.0,121,2898@TOP@human_GAPDH_TAA_len41_fa10_ta10_fm10_tm10,a
2898@TOP@human_GAPDH_TAA_len41_fa10_ta10_fm10_tm10*122*g,0,0,608,0,608,1.0,122,2898@TOP@human_GAPDH_TAA_len41_fa10_ta10_fm10_tm10,g
2898@TOP@human_GAPDH_TAA_len41_fa10_ta10_fm10_tm10*123*t,0,2,0,601,603,0.0,123,2898@TOP@human_GAPDH_TAA_len41_fa10_ta10_fm10_tm10,t
2898@TOP@human_GAPDH_TAA_len41_fa10_ta10_fm10_tm10*124*a,420,0,186,0,606,0.307,124,2898@TOP@human_GAPDH_TAA_len41_fa10_ta10_fm10_tm10,a
2898@TOP@human_GAPDH_TAA_len41_fa10_ta10_fm10_tm10*125*a,469,0,132,0,601,0.22,125,2898@TOP@human_GAPDH_TAA_len41_fa10_ta10_fm10_tm10,a
2898@TOP@human_GAPDH_TAA_len41_fa10_ta10_fm10_tm10*126*g,1,0,600,0,601,0.998,126,2898@TOP@human_GAPDH_TAA_len41_fa10_ta10_fm10_tm10,g
2898@TOP@human_GAPDH_TAA_len41_fa10_ta10_fm10_tm10*127*a,605,0,6,0,611,0.01,127,2898@TOP@human_GAPDH_TAA_len41_fa10_ta10_fm10_tm10,a
2898@TOP@human_GAPDH_TAA_len41_fa10_ta10_fm10_tm10*128*c,0,609,0,0,609,0.0,128,2898@TOP@human_GAPDH_TAA_len41_fa10_ta10_fm10_tm10,c
2898@TOP@human_GAPDH_TAA_len41_fa10_ta10_fm10_tm10*129*c,0,605,0,0,605,0.0,129,2898@TOP@human_GAPDH_TAA_len41_fa10_ta10_fm10_tm10,c
2898@TOP@human_GAPDH_TAA_len41_fa10_ta10_fm10_tm10*130*c,0,608,0,0,608,0.0,130,2898@TOP@human_GAPDH_TAA_len41_fa10_ta10_fm10_tm10,c
2898@TOP@human_GAPDH_TAA_len41_fa10_ta10_fm10_tm10*131*c,0,607,0,0,607,0.0,131,2898@TOP@human_GAPDH_TAA_len41_fa10_ta10_fm10_tm10,c
2898@TOP@human_GAPDH_TAA_len41_fa10_ta10_fm10_tm10*132*t,0,0,0,592,592,0.0,132,2898@TOP@human_GAPDH_TAA_len41_fa10_ta10_fm10_tm10,t
2898@TOP@human_GAPDH_TAA_len41_fa10_ta10_fm10_tm10*133*g,0,0,595,0,595,1.0,133,2898@TOP@human_GAPDH_TAA_len41_fa10_ta10_fm10_tm10,g
2898@TOP@human_GAPDH_TAA_len41_fa10_ta10_fm10_tm10*134*g,0,0,605,0,605,1.0,134,2898@TOP@human_GAPDH_TAA_len41_fa10_ta10_fm10_tm10,g
2899@TOP@human_GAPDH_TAA_len41_fa10_ta10_fm10_tm10*114*t,0,0,0,2134,2134,0.0,114,2899@TOP@human_GAPDH_TAA_len41_fa10_ta10_fm10_tm10,t
2899@TOP@human_GAPDH_TAA_len41_fa10_ta10_fm10_tm10*115*c,0,2151,0,0,2151,0.0,115,2899@TOP@human_GAPDH_TAA_len41_fa10_ta10_fm10_tm10,c
2899@TOP@human_GAPDH_TAA_len41_fa10_ta10_fm10_tm10*116*c,1,2137,0,0,2138,0.0,116,2899@TOP@human_GAPDH_TAA_len41_fa10_ta10_fm10_tm10,c
2899@TOP@human_GAPDH_TAA_len41_fa10_ta10_fm10_tm10*117*a,2079,0,60,0,2139,0.028,117,2899@TOP@human_GAPDH_TAA_len41_fa10_ta10_fm10_tm10,a
2899@TOP@human_GAPDH_TAA_len41_fa10_ta10_fm10_tm10*118*a,1753,0,368,0,2121,0.174,118,2899@TOP@human_GAPDH_TAA_len41_fa10_ta10_fm10_tm10,a
2899@TOP@human_GAPDH_TAA_len41_fa10_ta10_fm10_tm10*119*g,0,0,2122,0,2122,1.0,119,2899@TOP@human_GAPDH_TAA_len41_fa10_ta10_fm10_tm10,g
2899@TOP@human_GAPDH_TAA_len41_fa10_ta10_fm10_tm10*120*g,0,0,2124,0,2124,1.0,120,2899@TOP@human_GAPDH_TAA_len41_fa10_ta10_fm10_tm10,g
2899@TOP@human_GAPDH_TAA_len41_fa10_ta10_fm10_tm10*121*a,2129,0,3,0,2132,0.001,121,2899@TOP@human_GAPDH_TAA_len41_fa10_ta10_fm10_tm10,a
2899@TOP@human_GAPDH_TAA_len41_fa10_ta10_fm10_tm10*122*g,0,0,2137,0,2137,1.0,122,2899@TOP@human_GAPDH_TAA_len41_fa10_ta10_fm10_tm10,g
2899@TOP@human_GAPDH_TAA_len41_fa10_ta10_fm10_tm10*123*t,0,0,0,2107,2107,0.0,123,2899@TOP@human_GAPDH_TAA_len41_fa10_ta10_fm10_tm10,t
2899@TOP@human_GAPDH_TAA_len41_fa10_ta10_fm10_tm10*124*a,1794,0,318,0,2112,0.151,124,2899@TOP@human_GAPDH_TAA_len41_fa10_ta10_fm10_tm10,a
2899@TOP@human_GAPDH_TAA_len41_fa10_ta10_fm10_tm10*125*a,1940,0,161,0,2101,0.077,125,2899@TOP@human_GAPDH_TAA_len41_fa10_ta10_fm10_tm10,a
2899@TOP@human_GAPDH_TAA_len41_fa10_ta10_fm10_tm10*126*g,0,0,2096,0,2096,1.0,126,2899@TOP@human_GAPDH_TAA_len41_fa10_ta10_fm10_tm10,g
2899@TOP@human_GAPDH_TAA_len41_fa10_ta10_fm10_tm10*127*a,2125,0,7,0,2132,0.003,127,2899@TOP@human_GAPDH_TAA_len41_fa10_ta10_fm10_tm10,a
2899@TOP@human_GAPDH_TAA_len41_fa10_ta10_fm10_tm10*128*c,1,2146,1,0,2148,0.0,128,2899@TOP@human_GAPDH_TAA_len41_fa10_ta10_fm10_tm10,c
2899@TOP@human_GAPDH_TAA_len41_fa10_ta10_fm10_tm10*129*c,0,2126,0,0,2126,0.0,129,2899@TOP@human_GAPDH_TAA_len41_fa10_ta10_fm10_tm10,c
2899@TOP@human_GAPDH_TAA_len41_fa10_ta10_fm10_tm10*130*c,0,2142,0,0,2142,0.0,130,2899@TOP@human_GAPDH_TAA_len41_fa10_ta10_fm10_tm10,c
2899@TOP@human_GAPDH_TAA_len41_fa10_ta10_fm10_tm10*131*c,3,2142,0,0,2145,0.0,131,2899@TOP@human_GAPDH_TAA_len41_fa10_ta10_fm10_tm10,c
2899@TOP@human_GAPDH_TAA_len41_fa10_ta10_fm10_tm10*132*t,0,0,0,2113,2113,0.0,132,2899@TOP@human_GAPDH_TAA_len41_fa10_ta10_fm10_tm10,t
2899@TOP@human_GAPDH_TAA_len41_fa10_ta10_fm10_tm10*133*g,2,0,2108,0,2110,0.999,133,2899@TOP@human_GAPDH_TAA_len41_fa10_ta10_fm10_tm10,g
2899@TOP@human_GAPDH_TAA_len41_fa10_ta10_fm10_tm10*134*g,0,1,2124,0,2125,1.0,134,2899@TOP@human_GAPDH_TAA_len41_fa10_ta10_fm10_tm10,g
2900@TOP@human_GAPDH_TAA_len41_fa10_ta10_fm10_tm10*114*t,0,0,1,967,968,0.001,114,2900@TOP@human_GAPDH_TAA_len41_fa10_ta10_fm10_tm10,t
2900@TOP@human_GAPDH_TAA_len41_fa10_ta10_fm10_tm10*115*c,0,975,0,0,975,0.0,115,2900@TOP@human_GAPDH_TAA_len41_fa10_ta10_fm10_tm10,c
2900@TOP@human_GAPDH_TAA_len41_fa10_ta10_fm10_tm10*116*c,0,963,0,0,963,0.0,116,2900@TOP@human_GAPDH_TAA_len41_fa10_ta10_fm10_tm10,c
2900@TOP@human_GAPDH_TAA_len41_fa10_ta10_fm10_tm10*117*a,869,0,92,0,961,0.096,117,2900@TOP@human_GAPDH_TAA_len41_fa10_ta10_fm10_tm10,a
2900@TOP@human_GAPDH_TAA_len41_fa10_ta10_fm10_tm10*118*a,786,0,178,0,964,0.185,118,2900@TOP@human_GAPDH_TAA_len41_fa10_ta10_fm10_tm10,a
2900@TOP@human_GAPDH_TAA_len41_fa10_ta10_fm10_tm10*119*g,0,0,955,0,955,1.0,119,2900@TOP@human_GAPDH_TAA_len41_fa10_ta10_fm10_tm10,g
2900@TOP@human_GAPDH_TAA_len41_fa10_ta10_fm10_tm10*120*g,0,0,958,1,959,0.999,120,2900@TOP@human_GAPDH_TAA_len41_fa10_ta10_fm10_tm10,g
2900@TOP@human_GAPDH_TAA_len41_fa10_ta10_fm10_tm10*121*a,964,0,2,0,966,0.002,121,2900@TOP@human_GAPDH_TAA_len41_fa10_ta10_fm10_tm10,a
2900@TOP@human_GAPDH_TAA_len41_fa10_ta10_fm10_tm10*122*g,0,0,969,0,969,1.0,122,2900@TOP@human_GAPDH_TAA_len41_fa10_ta10_fm10_tm10,g
2900@TOP@human_GAPDH_TAA_len41_fa10_ta10_fm10_tm10*123*t,0,0,0,946,946,0.0,123,2900@TOP@human_GAPDH_TAA_len41_fa10_ta10_fm10_tm10,t
2900@TOP@human_GAPDH_TAA_len41_fa10_ta10_fm10_tm10*124*a,776,0,170,0,946,0.18,124,2900@TOP@human_GAPDH_TAA_len41_fa10_ta10_fm10_tm10,a
2900@TOP@human_GAPDH_TAA_len41_fa10_ta10_fm10_tm10*125*a,867,0,84,0,951,0.088,125,2900@TOP@human_GAPDH_TAA_len41_fa10_ta10_fm10_tm10,a
2900@TOP@human_GAPDH_TAA_len41_fa10_ta10_fm10_tm10*126*g,0,0,955,0,955,1.0,126,2900@TOP@human_GAPDH_TAA_len41_fa10_ta10_fm10_tm10,g
2900@TOP@human_GAPDH_TAA_len41_fa10_ta10_fm10_tm10*127*a,962,0,5,0,967,0.005,127,2900@TOP@human_GAPDH_TAA_len41_fa10_ta10_fm10_tm10,a
2900@TOP@human_GAPDH_TAA_len41_fa10_ta10_fm10_tm10*128*c,0,971,0,0,971,0.0,128,2900@TOP@human_GAPDH_TAA_len41_fa10_ta10_fm10_tm10,c
2900@TOP@human_GAPDH_TAA_len41_fa10_ta10_fm10_tm10*129*c,0,955,0,0,955,0.0,129,2900@TOP@human_GAPDH_TAA_len41_fa10_ta10_fm10_tm10,c
2900@TOP@human_GAPDH_TAA_len41_fa10_ta10_fm10_tm10*130*c,0,969,0,0,969,0.0,130,2900@TOP@human_GAPDH_TAA_len41_fa10_ta10_fm10_tm10,c
2900@TOP@human_GAPDH_TAA_len41_fa10_ta10_fm10_tm10*131*c,2,968,0,0,970,0.0,131,2900@TOP@human_GAPDH_TAA_len41_fa10_ta10_fm10_tm10,c
2900@TOP@human_GAPDH_TAA_len41_fa10_ta10_fm10_tm10*132*t,0,0,0,951,951,0.0,132,2900@TOP@human_GAPDH_TAA_len41_fa10_ta10_fm10_tm10,t
2900@TOP@human_GAPDH_TAA_len41_fa10_ta10_fm10_tm10*133*g,0,0,948,0,948,1.0,133,2900@TOP@human_GAPDH_TAA_len41_fa10_ta10_fm10_tm10,g
2900@TOP@human_GAPDH_TAA_len41_fa10_ta10_fm10_tm10*134*g,0,0,953,0,953,1.0,134,2900@TOP@human_GAPDH_TAA_len41_fa10_ta10_fm10_tm10,g
2901@TOP@human_GAPDH_TAA_len41_fa10_ta10_fm10_tm10*114*t,0,1,0,1476,1477,0.0,114,2901@TOP@human_GAPDH_TAA_len41_fa10_ta10_fm10_tm10,t
2901@TOP@human_GAPDH_TAA_len41_fa10_ta10_fm10_tm10*115*c,0,1489,0,0,1489,0.0,115,2901@TOP@human_GAPDH_TAA_len41_fa10_ta10_fm10_tm10,c
2901@TOP@human_GAPDH_TAA_len41_fa10_ta10_fm10_tm10*116*c,0,1482,0,0,1482,0.0,116,2901@TOP@human_GAPDH_TAA_len41_fa10_ta10_fm10_tm10,c
2901@TOP@human_GAPDH_TAA_len41_fa10_ta10_fm10_tm10*117*a,1475,0,8,0,1483,0.005,117,2901@TOP@human_GAPDH_TAA_len41_fa10_ta10_fm10_tm10,a
2901@TOP@human_GAPDH_TAA_len41_fa10_ta10_fm10_tm10*118*a,1320,1,154,0,1475,0.104,118,2901@TOP@human_GAPDH_TAA_len41_fa10_ta10_fm10_tm10,a
2901@TOP@human_GAPDH_TAA_len41_fa10_ta10_fm10_tm10*119*g,0,0,1476,0,1476,1.0,119,2901@TOP@human_GAPDH_TAA_len41_fa10_ta10_fm10_tm10,g
2901@TOP@human_GAPDH_TAA_len41_fa10_ta10_fm10_tm10*120*g,0,0,1466,0,1466,1.0,120,2901@TOP@human_GAPDH_TAA_len41_fa10_ta10_fm10_tm10,g
2901@TOP@human_GAPDH_TAA_len41_fa10_ta10_fm10_tm10*121*a,1480,0,1,0,1481,0.001,121,2901@TOP@human_GAPDH_TAA_len41_fa10_ta10_fm10_tm10,a
2901@TOP@human_GAPDH_TAA_len41_fa10_ta10_fm10_tm10*122*g,1,0,1480,2,1483,0.998,122,2901@TOP@human_GAPDH_TAA_len41_fa10_ta10_fm10_tm10,g
2901@TOP@human_GAPDH_TAA_len41_fa10_ta10_fm10_tm10*123*t,0,0,0,1465,1465,0.0,123,2901@TOP@human_GAPDH_TAA_len41_fa10_ta10_fm10_tm10,t
2901@TOP@human_GAPDH_TAA_len41_fa10_ta10_fm10_tm10*124*a,1262,0,199,0,1461,0.136,124,2901@TOP@human_GAPDH_TAA_len41_fa10_ta10_fm10_tm10,a
2901@TOP@human_GAPDH_TAA_len41_fa10_ta10_fm10_tm10*125*a,1423,1,42,0,1466,0.029,125,2901@TOP@human_GAPDH_TAA_len41_fa10_ta10_fm10_tm10,a
2901@TOP@human_GAPDH_TAA_len41_fa10_ta10_fm10_tm10*126*g,1,0,1456,0,1457,0.999,126,2901@TOP@human_GAPDH_TAA_len41_fa10_ta10_fm10_tm10,g
2901@TOP@human_GAPDH_TAA_len41_fa10_ta10_fm10_tm10*127*a,1475,0,2,0,1477,0.001,127,2901@TOP@human_GAPDH_TAA_len41_fa10_ta10_fm10_tm10,a
2901@TOP@human_GAPDH_TAA_len41_fa10_ta10_fm10_tm10*128*c,0,1489,0,0,1489,0.0,128,2901@TOP@human_GAPDH_TAA_len41_fa10_ta10_fm10_tm10,c
2901@TOP@human_GAPDH_TAA_len41_fa10_ta10_fm10_tm10*129*c,0,1482,0,0,1482,0.0,129,2901@TOP@human_GAPDH_TAA_len41_fa10_ta10_fm10_tm10,c
2901@TOP@human_GAPDH_TAA_len41_fa10_ta10_fm10_tm10*130*c,0,1485,0,0,1485,0.0,130,2901@TOP@human_GAPDH_TAA_len41_fa10_ta10_fm10_tm10,c
2901@TOP@human_GAPDH_TAA_len41_fa10_ta10_fm10_tm10*131*c,0,1489,0,0,1489,0.0,131,2901@TOP@human_GAPDH_TAA_len41_fa10_ta10_fm10_tm10,c
2901@TOP@human_GAPDH_TAA_len41_fa10_ta10_fm10_tm10*132*t,0,1,0,1465,1466,0.0,132,2901@TOP@human_GAPDH_TAA_len41_fa10_ta10_fm10_tm10,t
2901@TOP@human_GAPDH_TAA_len41_fa10_ta10_fm10_tm10*133*g,0,0,1456,0,1456,1.0,133,2901@TOP@human_GAPDH_TAA_len41_fa10_ta10_fm10_tm10,g
2901@TOP@human_GAPDH_TAA_len41_fa10_ta10_fm10_tm10*134*g,0,0,1464,0,1464,1.0,134,2901@TOP@human_GAPDH_TAA_len41_fa10_ta10_fm10_tm10,g
2902@TOP@human_GAPDH_TAA_len41_fa10_ta10_fm10_tm10*114*t,0,0,0,749,749,0.0,114,2902@TOP@human_GAPDH_TAA_len41_fa10_ta10_fm10_tm10,t
2902@TOP@human_GAPDH_TAA_len41_fa10_ta10_fm10_tm10*115*c,0,759,0,0,759,0.0,115,2902@TOP@human_GAPDH_TAA_len41_fa10_ta10_fm10_tm10,c
2902@TOP@human_GAPDH_TAA_len41_fa10_ta10_fm10_tm10*116*c,0,756,0,0,756,0.0,116,2902@TOP@human_GAPDH_TAA_len41_fa10_ta10_fm10_tm10,c
2902@TOP@human_GAPDH_TAA_len41_fa10_ta10_fm10_tm10*117*a,758,0,1,0,759,0.001,117,2902@TOP@human_GAPDH_TAA_len41_fa10_ta10_fm10_tm10,a
2902@TOP@human_GAPDH_TAA_len41_fa10_ta10_fm10_tm10*118*a,734,0,14,0,748,0.019,118,2902@TOP@human_GAPDH_TAA_len41_fa10_ta10_fm10_tm10,a
2902@TOP@human_GAPDH_TAA_len41_fa10_ta10_fm10_tm10*119*g,0,0,743,0,743,1.0,119,2902@TOP@human_GAPDH_TAA_len41_fa10_ta10_fm10_tm10,g
2902@TOP@human_GAPDH_TAA_len41_fa10_ta10_fm10_tm10*120*g,0,0,734,0,734,1.0,120,2902@TOP@human_GAPDH_TAA_len41_fa10_ta10_fm10_tm10,g
2902@TOP@human_GAPDH_TAA_len41_fa10_ta10_fm10_tm10*121*a,748,0,0,0,748,0.0,121,2902@TOP@human_GAPDH_TAA_len41_fa10_ta10_fm10_tm10,a
2902@TOP@human_GAPDH_TAA_len41_fa10_ta10_fm10_tm10*122*g,0,0,752,0,752,1.0,122,2902@TOP@human_GAPDH_TAA_len41_fa10_ta10_fm10_tm10,g
2902@TOP@human_GAPDH_TAA_len41_fa10_ta10_fm10_tm10*123*t,0,0,0,734,734,0.0,123,2902@TOP@human_GAPDH_TAA_len41_fa10_ta10_fm10_tm10,t
2902@TOP@human_GAPDH_TAA_len41_fa10_ta10_fm10_tm10*124*a,682,0,54,0,736,0.073,124,2902@TOP@human_GAPDH_TAA_len41_fa10_ta10_fm10_tm10,a
2902@TOP@human_GAPDH_TAA_len41_fa10_ta10_fm10_tm10*125*a,678,0,57,0,735,0.078,125,2902@TOP@human_GAPDH_TAA_len41_fa10_ta10_fm10_tm10,a
2902@TOP@human_GAPDH_TAA_len41_fa10_ta10_fm10_tm10*126*g,0,0,742,0,742,1.0,126,2902@TOP@human_GAPDH_TAA_len41_fa10_ta10_fm10_tm10,g
2902@TOP@human_GAPDH_TAA_len41_fa10_ta10_fm10_tm10*127*a,750,0,0,0,750,0.0,127,2902@TOP@human_GAPDH_TAA_len41_fa10_ta10_fm10_tm10,a
2902@TOP@human_GAPDH_TAA_len41_fa10_ta10_fm10_tm10*128*c,0,757,0,0,757,0.0,128,2902@TOP@human_GAPDH_TAA_len41_fa10_ta10_fm10_tm10,c
2902@TOP@human_GAPDH_TAA_len41_fa10_ta10_fm10_tm10*129*c,0,742,0,3,745,0.0,129,2902@TOP@human_GAPDH_TAA_len41_fa10_ta10_fm10_tm10,c
2902@TOP@human_GAPDH_TAA_len41_fa10_ta10_fm10_tm10*130*c,0,752,0,0,752,0.0,130,2902@TOP@human_GAPDH_TAA_len41_fa10_ta10_fm10_tm10,c
2902@TOP@human_GAPDH_TAA_len41_fa10_ta10_fm10_tm10*131*c,0,761,0,0,761,0.0,131,2902@TOP@human_GAPDH_TAA_len41_fa10_ta10_fm10_tm10,c
2902@TOP@human_GAPDH_TAA_len41_fa10_ta10_fm10_tm10*132*t,1,0,0,739,740,0.0,132,2902@TOP@human_GAPDH_TAA_len41_fa10_ta10_fm10_tm10,t
2902@TOP@human_GAPDH_TAA_len41_fa10_ta10_fm10_tm10*133*g,0,1,737,0,738,0.999,133,2902@TOP@human_GAPDH_TAA_len41_fa10_ta10_fm10_tm10,g
2902@TOP@human_GAPDH_TAA_len41_fa10_ta10_fm10_tm10*134*g,0,1,751,0,752,0.999,134,2902@TOP@human_GAPDH_TAA_len41_fa10_ta10_fm10_tm10,g
2903@TOP@human_GAPDH_TAA_len41_fa10_ta10_fm10_tm10*114*t,0,0,0,2173,2173,0.0,114,2903@TOP@human_GAPDH_TAA_len41_fa10_ta10_fm10_tm10,t
2903@TOP@human_GAPDH_TAA_len41_fa10_ta10_fm10_tm10*115*c,0,2183,0,0,2183,0.0,115,2903@TOP@human_GAPDH_TAA_len41_fa10_ta10_fm10_tm10,c
2903@TOP@human_GAPDH_TAA_len41_fa10_ta10_fm10_tm10*116*c,0,2178,0,0,2178,0.0,116,2903@TOP@human_GAPDH_TAA_len41_fa10_ta10_fm10_tm10,c
2903@TOP@human_GAPDH_TAA_len41_fa10_ta10_fm10_tm10*117*a,2173,0,0,0,2173,0.0,117,2903@TOP@human_GAPDH_TAA_len41_fa10_ta10_fm10_tm10,a
2903@TOP@human_GAPDH_TAA_len41_fa10_ta10_fm10_tm10*118*a,2128,0,25,0,2153,0.012,118,2903@TOP@human_GAPDH_TAA_len41_fa10_ta10_fm10_tm10,a
2903@TOP@human_GAPDH_TAA_len41_fa10_ta10_fm10_tm10*119*g,0,1,2159,0,2160,1.0,119,2903@TOP@human_GAPDH_TAA_len41_fa10_ta10_fm10_tm10,g
2903@TOP@human_GAPDH_TAA_len41_fa10_ta10_fm10_tm10*120*g,0,0,2142,0,2142,1.0,120,2903@TOP@human_GAPDH_TAA_len41_fa10_ta10_fm10_tm10,g
2903@TOP@human_GAPDH_TAA_len41_fa10_ta10_fm10_tm10*121*a,2167,0,2,0,2169,0.001,121,2903@TOP@human_GAPDH_TAA_len41_fa10_ta10_fm10_tm10,a
2903@TOP@human_GAPDH_TAA_len41_fa10_ta10_fm10_tm10*122*g,0,0,2177,0,2177,1.0,122,2903@TOP@human_GAPDH_TAA_len41_fa10_ta10_fm10_tm10,g
2903@TOP@human_GAPDH_TAA_len41_fa10_ta10_fm10_tm10*123*t,0,0,2,2146,2148,0.001,123,2903@TOP@human_GAPDH_TAA_len41_fa10_ta10_fm10_tm10,t
2903@TOP@human_GAPDH_TAA_len41_fa10_ta10_fm10_tm10*124*a,1779,0,356,0,2135,0.167,124,2903@TOP@human_GAPDH_TAA_len41_fa10_ta10_fm10_tm10,a
2903@TOP@human_GAPDH_TAA_len41_fa10_ta10_fm10_tm10*125*a,2042,0,87,0,2129,0.041,125,2903@TOP@human_GAPDH_TAA_len41_fa10_ta10_fm10_tm10,a
2903@TOP@human_GAPDH_TAA_len41_fa10_ta10_fm10_tm10*126*g,3,0,2143,1,2147,0.998,126,2903@TOP@human_GAPDH_TAA_len41_fa10_ta10_fm10_tm10,g
2903@TOP@human_GAPDH_TAA_len41_fa10_ta10_fm10_tm10*127*a,2157,0,4,0,2161,0.002,127,2903@TOP@human_GAPDH_TAA_len41_fa10_ta10_fm10_tm10,a
2903@TOP@human_GAPDH_TAA_len41_fa10_ta10_fm10_tm10*128*c,0,2177,2,0,2179,0.001,128,2903@TOP@human_GAPDH_TAA_len41_fa10_ta10_fm10_tm10,c
2903@TOP@human_GAPDH_TAA_len41_fa10_ta10_fm10_tm10*129*c,0,2159,0,2,2161,0.0,129,2903@TOP@human_GAPDH_TAA_len41_fa10_ta10_fm10_tm10,c
2903@TOP@human_GAPDH_TAA_len41_fa10_ta10_fm10_tm10*130*c,0,2171,0,0,2171,0.0,130,2903@TOP@human_GAPDH_TAA_len41_fa10_ta10_fm10_tm10,c
2903@TOP@human_GAPDH_TAA_len41_fa10_ta10_fm10_tm10*131*c,0,2180,0,0,2180,0.0,131,2903@TOP@human_GAPDH_TAA_len41_fa10_ta10_fm10_tm10,c
2903@TOP@human_GAPDH_TAA_len41_fa10_ta10_fm10_tm10*132*t,1,0,0,2150,2151,0.0,132,2903@TOP@human_GAPDH_TAA_len41_fa10_ta10_fm10_tm10,t
2903@TOP@human_GAPDH_TAA_len41_fa10_ta10_fm10_tm10*133*g,0,0,2151,0,2151,1.0,133,2903@TOP@human_GAPDH_TAA_len41_fa10_ta10_fm10_tm10,g
2903@TOP@human_GAPDH_TAA_len41_fa10_ta10_fm10_tm10*134*g,0,1,2157,0,2158,1.0,134,2903@TOP@human_GAPDH_TAA_len41_fa10_ta10_fm10_tm10,g
2904@TOP@human_GAPDH_TAA_len41_fa10_ta10_fm10_tm10*114*t,0,2,0,5735,5737,0.0,114,2904@TOP@human_GAPDH_TAA_len41_fa10_ta10_fm10_tm10,t
2904@TOP@human_GAPDH_TAA_len41_fa10_ta10_fm10_tm10*115*c,0,5769,0,0,5769,0.0,115,2904@TOP@human_GAPDH_TAA_len41_fa10_ta10_fm10_tm10,c
2904@TOP@human_GAPDH_TAA_len41_fa10_ta10_fm10_tm10*116*c,0,5741,0,0,5741,0.0,116,2904@TOP@human_GAPDH_TAA_len41_fa10_ta10_fm10_tm10,c
2904@TOP@human_GAPDH_TAA_len41_fa10_ta10_fm10_tm10*117*a,5735,0,2,0,5737,0.0,117,2904@TOP@human_GAPDH_TAA_len41_fa10_ta10_fm10_tm10,a
2904@TOP@human_GAPDH_TAA_len41_fa10_ta10_fm10_tm10*118*a,5642,0,60,0,5702,0.011,118,2904@TOP@human_GAPDH_TAA_len41_fa10_ta10_fm10_tm10,a
2904@TOP@human_GAPDH_TAA_len41_fa10_ta10_fm10_tm10*119*g,0,0,5693,0,5693,1.0,119,2904@TOP@human_GAPDH_TAA_len41_fa10_ta10_fm10_tm10,g
2904@TOP@human_GAPDH_TAA_len41_fa10_ta10_fm10_tm10*120*g,1,1,5688,0,5690,1.0,120,2904@TOP@human_GAPDH_TAA_len41_fa10_ta10_fm10_tm10,g
2904@TOP@human_GAPDH_TAA_len41_fa10_ta10_fm10_tm10*121*a,5730,0,0,0,5730,0.0,121,2904@TOP@human_GAPDH_TAA_len41_fa10_ta10_fm10_tm10,a
2904@TOP@human_GAPDH_TAA_len41_fa10_ta10_fm10_tm10*122*g,0,0,5746,0,5746,1.0,122,2904@TOP@human_GAPDH_TAA_len41_fa10_ta10_fm10_tm10,g
2904@TOP@human_GAPDH_TAA_len41_fa10_ta10_fm10_tm10*123*t,1,1,0,5672,5674,0.0,123,2904@TOP@human_GAPDH_TAA_len41_fa10_ta10_fm10_tm10,t
2904@TOP@human_GAPDH_TAA_len41_fa10_ta10_fm10_tm10*124*a,5481,0,164,0,5645,0.029,124,2904@TOP@human_GAPDH_TAA_len41_fa10_ta10_fm10_tm10,a
2904@TOP@human_GAPDH_TAA_len41_fa10_ta10_fm10_tm10*125*a,5555,0,77,1,5633,0.014,125,2904@TOP@human_GAPDH_TAA_len41_fa10_ta10_fm10_tm10,a
2904@TOP@human_GAPDH_TAA_len41_fa10_ta10_fm10_tm10*126*g,0,0,5667,0,5667,1.0,126,2904@TOP@human_GAPDH_TAA_len41_fa10_ta10_fm10_tm10,g
2904@TOP@human_GAPDH_TAA_len41_fa10_ta10_fm10_tm10*127*a,5717,2,3,0,5722,0.001,127,2904@TOP@human_GAPDH_TAA_len41_fa10_ta10_fm10_tm10,a
2904@TOP@human_GAPDH_TAA_len41_fa10_ta10_fm10_tm10*128*c,0,5748,2,0,5750,0.0,128,2904@TOP@human_GAPDH_TAA_len41_fa10_ta10_fm10_tm10,c
2904@TOP@human_GAPDH_TAA_len41_fa10_ta10_fm10_tm10*129*c,0,5704,0,0,5704,0.0,129,2904@TOP@human_GAPDH_TAA_len41_fa10_ta10_fm10_tm10,c
2904@TOP@human_GAPDH_TAA_len41_fa10_ta10_fm10_tm10*130*c,0,5739,0,1,5740,0.0,130,2904@TOP@human_GAPDH_TAA_len41_fa10_ta10_fm10_tm10,c
2904@TOP@human_GAPDH_TAA_len41_fa10_ta10_fm10_tm10*131*c,0,5761,0,0,5761,0.0,131,2904@TOP@human_GAPDH_TAA_len41_fa10_ta10_fm10_tm10,c
2904@TOP@human_GAPDH_TAA_len41_fa10_ta10_fm10_tm10*132*t,0,3,1,5683,5687,0.0,132,2904@TOP@human_GAPDH_TAA_len41_fa10_ta10_fm10_tm10,t
2904@TOP@human_GAPDH_TAA_len41_fa10_ta10_fm10_tm10*133*g,1,0,5656,0,5657,1.0,133,2904@TOP@human_GAPDH_TAA_len41_fa10_ta10_fm10_tm10,g
2904@TOP@human_GAPDH_TAA_len41_fa10_ta10_fm10_tm10*134*g,3,3,5690,0,5696,0.999,134,2904@TOP@human_GAPDH_TAA_len41_fa10_ta10_fm10_tm10,g
2905@TOP@human_GAPDH_TAA_len41_fa10_ta10_fm10_tm10*114*t,1,2,0,6192,6195,0.0,114,2905@TOP@human_GAPDH_TAA_len41_fa10_ta10_fm10_tm10,t
2905@TOP@human_GAPDH_TAA_len41_fa10_ta10_fm10_tm10*115*c,0,6249,0,0,6249,0.0,115,2905@TOP@human_GAPDH_TAA_len41_fa10_ta10_fm10_tm10,c
2905@TOP@human_GAPDH_TAA_len41_fa10_ta10_fm10_tm10*116*c,0,6220,0,0,6220,0.0,116,2905@TOP@human_GAPDH_TAA_len41_fa10_ta10_fm10_tm10,c
2905@TOP@human_GAPDH_TAA_len41_fa10_ta10_fm10_tm10*117*a,6222,0,9,0,6231,0.001,117,2905@TOP@human_GAPDH_TAA_len41_fa10_ta10_fm10_tm10,a
2905@TOP@human_GAPDH_TAA_len41_fa10_ta10_fm10_tm10*118*a,6078,0,110,2,6190,0.018,118,2905@TOP@human_GAPDH_TAA_len41_fa10_ta10_fm10_tm10,a
2905@TOP@human_GAPDH_TAA_len41_fa10_ta10_fm10_tm10*119*g,0,0,6185,0,6185,1.0,119,2905@TOP@human_GAPDH_TAA_len41_fa10_ta10_fm10_tm10,g
2905@TOP@human_GAPDH_TAA_len41_fa10_ta10_fm10_tm10*120*g,0,0,6127,0,6127,1.0,120,2905@TOP@human_GAPDH_TAA_len41_fa10_ta10_fm10_tm10,g
2905@TOP@human_GAPDH_TAA_len41_fa10_ta10_fm10_tm10*121*a,6207,0,0,2,6209,0.0,121,2905@TOP@human_GAPDH_TAA_len41_fa10_ta10_fm10_tm10,a
2905@TOP@human_GAPDH_TAA_len41_fa10_ta10_fm10_tm10*122*g,0,1,6227,0,6228,1.0,122,2905@TOP@human_GAPDH_TAA_len41_fa10_ta10_fm10_tm10,g
2905@TOP@human_GAPDH_TAA_len41_fa10_ta10_fm10_tm10*123*t,1,0,1,6147,6149,0.0,123,2905@TOP@human_GAPDH_TAA_len41_fa10_ta10_fm10_tm10,t
2905@TOP@human_GAPDH_TAA_len41_fa10_ta10_fm10_tm10*124*a,5833,0,268,0,6101,0.044,124,2905@TOP@human_GAPDH_TAA_len41_fa10_ta10_fm10_tm10,a
2905@TOP@human_GAPDH_TAA_len41_fa10_ta10_fm10_tm10*125*a,5935,0,174,1,6110,0.028,125,2905@TOP@human_GAPDH_TAA_len41_fa10_ta10_fm10_tm10,a
2905@TOP@human_GAPDH_TAA_len41_fa10_ta10_fm10_tm10*126*g,1,0,6132,0,6133,1.0,126,2905@TOP@human_GAPDH_TAA_len41_fa10_ta10_fm10_tm10,g
2905@TOP@human_GAPDH_TAA_len41_fa10_ta10_fm10_tm10*127*a,6190,0,7,0,6197,0.001,127,2905@TOP@human_GAPDH_TAA_len41_fa10_ta10_fm10_tm10,a
2905@TOP@human_GAPDH_TAA_len41_fa10_ta10_fm10_tm10*128*c,0,6227,1,0,6228,0.0,128,2905@TOP@human_GAPDH_TAA_len41_fa10_ta10_fm10_tm10,c
2905@TOP@human_GAPDH_TAA_len41_fa10_ta10_fm10_tm10*129*c,2,6178,0,0,6180,0.0,129,2905@TOP@human_GAPDH_TAA_len41_fa10_ta10_fm10_tm10,c
2905@TOP@human_GAPDH_TAA_len41_fa10_ta10_fm10_tm10*130*c,0,6222,0,0,6222,0.0,130,2905@TOP@human_GAPDH_TAA_len41_fa10_ta10_fm10_tm10,c
2905@TOP@human_GAPDH_TAA_len41_fa10_ta10_fm10_tm10*131*c,0,6226,0,3,6229,0.0,131,2905@TOP@human_GAPDH_TAA_len41_fa10_ta10_fm10_tm10,c
2905@TOP@human_GAPDH_TAA_len41_fa10_ta10_fm10_tm10*132*t,0,1,0,6129,6130,0.0,132,2905@TOP@human_GAPDH_TAA_len41_fa10_ta10_fm10_tm10,t
2905@TOP@human_GAPDH_TAA_len41_fa10_ta10_fm10_tm10*133*g,0,0,6143,1,6144,1.0,133,2905@TOP@human_GAPDH_TAA_len41_fa10_ta10_fm10_tm10,g
2905@TOP@human_GAPDH_TAA_len41_fa10_ta10_fm10_tm10*134*g,1,0,6169,0,6170,1.0,134,2905@TOP@human_GAPDH_TAA_len41_fa10_ta10_fm10_tm10,g
2906@TOP@human_GAPDH_TAA_len41_fa10_ta10_fm10_tm10*114*t,0,1,0,11258,11259,0.0,114,2906@TOP@human_GAPDH_TAA_len41_fa10_ta10_fm10_tm10,t
2906@TOP@human_GAPDH_TAA_len41_fa10_ta10_fm10_tm10*115*c,0,11320,0,0,11320,0.0,115,2906@TOP@human_GAPDH_TAA_len41_fa10_ta10_fm10_tm10,c
2906@TOP@human_GAPDH_TAA_len41_fa10_ta10_fm10_tm10*116*c,3,11267,0,3,11273,0.0,116,2906@TOP@human_GAPDH_TAA_len41_fa10_ta10_fm10_tm10,c
2906@TOP@human_GAPDH_TAA_len41_fa10_ta10_fm10_tm10*117*a,11219,0,49,0,11268,0.004,117,2906@TOP@human_GAPDH_TAA_len41_fa10_ta10_fm10_tm10,a
2906@TOP@human_GAPDH_TAA_len41_fa10_ta10_fm10_tm10*118*a,9625,1,1566,0,11192,0.14,118,2906@TOP@human_GAPDH_TAA_len41_fa10_ta10_fm10_tm10,a
2906@TOP@human_GAPDH_TAA_len41_fa10_ta10_fm10_tm10*119*g,0,0,11171,0,11171,1.0,119,2906@TOP@human_GAPDH_TAA_len41_fa10_ta10_fm10_tm10,g
2906@TOP@human_GAPDH_TAA_len41_fa10_ta10_fm10_tm10*120*g,0,0,11133,0,11133,1.0,120,2906@TOP@human_GAPDH_TAA_len41_fa10_ta10_fm10_tm10,g
2906@TOP@human_GAPDH_TAA_len41_fa10_ta10_fm10_tm10*121*a,11227,0,8,0,11235,0.001,121,2906@TOP@human_GAPDH_TAA_len41_fa10_ta10_fm10_tm10,a
2906@TOP@human_GAPDH_TAA_len41_fa10_ta10_fm10_tm10*122*g,0,0,11272,0,11272,1.0,122,2906@TOP@human_GAPDH_TAA_len41_fa10_ta10_fm10_tm10,g
2906@TOP@human_GAPDH_TAA_len41_fa10_ta10_fm10_tm10*123*t,1,0,0,11086,11087,0.0,123,2906@TOP@human_GAPDH_TAA_len41_fa10_ta10_fm10_tm10,t
2906@TOP@human_GAPDH_TAA_len41_fa10_ta10_fm10_tm10*124*a,9166,2,1956,0,11124,0.176,124,2906@TOP@human_GAPDH_TAA_len41_fa10_ta10_fm10_tm10,a
2906@TOP@human_GAPDH_TAA_len41_fa10_ta10_fm10_tm10*125*a,10435,0,642,6,11083,0.058,125,2906@TOP@human_GAPDH_TAA_len41_fa10_ta10_fm10_tm10,a
2906@TOP@human_GAPDH_TAA_len41_fa10_ta10_fm10_tm10*126*g,0,0,11159,0,11159,1.0,126,2906@TOP@human_GAPDH_TAA_len41_fa10_ta10_fm10_tm10,g
2906@TOP@human_GAPDH_TAA_len41_fa10_ta10_fm10_tm10*127*a,11227,0,5,0,11232,0.0,127,2906@TOP@human_GAPDH_TAA_len41_fa10_ta10_fm10_tm10,a
2906@TOP@human_GAPDH_TAA_len41_fa10_ta10_fm10_tm10*128*c,1,11273,0,3,11277,0.0,128,2906@TOP@human_GAPDH_TAA_len41_fa10_ta10_fm10_tm10,c
2906@TOP@human_GAPDH_TAA_len41_fa10_ta10_fm10_tm10*129*c,1,11196,1,0,11198,0.0,129,2906@TOP@human_GAPDH_TAA_len41_fa10_ta10_fm10_tm10,c
2906@TOP@human_GAPDH_TAA_len41_fa10_ta10_fm10_tm10*130*c,0,11266,0,1,11267,0.0,130,2906@TOP@human_GAPDH_TAA_len41_fa10_ta10_fm10_tm10,c
2906@TOP@human_GAPDH_TAA_len41_fa10_ta10_fm10_tm10*131*c,1,11288,0,0,11289,0.0,131,2906@TOP@human_GAPDH_TAA_len41_fa10_ta10_fm10_tm10,c
2906@TOP@human_GAPDH_TAA_len41_fa10_ta10_fm10_tm10*132*t,1,5,2,11122,11130,0.0,132,2906@TOP@human_GAPDH_TAA_len41_fa10_ta10_fm10_tm10,t
2906@TOP@human_GAPDH_TAA_len41_fa10_ta10_fm10_tm10*133*g,0,0,11119,3,11122,1.0,133,2906@TOP@human_GAPDH_TAA_len41_fa10_ta10_fm10_tm10,g
2906@TOP@human_GAPDH_TAA_len41_fa10_ta10_fm10_tm10*134*g,0,2,11159,0,11161,1.0,134,2906@TOP@human_GAPDH_TAA_len41_fa10_ta10_fm10_tm10,g
2907@TOP@human_GAPDH_TAA_len41_fa10_ta10_fm10_tm10*114*t,1,2,0,4942,4945,0.0,114,2907@TOP@human_GAPDH_TAA_len41_fa10_ta10_fm10_tm10,t
2907@TOP@human_GAPDH_TAA_len41_fa10_ta10_fm10_tm10*115*c,0,4984,0,0,4984,0.0,115,2907@TOP@human_GAPDH_TAA_len41_fa10_ta10_fm10_tm10,c
2907@TOP@human_GAPDH_TAA_len41_fa10_ta10_fm10_tm10*116*c,0,4962,0,0,4962,0.0,116,2907@TOP@human_GAPDH_TAA_len41_fa10_ta10_fm10_tm10,c
2907@TOP@human_GAPDH_TAA_len41_fa10_ta10_fm10_tm10*117*a,4939,0,6,0,4945,0.001,117,2907@TOP@human_GAPDH_TAA_len41_fa10_ta10_fm10_tm10,a
2907@TOP@human_GAPDH_TAA_len41_fa10_ta10_fm10_tm10*118*a,4420,0,495,0,4915,0.101,118,2907@TOP@human_GAPDH_TAA_len41_fa10_ta10_fm10_tm10,a
2907@TOP@human_GAPDH_TAA_len41_fa10_ta10_fm10_tm10*119*g,0,0,4933,0,4933,1.0,119,2907@TOP@human_GAPDH_TAA_len41_fa10_ta10_fm10_tm10,g
2907@TOP@human_GAPDH_TAA_len41_fa10_ta10_fm10_tm10*120*g,1,0,4891,0,4892,1.0,120,2907@TOP@human_GAPDH_TAA_len41_fa10_ta10_fm10_tm10,g
2907@TOP@human_GAPDH_TAA_len41_fa10_ta10_fm10_tm10*121*a,4953,0,1,0,4954,0.0,121,2907@TOP@human_GAPDH_TAA_len41_fa10_ta10_fm10_tm10,a
2907@TOP@human_GAPDH_TAA_len41_fa10_ta10_fm10_tm10*122*g,0,0,4972,0,4972,1.0,122,2907@TOP@human_GAPDH_TAA_len41_fa10_ta10_fm10_tm10,g
2907@TOP@human_GAPDH_TAA_len41_fa10_ta10_fm10_tm10*123*t,1,1,1,4903,4906,0.0,123,2907@TOP@human_GAPDH_TAA_len41_fa10_ta10_fm10_tm10,t
2907@TOP@human_GAPDH_TAA_len41_fa10_ta10_fm10_tm10*124*a,3455,0,1427,0,4882,0.292,124,2907@TOP@human_GAPDH_TAA_len41_fa10_ta10_fm10_tm10,a
2907@TOP@human_GAPDH_TAA_len41_fa10_ta10_fm10_tm10*125*a,4315,0,556,0,4871,0.114,125,2907@TOP@human_GAPDH_TAA_len41_fa10_ta10_fm10_tm10,a
2907@TOP@human_GAPDH_TAA_len41_fa10_ta10_fm10_tm10*126*g,0,0,4910,0,4910,1.0,126,2907@TOP@human_GAPDH_TAA_len41_fa10_ta10_fm10_tm10,g
2907@TOP@human_GAPDH_TAA_len41_fa10_ta10_fm10_tm10*127*a,4944,0,7,0,4951,0.001,127,2907@TOP@human_GAPDH_TAA_len41_fa10_ta10_fm10_tm10,a
2907@TOP@human_GAPDH_TAA_len41_fa10_ta10_fm10_tm10*128*c,0,4965,0,0,4965,0.0,128,2907@TOP@human_GAPDH_TAA_len41_fa10_ta10_fm10_tm10,c
2907@TOP@human_GAPDH_TAA_len41_fa10_ta10_fm10_tm10*129*c,0,4941,0,0,4941,0.0,129,2907@TOP@human_GAPDH_TAA_len41_fa10_ta10_fm10_tm10,c
2907@TOP@human_GAPDH_TAA_len41_fa10_ta10_fm10_tm10*130*c,0,4972,0,0,4972,0.0,130,2907@TOP@human_GAPDH_TAA_len41_fa10_ta10_fm10_tm10,c
2907@TOP@human_GAPDH_TAA_len41_fa10_ta10_fm10_tm10*131*c,0,4976,0,2,4978,0.0,131,2907@TOP@human_GAPDH_TAA_len41_fa10_ta10_fm10_tm10,c
2907@TOP@human_GAPDH_TAA_len41_fa10_ta10_fm10_tm10*132*t,1,0,0,4904,4905,0.0,132,2907@TOP@human_GAPDH_TAA_len41_fa10_ta10_fm10_tm10,t
2907@TOP@human_GAPDH_TAA_len41_fa10_ta10_fm10_tm10*133*g,1,0,4899,0,4900,1.0,133,2907@TOP@human_GAPDH_TAA_len41_fa10_ta10_fm10_tm10,g
2907@TOP@human_GAPDH_TAA_len41_fa10_ta10_fm10_tm10*134*g,0,2,4913,0,4915,1.0,134,2907@TOP@human_GAPDH_TAA_len41_fa10_ta10_fm10_tm10,g
2908@TOP@human_GAPDH_TAA_len41_fa10_ta10_fm10_tm10*114*t,3,2,0,11338,11343,0.0,114,2908@TOP@human_GAPDH_TAA_len41_fa10_ta10_fm10_tm10,t
2908@TOP@human_GAPDH_TAA_len41_fa10_ta10_fm10_tm10*115*c,0,11407,0,1,11408,0.0,115,2908@TOP@human_GAPDH_TAA_len41_fa10_ta10_fm10_tm10,c
2908@TOP@human_GAPDH_TAA_len41_fa10_ta10_fm10_tm10*116*c,2,11365,0,0,11367,0.0,116,2908@TOP@human_GAPDH_TAA_len41_fa10_ta10_fm10_tm10,c
2908@TOP@human_GAPDH_TAA_len41_fa10_ta10_fm10_tm10*117*a,11305,1,29,1,11336,0.003,117,2908@TOP@human_GAPDH_TAA_len41_fa10_ta10_fm10_tm10,a
2908@TOP@human_GAPDH_TAA_len41_fa10_ta10_fm10_tm10*118*a,5806,1,5481,0,11288,0.486,118,2908@TOP@human_GAPDH_TAA_len41_fa10_ta10_fm10_tm10,a
2908@TOP@human_GAPDH_TAA_len41_fa10_ta10_fm10_tm10*119*g,1,0,11258,2,11261,1.0,119,2908@TOP@human_GAPDH_TAA_len41_fa10_ta10_fm10_tm10,g
2908@TOP@human_GAPDH_TAA_len41_fa10_ta10_fm10_tm10*120*g,0,1,11269,0,11270,1.0,120,2908@TOP@human_GAPDH_TAA_len41_fa10_ta10_fm10_tm10,g
2908@TOP@human_GAPDH_TAA_len41_fa10_ta10_fm10_tm10*121*a,11282,0,10,0,11292,0.001,121,2908@TOP@human_GAPDH_TAA_len41_fa10_ta10_fm10_tm10,a
2908@TOP@human_GAPDH_TAA_len41_fa10_ta10_fm10_tm10*122*g,0,0,11365,0,11365,1.0,122,2908@TOP@human_GAPDH_TAA_len41_fa10_ta10_fm10_tm10,g
2908@TOP@human_GAPDH_TAA_len41_fa10_ta10_fm10_tm10*123*t,1,1,2,11217,11221,0.0,123,2908@TOP@human_GAPDH_TAA_len41_fa10_ta10_fm10_tm10,t
2908@TOP@human_GAPDH_TAA_len41_fa10_ta10_fm10_tm10*124*a,10714,1,403,0,11118,0.036,124,2908@TOP@human_GAPDH_TAA_len41_fa10_ta10_fm10_tm10,a
2908@TOP@human_GAPDH_TAA_len41_fa10_ta10_fm10_tm10*125*a,9806,1,1316,2,11125,0.118,125,2908@TOP@human_GAPDH_TAA_len41_fa10_ta10_fm10_tm10,a
2908@TOP@human_GAPDH_TAA_len41_fa10_ta10_fm10_tm10*126*g,1,0,11208,0,11209,1.0,126,2908@TOP@human_GAPDH_TAA_len41_fa10_ta10_fm10_tm10,g
2908@TOP@human_GAPDH_TAA_len41_fa10_ta10_fm10_tm10*127*a,11303,0,2,0,11305,0.0,127,2908@TOP@human_GAPDH_TAA_len41_fa10_ta10_fm10_tm10,a
2908@TOP@human_GAPDH_TAA_len41_fa10_ta10_fm10_tm10*128*c,0,11373,0,2,11375,0.0,128,2908@TOP@human_GAPDH_TAA_len41_fa10_ta10_fm10_tm10,c
2908@TOP@human_GAPDH_TAA_len41_fa10_ta10_fm10_tm10*129*c,3,11299,0,0,11302,0.0,129,2908@TOP@human_GAPDH_TAA_len41_fa10_ta10_fm10_tm10,c
2908@TOP@human_GAPDH_TAA_len41_fa10_ta10_fm10_tm10*130*c,1,11367,0,0,11368,0.0,130,2908@TOP@human_GAPDH_TAA_len41_fa10_ta10_fm10_tm10,c
2908@TOP@human_GAPDH_TAA_len41_fa10_ta10_fm10_tm10*131*c,0,11378,0,0,11378,0.0,131,2908@TOP@human_GAPDH_TAA_len41_fa10_ta10_fm10_tm10,c
2908@TOP@human_GAPDH_TAA_len41_fa10_ta10_fm10_tm10*132*t,1,0,1,11222,11224,0.0,132,2908@TOP@human_GAPDH_TAA_len41_fa10_ta10_fm10_tm10,t
2908@TOP@human_GAPDH_TAA_len41_fa10_ta10_fm10_tm10*133*g,0,0,11192,0,11192,1.0,133,2908@TOP@human_GAPDH_TAA_len41_fa10_ta10_fm10_tm10,g
2908@TOP@human_GAPDH_TAA_len41_fa10_ta10_fm10_tm10*134*g,0,3,11254,0,11257,1.0,134,2908@TOP@human_GAPDH_TAA_len41_fa10_ta10_fm10_tm10,g
2909@TOP@human_GAPDH_TAA_len41_fa10_ta10_fm10_tm10*114*t,0,4,0,14476,14480,0.0,114,2909@TOP@human_GAPDH_TAA_len41_fa10_ta10_fm10_tm10,t
2909@TOP@human_GAPDH_TAA_len41_fa10_ta10_fm10_tm10*115*c,0,14558,0,0,14558,0.0,115,2909@TOP@human_GAPDH_TAA_len41_fa10_ta10_fm10_tm10,c
2909@TOP@human_GAPDH_TAA_len41_fa10_ta10_fm10_tm10*116*c,0,14491,0,6,14497,0.0,116,2909@TOP@human_GAPDH_TAA_len41_fa10_ta10_fm10_tm10,c
2909@TOP@human_GAPDH_TAA_len41_fa10_ta10_fm10_tm10*117*a,14442,0,33,0,14475,0.002,117,2909@TOP@human_GAPDH_TAA_len41_fa10_ta10_fm10_tm10,a
2909@TOP@human_GAPDH_TAA_len41_fa10_ta10_fm10_tm10*118*a,9683,0,4705,2,14390,0.327,118,2909@TOP@human_GAPDH_TAA_len41_fa10_ta10_fm10_tm10,a
2909@TOP@human_GAPDH_TAA_len41_fa10_ta10_fm10_tm10*119*g,3,0,14375,0,14378,1.0,119,2909@TOP@human_GAPDH_TAA_len41_fa10_ta10_fm10_tm10,g
2909@TOP@human_GAPDH_TAA_len41_fa10_ta10_fm10_tm10*120*g,1,0,14374,0,14375,1.0,120,2909@TOP@human_GAPDH_TAA_len41_fa10_ta10_fm10_tm10,g
2909@TOP@human_GAPDH_TAA_len41_fa10_ta10_fm10_tm10*121*a,14441,0,6,0,14447,0.0,121,2909@TOP@human_GAPDH_TAA_len41_fa10_ta10_fm10_tm10,a
2909@TOP@human_GAPDH_TAA_len41_fa10_ta10_fm10_tm10*122*g,0,0,14504,0,14504,1.0,122,2909@TOP@human_GAPDH_TAA_len41_fa10_ta10_fm10_tm10,g
2909@TOP@human_GAPDH_TAA_len41_fa10_ta10_fm10_tm10*123*t,1,2,2,14298,14303,0.0,123,2909@TOP@human_GAPDH_TAA_len41_fa10_ta10_fm10_tm10,t
2909@TOP@human_GAPDH_TAA_len41_fa10_ta10_fm10_tm10*124*a,13215,0,1019,0,14234,0.072,124,2909@TOP@human_GAPDH_TAA_len41_fa10_ta10_fm10_tm10,a
2909@TOP@human_GAPDH_TAA_len41_fa10_ta10_fm10_tm10*125*a,13332,2,836,1,14171,0.059,125,2909@TOP@human_GAPDH_TAA_len41_fa10_ta10_fm10_tm10,a
2909@TOP@human_GAPDH_TAA_len41_fa10_ta10_fm10_tm10*126*g,3,2,14301,1,14307,1.0,126,2909@TOP@human_GAPDH_TAA_len41_fa10_ta10_fm10_tm10,g
2909@TOP@human_GAPDH_TAA_len41_fa10_ta10_fm10_tm10*127*a,14449,3,3,1,14456,0.0,127,2909@TOP@human_GAPDH_TAA_len41_fa10_ta10_fm10_tm10,a
2909@TOP@human_GAPDH_TAA_len41_fa10_ta10_fm10_tm10*128*c,0,14517,1,1,14519,0.0,128,2909@TOP@human_GAPDH_TAA_len41_fa10_ta10_fm10_tm10,c
2909@TOP@human_GAPDH_TAA_len41_fa10_ta10_fm10_tm10*129*c,1,14401,0,0,14402,0.0,129,2909@TOP@human_GAPDH_TAA_len41_fa10_ta10_fm10_tm10,c
2909@TOP@human_GAPDH_TAA_len41_fa10_ta10_fm10_tm10*130*c,0,14495,0,1,14496,0.0,130,2909@TOP@human_GAPDH_TAA_len41_fa10_ta10_fm10_tm10,c
2909@TOP@human_GAPDH_TAA_len41_fa10_ta10_fm10_tm10*131*c,0,14524,0,1,14525,0.0,131,2909@TOP@human_GAPDH_TAA_len41_fa10_ta10_fm10_tm10,c
2909@TOP@human_GAPDH_TAA_len41_fa10_ta10_fm10_tm10*132*t,4,2,3,14313,14322,0.0,132,2909@TOP@human_GAPDH_TAA_len41_fa10_ta10_fm10_tm10,t
2909@TOP@human_GAPDH_TAA_len41_fa10_ta10_fm10_tm10*133*g,1,0,14282,1,14284,1.0,133,2909@TOP@human_GAPDH_TAA_len41_fa10_ta10_fm10_tm10,g
2909@TOP@human_GAPDH_TAA_len41_fa10_ta10_fm10_tm10*134*g,4,1,14347,0,14352,1.0,134,2909@TOP@human_GAPDH_TAA_len41_fa10_ta10_fm10_tm10,g
2910@TOP@human_GAPDH_TAA_len41_fa10_ta10_fm10_tm10*114*t,0,0,0,2950,2950,0.0,114,2910@TOP@human_GAPDH_TAA_len41_fa10_ta10_fm10_tm10,t
2910@TOP@human_GAPDH_TAA_len41_fa10_ta10_fm10_tm10*115*c,0,2969,0,0,2969,0.0,115,2910@TOP@human_GAPDH_TAA_len41_fa10_ta10_fm10_tm10,c
2910@TOP@human_GAPDH_TAA_len41_fa10_ta10_fm10_tm10*116*c,0,2948,0,0,2948,0.0,116,2910@TOP@human_GAPDH_TAA_len41_fa10_ta10_fm10_tm10,c
2910@TOP@human_GAPDH_TAA_len41_fa10_ta10_fm10_tm10*117*a,2425,0,527,0,2952,0.179,117,2910@TOP@human_GAPDH_TAA_len41_fa10_ta10_fm10_tm10,a
2910@TOP@human_GAPDH_TAA_len41_fa10_ta10_fm10_tm10*118*a,1766,0,1177,0,2943,0.4,118,2910@TOP@human_GAPDH_TAA_len41_fa10_ta10_fm10_tm10,a
2910@TOP@human_GAPDH_TAA_len41_fa10_ta10_fm10_tm10*119*g,0,0,2936,0,2936,1.0,119,2910@TOP@human_GAPDH_TAA_len41_fa10_ta10_fm10_tm10,g
2910@TOP@human_GAPDH_TAA_len41_fa10_ta10_fm10_tm10*120*g,0,0,2943,0,2943,1.0,120,2910@TOP@human_GAPDH_TAA_len41_fa10_ta10_fm10_tm10,g
2910@TOP@human_GAPDH_TAA_len41_fa10_ta10_fm10_tm10*121*a,2924,0,13,0,2937,0.004,121,2910@TOP@human_GAPDH_TAA_len41_fa10_ta10_fm10_tm10,a
2910@TOP@human_GAPDH_TAA_len41_fa10_ta10_fm10_tm10*122*g,0,0,2961,0,2961,1.0,122,2910@TOP@human_GAPDH_TAA_len41_fa10_ta10_fm10_tm10,g
2910@TOP@human_GAPDH_TAA_len41_fa10_ta10_fm10_tm10*123*t,0,0,0,2924,2924,0.0,123,2910@TOP@human_GAPDH_TAA_len41_fa10_ta10_fm10_tm10,t
2910@TOP@human_GAPDH_TAA_len41_fa10_ta10_fm10_tm10*124*a,2092,0,830,0,2922,0.284,124,2910@TOP@human_GAPDH_TAA_len41_fa10_ta10_fm10_tm10,a
2910@TOP@human_GAPDH_TAA_len41_fa10_ta10_fm10_tm10*125*a,2150,0,770,0,2920,0.264,125,2910@TOP@human_GAPDH_TAA_len41_fa10_ta10_fm10_tm10,a
2910@TOP@human_GAPDH_TAA_len41_fa10_ta10_fm10_tm10*126*g,1,0,2923,1,2925,0.999,126,2910@TOP@human_GAPDH_TAA_len41_fa10_ta10_fm10_tm10,g
2910@TOP@human_GAPDH_TAA_len41_fa10_ta10_fm10_tm10*127*a,2946,0,2,0,2948,0.001,127,2910@TOP@human_GAPDH_TAA_len41_fa10_ta10_fm10_tm10,a
2910@TOP@human_GAPDH_TAA_len41_fa10_ta10_fm10_tm10*128*c,0,2964,0,1,2965,0.0,128,2910@TOP@human_GAPDH_TAA_len41_fa10_ta10_fm10_tm10,c
2910@TOP@human_GAPDH_TAA_len41_fa10_ta10_fm10_tm10*129*c,0,2953,0,0,2953,0.0,129,2910@TOP@human_GAPDH_TAA_len41_fa10_ta10_fm10_tm10,c
2910@TOP@human_GAPDH_TAA_len41_fa10_ta10_fm10_tm10*130*c,0,2961,1,0,2962,0.0,130,2910@TOP@human_GAPDH_TAA_len41_fa10_ta10_fm10_tm10,c
2910@TOP@human_GAPDH_TAA_len41_fa10_ta10_fm10_tm10*131*c,0,2963,0,2,2965,0.0,131,2910@TOP@human_GAPDH_TAA_len41_fa10_ta10_fm10_tm10,c
2910@TOP@human_GAPDH_TAA_len41_fa10_ta10_fm10_tm10*132*t,0,2,1,2926,2929,0.0,132,2910@TOP@human_GAPDH_TAA_len41_fa10_ta10_fm10_tm10,t
2910@TOP@human_GAPDH_TAA_len41_fa10_ta10_fm10_tm10*133*g,0,0,2927,0,2927,1.0,133,2910@TOP@human_GAPDH_TAA_len41_fa10_ta10_fm10_tm10,g
2910@TOP@human_GAPDH_TAA_len41_fa10_ta10_fm10_tm10*134*g,0,0,2934,0,2934,1.0,134,2910@TOP@human_GAPDH_TAA_len41_fa10_ta10_fm10_tm10,g
2911@TOP@human_GAPDH_TAA_len41_fa10_ta10_fm10_tm10*114*t,0,2,0,8314,8316,0.0,114,2911@TOP@human_GAPDH_TAA_len41_fa10_ta10_fm10_tm10,t
2911@TOP@human_GAPDH_TAA_len41_fa10_ta10_fm10_tm10*115*c,0,8366,0,2,8368,0.0,115,2911@TOP@human_GAPDH_TAA_len41_fa10_ta10_fm10_tm10,c
2911@TOP@human_GAPDH_TAA_len41_fa10_ta10_fm10_tm10*116*c,0,8335,0,0,8335,0.0,116,2911@TOP@human_GAPDH_TAA_len41_fa10_ta10_fm10_tm10,c
2911@TOP@human_GAPDH_TAA_len41_fa10_ta10_fm10_tm10*117*a,7721,0,611,0,8332,0.073,117,2911@TOP@human_GAPDH_TAA_len41_fa10_ta10_fm10_tm10,a
2911@TOP@human_GAPDH_TAA_len41_fa10_ta10_fm10_tm10*118*a,6994,0,1279,0,8273,0.155,118,2911@TOP@human_GAPDH_TAA_len41_fa10_ta10_fm10_tm10,a
2911@TOP@human_GAPDH_TAA_len41_fa10_ta10_fm10_tm10*119*g,1,0,8261,0,8262,1.0,119,2911@TOP@human_GAPDH_TAA_len41_fa10_ta10_fm10_tm10,g
2911@TOP@human_GAPDH_TAA_len41_fa10_ta10_fm10_tm10*120*g,1,0,8224,0,8225,1.0,120,2911@TOP@human_GAPDH_TAA_len41_fa10_ta10_fm10_tm10,g
2911@TOP@human_GAPDH_TAA_len41_fa10_ta10_fm10_tm10*121*a,8294,0,26,0,8320,0.003,121,2911@TOP@human_GAPDH_TAA_len41_fa10_ta10_fm10_tm10,a
2911@TOP@human_GAPDH_TAA_len41_fa10_ta10_fm10_tm10*122*g,1,0,8342,0,8343,1.0,122,2911@TOP@human_GAPDH_TAA_len41_fa10_ta10_fm10_tm10,g
2911@TOP@human_GAPDH_TAA_len41_fa10_ta10_fm10_tm10*123*t,3,0,0,8226,8229,0.0,123,2911@TOP@human_GAPDH_TAA_len41_fa10_ta10_fm10_tm10,t
2911@TOP@human_GAPDH_TAA_len41_fa10_ta10_fm10_tm10*124*a,7244,0,981,0,8225,0.119,124,2911@TOP@human_GAPDH_TAA_len41_fa10_ta10_fm10_tm10,a
2911@TOP@human_GAPDH_TAA_len41_fa10_ta10_fm10_tm10*125*a,7723,0,445,0,8168,0.054,125,2911@TOP@human_GAPDH_TAA_len41_fa10_ta10_fm10_tm10,a
2911@TOP@human_GAPDH_TAA_len41_fa10_ta10_fm10_tm10*126*g,0,0,8218,0,8218,1.0,126,2911@TOP@human_GAPDH_TAA_len41_fa10_ta10_fm10_tm10,g
2911@TOP@human_GAPDH_TAA_len41_fa10_ta10_fm10_tm10*127*a,8316,0,3,0,8319,0.0,127,2911@TOP@human_GAPDH_TAA_len41_fa10_ta10_fm10_tm10,a
2911@TOP@human_GAPDH_TAA_len41_fa10_ta10_fm10_tm10*128*c,0,8343,0,0,8343,0.0,128,2911@TOP@human_GAPDH_TAA_len41_fa10_ta10_fm10_tm10,c
2911@TOP@human_GAPDH_TAA_len41_fa10_ta10_fm10_tm10*129*c,0,8274,0,0,8274,0.0,129,2911@TOP@human_GAPDH_TAA_len41_fa10_ta10_fm10_tm10,c
2911@TOP@human_GAPDH_TAA_len41_fa10_ta10_fm10_tm10*130*c,1,8323,0,2,8326,0.0,130,2911@TOP@human_GAPDH_TAA_len41_fa10_ta10_fm10_tm10,c
2911@TOP@human_GAPDH_TAA_len41_fa10_ta10_fm10_tm10*131*c,0,8349,0,1,8350,0.0,131,2911@TOP@human_GAPDH_TAA_len41_fa10_ta10_fm10_tm10,c
2911@TOP@human_GAPDH_TAA_len41_fa10_ta10_fm10_tm10*132*t,0,1,1,8204,8206,0.0,132,2911@TOP@human_GAPDH_TAA_len41_fa10_ta10_fm10_tm10,t
2911@TOP@human_GAPDH_TAA_len41_fa10_ta10_fm10_tm10*133*g,0,0,8214,0,8214,1.0,133,2911@TOP@human_GAPDH_TAA_len41_fa10_ta10_fm10_tm10,g
2911@TOP@human_GAPDH_TAA_len41_fa10_ta10_fm10_tm10*134*g,0,2,8257,0,8259,1.0,134,2911@TOP@human_GAPDH_TAA_len41_fa10_ta10_fm10_tm10,g
2912@TOP@human_GAPDH_TAA_len41_fa10_ta10_fm10_tm10*114*t,0,0,0,1435,1435,0.0,114,2912@TOP@human_GAPDH_TAA_len41_fa10_ta10_fm10_tm10,t
2912@TOP@human_GAPDH_TAA_len41_fa10_ta10_fm10_tm10*115*c,0,1450,0,0,1450,0.0,115,2912@TOP@human_GAPDH_TAA_len41_fa10_ta10_fm10_tm10,c
2912@TOP@human_GAPDH_TAA_len41_fa10_ta10_fm10_tm10*116*c,0,1442,0,0,1442,0.0,116,2912@TOP@human_GAPDH_TAA_len41_fa10_ta10_fm10_tm10,c
2912@TOP@human_GAPDH_TAA_len41_fa10_ta10_fm10_tm10*117*a,1418,0,25,0,1443,0.017,117,2912@TOP@human_GAPDH_TAA_len41_fa10_ta10_fm10_tm10,a
2912@TOP@human_GAPDH_TAA_len41_fa10_ta10_fm10_tm10*118*a,1045,0,391,0,1436,0.272,118,2912@TOP@human_GAPDH_TAA_len41_fa10_ta10_fm10_tm10,a
2912@TOP@human_GAPDH_TAA_len41_fa10_ta10_fm10_tm10*119*g,0,0,1428,0,1428,1.0,119,2912@TOP@human_GAPDH_TAA_len41_fa10_ta10_fm10_tm10,g
2912@TOP@human_GAPDH_TAA_len41_fa10_ta10_fm10_tm10*120*g,0,0,1424,0,1424,1.0,120,2912@TOP@human_GAPDH_TAA_len41_fa10_ta10_fm10_tm10,g
2912@TOP@human_GAPDH_TAA_len41_fa10_ta10_fm10_tm10*121*a,1436,0,4,0,1440,0.003,121,2912@TOP@human_GAPDH_TAA_len41_fa10_ta10_fm10_tm10,a
2912@TOP@human_GAPDH_TAA_len41_fa10_ta10_fm10_tm10*122*g,0,0,1440,0,1440,1.0,122,2912@TOP@human_GAPDH_TAA_len41_fa10_ta10_fm10_tm10,g
2912@TOP@human_GAPDH_TAA_len41_fa10_ta10_fm10_tm10*123*t,0,0,0,1418,1418,0.0,123,2912@TOP@human_GAPDH_TAA_len41_fa10_ta10_fm10_tm10,t
2912@TOP@human_GAPDH_TAA_len41_fa10_ta10_fm10_tm10*124*a,1310,0,115,0,1425,0.081,124,2912@TOP@human_GAPDH_TAA_len41_fa10_ta10_fm10_tm10,a
2912@TOP@human_GAPDH_TAA_len41_fa10_ta10_fm10_tm10*125*a,1171,0,252,0,1423,0.177,125,2912@TOP@human_GAPDH_TAA_len41_fa10_ta10_fm10_tm10,a
2912@TOP@human_GAPDH_TAA_len41_fa10_ta10_fm10_tm10*126*g,0,0,1410,0,1410,1.0,126,2912@TOP@human_GAPDH_TAA_len41_fa10_ta10_fm10_tm10,g
2912@TOP@human_GAPDH_TAA_len41_fa10_ta10_fm10_tm10*127*a,1424,0,8,0,1432,0.006,127,2912@TOP@human_GAPDH_TAA_len41_fa10_ta10_fm10_tm10,a
2912@TOP@human_GAPDH_TAA_len41_fa10_ta10_fm10_tm10*128*c,0,1446,0,0,1446,0.0,128,2912@TOP@human_GAPDH_TAA_len41_fa10_ta10_fm10_tm10,c
2912@TOP@human_GAPDH_TAA_len41_fa10_ta10_fm10_tm10*129*c,0,1431,0,0,1431,0.0,129,2912@TOP@human_GAPDH_TAA_len41_fa10_ta10_fm10_tm10,c
2912@TOP@human_GAPDH_TAA_len41_fa10_ta10_fm10_tm10*130*c,0,1442,0,0,1442,0.0,130,2912@TOP@human_GAPDH_TAA_len41_fa10_ta10_fm10_tm10,c
2912@TOP@human_GAPDH_TAA_len41_fa10_ta10_fm10_tm10*131*c,0,1448,0,0,1448,0.0,131,2912@TOP@human_GAPDH_TAA_len41_fa10_ta10_fm10_tm10,c
2912@TOP@human_GAPDH_TAA_len41_fa10_ta10_fm10_tm10*132*t,0,1,0,1424,1425,0.0,132,2912@TOP@human_GAPDH_TAA_len41_fa10_ta10_fm10_tm10,t
2912@TOP@human_GAPDH_TAA_len41_fa10_ta10_fm10_tm10*133*g,1,0,1410,0,1411,0.999,133,2912@TOP@human_GAPDH_TAA_len41_fa10_ta10_fm10_tm10,g
2912@TOP@human_GAPDH_TAA_len41_fa10_ta10_fm10_tm10*134*g,0,0,1428,0,1428,1.0,134,2912@TOP@human_GAPDH_TAA_len41_fa10_ta10_fm10_tm10,g
2913@TOP@human_GAPDH_TAA_len41_fa10_ta10_fm10_tm10*114*t,2,4,0,5636,5642,0.0,114,2913@TOP@human_GAPDH_TAA_len41_fa10_ta10_fm10_tm10,t
2913@TOP@human_GAPDH_TAA_len41_fa10_ta10_fm10_tm10*115*c,0,5672,0,0,5672,0.0,115,2913@TOP@human_GAPDH_TAA_len41_fa10_ta10_fm10_tm10,c
2913@TOP@human_GAPDH_TAA_len41_fa10_ta10_fm10_tm10*116*c,0,5659,0,0,5659,0.0,116,2913@TOP@human_GAPDH_TAA_len41_fa10_ta10_fm10_tm10,c
2913@TOP@human_GAPDH_TAA_len41_fa10_ta10_fm10_tm10*117*a,5614,0,38,0,5652,0.007,117,2913@TOP@human_GAPDH_TAA_len41_fa10_ta10_fm10_tm10,a
2913@TOP@human_GAPDH_TAA_len41_fa10_ta10_fm10_tm10*118*a,4858,0,778,1,5637,0.138,118,2913@TOP@human_GAPDH_TAA_len41_fa10_ta10_fm10_tm10,a
2913@TOP@human_GAPDH_TAA_len41_fa10_ta10_fm10_tm10*119*g,0,0,5600,0,5600,1.0,119,2913@TOP@human_GAPDH_TAA_len41_fa10_ta10_fm10_tm10,g
2913@TOP@human_GAPDH_TAA_len41_fa10_ta10_fm10_tm10*120*g,0,0,5599,0,5599,1.0,120,2913@TOP@human_GAPDH_TAA_len41_fa10_ta10_fm10_tm10,g
2913@TOP@human_GAPDH_TAA_len41_fa10_ta10_fm10_tm10*121*a,5601,0,32,0,5633,0.006,121,2913@TOP@human_GAPDH_TAA_len41_fa10_ta10_fm10_tm10,a
2913@TOP@human_GAPDH_TAA_len41_fa10_ta10_fm10_tm10*122*g,1,0,5650,0,5651,1.0,122,2913@TOP@human_GAPDH_TAA_len41_fa10_ta10_fm10_tm10,g
2913@TOP@human_GAPDH_TAA_len41_fa10_ta10_fm10_tm10*123*t,0,0,1,5575,5576,0.0,123,2913@TOP@human_GAPDH_TAA_len41_fa10_ta10_fm10_tm10,t
2913@TOP@human_GAPDH_TAA_len41_fa10_ta10_fm10_tm10*124*a,5027,0,551,2,5580,0.099,124,2913@TOP@human_GAPDH_TAA_len41_fa10_ta10_fm10_tm10,a
2913@TOP@human_GAPDH_TAA_len41_fa10_ta10_fm10_tm10*125*a,5016,0,533,1,5550,0.096,125,2913@TOP@human_GAPDH_TAA_len41_fa10_ta10_fm10_tm10,a
2913@TOP@human_GAPDH_TAA_len41_fa10_ta10_fm10_tm10*126*g,1,0,5582,0,5583,1.0,126,2913@TOP@human_GAPDH_TAA_len41_fa10_ta10_fm10_tm10,g
2913@TOP@human_GAPDH_TAA_len41_fa10_ta10_fm10_tm10*127*a,5620,0,8,1,5629,0.001,127,2913@TOP@human_GAPDH_TAA_len41_fa10_ta10_fm10_tm10,a
2913@TOP@human_GAPDH_TAA_len41_fa10_ta10_fm10_tm10*128*c,1,5656,1,1,5659,0.0,128,2913@TOP@human_GAPDH_TAA_len41_fa10_ta10_fm10_tm10,c
2913@TOP@human_GAPDH_TAA_len41_fa10_ta10_fm10_tm10*129*c,0,5613,0,0,5613,0.0,129,2913@TOP@human_GAPDH_TAA_len41_fa10_ta10_fm10_tm10,c
2913@TOP@human_GAPDH_TAA_len41_fa10_ta10_fm10_tm10*130*c,1,5649,0,1,5651,0.0,130,2913@TOP@human_GAPDH_TAA_len41_fa10_ta10_fm10_tm10,c
2913@TOP@human_GAPDH_TAA_len41_fa10_ta10_fm10_tm10*131*c,0,5664,0,1,5665,0.0,131,2913@TOP@human_GAPDH_TAA_len41_fa10_ta10_fm10_tm10,c
2913@TOP@human_GAPDH_TAA_len41_fa10_ta10_fm10_tm10*132*t,0,0,0,5596,5596,0.0,132,2913@TOP@human_GAPDH_TAA_len41_fa10_ta10_fm10_tm10,t
2913@TOP@human_GAPDH_TAA_len41_fa10_ta10_fm10_tm10*133*g,0,1,5579,1,5581,1.0,133,2913@TOP@human_GAPDH_TAA_len41_fa10_ta10_fm10_tm10,g
2913@TOP@human_GAPDH_TAA_len41_fa10_ta10_fm10_tm10*134*g,1,1,5607,0,5609,1.0,134,2913@TOP@human_GAPDH_TAA_len41_fa10_ta10_fm10_tm10,g
2914@TOP@human_GAPDH_TAA_len41_fa10_ta10_fm10_tm10*114*t,0,1,0,4292,4293,0.0,114,2914@TOP@human_GAPDH_TAA_len41_fa10_ta10_fm10_tm10,t
2914@TOP@human_GAPDH_TAA_len41_fa10_ta10_fm10_tm10*115*c,0,4313,0,0,4313,0.0,115,2914@TOP@human_GAPDH_TAA_len41_fa10_ta10_fm10_tm10,c
2914@TOP@human_GAPDH_TAA_len41_fa10_ta10_fm10_tm10*116*c,0,4292,0,0,4292,0.0,116,2914@TOP@human_GAPDH_TAA_len41_fa10_ta10_fm10_tm10,c
2914@TOP@human_GAPDH_TAA_len41_fa10_ta10_fm10_tm10*117*a,4176,0,105,0,4281,0.025,117,2914@TOP@human_GAPDH_TAA_len41_fa10_ta10_fm10_tm10,a
2914@TOP@human_GAPDH_TAA_len41_fa10_ta10_fm10_tm10*118*a,3041,0,1220,0,4261,0.286,118,2914@TOP@human_GAPDH_TAA_len41_fa10_ta10_fm10_tm10,a
2914@TOP@human_GAPDH_TAA_len41_fa10_ta10_fm10_tm10*119*g,0,0,4251,0,4251,1.0,119,2914@TOP@human_GAPDH_TAA_len41_fa10_ta10_fm10_tm10,g
2914@TOP@human_GAPDH_TAA_len41_fa10_ta10_fm10_tm10*120*g,0,0,4255,0,4255,1.0,120,2914@TOP@human_GAPDH_TAA_len41_fa10_ta10_fm10_tm10,g
2914@TOP@human_GAPDH_TAA_len41_fa10_ta10_fm10_tm10*121*a,4273,0,5,0,4278,0.001,121,2914@TOP@human_GAPDH_TAA_len41_fa10_ta10_fm10_tm10,a
2914@TOP@human_GAPDH_TAA_len41_fa10_ta10_fm10_tm10*122*g,1,0,4284,3,4288,0.999,122,2914@TOP@human_GAPDH_TAA_len41_fa10_ta10_fm10_tm10,g
2914@TOP@human_GAPDH_TAA_len41_fa10_ta10_fm10_tm10*123*t,2,11,1,4227,4241,0.0,123,2914@TOP@human_GAPDH_TAA_len41_fa10_ta10_fm10_tm10,t
2914@TOP@human_GAPDH_TAA_len41_fa10_ta10_fm10_tm10*124*a,2563,3,1666,0,4232,0.394,124,2914@TOP@human_GAPDH_TAA_len41_fa10_ta10_fm10_tm10,a
2914@TOP@human_GAPDH_TAA_len41_fa10_ta10_fm10_tm10*125*a,3382,3,857,0,4242,0.202,125,2914@TOP@human_GAPDH_TAA_len41_fa10_ta10_fm10_tm10,a
2914@TOP@human_GAPDH_TAA_len41_fa10_ta10_fm10_tm10*126*g,3,0,4251,0,4254,0.999,126,2914@TOP@human_GAPDH_TAA_len41_fa10_ta10_fm10_tm10,g
2914@TOP@human_GAPDH_TAA_len41_fa10_ta10_fm10_tm10*127*a,4265,5,2,0,4272,0.0,127,2914@TOP@human_GAPDH_TAA_len41_fa10_ta10_fm10_tm10,a
2914@TOP@human_GAPDH_TAA_len41_fa10_ta10_fm10_tm10*128*c,0,4293,0,4,4297,0.0,128,2914@TOP@human_GAPDH_TAA_len41_fa10_ta10_fm10_tm10,c
2914@TOP@human_GAPDH_TAA_len41_fa10_ta10_fm10_tm10*129*c,0,4280,0,0,4280,0.0,129,2914@TOP@human_GAPDH_TAA_len41_fa10_ta10_fm10_tm10,c
2914@TOP@human_GAPDH_TAA_len41_fa10_ta10_fm10_tm10*130*c,0,4299,0,0,4299,0.0,130,2914@TOP@human_GAPDH_TAA_len41_fa10_ta10_fm10_tm10,c
2914@TOP@human_GAPDH_TAA_len41_fa10_ta10_fm10_tm10*131*c,0,4308,0,0,4308,0.0,131,2914@TOP@human_GAPDH_TAA_len41_fa10_ta10_fm10_tm10,c
2914@TOP@human_GAPDH_TAA_len41_fa10_ta10_fm10_tm10*132*t,0,0,0,4244,4244,0.0,132,2914@TOP@human_GAPDH_TAA_len41_fa10_ta10_fm10_tm10,t
2914@TOP@human_GAPDH_TAA_len41_fa10_ta10_fm10_tm10*133*g,1,0,4227,3,4231,0.999,133,2914@TOP@human_GAPDH_TAA_len41_fa10_ta10_fm10_tm10,g
2914@TOP@human_GAPDH_TAA_len41_fa10_ta10_fm10_tm10*134*g,2,1,4259,0,4262,0.999,134,2914@TOP@human_GAPDH_TAA_len41_fa10_ta10_fm10_tm10,g
2915@TOP@human_GAPDH_TAA_len41_fa10_ta10_fm10_tm10*114*t,0,0,0,1678,1678,0.0,114,2915@TOP@human_GAPDH_TAA_len41_fa10_ta10_fm10_tm10,t
2915@TOP@human_GAPDH_TAA_len41_fa10_ta10_fm10_tm10*115*c,0,1693,0,0,1693,0.0,115,2915@TOP@human_GAPDH_TAA_len41_fa10_ta10_fm10_tm10,c
2915@TOP@human_GAPDH_TAA_len41_fa10_ta10_fm10_tm10*116*c,0,1684,0,1,1685,0.0,116,2915@TOP@human_GAPDH_TAA_len41_fa10_ta10_fm10_tm10,c
2915@TOP@human_GAPDH_TAA_len41_fa10_ta10_fm10_tm10*117*a,1592,0,93,0,1685,0.055,117,2915@TOP@human_GAPDH_TAA_len41_fa10_ta10_fm10_tm10,a
2915@TOP@human_GAPDH_TAA_len41_fa10_ta10_fm10_tm10*118*a,1428,0,245,0,1673,0.146,118,2915@TOP@human_GAPDH_TAA_len41_fa10_ta10_fm10_tm10,a
2915@TOP@human_GAPDH_TAA_len41_fa10_ta10_fm10_tm10*119*g,0,0,1668,0,1668,1.0,119,2915@TOP@human_GAPDH_TAA_len41_fa10_ta10_fm10_tm10,g
2915@TOP@human_GAPDH_TAA_len41_fa10_ta10_fm10_tm10*120*g,0,0,1662,0,1662,1.0,120,2915@TOP@human_GAPDH_TAA_len41_fa10_ta10_fm10_tm10,g
2915@TOP@human_GAPDH_TAA_len41_fa10_ta10_fm10_tm10*121*a,1675,0,0,0,1675,0.0,121,2915@TOP@human_GAPDH_TAA_len41_fa10_ta10_fm10_tm10,a
2915@TOP@human_GAPDH_TAA_len41_fa10_ta10_fm10_tm10*122*g,0,0,1687,0,1687,1.0,122,2915@TOP@human_GAPDH_TAA_len41_fa10_ta10_fm10_tm10,g
2915@TOP@human_GAPDH_TAA_len41_fa10_ta10_fm10_tm10*123*t,0,3,0,1657,1660,0.0,123,2915@TOP@human_GAPDH_TAA_len41_fa10_ta10_fm10_tm10,t
2915@TOP@human_GAPDH_TAA_len41_fa10_ta10_fm10_tm10*124*a,1456,0,197,0,1653,0.119,124,2915@TOP@human_GAPDH_TAA_len41_fa10_ta10_fm10_tm10,a
2915@TOP@human_GAPDH_TAA_len41_fa10_ta10_fm10_tm10*125*a,1531,0,131,0,1662,0.079,125,2915@TOP@human_GAPDH_TAA_len41_fa10_ta10_fm10_tm10,a
2915@TOP@human_GAPDH_TAA_len41_fa10_ta10_fm10_tm10*126*g,0,0,1670,0,1670,1.0,126,2915@TOP@human_GAPDH_TAA_len41_fa10_ta10_fm10_tm10,g
2915@TOP@human_GAPDH_TAA_len41_fa10_ta10_fm10_tm10*127*a,1672,0,2,0,1674,0.001,127,2915@TOP@human_GAPDH_TAA_len41_fa10_ta10_fm10_tm10,a
2915@TOP@human_GAPDH_TAA_len41_fa10_ta10_fm10_tm10*128*c,0,1686,0,0,1686,0.0,128,2915@TOP@human_GAPDH_TAA_len41_fa10_ta10_fm10_tm10,c
2915@TOP@human_GAPDH_TAA_len41_fa10_ta10_fm10_tm10*129*c,1,1676,0,0,1677,0.0,129,2915@TOP@human_GAPDH_TAA_len41_fa10_ta10_fm10_tm10,c
2915@TOP@human_GAPDH_TAA_len41_fa10_ta10_fm10_tm10*130*c,1,1682,0,0,1683,0.0,130,2915@TOP@human_GAPDH_TAA_len41_fa10_ta10_fm10_tm10,c
2915@TOP@human_GAPDH_TAA_len41_fa10_ta10_fm10_tm10*131*c,0,1690,0,0,1690,0.0,131,2915@TOP@human_GAPDH_TAA_len41_fa10_ta10_fm10_tm10,c
2915@TOP@human_GAPDH_TAA_len41_fa10_ta10_fm10_tm10*132*t,0,0,0,1655,1655,0.0,132,2915@TOP@human_GAPDH_TAA_len41_fa10_ta10_fm10_tm10,t
2915@TOP@human_GAPDH_TAA_len41_fa10_ta10_fm10_tm10*133*g,0,0,1648,0,1648,1.0,133,2915@TOP@human_GAPDH_TAA_len41_fa10_ta10_fm10_tm10,g
2915@TOP@human_GAPDH_TAA_len41_fa10_ta10_fm10_tm10*134*g,2,1,1666,0,1669,0.998,134,2915@TOP@human_GAPDH_TAA_len41_fa10_ta10_fm10_tm10,g
2916@TOP@human_GAPDH_TAA_len41_fa10_ta10_fm10_tm10*114*t,1,5,0,14182,14188,0.0,114,2916@TOP@human_GAPDH_TAA_len41_fa10_ta10_fm10_tm10,t
2916@TOP@human_GAPDH_TAA_len41_fa10_ta10_fm10_tm10*115*c,0,14268,0,0,14268,0.0,115,2916@TOP@human_GAPDH_TAA_len41_fa10_ta10_fm10_tm10,c
2916@TOP@human_GAPDH_TAA_len41_fa10_ta10_fm10_tm10*116*c,0,14222,0,0,14222,0.0,116,2916@TOP@human_GAPDH_TAA_len41_fa10_ta10_fm10_tm10,c
2916@TOP@human_GAPDH_TAA_len41_fa10_ta10_fm10_tm10*117*a,13898,0,304,1,14203,0.021,117,2916@TOP@human_GAPDH_TAA_len41_fa10_ta10_fm10_tm10,a
2916@TOP@human_GAPDH_TAA_len41_fa10_ta10_fm10_tm10*118*a,13058,0,1047,0,14105,0.074,118,2916@TOP@human_GAPDH_TAA_len41_fa10_ta10_fm10_tm10,a
2916@TOP@human_GAPDH_TAA_len41_fa10_ta10_fm10_tm10*119*g,0,0,14103,1,14104,1.0,119,2916@TOP@human_GAPDH_TAA_len41_fa10_ta10_fm10_tm10,g
2916@TOP@human_GAPDH_TAA_len41_fa10_ta10_fm10_tm10*120*g,2,1,14034,0,14037,1.0,120,2916@TOP@human_GAPDH_TAA_len41_fa10_ta10_fm10_tm10,g
2916@TOP@human_GAPDH_TAA_len41_fa10_ta10_fm10_tm10*121*a,14158,0,9,0,14167,0.001,121,2916@TOP@human_GAPDH_TAA_len41_fa10_ta10_fm10_tm10,a
2916@TOP@human_GAPDH_TAA_len41_fa10_ta10_fm10_tm10*122*g,0,0,14225,3,14228,1.0,122,2916@TOP@human_GAPDH_TAA_len41_fa10_ta10_fm10_tm10,g
2916@TOP@human_GAPDH_TAA_len41_fa10_ta10_fm10_tm10*123*t,1,2,1,14005,14009,0.0,123,2916@TOP@human_GAPDH_TAA_len41_fa10_ta10_fm10_tm10,t
2916@TOP@human_GAPDH_TAA_len41_fa10_ta10_fm10_tm10*124*a,12677,0,1289,1,13967,0.092,124,2916@TOP@human_GAPDH_TAA_len41_fa10_ta10_fm10_tm10,a
2916@TOP@human_GAPDH_TAA_len41_fa10_ta10_fm10_tm10*125*a,13384,2,552,0,13938,0.04,125,2916@TOP@human_GAPDH_TAA_len41_fa10_ta10_fm10_tm10,a
2916@TOP@human_GAPDH_TAA_len41_fa10_ta10_fm10_tm10*126*g,0,0,14024,3,14027,1.0,126,2916@TOP@human_GAPDH_TAA_len41_fa10_ta10_fm10_tm10,g
2916@TOP@human_GAPDH_TAA_len41_fa10_ta10_fm10_tm10*127*a,14158,0,10,0,14168,0.001,127,2916@TOP@human_GAPDH_TAA_len41_fa10_ta10_fm10_tm10,a
2916@TOP@human_GAPDH_TAA_len41_fa10_ta10_fm10_tm10*128*c,5,14235,2,0,14242,0.0,128,2916@TOP@human_GAPDH_TAA_len41_fa10_ta10_fm10_tm10,c
2916@TOP@human_GAPDH_TAA_len41_fa10_ta10_fm10_tm10*129*c,0,14137,0,3,14140,0.0,129,2916@TOP@human_GAPDH_TAA_len41_fa10_ta10_fm10_tm10,c
2916@TOP@human_GAPDH_TAA_len41_fa10_ta10_fm10_tm10*130*c,0,14226,0,0,14226,0.0,130,2916@TOP@human_GAPDH_TAA_len41_fa10_ta10_fm10_tm10,c
2916@TOP@human_GAPDH_TAA_len41_fa10_ta10_fm10_tm10*131*c,3,14242,0,1,14246,0.0,131,2916@TOP@human_GAPDH_TAA_len41_fa10_ta10_fm10_tm10,c
2916@TOP@human_GAPDH_TAA_len41_fa10_ta10_fm10_tm10*132*t,2,4,1,14045,14052,0.0,132,2916@TOP@human_GAPDH_TAA_len41_fa10_ta10_fm10_tm10,t
2916@TOP@human_GAPDH_TAA_len41_fa10_ta10_fm10_tm10*133*g,1,0,14032,1,14034,1.0,133,2916@TOP@human_GAPDH_TAA_len41_fa10_ta10_fm10_tm10,g
2916@TOP@human_GAPDH_TAA_len41_fa10_ta10_fm10_tm10*134*g,1,0,14104,0,14105,1.0,134,2916@TOP@human_GAPDH_TAA_len41_fa10_ta10_fm10_tm10,g
2917@TOP@human_GAPDH_TAA_len41_fa10_ta10_fm10_tm10*114*t,0,0,0,881,881,0.0,114,2917@TOP@human_GAPDH_TAA_len41_fa10_ta10_fm10_tm10,t
2917@TOP@human_GAPDH_TAA_len41_fa10_ta10_fm10_tm10*115*c,0,883,0,0,883,0.0,115,2917@TOP@human_GAPDH_TAA_len41_fa10_ta10_fm10_tm10,c
2917@TOP@human_GAPDH_TAA_len41_fa10_ta10_fm10_tm10*116*c,0,881,0,0,881,0.0,116,2917@TOP@human_GAPDH_TAA_len41_fa10_ta10_fm10_tm10,c
2917@TOP@human_GAPDH_TAA_len41_fa10_ta10_fm10_tm10*117*a,868,0,12,1,881,0.014,117,2917@TOP@human_GAPDH_TAA_len41_fa10_ta10_fm10_tm10,a
2917@TOP@human_GAPDH_TAA_len41_fa10_ta10_fm10_tm10*118*a,565,0,306,0,871,0.351,118,2917@TOP@human_GAPDH_TAA_len41_fa10_ta10_fm10_tm10,a
2917@TOP@human_GAPDH_TAA_len41_fa10_ta10_fm10_tm10*119*g,0,0,868,0,868,1.0,119,2917@TOP@human_GAPDH_TAA_len41_fa10_ta10_fm10_tm10,g
2917@TOP@human_GAPDH_TAA_len41_fa10_ta10_fm10_tm10*120*g,0,0,878,0,878,1.0,120,2917@TOP@human_GAPDH_TAA_len41_fa10_ta10_fm10_tm10,g
2917@TOP@human_GAPDH_TAA_len41_fa10_ta10_fm10_tm10*121*a,873,0,0,0,873,0.0,121,2917@TOP@human_GAPDH_TAA_len41_fa10_ta10_fm10_tm10,a
2917@TOP@human_GAPDH_TAA_len41_fa10_ta10_fm10_tm10*122*g,0,0,876,0,876,1.0,122,2917@TOP@human_GAPDH_TAA_len41_fa10_ta10_fm10_tm10,g
2917@TOP@human_GAPDH_TAA_len41_fa10_ta10_fm10_tm10*123*t,0,1,0,865,866,0.0,123,2917@TOP@human_GAPDH_TAA_len41_fa10_ta10_fm10_tm10,t
2917@TOP@human_GAPDH_TAA_len41_fa10_ta10_fm10_tm10*124*a,620,0,244,0,864,0.282,124,2917@TOP@human_GAPDH_TAA_len41_fa10_ta10_fm10_tm10,a
2917@TOP@human_GAPDH_TAA_len41_fa10_ta10_fm10_tm10*125*a,677,0,186,2,865,0.215,125,2917@TOP@human_GAPDH_TAA_len41_fa10_ta10_fm10_tm10,a
2917@TOP@human_GAPDH_TAA_len41_fa10_ta10_fm10_tm10*126*g,0,0,871,0,871,1.0,126,2917@TOP@human_GAPDH_TAA_len41_fa10_ta10_fm10_tm10,g
2917@TOP@human_GAPDH_TAA_len41_fa10_ta10_fm10_tm10*127*a,870,0,6,0,876,0.007,127,2917@TOP@human_GAPDH_TAA_len41_fa10_ta10_fm10_tm10,a
2917@TOP@human_GAPDH_TAA_len41_fa10_ta10_fm10_tm10*128*c,0,883,0,0,883,0.0,128,2917@TOP@human_GAPDH_TAA_len41_fa10_ta10_fm10_tm10,c
2917@TOP@human_GAPDH_TAA_len41_fa10_ta10_fm10_tm10*129*c,0,876,0,0,876,0.0,129,2917@TOP@human_GAPDH_TAA_len41_fa10_ta10_fm10_tm10,c
2917@TOP@human_GAPDH_TAA_len41_fa10_ta10_fm10_tm10*130*c,0,881,0,0,881,0.0,130,2917@TOP@human_GAPDH_TAA_len41_fa10_ta10_fm10_tm10,c
2917@TOP@human_GAPDH_TAA_len41_fa10_ta10_fm10_tm10*131*c,0,879,0,2,881,0.0,131,2917@TOP@human_GAPDH_TAA_len41_fa10_ta10_fm10_tm10,c
2917@TOP@human_GAPDH_TAA_len41_fa10_ta10_fm10_tm10*132*t,0,0,0,875,875,0.0,132,2917@TOP@human_GAPDH_TAA_len41_fa10_ta10_fm10_tm10,t
2917@TOP@human_GAPDH_TAA_len41_fa10_ta10_fm10_tm10*133*g,0,0,869,0,869,1.0,133,2917@TOP@human_GAPDH_TAA_len41_fa10_ta10_fm10_tm10,g
2917@TOP@human_GAPDH_TAA_len41_fa10_ta10_fm10_tm10*134*g,0,0,872,0,872,1.0,134,2917@TOP@human_GAPDH_TAA_len41_fa10_ta10_fm10_tm10,g
2918@TOP@human_GAPDH_TAA_len41_fa10_ta10_fm10_tm10*114*t,1,2,0,9677,9680,0.0,114,2918@TOP@human_GAPDH_TAA_len41_fa10_ta10_fm10_tm10,t
2918@TOP@human_GAPDH_TAA_len41_fa10_ta10_fm10_tm10*115*c,1,9726,0,0,9727,0.0,115,2918@TOP@human_GAPDH_TAA_len41_fa10_ta10_fm10_tm10,c
2918@TOP@human_GAPDH_TAA_len41_fa10_ta10_fm10_tm10*116*c,0,9699,0,2,9701,0.0,116,2918@TOP@human_GAPDH_TAA_len41_fa10_ta10_fm10_tm10,c
2918@TOP@human_GAPDH_TAA_len41_fa10_ta10_fm10_tm10*117*a,9542,0,133,1,9676,0.014,117,2918@TOP@human_GAPDH_TAA_len41_fa10_ta10_fm10_tm10,a
2918@TOP@human_GAPDH_TAA_len41_fa10_ta10_fm10_tm10*118*a,8097,0,1541,0,9638,0.16,118,2918@TOP@human_GAPDH_TAA_len41_fa10_ta10_fm10_tm10,a
2918@TOP@human_GAPDH_TAA_len41_fa10_ta10_fm10_tm10*119*g,0,0,9612,0,9612,1.0,119,2918@TOP@human_GAPDH_TAA_len41_fa10_ta10_fm10_tm10,g
2918@TOP@human_GAPDH_TAA_len41_fa10_ta10_fm10_tm10*120*g,0,0,9603,0,9603,1.0,120,2918@TOP@human_GAPDH_TAA_len41_fa10_ta10_fm10_tm10,g
2918@TOP@human_GAPDH_TAA_len41_fa10_ta10_fm10_tm10*121*a,9661,0,5,1,9667,0.001,121,2918@TOP@human_GAPDH_TAA_len41_fa10_ta10_fm10_tm10,a
2918@TOP@human_GAPDH_TAA_len41_fa10_ta10_fm10_tm10*122*g,3,0,9702,0,9705,1.0,122,2918@TOP@human_GAPDH_TAA_len41_fa10_ta10_fm10_tm10,g
2918@TOP@human_GAPDH_TAA_len41_fa10_ta10_fm10_tm10*123*t,1,0,0,9587,9588,0.0,123,2918@TOP@human_GAPDH_TAA_len41_fa10_ta10_fm10_tm10,t
2918@TOP@human_GAPDH_TAA_len41_fa10_ta10_fm10_tm10*124*a,8675,0,864,0,9539,0.091,124,2918@TOP@human_GAPDH_TAA_len41_fa10_ta10_fm10_tm10,a
2918@TOP@human_GAPDH_TAA_len41_fa10_ta10_fm10_tm10*125*a,9021,2,504,0,9527,0.053,125,2918@TOP@human_GAPDH_TAA_len41_fa10_ta10_fm10_tm10,a
2918@TOP@human_GAPDH_TAA_len41_fa10_ta10_fm10_tm10*126*g,0,0,9568,1,9569,1.0,126,2918@TOP@human_GAPDH_TAA_len41_fa10_ta10_fm10_tm10,g
2918@TOP@human_GAPDH_TAA_len41_fa10_ta10_fm10_tm10*127*a,9638,0,7,0,9645,0.001,127,2918@TOP@human_GAPDH_TAA_len41_fa10_ta10_fm10_tm10,a
2918@TOP@human_GAPDH_TAA_len41_fa10_ta10_fm10_tm10*128*c,0,9713,0,0,9713,0.0,128,2918@TOP@human_GAPDH_TAA_len41_fa10_ta10_fm10_tm10,c
2918@TOP@human_GAPDH_TAA_len41_fa10_ta10_fm10_tm10*129*c,0,9639,0,0,9639,0.0,129,2918@TOP@human_GAPDH_TAA_len41_fa10_ta10_fm10_tm10,c
2918@TOP@human_GAPDH_TAA_len41_fa10_ta10_fm10_tm10*130*c,0,9692,0,3,9695,0.0,130,2918@TOP@human_GAPDH_TAA_len41_fa10_ta10_fm10_tm10,c
2918@TOP@human_GAPDH_TAA_len41_fa10_ta10_fm10_tm10*131*c,1,9719,0,0,9720,0.0,131,2918@TOP@human_GAPDH_TAA_len41_fa10_ta10_fm10_tm10,c
2918@TOP@human_GAPDH_TAA_len41_fa10_ta10_fm10_tm10*132*t,0,1,4,9569,9574,0.0,132,2918@TOP@human_GAPDH_TAA_len41_fa10_ta10_fm10_tm10,t
2918@TOP@human_GAPDH_TAA_len41_fa10_ta10_fm10_tm10*133*g,1,2,9554,0,9557,1.0,133,2918@TOP@human_GAPDH_TAA_len41_fa10_ta10_fm10_tm10,g
2918@TOP@human_GAPDH_TAA_len41_fa10_ta10_fm10_tm10*134*g,4,4,9608,0,9616,0.999,134,2918@TOP@human_GAPDH_TAA_len41_fa10_ta10_fm10_tm10,g
2919@TOP@human_GAPDH_TAA_len41_fa10_ta10_fm10_tm10*114*t,6,14,1,53224,53245,0.0,114,2919@TOP@human_GAPDH_TAA_len41_fa10_ta10_fm10_tm10,t
2919@TOP@human_GAPDH_TAA_len41_fa10_ta10_fm10_tm10*115*c,2,53542,1,2,53547,0.0,115,2919@TOP@human_GAPDH_TAA_len41_fa10_ta10_fm10_tm10,c
2919@TOP@human_GAPDH_TAA_len41_fa10_ta10_fm10_tm10*116*c,2,53344,0,4,53350,0.0,116,2919@TOP@human_GAPDH_TAA_len41_fa10_ta10_fm10_tm10,c
2919@TOP@human_GAPDH_TAA_len41_fa10_ta10_fm10_tm10*117*a,53158,0,124,0,53282,0.002,117,2919@TOP@human_GAPDH_TAA_len41_fa10_ta10_fm10_tm10,a
2919@TOP@human_GAPDH_TAA_len41_fa10_ta10_fm10_tm10*118*a,48333,1,4654,3,52991,0.088,118,2919@TOP@human_GAPDH_TAA_len41_fa10_ta10_fm10_tm10,a
2919@TOP@human_GAPDH_TAA_len41_fa10_ta10_fm10_tm10*119*g,8,1,52885,4,52898,1.0,119,2919@TOP@human_GAPDH_TAA_len41_fa10_ta10_fm10_tm10,g
2919@TOP@human_GAPDH_TAA_len41_fa10_ta10_fm10_tm10*120*g,1,2,52721,0,52724,1.0,120,2919@TOP@human_GAPDH_TAA_len41_fa10_ta10_fm10_tm10,g
2919@TOP@human_GAPDH_TAA_len41_fa10_ta10_fm10_tm10*121*a,53198,0,18,0,53216,0.0,121,2919@TOP@human_GAPDH_TAA_len41_fa10_ta10_fm10_tm10,a
2919@TOP@human_GAPDH_TAA_len41_fa10_ta10_fm10_tm10*122*g,7,1,53350,0,53358,1.0,122,2919@TOP@human_GAPDH_TAA_len41_fa10_ta10_fm10_tm10,g
2919@TOP@human_GAPDH_TAA_len41_fa10_ta10_fm10_tm10*123*t,5,14,5,52600,52624,0.0,123,2919@TOP@human_GAPDH_TAA_len41_fa10_ta10_fm10_tm10,t
2919@TOP@human_GAPDH_TAA_len41_fa10_ta10_fm10_tm10*124*a,50917,1,1406,0,52324,0.027,124,2919@TOP@human_GAPDH_TAA_len41_fa10_ta10_fm10_tm10,a
2919@TOP@human_GAPDH_TAA_len41_fa10_ta10_fm10_tm10*125*a,51381,3,772,3,52159,0.015,125,2919@TOP@human_GAPDH_TAA_len41_fa10_ta10_fm10_tm10,a
2919@TOP@human_GAPDH_TAA_len41_fa10_ta10_fm10_tm10*126*g,0,2,52644,4,52650,1.0,126,2919@TOP@human_GAPDH_TAA_len41_fa10_ta10_fm10_tm10,g
2919@TOP@human_GAPDH_TAA_len41_fa10_ta10_fm10_tm10*127*a,53061,0,50,0,53111,0.001,127,2919@TOP@human_GAPDH_TAA_len41_fa10_ta10_fm10_tm10,a
2919@TOP@human_GAPDH_TAA_len41_fa10_ta10_fm10_tm10*128*c,0,53427,6,3,53436,0.0,128,2919@TOP@human_GAPDH_TAA_len41_fa10_ta10_fm10_tm10,c
2919@TOP@human_GAPDH_TAA_len41_fa10_ta10_fm10_tm10*129*c,2,53017,0,2,53021,0.0,129,2919@TOP@human_GAPDH_TAA_len41_fa10_ta10_fm10_tm10,c
2919@TOP@human_GAPDH_TAA_len41_fa10_ta10_fm10_tm10*130*c,3,53308,0,4,53315,0.0,130,2919@TOP@human_GAPDH_TAA_len41_fa10_ta10_fm10_tm10,c
2919@TOP@human_GAPDH_TAA_len41_fa10_ta10_fm10_tm10*131*c,3,53465,0,8,53476,0.0,131,2919@TOP@human_GAPDH_TAA_len41_fa10_ta10_fm10_tm10,c
2919@TOP@human_GAPDH_TAA_len41_fa10_ta10_fm10_tm10*132*t,6,18,0,52683,52707,0.0,132,2919@TOP@human_GAPDH_TAA_len41_fa10_ta10_fm10_tm10,t
2919@TOP@human_GAPDH_TAA_len41_fa10_ta10_fm10_tm10*133*g,1,0,52602,5,52608,1.0,133,2919@TOP@human_GAPDH_TAA_len41_fa10_ta10_fm10_tm10,g
2919@TOP@human_GAPDH_TAA_len41_fa10_ta10_fm10_tm10*134*g,0,11,52860,2,52873,1.0,134,2919@TOP@human_GAPDH_TAA_len41_fa10_ta10_fm10_tm10,g
2920@TOP@human_GAPDH_TAA_len41_fa10_ta10_fm10_tm10*114*t,4,11,0,55100,55115,0.0,114,2920@TOP@human_GAPDH_TAA_len41_fa10_ta10_fm10_tm10,t
2920@TOP@human_GAPDH_TAA_len41_fa10_ta10_fm10_tm10*115*c,1,55392,0,3,55396,0.0,115,2920@TOP@human_GAPDH_TAA_len41_fa10_ta10_fm10_tm10,c
2920@TOP@human_GAPDH_TAA_len41_fa10_ta10_fm10_tm10*116*c,1,55206,0,4,55211,0.0,116,2920@TOP@human_GAPDH_TAA_len41_fa10_ta10_fm10_tm10,c
2920@TOP@human_GAPDH_TAA_len41_fa10_ta10_fm10_tm10*117*a,55098,0,80,0,55178,0.001,117,2920@TOP@human_GAPDH_TAA_len41_fa10_ta10_fm10_tm10,a
2920@TOP@human_GAPDH_TAA_len41_fa10_ta10_fm10_tm10*118*a,52533,1,2334,3,54871,0.043,118,2920@TOP@human_GAPDH_TAA_len41_fa10_ta10_fm10_tm10,a
2920@TOP@human_GAPDH_TAA_len41_fa10_ta10_fm10_tm10*119*g,3,1,54723,3,54730,1.0,119,2920@TOP@human_GAPDH_TAA_len41_fa10_ta10_fm10_tm10,g
2920@TOP@human_GAPDH_TAA_len41_fa10_ta10_fm10_tm10*120*g,2,0,54580,3,54585,1.0,120,2920@TOP@human_GAPDH_TAA_len41_fa10_ta10_fm10_tm10,g
2920@TOP@human_GAPDH_TAA_len41_fa10_ta10_fm10_tm10*121*a,55075,1,14,0,55090,0.0,121,2920@TOP@human_GAPDH_TAA_len41_fa10_ta10_fm10_tm10,a
2920@TOP@human_GAPDH_TAA_len41_fa10_ta10_fm10_tm10*122*g,3,0,55199,1,55203,1.0,122,2920@TOP@human_GAPDH_TAA_len41_fa10_ta10_fm10_tm10,g
2920@TOP@human_GAPDH_TAA_len41_fa10_ta10_fm10_tm10*123*t,5,2,6,54489,54502,0.0,123,2920@TOP@human_GAPDH_TAA_len41_fa10_ta10_fm10_tm10,t
2920@TOP@human_GAPDH_TAA_len41_fa10_ta10_fm10_tm10*124*a,52829,2,1519,0,54350,0.028,124,2920@TOP@human_GAPDH_TAA_len41_fa10_ta10_fm10_tm10,a
2920@TOP@human_GAPDH_TAA_len41_fa10_ta10_fm10_tm10*125*a,53355,4,804,1,54164,0.015,125,2920@TOP@human_GAPDH_TAA_len41_fa10_ta10_fm10_tm10,a
2920@TOP@human_GAPDH_TAA_len41_fa10_ta10_fm10_tm10*126*g,2,0,54440,5,54447,1.0,126,2920@TOP@human_GAPDH_TAA_len41_fa10_ta10_fm10_tm10,g
2920@TOP@human_GAPDH_TAA_len41_fa10_ta10_fm10_tm10*127*a,54935,0,29,2,54966,0.001,127,2920@TOP@human_GAPDH_TAA_len41_fa10_ta10_fm10_tm10,a
2920@TOP@human_GAPDH_TAA_len41_fa10_ta10_fm10_tm10*128*c,1,55242,10,1,55254,0.0,128,2920@TOP@human_GAPDH_TAA_len41_fa10_ta10_fm10_tm10,c
2920@TOP@human_GAPDH_TAA_len41_fa10_ta10_fm10_tm10*129*c,3,54874,0,2,54879,0.0,129,2920@TOP@human_GAPDH_TAA_len41_fa10_ta10_fm10_tm10,c
2920@TOP@human_GAPDH_TAA_len41_fa10_ta10_fm10_tm10*130*c,5,55191,0,2,55198,0.0,130,2920@TOP@human_GAPDH_TAA_len41_fa10_ta10_fm10_tm10,c
2920@TOP@human_GAPDH_TAA_len41_fa10_ta10_fm10_tm10*131*c,14,55292,0,3,55309,0.0,131,2920@TOP@human_GAPDH_TAA_len41_fa10_ta10_fm10_tm10,c
2920@TOP@human_GAPDH_TAA_len41_fa10_ta10_fm10_tm10*132*t,6,12,3,54563,54584,0.0,132,2920@TOP@human_GAPDH_TAA_len41_fa10_ta10_fm10_tm10,t
2920@TOP@human_GAPDH_TAA_len41_fa10_ta10_fm10_tm10*133*g,3,1,54364,2,54370,1.0,133,2920@TOP@human_GAPDH_TAA_len41_fa10_ta10_fm10_tm10,g
2920@TOP@human_GAPDH_TAA_len41_fa10_ta10_fm10_tm10*134*g,0,16,54703,0,54719,1.0,134,2920@TOP@human_GAPDH_TAA_len41_fa10_ta10_fm10_tm10,g
2921@TOP@human_GAPDH_TAA_len41_fa10_ta10_fm10_tm10*114*t,0,0,0,16079,16079,0.0,114,2921@TOP@human_GAPDH_TAA_len41_fa10_ta10_fm10_tm10,t
2921@TOP@human_GAPDH_TAA_len41_fa10_ta10_fm10_tm10*115*c,0,16153,2,2,16157,0.0,115,2921@TOP@human_GAPDH_TAA_len41_fa10_ta10_fm10_tm10,c
2921@TOP@human_GAPDH_TAA_len41_fa10_ta10_fm10_tm10*116*c,0,16085,0,1,16086,0.0,116,2921@TOP@human_GAPDH_TAA_len41_fa10_ta10_fm10_tm10,c
2921@TOP@human_GAPDH_TAA_len41_fa10_ta10_fm10_tm10*117*a,15896,0,173,1,16070,0.011,117,2921@TOP@human_GAPDH_TAA_len41_fa10_ta10_fm10_tm10,a
2921@TOP@human_GAPDH_TAA_len41_fa10_ta10_fm10_tm10*118*a,12356,1,3636,1,15994,0.227,118,2921@TOP@human_GAPDH_TAA_len41_fa10_ta10_fm10_tm10,a
2921@TOP@human_GAPDH_TAA_len41_fa10_ta10_fm10_tm10*119*g,1,0,15948,0,15949,1.0,119,2921@TOP@human_GAPDH_TAA_len41_fa10_ta10_fm10_tm10,g
2921@TOP@human_GAPDH_TAA_len41_fa10_ta10_fm10_tm10*120*g,0,2,15965,2,15969,1.0,120,2921@TOP@human_GAPDH_TAA_len41_fa10_ta10_fm10_tm10,g
2921@TOP@human_GAPDH_TAA_len41_fa10_ta10_fm10_tm10*121*a,16017,0,5,1,16023,0.0,121,2921@TOP@human_GAPDH_TAA_len41_fa10_ta10_fm10_tm10,a
2921@TOP@human_GAPDH_TAA_len41_fa10_ta10_fm10_tm10*122*g,0,0,16109,0,16109,1.0,122,2921@TOP@human_GAPDH_TAA_len41_fa10_ta10_fm10_tm10,g
2921@TOP@human_GAPDH_TAA_len41_fa10_ta10_fm10_tm10*123*t,3,8,2,15868,15881,0.0,123,2921@TOP@human_GAPDH_TAA_len41_fa10_ta10_fm10_tm10,t
2921@TOP@human_GAPDH_TAA_len41_fa10_ta10_fm10_tm10*124*a,13556,1,2264,1,15822,0.143,124,2921@TOP@human_GAPDH_TAA_len41_fa10_ta10_fm10_tm10,a
2921@TOP@human_GAPDH_TAA_len41_fa10_ta10_fm10_tm10*125*a,14109,1,1690,4,15804,0.107,125,2921@TOP@human_GAPDH_TAA_len41_fa10_ta10_fm10_tm10,a
2921@TOP@human_GAPDH_TAA_len41_fa10_ta10_fm10_tm10*126*g,0,0,15901,0,15901,1.0,126,2921@TOP@human_GAPDH_TAA_len41_fa10_ta10_fm10_tm10,g
2921@TOP@human_GAPDH_TAA_len41_fa10_ta10_fm10_tm10*127*a,16020,0,20,0,16040,0.001,127,2921@TOP@human_GAPDH_TAA_len41_fa10_ta10_fm10_tm10,a
2921@TOP@human_GAPDH_TAA_len41_fa10_ta10_fm10_tm10*128*c,1,16127,3,0,16131,0.0,128,2921@TOP@human_GAPDH_TAA_len41_fa10_ta10_fm10_tm10,c
2921@TOP@human_GAPDH_TAA_len41_fa10_ta10_fm10_tm10*129*c,0,16025,0,0,16025,0.0,129,2921@TOP@human_GAPDH_TAA_len41_fa10_ta10_fm10_tm10,c
2921@TOP@human_GAPDH_TAA_len41_fa10_ta10_fm10_tm10*130*c,4,16091,0,0,16095,0.0,130,2921@TOP@human_GAPDH_TAA_len41_fa10_ta10_fm10_tm10,c
2921@TOP@human_GAPDH_TAA_len41_fa10_ta10_fm10_tm10*131*c,1,16142,0,0,16143,0.0,131,2921@TOP@human_GAPDH_TAA_len41_fa10_ta10_fm10_tm10,c
2921@TOP@human_GAPDH_TAA_len41_fa10_ta10_fm10_tm10*132*t,1,2,2,15890,15895,0.0,132,2921@TOP@human_GAPDH_TAA_len41_fa10_ta10_fm10_tm10,t
2921@TOP@human_GAPDH_TAA_len41_fa10_ta10_fm10_tm10*133*g,1,0,15891,1,15893,1.0,133,2921@TOP@human_GAPDH_TAA_len41_fa10_ta10_fm10_tm10,g
2921@TOP@human_GAPDH_TAA_len41_fa10_ta10_fm10_tm10*134*g,0,5,15970,0,15975,1.0,134,2921@TOP@human_GAPDH_TAA_len41_fa10_ta10_fm10_tm10,g
2922@TOP@human_GAPDH_TAA_len41_fa10_ta10_fm10_tm10*114*t,3,10,0,33429,33442,0.0,114,2922@TOP@human_GAPDH_TAA_len41_fa10_ta10_fm10_tm10,t
2922@TOP@human_GAPDH_TAA_len41_fa10_ta10_fm10_tm10*115*c,0,33634,0,0,33634,0.0,115,2922@TOP@human_GAPDH_TAA_len41_fa10_ta10_fm10_tm10,c
2922@TOP@human_GAPDH_TAA_len41_fa10_ta10_fm10_tm10*116*c,3,33506,0,5,33514,0.0,116,2922@TOP@human_GAPDH_TAA_len41_fa10_ta10_fm10_tm10,c
2922@TOP@human_GAPDH_TAA_len41_fa10_ta10_fm10_tm10*117*a,33034,1,445,1,33481,0.013,117,2922@TOP@human_GAPDH_TAA_len41_fa10_ta10_fm10_tm10,a
2922@TOP@human_GAPDH_TAA_len41_fa10_ta10_fm10_tm10*118*a,27254,0,5995,2,33251,0.18,118,2922@TOP@human_GAPDH_TAA_len41_fa10_ta10_fm10_tm10,a
2922@TOP@human_GAPDH_TAA_len41_fa10_ta10_fm10_tm10*119*g,1,0,33226,4,33231,1.0,119,2922@TOP@human_GAPDH_TAA_len41_fa10_ta10_fm10_tm10,g
2922@TOP@human_GAPDH_TAA_len41_fa10_ta10_fm10_tm10*120*g,0,0,33139,2,33141,1.0,120,2922@TOP@human_GAPDH_TAA_len41_fa10_ta10_fm10_tm10,g
2922@TOP@human_GAPDH_TAA_len41_fa10_ta10_fm10_tm10*121*a,33396,0,3,2,33401,0.0,121,2922@TOP@human_GAPDH_TAA_len41_fa10_ta10_fm10_tm10,a
2922@TOP@human_GAPDH_TAA_len41_fa10_ta10_fm10_tm10*122*g,1,0,33500,1,33502,1.0,122,2922@TOP@human_GAPDH_TAA_len41_fa10_ta10_fm10_tm10,g
2922@TOP@human_GAPDH_TAA_len41_fa10_ta10_fm10_tm10*123*t,3,6,10,33081,33100,0.0,123,2922@TOP@human_GAPDH_TAA_len41_fa10_ta10_fm10_tm10,t
2922@TOP@human_GAPDH_TAA_len41_fa10_ta10_fm10_tm10*124*a,25283,0,7662,1,32946,0.233,124,2922@TOP@human_GAPDH_TAA_len41_fa10_ta10_fm10_tm10,a
2922@TOP@human_GAPDH_TAA_len41_fa10_ta10_fm10_tm10*125*a,31086,3,1901,0,32990,0.058,125,2922@TOP@human_GAPDH_TAA_len41_fa10_ta10_fm10_tm10,a
2922@TOP@human_GAPDH_TAA_len41_fa10_ta10_fm10_tm10*126*g,0,0,33146,1,33147,1.0,126,2922@TOP@human_GAPDH_TAA_len41_fa10_ta10_fm10_tm10,g
2922@TOP@human_GAPDH_TAA_len41_fa10_ta10_fm10_tm10*127*a,33357,2,10,1,33370,0.0,127,2922@TOP@human_GAPDH_TAA_len41_fa10_ta10_fm10_tm10,a
2922@TOP@human_GAPDH_TAA_len41_fa10_ta10_fm10_tm10*128*c,0,33538,3,3,33544,0.0,128,2922@TOP@human_GAPDH_TAA_len41_fa10_ta10_fm10_tm10,c
2922@TOP@human_GAPDH_TAA_len41_fa10_ta10_fm10_tm10*129*c,2,33327,0,1,33330,0.0,129,2922@TOP@human_GAPDH_TAA_len41_fa10_ta10_fm10_tm10,c
2922@TOP@human_GAPDH_TAA_len41_fa10_ta10_fm10_tm10*130*c,5,33504,0,0,33509,0.0,130,2922@TOP@human_GAPDH_TAA_len41_fa10_ta10_fm10_tm10,c
2922@TOP@human_GAPDH_TAA_len41_fa10_ta10_fm10_tm10*131*c,3,33590,0,1,33594,0.0,131,2922@TOP@human_GAPDH_TAA_len41_fa10_ta10_fm10_tm10,c
2922@TOP@human_GAPDH_TAA_len41_fa10_ta10_fm10_tm10*132*t,5,6,2,33104,33117,0.0,132,2922@TOP@human_GAPDH_TAA_len41_fa10_ta10_fm10_tm10,t
2922@TOP@human_GAPDH_TAA_len41_fa10_ta10_fm10_tm10*133*g,0,2,33061,1,33064,1.0,133,2922@TOP@human_GAPDH_TAA_len41_fa10_ta10_fm10_tm10,g
2922@TOP@human_GAPDH_TAA_len41_fa10_ta10_fm10_tm10*134*g,0,7,33219,1,33227,1.0,134,2922@TOP@human_GAPDH_TAA_len41_fa10_ta10_fm10_tm10,g
2923@TOP@human_GAPDH_TAA_len41_fa10_ta10_fm10_tm10*114*t,2,6,0,12477,12485,0.0,114,2923@TOP@human_GAPDH_TAA_len41_fa10_ta10_fm10_tm10,t
2923@TOP@human_GAPDH_TAA_len41_fa10_ta10_fm10_tm10*115*c,0,12555,0,0,12555,0.0,115,2923@TOP@human_GAPDH_TAA_len41_fa10_ta10_fm10_tm10,c
2923@TOP@human_GAPDH_TAA_len41_fa10_ta10_fm10_tm10*116*c,1,12511,0,0,12512,0.0,116,2923@TOP@human_GAPDH_TAA_len41_fa10_ta10_fm10_tm10,c
2923@TOP@human_GAPDH_TAA_len41_fa10_ta10_fm10_tm10*117*a,12395,3,88,0,12486,0.007,117,2923@TOP@human_GAPDH_TAA_len41_fa10_ta10_fm10_tm10,a
2923@TOP@human_GAPDH_TAA_len41_fa10_ta10_fm10_tm10*118*a,10193,0,2240,0,12433,0.18,118,2923@TOP@human_GAPDH_TAA_len41_fa10_ta10_fm10_tm10,a
2923@TOP@human_GAPDH_TAA_len41_fa10_ta10_fm10_tm10*119*g,0,0,12405,0,12405,1.0,119,2923@TOP@human_GAPDH_TAA_len41_fa10_ta10_fm10_tm10,g
2923@TOP@human_GAPDH_TAA_len41_fa10_ta10_fm10_tm10*120*g,1,0,12349,0,12350,1.0,120,2923@TOP@human_GAPDH_TAA_len41_fa10_ta10_fm10_tm10,g
2923@TOP@human_GAPDH_TAA_len41_fa10_ta10_fm10_tm10*121*a,12479,0,3,0,12482,0.0,121,2923@TOP@human_GAPDH_TAA_len41_fa10_ta10_fm10_tm10,a
2923@TOP@human_GAPDH_TAA_len41_fa10_ta10_fm10_tm10*122*g,0,0,12513,0,12513,1.0,122,2923@TOP@human_GAPDH_TAA_len41_fa10_ta10_fm10_tm10,g
2923@TOP@human_GAPDH_TAA_len41_fa10_ta10_fm10_tm10*123*t,1,11,2,12329,12343,0.0,123,2923@TOP@human_GAPDH_TAA_len41_fa10_ta10_fm10_tm10,t
2923@TOP@human_GAPDH_TAA_len41_fa10_ta10_fm10_tm10*124*a,10958,1,1336,0,12295,0.109,124,2923@TOP@human_GAPDH_TAA_len41_fa10_ta10_fm10_tm10,a
2923@TOP@human_GAPDH_TAA_len41_fa10_ta10_fm10_tm10*125*a,11303,1,967,0,12271,0.079,125,2923@TOP@human_GAPDH_TAA_len41_fa10_ta10_fm10_tm10,a
2923@TOP@human_GAPDH_TAA_len41_fa10_ta10_fm10_tm10*126*g,0,0,12363,0,12363,1.0,126,2923@TOP@human_GAPDH_TAA_len41_fa10_ta10_fm10_tm10,g
2923@TOP@human_GAPDH_TAA_len41_fa10_ta10_fm10_tm10*127*a,12458,0,11,0,12469,0.001,127,2923@TOP@human_GAPDH_TAA_len41_fa10_ta10_fm10_tm10,a
2923@TOP@human_GAPDH_TAA_len41_fa10_ta10_fm10_tm10*128*c,0,12518,2,3,12523,0.0,128,2923@TOP@human_GAPDH_TAA_len41_fa10_ta10_fm10_tm10,c
2923@TOP@human_GAPDH_TAA_len41_fa10_ta10_fm10_tm10*129*c,0,12430,1,0,12431,0.0,129,2923@TOP@human_GAPDH_TAA_len41_fa10_ta10_fm10_tm10,c
2923@TOP@human_GAPDH_TAA_len41_fa10_ta10_fm10_tm10*130*c,0,12515,0,1,12516,0.0,130,2923@TOP@human_GAPDH_TAA_len41_fa10_ta10_fm10_tm10,c
2923@TOP@human_GAPDH_TAA_len41_fa10_ta10_fm10_tm10*131*c,3,12528,0,1,12532,0.0,131,2923@TOP@human_GAPDH_TAA_len41_fa10_ta10_fm10_tm10,c
2923@TOP@human_GAPDH_TAA_len41_fa10_ta10_fm10_tm10*132*t,0,2,1,12347,12350,0.0,132,2923@TOP@human_GAPDH_TAA_len41_fa10_ta10_fm10_tm10,t
2923@TOP@human_GAPDH_TAA_len41_fa10_ta10_fm10_tm10*133*g,0,0,12352,0,12352,1.0,133,2923@TOP@human_GAPDH_TAA_len41_fa10_ta10_fm10_tm10,g
2923@TOP@human_GAPDH_TAA_len41_fa10_ta10_fm10_tm10*134*g,0,2,12409,1,12412,1.0,134,2923@TOP@human_GAPDH_TAA_len41_fa10_ta10_fm10_tm10,g
2924@TOP@human_GAPDH_TAA_len41_fa10_ta10_fm10_tm10*114*t,3,4,0,27154,27161,0.0,114,2924@TOP@human_GAPDH_TAA_len41_fa10_ta10_fm10_tm10,t
2924@TOP@human_GAPDH_TAA_len41_fa10_ta10_fm10_tm10*115*c,0,27329,0,4,27333,0.0,115,2924@TOP@human_GAPDH_TAA_len41_fa10_ta10_fm10_tm10,c
2924@TOP@human_GAPDH_TAA_len41_fa10_ta10_fm10_tm10*116*c,6,27219,1,1,27227,0.0,116,2924@TOP@human_GAPDH_TAA_len41_fa10_ta10_fm10_tm10,c
2924@TOP@human_GAPDH_TAA_len41_fa10_ta10_fm10_tm10*117*a,27023,0,133,3,27159,0.005,117,2924@TOP@human_GAPDH_TAA_len41_fa10_ta10_fm10_tm10,a
2924@TOP@human_GAPDH_TAA_len41_fa10_ta10_fm10_tm10*118*a,23884,0,3030,3,26917,0.113,118,2924@TOP@human_GAPDH_TAA_len41_fa10_ta10_fm10_tm10,a
2924@TOP@human_GAPDH_TAA_len41_fa10_ta10_fm10_tm10*119*g,0,1,26983,1,26985,1.0,119,2924@TOP@human_GAPDH_TAA_len41_fa10_ta10_fm10_tm10,g
2924@TOP@human_GAPDH_TAA_len41_fa10_ta10_fm10_tm10*120*g,3,0,26878,0,26881,1.0,120,2924@TOP@human_GAPDH_TAA_len41_fa10_ta10_fm10_tm10,g
2924@TOP@human_GAPDH_TAA_len41_fa10_ta10_fm10_tm10*121*a,27065,0,10,1,27076,0.0,121,2924@TOP@human_GAPDH_TAA_len41_fa10_ta10_fm10_tm10,a
2924@TOP@human_GAPDH_TAA_len41_fa10_ta10_fm10_tm10*122*g,1,0,27209,0,27210,1.0,122,2924@TOP@human_GAPDH_TAA_len41_fa10_ta10_fm10_tm10,g
2924@TOP@human_GAPDH_TAA_len41_fa10_ta10_fm10_tm10*123*t,3,4,5,26759,26771,0.0,123,2924@TOP@human_GAPDH_TAA_len41_fa10_ta10_fm10_tm10,t
2924@TOP@human_GAPDH_TAA_len41_fa10_ta10_fm10_tm10*124*a,21141,2,5457,0,26600,0.205,124,2924@TOP@human_GAPDH_TAA_len41_fa10_ta10_fm10_tm10,a
2924@TOP@human_GAPDH_TAA_len41_fa10_ta10_fm10_tm10*125*a,25386,3,1166,6,26561,0.044,125,2924@TOP@human_GAPDH_TAA_len41_fa10_ta10_fm10_tm10,a
2924@TOP@human_GAPDH_TAA_len41_fa10_ta10_fm10_tm10*126*g,0,0,26908,1,26909,1.0,126,2924@TOP@human_GAPDH_TAA_len41_fa10_ta10_fm10_tm10,g
2924@TOP@human_GAPDH_TAA_len41_fa10_ta10_fm10_tm10*127*a,27025,0,4,0,27029,0.0,127,2924@TOP@human_GAPDH_TAA_len41_fa10_ta10_fm10_tm10,a
2924@TOP@human_GAPDH_TAA_len41_fa10_ta10_fm10_tm10*128*c,1,27239,2,2,27244,0.0,128,2924@TOP@human_GAPDH_TAA_len41_fa10_ta10_fm10_tm10,c
2924@TOP@human_GAPDH_TAA_len41_fa10_ta10_fm10_tm10*129*c,1,27047,0,0,27048,0.0,129,2924@TOP@human_GAPDH_TAA_len41_fa10_ta10_fm10_tm10,c
2924@TOP@human_GAPDH_TAA_len41_fa10_ta10_fm10_tm10*130*c,7,27214,0,1,27222,0.0,130,2924@TOP@human_GAPDH_TAA_len41_fa10_ta10_fm10_tm10,c
2924@TOP@human_GAPDH_TAA_len41_fa10_ta10_fm10_tm10*131*c,1,27266,1,0,27268,0.0,131,2924@TOP@human_GAPDH_TAA_len41_fa10_ta10_fm10_tm10,c
2924@TOP@human_GAPDH_TAA_len41_fa10_ta10_fm10_tm10*132*t,1,7,1,26810,26819,0.0,132,2924@TOP@human_GAPDH_TAA_len41_fa10_ta10_fm10_tm10,t
2924@TOP@human_GAPDH_TAA_len41_fa10_ta10_fm10_tm10*133*g,4,0,26804,1,26809,1.0,133,2924@TOP@human_GAPDH_TAA_len41_fa10_ta10_fm10_tm10,g
2924@TOP@human_GAPDH_TAA_len41_fa10_ta10_fm10_tm10*134*g,4,0,26964,0,26968,1.0,134,2924@TOP@human_GAPDH_TAA_len41_fa10_ta10_fm10_tm10,g
2925@TOP@human_GAPDH_TAA_len41_fa10_ta10_fm10_tm10*114*t,2,4,1,27733,27740,0.0,114,2925@TOP@human_GAPDH_TAA_len41_fa10_ta10_fm10_tm10,t
2925@TOP@human_GAPDH_TAA_len41_fa10_ta10_fm10_tm10*115*c,1,27901,0,0,27902,0.0,115,2925@TOP@human_GAPDH_TAA_len41_fa10_ta10_fm10_tm10,c
2925@TOP@human_GAPDH_TAA_len41_fa10_ta10_fm10_tm10*116*c,0,27794,0,0,27794,0.0,116,2925@TOP@human_GAPDH_TAA_len41_fa10_ta10_fm10_tm10,c
2925@TOP@human_GAPDH_TAA_len41_fa10_ta10_fm10_tm10*117*a,27743,0,24,0,27767,0.001,117,2925@TOP@human_GAPDH_TAA_len41_fa10_ta10_fm10_tm10,a
2925@TOP@human_GAPDH_TAA_len41_fa10_ta10_fm10_tm10*118*a,27320,2,312,0,27634,0.011,118,2925@TOP@human_GAPDH_TAA_len41_fa10_ta10_fm10_tm10,a
2925@TOP@human_GAPDH_TAA_len41_fa10_ta10_fm10_tm10*119*g,1,1,27587,7,27596,1.0,119,2925@TOP@human_GAPDH_TAA_len41_fa10_ta10_fm10_tm10,g
2925@TOP@human_GAPDH_TAA_len41_fa10_ta10_fm10_tm10*120*g,6,0,27479,0,27485,1.0,120,2925@TOP@human_GAPDH_TAA_len41_fa10_ta10_fm10_tm10,g
2925@TOP@human_GAPDH_TAA_len41_fa10_ta10_fm10_tm10*121*a,27730,0,19,0,27749,0.001,121,2925@TOP@human_GAPDH_TAA_len41_fa10_ta10_fm10_tm10,a
2925@TOP@human_GAPDH_TAA_len41_fa10_ta10_fm10_tm10*122*g,3,1,27807,0,27811,1.0,122,2925@TOP@human_GAPDH_TAA_len41_fa10_ta10_fm10_tm10,g
2925@TOP@human_GAPDH_TAA_len41_fa10_ta10_fm10_tm10*123*t,2,2,3,27404,27411,0.0,123,2925@TOP@human_GAPDH_TAA_len41_fa10_ta10_fm10_tm10,t
2925@TOP@human_GAPDH_TAA_len41_fa10_ta10_fm10_tm10*124*a,21455,1,5907,2,27365,0.216,124,2925@TOP@human_GAPDH_TAA_len41_fa10_ta10_fm10_tm10,a
2925@TOP@human_GAPDH_TAA_len41_fa10_ta10_fm10_tm10*125*a,25626,4,1679,2,27311,0.061,125,2925@TOP@human_GAPDH_TAA_len41_fa10_ta10_fm10_tm10,a
2925@TOP@human_GAPDH_TAA_len41_fa10_ta10_fm10_tm10*126*g,0,0,27471,1,27472,1.0,126,2925@TOP@human_GAPDH_TAA_len41_fa10_ta10_fm10_tm10,g
2925@TOP@human_GAPDH_TAA_len41_fa10_ta10_fm10_tm10*127*a,27694,5,18,1,27718,0.001,127,2925@TOP@human_GAPDH_TAA_len41_fa10_ta10_fm10_tm10,a
2925@TOP@human_GAPDH_TAA_len41_fa10_ta10_fm10_tm10*128*c,0,27841,4,1,27846,0.0,128,2925@TOP@human_GAPDH_TAA_len41_fa10_ta10_fm10_tm10,c
2925@TOP@human_GAPDH_TAA_len41_fa10_ta10_fm10_tm10*129*c,2,27657,0,2,27661,0.0,129,2925@TOP@human_GAPDH_TAA_len41_fa10_ta10_fm10_tm10,c
2925@TOP@human_GAPDH_TAA_len41_fa10_ta10_fm10_tm10*130*c,0,27796,3,1,27800,0.0,130,2925@TOP@human_GAPDH_TAA_len41_fa10_ta10_fm10_tm10,c
2925@TOP@human_GAPDH_TAA_len41_fa10_ta10_fm10_tm10*131*c,5,27854,0,1,27860,0.0,131,2925@TOP@human_GAPDH_TAA_len41_fa10_ta10_fm10_tm10,c
2925@TOP@human_GAPDH_TAA_len41_fa10_ta10_fm10_tm10*132*t,1,7,3,27453,27464,0.0,132,2925@TOP@human_GAPDH_TAA_len41_fa10_ta10_fm10_tm10,t
2925@TOP@human_GAPDH_TAA_len41_fa10_ta10_fm10_tm10*133*g,2,0,27446,2,27450,1.0,133,2925@TOP@human_GAPDH_TAA_len41_fa10_ta10_fm10_tm10,g
2925@TOP@human_GAPDH_TAA_len41_fa10_ta10_fm10_tm10*134*g,1,2,27573,1,27577,1.0,134,2925@TOP@human_GAPDH_TAA_len41_fa10_ta10_fm10_tm10,g
2926@TOP@human_GAPDH_TAA_len41_fa10_ta10_fm10_tm10*114*t,4,15,1,35747,35767,0.0,114,2926@TOP@human_GAPDH_TAA_len41_fa10_ta10_fm10_tm10,t
2926@TOP@human_GAPDH_TAA_len41_fa10_ta10_fm10_tm10*115*c,1,35949,0,1,35951,0.0,115,2926@TOP@human_GAPDH_TAA_len41_fa10_ta10_fm10_tm10,c
2926@TOP@human_GAPDH_TAA_len41_fa10_ta10_fm10_tm10*116*c,1,35817,0,1,35819,0.0,116,2926@TOP@human_GAPDH_TAA_len41_fa10_ta10_fm10_tm10,c
2926@TOP@human_GAPDH_TAA_len41_fa10_ta10_fm10_tm10*117*a,35601,0,161,0,35762,0.005,117,2926@TOP@human_GAPDH_TAA_len41_fa10_ta10_fm10_tm10,a
2926@TOP@human_GAPDH_TAA_len41_fa10_ta10_fm10_tm10*118*a,35142,0,431,0,35573,0.012,118,2926@TOP@human_GAPDH_TAA_len41_fa10_ta10_fm10_tm10,a
2926@TOP@human_GAPDH_TAA_len41_fa10_ta10_fm10_tm10*119*g,1,0,35555,0,35556,1.0,119,2926@TOP@human_GAPDH_TAA_len41_fa10_ta10_fm10_tm10,g
2926@TOP@human_GAPDH_TAA_len41_fa10_ta10_fm10_tm10*120*g,1,0,35403,0,35404,1.0,120,2926@TOP@human_GAPDH_TAA_len41_fa10_ta10_fm10_tm10,g
2926@TOP@human_GAPDH_TAA_len41_fa10_ta10_fm10_tm10*121*a,35763,1,11,0,35775,0.0,121,2926@TOP@human_GAPDH_TAA_len41_fa10_ta10_fm10_tm10,a
2926@TOP@human_GAPDH_TAA_len41_fa10_ta10_fm10_tm10*122*g,0,0,35803,1,35804,1.0,122,2926@TOP@human_GAPDH_TAA_len41_fa10_ta10_fm10_tm10,g
2926@TOP@human_GAPDH_TAA_len41_fa10_ta10_fm10_tm10*123*t,4,5,5,35278,35292,0.0,123,2926@TOP@human_GAPDH_TAA_len41_fa10_ta10_fm10_tm10,t
2926@TOP@human_GAPDH_TAA_len41_fa10_ta10_fm10_tm10*124*a,34143,3,1020,2,35168,0.029,124,2926@TOP@human_GAPDH_TAA_len41_fa10_ta10_fm10_tm10,a
2926@TOP@human_GAPDH_TAA_len41_fa10_ta10_fm10_tm10*125*a,34492,2,644,1,35139,0.018,125,2926@TOP@human_GAPDH_TAA_len41_fa10_ta10_fm10_tm10,a
2926@TOP@human_GAPDH_TAA_len41_fa10_ta10_fm10_tm10*126*g,3,0,35326,0,35329,1.0,126,2926@TOP@human_GAPDH_TAA_len41_fa10_ta10_fm10_tm10,g
2926@TOP@human_GAPDH_TAA_len41_fa10_ta10_fm10_tm10*127*a,35641,0,26,1,35668,0.001,127,2926@TOP@human_GAPDH_TAA_len41_fa10_ta10_fm10_tm10,a
2926@TOP@human_GAPDH_TAA_len41_fa10_ta10_fm10_tm10*128*c,0,35864,3,3,35870,0.0,128,2926@TOP@human_GAPDH_TAA_len41_fa10_ta10_fm10_tm10,c
2926@TOP@human_GAPDH_TAA_len41_fa10_ta10_fm10_tm10*129*c,3,35590,1,0,35594,0.0,129,2926@TOP@human_GAPDH_TAA_len41_fa10_ta10_fm10_tm10,c
2926@TOP@human_GAPDH_TAA_len41_fa10_ta10_fm10_tm10*130*c,5,35783,0,3,35791,0.0,130,2926@TOP@human_GAPDH_TAA_len41_fa10_ta10_fm10_tm10,c
2926@TOP@human_GAPDH_TAA_len41_fa10_ta10_fm10_tm10*131*c,1,35893,0,2,35896,0.0,131,2926@TOP@human_GAPDH_TAA_len41_fa10_ta10_fm10_tm10,c
2926@TOP@human_GAPDH_TAA_len41_fa10_ta10_fm10_tm10*132*t,4,5,5,35352,35366,0.0,132,2926@TOP@human_GAPDH_TAA_len41_fa10_ta10_fm10_tm10,t
2926@TOP@human_GAPDH_TAA_len41_fa10_ta10_fm10_tm10*133*g,4,0,35330,0,35334,1.0,133,2926@TOP@human_GAPDH_TAA_len41_fa10_ta10_fm10_tm10,g
2926@TOP@human_GAPDH_TAA_len41_fa10_ta10_fm10_tm10*134*g,2,4,35557,1,35564,1.0,134,2926@TOP@human_GAPDH_TAA_len41_fa10_ta10_fm10_tm10,g
2927@TOP@human_GAPDH_TAA_len41_fa10_ta10_fm10_tm10*114*t,1,11,2,38890,38904,0.0,114,2927@TOP@human_GAPDH_TAA_len41_fa10_ta10_fm10_tm10,t
2927@TOP@human_GAPDH_TAA_len41_fa10_ta10_fm10_tm10*115*c,1,39107,0,0,39108,0.0,115,2927@TOP@human_GAPDH_TAA_len41_fa10_ta10_fm10_tm10,c
2927@TOP@human_GAPDH_TAA_len41_fa10_ta10_fm10_tm10*116*c,0,38987,0,3,38990,0.0,116,2927@TOP@human_GAPDH_TAA_len41_fa10_ta10_fm10_tm10,c
2927@TOP@human_GAPDH_TAA_len41_fa10_ta10_fm10_tm10*117*a,38729,1,209,1,38940,0.005,117,2927@TOP@human_GAPDH_TAA_len41_fa10_ta10_fm10_tm10,a
2927@TOP@human_GAPDH_TAA_len41_fa10_ta10_fm10_tm10*118*a,38333,1,428,5,38767,0.011,118,2927@TOP@human_GAPDH_TAA_len41_fa10_ta10_fm10_tm10,a
2927@TOP@human_GAPDH_TAA_len41_fa10_ta10_fm10_tm10*119*g,0,0,38676,2,38678,1.0,119,2927@TOP@human_GAPDH_TAA_len41_fa10_ta10_fm10_tm10,g
2927@TOP@human_GAPDH_TAA_len41_fa10_ta10_fm10_tm10*120*g,3,0,38528,1,38532,1.0,120,2927@TOP@human_GAPDH_TAA_len41_fa10_ta10_fm10_tm10,g
2927@TOP@human_GAPDH_TAA_len41_fa10_ta10_fm10_tm10*121*a,38884,0,8,3,38895,0.0,121,2927@TOP@human_GAPDH_TAA_len41_fa10_ta10_fm10_tm10,a
2927@TOP@human_GAPDH_TAA_len41_fa10_ta10_fm10_tm10*122*g,1,1,38953,1,38956,1.0,122,2927@TOP@human_GAPDH_TAA_len41_fa10_ta10_fm10_tm10,g
2927@TOP@human_GAPDH_TAA_len41_fa10_ta10_fm10_tm10*123*t,8,2,0,38445,38455,0.0,123,2927@TOP@human_GAPDH_TAA_len41_fa10_ta10_fm10_tm10,t
2927@TOP@human_GAPDH_TAA_len41_fa10_ta10_fm10_tm10*124*a,34913,2,3463,0,38378,0.09,124,2927@TOP@human_GAPDH_TAA_len41_fa10_ta10_fm10_tm10,a
2927@TOP@human_GAPDH_TAA_len41_fa10_ta10_fm10_tm10*125*a,37106,3,1209,4,38322,0.032,125,2927@TOP@human_GAPDH_TAA_len41_fa10_ta10_fm10_tm10,a
2927@TOP@human_GAPDH_TAA_len41_fa10_ta10_fm10_tm10*126*g,1,1,38480,0,38482,1.0,126,2927@TOP@human_GAPDH_TAA_len41_fa10_ta10_fm10_tm10,g
2927@TOP@human_GAPDH_TAA_len41_fa10_ta10_fm10_tm10*127*a,38781,2,18,0,38801,0.0,127,2927@TOP@human_GAPDH_TAA_len41_fa10_ta10_fm10_tm10,a
2927@TOP@human_GAPDH_TAA_len41_fa10_ta10_fm10_tm10*128*c,3,39044,4,0,39051,0.0,128,2927@TOP@human_GAPDH_TAA_len41_fa10_ta10_fm10_tm10,c
2927@TOP@human_GAPDH_TAA_len41_fa10_ta10_fm10_tm10*129*c,1,38786,0,1,38788,0.0,129,2927@TOP@human_GAPDH_TAA_len41_fa10_ta10_fm10_tm10,c
2927@TOP@human_GAPDH_TAA_len41_fa10_ta10_fm10_tm10*130*c,3,38955,0,4,38962,0.0,130,2927@TOP@human_GAPDH_TAA_len41_fa10_ta10_fm10_tm10,c
2927@TOP@human_GAPDH_TAA_len41_fa10_ta10_fm10_tm10*131*c,5,39031,0,2,39038,0.0,131,2927@TOP@human_GAPDH_TAA_len41_fa10_ta10_fm10_tm10,c
2927@TOP@human_GAPDH_TAA_len41_fa10_ta10_fm10_tm10*132*t,4,4,2,38480,38490,0.0,132,2927@TOP@human_GAPDH_TAA_len41_fa10_ta10_fm10_tm10,t
2927@TOP@human_GAPDH_TAA_len41_fa10_ta10_fm10_tm10*133*g,4,2,38428,1,38435,1.0,133,2927@TOP@human_GAPDH_TAA_len41_fa10_ta10_fm10_tm10,g
2927@TOP@human_GAPDH_TAA_len41_fa10_ta10_fm10_tm10*134*g,0,8,38625,3,38636,1.0,134,2927@TOP@human_GAPDH_TAA_len41_fa10_ta10_fm10_tm10,g
2928@TOP@human_GAPDH_TAA_len41_fa10_ta10_fm10_tm10*114*t,4,7,0,47346,47357,0.0,114,2928@TOP@human_GAPDH_TAA_len41_fa10_ta10_fm10_tm10,t
2928@TOP@human_GAPDH_TAA_len41_fa10_ta10_fm10_tm10*115*c,2,47618,0,5,47625,0.0,115,2928@TOP@human_GAPDH_TAA_len41_fa10_ta10_fm10_tm10,c
2928@TOP@human_GAPDH_TAA_len41_fa10_ta10_fm10_tm10*116*c,2,47442,0,5,47449,0.0,116,2928@TOP@human_GAPDH_TAA_len41_fa10_ta10_fm10_tm10,c
2928@TOP@human_GAPDH_TAA_len41_fa10_ta10_fm10_tm10*117*a,46665,0,765,0,47430,0.016,117,2928@TOP@human_GAPDH_TAA_len41_fa10_ta10_fm10_tm10,a
2928@TOP@human_GAPDH_TAA_len41_fa10_ta10_fm10_tm10*118*a,41027,1,6130,0,47158,0.13,118,2928@TOP@human_GAPDH_TAA_len41_fa10_ta10_fm10_tm10,a
2928@TOP@human_GAPDH_TAA_len41_fa10_ta10_fm10_tm10*119*g,2,0,47042,2,47046,1.0,119,2928@TOP@human_GAPDH_TAA_len41_fa10_ta10_fm10_tm10,g
2928@TOP@human_GAPDH_TAA_len41_fa10_ta10_fm10_tm10*120*g,2,2,46939,1,46944,1.0,120,2928@TOP@human_GAPDH_TAA_len41_fa10_ta10_fm10_tm10,g
2928@TOP@human_GAPDH_TAA_len41_fa10_ta10_fm10_tm10*121*a,47247,1,26,1,47275,0.001,121,2928@TOP@human_GAPDH_TAA_len41_fa10_ta10_fm10_tm10,a
2928@TOP@human_GAPDH_TAA_len41_fa10_ta10_fm10_tm10*122*g,3,1,47419,3,47426,1.0,122,2928@TOP@human_GAPDH_TAA_len41_fa10_ta10_fm10_tm10,g
2928@TOP@human_GAPDH_TAA_len41_fa10_ta10_fm10_tm10*123*t,4,11,7,46812,46834,0.0,123,2928@TOP@human_GAPDH_TAA_len41_fa10_ta10_fm10_tm10,t
2928@TOP@human_GAPDH_TAA_len41_fa10_ta10_fm10_tm10*124*a,45372,0,1160,2,46534,0.025,124,2928@TOP@human_GAPDH_TAA_len41_fa10_ta10_fm10_tm10,a
2928@TOP@human_GAPDH_TAA_len41_fa10_ta10_fm10_tm10*125*a,45789,8,640,3,46440,0.014,125,2928@TOP@human_GAPDH_TAA_len41_fa10_ta10_fm10_tm10,a
2928@TOP@human_GAPDH_TAA_len41_fa10_ta10_fm10_tm10*126*g,0,1,46819,3,46823,1.0,126,2928@TOP@human_GAPDH_TAA_len41_fa10_ta10_fm10_tm10,g
2928@TOP@human_GAPDH_TAA_len41_fa10_ta10_fm10_tm10*127*a,47163,1,83,0,47247,0.002,127,2928@TOP@human_GAPDH_TAA_len41_fa10_ta10_fm10_tm10,a
2928@TOP@human_GAPDH_TAA_len41_fa10_ta10_fm10_tm10*128*c,0,47506,5,2,47513,0.0,128,2928@TOP@human_GAPDH_TAA_len41_fa10_ta10_fm10_tm10,c
2928@TOP@human_GAPDH_TAA_len41_fa10_ta10_fm10_tm10*129*c,0,47168,0,3,47171,0.0,129,2928@TOP@human_GAPDH_TAA_len41_fa10_ta10_fm10_tm10,c
2928@TOP@human_GAPDH_TAA_len41_fa10_ta10_fm10_tm10*130*c,2,47401,0,3,47406,0.0,130,2928@TOP@human_GAPDH_TAA_len41_fa10_ta10_fm10_tm10,c
2928@TOP@human_GAPDH_TAA_len41_fa10_ta10_fm10_tm10*131*c,6,47528,0,5,47539,0.0,131,2928@TOP@human_GAPDH_TAA_len41_fa10_ta10_fm10_tm10,c
2928@TOP@human_GAPDH_TAA_len41_fa10_ta10_fm10_tm10*132*t,3,17,8,46782,46810,0.0,132,2928@TOP@human_GAPDH_TAA_len41_fa10_ta10_fm10_tm10,t
2928@TOP@human_GAPDH_TAA_len41_fa10_ta10_fm10_tm10*133*g,2,1,46784,1,46788,1.0,133,2928@TOP@human_GAPDH_TAA_len41_fa10_ta10_fm10_tm10,g
2928@TOP@human_GAPDH_TAA_len41_fa10_ta10_fm10_tm10*134*g,9,7,46993,2,47011,1.0,134,2928@TOP@human_GAPDH_TAA_len41_fa10_ta10_fm10_tm10,g
2929@TOP@human_GAPDH_TAA_len41_fa10_ta10_fm10_tm10*114*t,3,14,0,41152,41169,0.0,114,2929@TOP@human_GAPDH_TAA_len41_fa10_ta10_fm10_tm10,t
2929@TOP@human_GAPDH_TAA_len41_fa10_ta10_fm10_tm10*115*c,1,41381,0,6,41388,0.0,115,2929@TOP@human_GAPDH_TAA_len41_fa10_ta10_fm10_tm10,c
2929@TOP@human_GAPDH_TAA_len41_fa10_ta10_fm10_tm10*116*c,1,41220,0,1,41222,0.0,116,2929@TOP@human_GAPDH_TAA_len41_fa10_ta10_fm10_tm10,c
2929@TOP@human_GAPDH_TAA_len41_fa10_ta10_fm10_tm10*117*a,40835,0,344,0,41179,0.008,117,2929@TOP@human_GAPDH_TAA_len41_fa10_ta10_fm10_tm10,a
2929@TOP@human_GAPDH_TAA_len41_fa10_ta10_fm10_tm10*118*a,38165,0,2795,0,40960,0.068,118,2929@TOP@human_GAPDH_TAA_len41_fa10_ta10_fm10_tm10,a
2929@TOP@human_GAPDH_TAA_len41_fa10_ta10_fm10_tm10*119*g,4,0,40922,2,40928,1.0,119,2929@TOP@human_GAPDH_TAA_len41_fa10_ta10_fm10_tm10,g
2929@TOP@human_GAPDH_TAA_len41_fa10_ta10_fm10_tm10*120*g,3,0,40764,1,40768,1.0,120,2929@TOP@human_GAPDH_TAA_len41_fa10_ta10_fm10_tm10,g
2929@TOP@human_GAPDH_TAA_len41_fa10_ta10_fm10_tm10*121*a,41123,0,10,0,41133,0.0,121,2929@TOP@human_GAPDH_TAA_len41_fa10_ta10_fm10_tm10,a
2929@TOP@human_GAPDH_TAA_len41_fa10_ta10_fm10_tm10*122*g,0,1,41211,0,41212,1.0,122,2929@TOP@human_GAPDH_TAA_len41_fa10_ta10_fm10_tm10,g
2929@TOP@human_GAPDH_TAA_len41_fa10_ta10_fm10_tm10*123*t,2,6,1,40677,40686,0.0,123,2929@TOP@human_GAPDH_TAA_len41_fa10_ta10_fm10_tm10,t
2929@TOP@human_GAPDH_TAA_len41_fa10_ta10_fm10_tm10*124*a,39562,3,936,0,40501,0.023,124,2929@TOP@human_GAPDH_TAA_len41_fa10_ta10_fm10_tm10,a
2929@TOP@human_GAPDH_TAA_len41_fa10_ta10_fm10_tm10*125*a,39888,2,564,5,40459,0.014,125,2929@TOP@human_GAPDH_TAA_len41_fa10_ta10_fm10_tm10,a
2929@TOP@human_GAPDH_TAA_len41_fa10_ta10_fm10_tm10*126*g,0,0,40687,5,40692,1.0,126,2929@TOP@human_GAPDH_TAA_len41_fa10_ta10_fm10_tm10,g
2929@TOP@human_GAPDH_TAA_len41_fa10_ta10_fm10_tm10*127*a,40989,0,22,3,41014,0.001,127,2929@TOP@human_GAPDH_TAA_len41_fa10_ta10_fm10_tm10,a
2929@TOP@human_GAPDH_TAA_len41_fa10_ta10_fm10_tm10*128*c,1,41280,3,2,41286,0.0,128,2929@TOP@human_GAPDH_TAA_len41_fa10_ta10_fm10_tm10,c
2929@TOP@human_GAPDH_TAA_len41_fa10_ta10_fm10_tm10*129*c,1,41004,0,2,41007,0.0,129,2929@TOP@human_GAPDH_TAA_len41_fa10_ta10_fm10_tm10,c
2929@TOP@human_GAPDH_TAA_len41_fa10_ta10_fm10_tm10*130*c,3,41209,0,6,41218,0.0,130,2929@TOP@human_GAPDH_TAA_len41_fa10_ta10_fm10_tm10,c
2929@TOP@human_GAPDH_TAA_len41_fa10_ta10_fm10_tm10*131*c,2,41304,0,1,41307,0.0,131,2929@TOP@human_GAPDH_TAA_len41_fa10_ta10_fm10_tm10,c
2929@TOP@human_GAPDH_TAA_len41_fa10_ta10_fm10_tm10*132*t,4,13,1,40717,40735,0.0,132,2929@TOP@human_GAPDH_TAA_len41_fa10_ta10_fm10_tm10,t
2929@TOP@human_GAPDH_TAA_len41_fa10_ta10_fm10_tm10*133*g,1,1,40634,5,40641,1.0,133,2929@TOP@human_GAPDH_TAA_len41_fa10_ta10_fm10_tm10,g
2929@TOP@human_GAPDH_TAA_len41_fa10_ta10_fm10_tm10*134*g,3,6,40829,4,40842,1.0,134,2929@TOP@human_GAPDH_TAA_len41_fa10_ta10_fm10_tm10,g
2930@TOP@human_GAPDH_TAA_len41_fa10_ta10_fm10_tm10*114*t,0,0,0,5894,5894,0.0,114,2930@TOP@human_GAPDH_TAA_len41_fa10_ta10_fm10_tm10,t
2930@TOP@human_GAPDH_TAA_len41_fa10_ta10_fm10_tm10*115*c,0,5937,0,0,5937,0.0,115,2930@TOP@human_GAPDH_TAA_len41_fa10_ta10_fm10_tm10,c
2930@TOP@human_GAPDH_TAA_len41_fa10_ta10_fm10_tm10*116*c,0,5906,0,0,5906,0.0,116,2930@TOP@human_GAPDH_TAA_len41_fa10_ta10_fm10_tm10,c
2930@TOP@human_GAPDH_TAA_len41_fa10_ta10_fm10_tm10*117*a,5892,0,19,0,5911,0.003,117,2930@TOP@human_GAPDH_TAA_len41_fa10_ta10_fm10_tm10,a
2930@TOP@human_GAPDH_TAA_len41_fa10_ta10_fm10_tm10*118*a,5782,0,113,0,5895,0.019,118,2930@TOP@human_GAPDH_TAA_len41_fa10_ta10_fm10_tm10,a
2930@TOP@human_GAPDH_TAA_len41_fa10_ta10_fm10_tm10*119*g,3,0,5867,0,5870,0.999,119,2930@TOP@human_GAPDH_TAA_len41_fa10_ta10_fm10_tm10,g
2930@TOP@human_GAPDH_TAA_len41_fa10_ta10_fm10_tm10*120*g,0,0,5844,1,5845,1.0,120,2930@TOP@human_GAPDH_TAA_len41_fa10_ta10_fm10_tm10,g
2930@TOP@human_GAPDH_TAA_len41_fa10_ta10_fm10_tm10*121*a,5904,1,6,0,5911,0.001,121,2930@TOP@human_GAPDH_TAA_len41_fa10_ta10_fm10_tm10,a
2930@TOP@human_GAPDH_TAA_len41_fa10_ta10_fm10_tm10*122*g,0,0,5923,0,5923,1.0,122,2930@TOP@human_GAPDH_TAA_len41_fa10_ta10_fm10_tm10,g
2930@TOP@human_GAPDH_TAA_len41_fa10_ta10_fm10_tm10*123*t,1,0,0,5840,5841,0.0,123,2930@TOP@human_GAPDH_TAA_len41_fa10_ta10_fm10_tm10,t
2930@TOP@human_GAPDH_TAA_len41_fa10_ta10_fm10_tm10*124*a,5491,0,327,0,5818,0.056,124,2930@TOP@human_GAPDH_TAA_len41_fa10_ta10_fm10_tm10,a
2930@TOP@human_GAPDH_TAA_len41_fa10_ta10_fm10_tm10*125*a,5746,0,80,1,5827,0.014,125,2930@TOP@human_GAPDH_TAA_len41_fa10_ta10_fm10_tm10,a
2930@TOP@human_GAPDH_TAA_len41_fa10_ta10_fm10_tm10*126*g,0,0,5822,0,5822,1.0,126,2930@TOP@human_GAPDH_TAA_len41_fa10_ta10_fm10_tm10,g
2930@TOP@human_GAPDH_TAA_len41_fa10_ta10_fm10_tm10*127*a,5891,0,5,0,5896,0.001,127,2930@TOP@human_GAPDH_TAA_len41_fa10_ta10_fm10_tm10,a
2930@TOP@human_GAPDH_TAA_len41_fa10_ta10_fm10_tm10*128*c,0,5922,1,0,5923,0.0,128,2930@TOP@human_GAPDH_TAA_len41_fa10_ta10_fm10_tm10,c
2930@TOP@human_GAPDH_TAA_len41_fa10_ta10_fm10_tm10*129*c,0,5871,0,1,5872,0.0,129,2930@TOP@human_GAPDH_TAA_len41_fa10_ta10_fm10_tm10,c
2930@TOP@human_GAPDH_TAA_len41_fa10_ta10_fm10_tm10*130*c,4,5905,0,1,5910,0.0,130,2930@TOP@human_GAPDH_TAA_len41_fa10_ta10_fm10_tm10,c
2930@TOP@human_GAPDH_TAA_len41_fa10_ta10_fm10_tm10*131*c,0,5931,0,0,5931,0.0,131,2930@TOP@human_GAPDH_TAA_len41_fa10_ta10_fm10_tm10,c
2930@TOP@human_GAPDH_TAA_len41_fa10_ta10_fm10_tm10*132*t,0,2,0,5852,5854,0.0,132,2930@TOP@human_GAPDH_TAA_len41_fa10_ta10_fm10_tm10,t
2930@TOP@human_GAPDH_TAA_len41_fa10_ta10_fm10_tm10*133*g,0,1,5829,1,5831,1.0,133,2930@TOP@human_GAPDH_TAA_len41_fa10_ta10_fm10_tm10,g
2930@TOP@human_GAPDH_TAA_len41_fa10_ta10_fm10_tm10*134*g,0,1,5851,0,5852,1.0,134,2930@TOP@human_GAPDH_TAA_len41_fa10_ta10_fm10_tm10,g
2931@TOP@human_GAPDH_TAA_len41_fa10_ta10_fm10_tm10*114*t,1,3,0,17510,17514,0.0,114,2931@TOP@human_GAPDH_TAA_len41_fa10_ta10_fm10_tm10,t
2931@TOP@human_GAPDH_TAA_len41_fa10_ta10_fm10_tm10*115*c,0,17618,0,0,17618,0.0,115,2931@TOP@human_GAPDH_TAA_len41_fa10_ta10_fm10_tm10,c
2931@TOP@human_GAPDH_TAA_len41_fa10_ta10_fm10_tm10*116*c,0,17542,3,0,17545,0.0,116,2931@TOP@human_GAPDH_TAA_len41_fa10_ta10_fm10_tm10,c
2931@TOP@human_GAPDH_TAA_len41_fa10_ta10_fm10_tm10*117*a,17462,0,73,0,17535,0.004,117,2931@TOP@human_GAPDH_TAA_len41_fa10_ta10_fm10_tm10,a
2931@TOP@human_GAPDH_TAA_len41_fa10_ta10_fm10_tm10*118*a,15585,1,1838,2,17426,0.105,118,2931@TOP@human_GAPDH_TAA_len41_fa10_ta10_fm10_tm10,a
2931@TOP@human_GAPDH_TAA_len41_fa10_ta10_fm10_tm10*119*g,1,0,17408,0,17409,1.0,119,2931@TOP@human_GAPDH_TAA_len41_fa10_ta10_fm10_tm10,g
2931@TOP@human_GAPDH_TAA_len41_fa10_ta10_fm10_tm10*120*g,3,1,17370,1,17375,1.0,120,2931@TOP@human_GAPDH_TAA_len41_fa10_ta10_fm10_tm10,g
2931@TOP@human_GAPDH_TAA_len41_fa10_ta10_fm10_tm10*121*a,17478,0,18,0,17496,0.001,121,2931@TOP@human_GAPDH_TAA_len41_fa10_ta10_fm10_tm10,a
2931@TOP@human_GAPDH_TAA_len41_fa10_ta10_fm10_tm10*122*g,0,0,17555,0,17555,1.0,122,2931@TOP@human_GAPDH_TAA_len41_fa10_ta10_fm10_tm10,g
2931@TOP@human_GAPDH_TAA_len41_fa10_ta10_fm10_tm10*123*t,1,15,0,17288,17304,0.0,123,2931@TOP@human_GAPDH_TAA_len41_fa10_ta10_fm10_tm10,t
2931@TOP@human_GAPDH_TAA_len41_fa10_ta10_fm10_tm10*124*a,16607,0,596,0,17203,0.035,124,2931@TOP@human_GAPDH_TAA_len41_fa10_ta10_fm10_tm10,a
2931@TOP@human_GAPDH_TAA_len41_fa10_ta10_fm10_tm10*125*a,15882,1,1357,0,17240,0.079,125,2931@TOP@human_GAPDH_TAA_len41_fa10_ta10_fm10_tm10,a
2931@TOP@human_GAPDH_TAA_len41_fa10_ta10_fm10_tm10*126*g,0,0,17354,1,17355,1.0,126,2931@TOP@human_GAPDH_TAA_len41_fa10_ta10_fm10_tm10,g
2931@TOP@human_GAPDH_TAA_len41_fa10_ta10_fm10_tm10*127*a,17493,0,5,0,17498,0.0,127,2931@TOP@human_GAPDH_TAA_len41_fa10_ta10_fm10_tm10,a
2931@TOP@human_GAPDH_TAA_len41_fa10_ta10_fm10_tm10*128*c,1,17572,0,1,17574,0.0,128,2931@TOP@human_GAPDH_TAA_len41_fa10_ta10_fm10_tm10,c
2931@TOP@human_GAPDH_TAA_len41_fa10_ta10_fm10_tm10*129*c,0,17448,0,0,17448,0.0,129,2931@TOP@human_GAPDH_TAA_len41_fa10_ta10_fm10_tm10,c
2931@TOP@human_GAPDH_TAA_len41_fa10_ta10_fm10_tm10*130*c,1,17543,0,0,17544,0.0,130,2931@TOP@human_GAPDH_TAA_len41_fa10_ta10_fm10_tm10,c
2931@TOP@human_GAPDH_TAA_len41_fa10_ta10_fm10_tm10*131*c,1,17583,0,2,17586,0.0,131,2931@TOP@human_GAPDH_TAA_len41_fa10_ta10_fm10_tm10,c
2931@TOP@human_GAPDH_TAA_len41_fa10_ta10_fm10_tm10*132*t,5,6,0,17341,17352,0.0,132,2931@TOP@human_GAPDH_TAA_len41_fa10_ta10_fm10_tm10,t
2931@TOP@human_GAPDH_TAA_len41_fa10_ta10_fm10_tm10*133*g,0,0,17291,0,17291,1.0,133,2931@TOP@human_GAPDH_TAA_len41_fa10_ta10_fm10_tm10,g
2931@TOP@human_GAPDH_TAA_len41_fa10_ta10_fm10_tm10*134*g,0,6,17393,1,17400,1.0,134,2931@TOP@human_GAPDH_TAA_len41_fa10_ta10_fm10_tm10,g
2932@TOP@human_GAPDH_TAA_len41_fa10_ta10_fm10_tm10*114*t,1,8,0,26841,26850,0.0,114,2932@TOP@human_GAPDH_TAA_len41_fa10_ta10_fm10_tm10,t
2932@TOP@human_GAPDH_TAA_len41_fa10_ta10_fm10_tm10*115*c,0,27018,0,0,27018,0.0,115,2932@TOP@human_GAPDH_TAA_len41_fa10_ta10_fm10_tm10,c
2932@TOP@human_GAPDH_TAA_len41_fa10_ta10_fm10_tm10*116*c,0,26915,0,1,26916,0.0,116,2932@TOP@human_GAPDH_TAA_len41_fa10_ta10_fm10_tm10,c
2932@TOP@human_GAPDH_TAA_len41_fa10_ta10_fm10_tm10*117*a,26836,0,47,0,26883,0.002,117,2932@TOP@human_GAPDH_TAA_len41_fa10_ta10_fm10_tm10,a
2932@TOP@human_GAPDH_TAA_len41_fa10_ta10_fm10_tm10*118*a,25318,3,1434,5,26760,0.054,118,2932@TOP@human_GAPDH_TAA_len41_fa10_ta10_fm10_tm10,a
2932@TOP@human_GAPDH_TAA_len41_fa10_ta10_fm10_tm10*119*g,4,1,26695,1,26701,1.0,119,2932@TOP@human_GAPDH_TAA_len41_fa10_ta10_fm10_tm10,g
2932@TOP@human_GAPDH_TAA_len41_fa10_ta10_fm10_tm10*120*g,0,0,26636,0,26636,1.0,120,2932@TOP@human_GAPDH_TAA_len41_fa10_ta10_fm10_tm10,g
2932@TOP@human_GAPDH_TAA_len41_fa10_ta10_fm10_tm10*121*a,26841,1,11,0,26853,0.0,121,2932@TOP@human_GAPDH_TAA_len41_fa10_ta10_fm10_tm10,a
2932@TOP@human_GAPDH_TAA_len41_fa10_ta10_fm10_tm10*122*g,1,0,26903,2,26906,1.0,122,2932@TOP@human_GAPDH_TAA_len41_fa10_ta10_fm10_tm10,g
2932@TOP@human_GAPDH_TAA_len41_fa10_ta10_fm10_tm10*123*t,2,3,4,26560,26569,0.0,123,2932@TOP@human_GAPDH_TAA_len41_fa10_ta10_fm10_tm10,t
2932@TOP@human_GAPDH_TAA_len41_fa10_ta10_fm10_tm10*124*a,25598,2,822,0,26422,0.031,124,2932@TOP@human_GAPDH_TAA_len41_fa10_ta10_fm10_tm10,a
2932@TOP@human_GAPDH_TAA_len41_fa10_ta10_fm10_tm10*125*a,25120,0,1254,5,26379,0.048,125,2932@TOP@human_GAPDH_TAA_len41_fa10_ta10_fm10_tm10,a
2932@TOP@human_GAPDH_TAA_len41_fa10_ta10_fm10_tm10*126*g,0,0,26535,2,26537,1.0,126,2932@TOP@human_GAPDH_TAA_len41_fa10_ta10_fm10_tm10,g
2932@TOP@human_GAPDH_TAA_len41_fa10_ta10_fm10_tm10*127*a,26787,4,12,0,26803,0.0,127,2932@TOP@human_GAPDH_TAA_len41_fa10_ta10_fm10_tm10,a
2932@TOP@human_GAPDH_TAA_len41_fa10_ta10_fm10_tm10*128*c,0,26955,1,0,26956,0.0,128,2932@TOP@human_GAPDH_TAA_len41_fa10_ta10_fm10_tm10,c
2932@TOP@human_GAPDH_TAA_len41_fa10_ta10_fm10_tm10*129*c,0,26762,0,1,26763,0.0,129,2932@TOP@human_GAPDH_TAA_len41_fa10_ta10_fm10_tm10,c
2932@TOP@human_GAPDH_TAA_len41_fa10_ta10_fm10_tm10*130*c,0,26908,0,1,26909,0.0,130,2932@TOP@human_GAPDH_TAA_len41_fa10_ta10_fm10_tm10,c
2932@TOP@human_GAPDH_TAA_len41_fa10_ta10_fm10_tm10*131*c,2,26971,0,1,26974,0.0,131,2932@TOP@human_GAPDH_TAA_len41_fa10_ta10_fm10_tm10,c
2932@TOP@human_GAPDH_TAA_len41_fa10_ta10_fm10_tm10*132*t,1,5,1,26567,26574,0.0,132,2932@TOP@human_GAPDH_TAA_len41_fa10_ta10_fm10_tm10,t
2932@TOP@human_GAPDH_TAA_len41_fa10_ta10_fm10_tm10*133*g,1,1,26537,0,26539,1.0,133,2932@TOP@human_GAPDH_TAA_len41_fa10_ta10_fm10_tm10,g
2932@TOP@human_GAPDH_TAA_len41_fa10_ta10_fm10_tm10*134*g,1,8,26700,2,26711,1.0,134,2932@TOP@human_GAPDH_TAA_len41_fa10_ta10_fm10_tm10,g
2933@TOP@human_GAPDH_TAA_len41_fa10_ta10_fm10_tm10*114*t,0,0,0,454,454,0.0,114,2933@TOP@human_GAPDH_TAA_len41_fa10_ta10_fm10_tm10,t
2933@TOP@human_GAPDH_TAA_len41_fa10_ta10_fm10_tm10*115*c,0,458,0,0,458,0.0,115,2933@TOP@human_GAPDH_TAA_len41_fa10_ta10_fm10_tm10,c
2933@TOP@human_GAPDH_TAA_len41_fa10_ta10_fm10_tm10*116*c,0,454,0,0,454,0.0,116,2933@TOP@human_GAPDH_TAA_len41_fa10_ta10_fm10_tm10,c
2933@TOP@human_GAPDH_TAA_len41_fa10_ta10_fm10_tm10*117*a,424,0,30,0,454,0.066,117,2933@TOP@human_GAPDH_TAA_len41_fa10_ta10_fm10_tm10,a
2933@TOP@human_GAPDH_TAA_len41_fa10_ta10_fm10_tm10*118*a,337,0,112,0,449,0.249,118,2933@TOP@human_GAPDH_TAA_len41_fa10_ta10_fm10_tm10,a
2933@TOP@human_GAPDH_TAA_len41_fa10_ta10_fm10_tm10*119*g,0,0,449,0,449,1.0,119,2933@TOP@human_GAPDH_TAA_len41_fa10_ta10_fm10_tm10,g
2933@TOP@human_GAPDH_TAA_len41_fa10_ta10_fm10_tm10*120*g,0,0,448,0,448,1.0,120,2933@TOP@human_GAPDH_TAA_len41_fa10_ta10_fm10_tm10,g
2933@TOP@human_GAPDH_TAA_len41_fa10_ta10_fm10_tm10*121*a,454,0,0,0,454,0.0,121,2933@TOP@human_GAPDH_TAA_len41_fa10_ta10_fm10_tm10,a
2933@TOP@human_GAPDH_TAA_len41_fa10_ta10_fm10_tm10*122*g,0,0,452,0,452,1.0,122,2933@TOP@human_GAPDH_TAA_len41_fa10_ta10_fm10_tm10,g
2933@TOP@human_GAPDH_TAA_len41_fa10_ta10_fm10_tm10*123*t,0,0,1,447,448,0.002,123,2933@TOP@human_GAPDH_TAA_len41_fa10_ta10_fm10_tm10,t
2933@TOP@human_GAPDH_TAA_len41_fa10_ta10_fm10_tm10*124*a,335,0,109,0,444,0.245,124,2933@TOP@human_GAPDH_TAA_len41_fa10_ta10_fm10_tm10,a
2933@TOP@human_GAPDH_TAA_len41_fa10_ta10_fm10_tm10*125*a,410,0,40,0,450,0.089,125,2933@TOP@human_GAPDH_TAA_len41_fa10_ta10_fm10_tm10,a
2933@TOP@human_GAPDH_TAA_len41_fa10_ta10_fm10_tm10*126*g,0,0,446,0,446,1.0,126,2933@TOP@human_GAPDH_TAA_len41_fa10_ta10_fm10_tm10,g
2933@TOP@human_GAPDH_TAA_len41_fa10_ta10_fm10_tm10*127*a,450,0,4,0,454,0.009,127,2933@TOP@human_GAPDH_TAA_len41_fa10_ta10_fm10_tm10,a
2933@TOP@human_GAPDH_TAA_len41_fa10_ta10_fm10_tm10*128*c,0,456,0,1,457,0.0,128,2933@TOP@human_GAPDH_TAA_len41_fa10_ta10_fm10_tm10,c
2933@TOP@human_GAPDH_TAA_len41_fa10_ta10_fm10_tm10*129*c,0,451,0,0,451,0.0,129,2933@TOP@human_GAPDH_TAA_len41_fa10_ta10_fm10_tm10,c
2933@TOP@human_GAPDH_TAA_len41_fa10_ta10_fm10_tm10*130*c,0,455,0,0,455,0.0,130,2933@TOP@human_GAPDH_TAA_len41_fa10_ta10_fm10_tm10,c
2933@TOP@human_GAPDH_TAA_len41_fa10_ta10_fm10_tm10*131*c,0,457,0,0,457,0.0,131,2933@TOP@human_GAPDH_TAA_len41_fa10_ta10_fm10_tm10,c
2933@TOP@human_GAPDH_TAA_len41_fa10_ta10_fm10_tm10*132*t,0,0,0,445,445,0.0,132,2933@TOP@human_GAPDH_TAA_len41_fa10_ta10_fm10_tm10,t
2933@TOP@human_GAPDH_TAA_len41_fa10_ta10_fm10_tm10*133*g,0,1,443,0,444,0.998,133,2933@TOP@human_GAPDH_TAA_len41_fa10_ta10_fm10_tm10,g
2933@TOP@human_GAPDH_TAA_len41_fa10_ta10_fm10_tm10*134*g,0,0,450,0,450,1.0,134,2933@TOP@human_GAPDH_TAA_len41_fa10_ta10_fm10_tm10,g
2934@TOP@human_GAPDH_TAA_len41_fa10_ta10_fm10_tm10*114*t,0,0,0,2066,2066,0.0,114,2934@TOP@human_GAPDH_TAA_len41_fa10_ta10_fm10_tm10,t
2934@TOP@human_GAPDH_TAA_len41_fa10_ta10_fm10_tm10*115*c,0,2080,0,0,2080,0.0,115,2934@TOP@human_GAPDH_TAA_len41_fa10_ta10_fm10_tm10,c
2934@TOP@human_GAPDH_TAA_len41_fa10_ta10_fm10_tm10*116*c,0,2067,0,0,2067,0.0,116,2934@TOP@human_GAPDH_TAA_len41_fa10_ta10_fm10_tm10,c
2934@TOP@human_GAPDH_TAA_len41_fa10_ta10_fm10_tm10*117*a,2062,0,7,0,2069,0.003,117,2934@TOP@human_GAPDH_TAA_len41_fa10_ta10_fm10_tm10,a
2934@TOP@human_GAPDH_TAA_len41_fa10_ta10_fm10_tm10*118*a,1936,0,127,0,2063,0.062,118,2934@TOP@human_GAPDH_TAA_len41_fa10_ta10_fm10_tm10,a
2934@TOP@human_GAPDH_TAA_len41_fa10_ta10_fm10_tm10*119*g,0,0,2043,0,2043,1.0,119,2934@TOP@human_GAPDH_TAA_len41_fa10_ta10_fm10_tm10,g
2934@TOP@human_GAPDH_TAA_len41_fa10_ta10_fm10_tm10*120*g,0,0,2043,1,2044,1.0,120,2934@TOP@human_GAPDH_TAA_len41_fa10_ta10_fm10_tm10,g
2934@TOP@human_GAPDH_TAA_len41_fa10_ta10_fm10_tm10*121*a,2055,0,4,0,2059,0.002,121,2934@TOP@human_GAPDH_TAA_len41_fa10_ta10_fm10_tm10,a
2934@TOP@human_GAPDH_TAA_len41_fa10_ta10_fm10_tm10*122*g,0,0,2070,0,2070,1.0,122,2934@TOP@human_GAPDH_TAA_len41_fa10_ta10_fm10_tm10,g
2934@TOP@human_GAPDH_TAA_len41_fa10_ta10_fm10_tm10*123*t,0,0,1,2047,2048,0.0,123,2934@TOP@human_GAPDH_TAA_len41_fa10_ta10_fm10_tm10,t
2934@TOP@human_GAPDH_TAA_len41_fa10_ta10_fm10_tm10*124*a,1749,0,295,0,2044,0.144,124,2934@TOP@human_GAPDH_TAA_len41_fa10_ta10_fm10_tm10,a
2934@TOP@human_GAPDH_TAA_len41_fa10_ta10_fm10_tm10*125*a,1915,0,126,0,2041,0.062,125,2934@TOP@human_GAPDH_TAA_len41_fa10_ta10_fm10_tm10,a
2934@TOP@human_GAPDH_TAA_len41_fa10_ta10_fm10_tm10*126*g,1,0,2048,0,2049,1.0,126,2934@TOP@human_GAPDH_TAA_len41_fa10_ta10_fm10_tm10,g
2934@TOP@human_GAPDH_TAA_len41_fa10_ta10_fm10_tm10*127*a,2059,0,0,0,2059,0.0,127,2934@TOP@human_GAPDH_TAA_len41_fa10_ta10_fm10_tm10,a
2934@TOP@human_GAPDH_TAA_len41_fa10_ta10_fm10_tm10*128*c,0,2073,0,0,2073,0.0,128,2934@TOP@human_GAPDH_TAA_len41_fa10_ta10_fm10_tm10,c
2934@TOP@human_GAPDH_TAA_len41_fa10_ta10_fm10_tm10*129*c,0,2057,0,0,2057,0.0,129,2934@TOP@human_GAPDH_TAA_len41_fa10_ta10_fm10_tm10,c
2934@TOP@human_GAPDH_TAA_len41_fa10_ta10_fm10_tm10*130*c,0,2063,0,0,2063,0.0,130,2934@TOP@human_GAPDH_TAA_len41_fa10_ta10_fm10_tm10,c
2934@TOP@human_GAPDH_TAA_len41_fa10_ta10_fm10_tm10*131*c,0,2072,0,0,2072,0.0,131,2934@TOP@human_GAPDH_TAA_len41_fa10_ta10_fm10_tm10,c
2934@TOP@human_GAPDH_TAA_len41_fa10_ta10_fm10_tm10*132*t,0,0,0,2044,2044,0.0,132,2934@TOP@human_GAPDH_TAA_len41_fa10_ta10_fm10_tm10,t
2934@TOP@human_GAPDH_TAA_len41_fa10_ta10_fm10_tm10*133*g,0,0,2048,0,2048,1.0,133,2934@TOP@human_GAPDH_TAA_len41_fa10_ta10_fm10_tm10,g
2934@TOP@human_GAPDH_TAA_len41_fa10_ta10_fm10_tm10*134*g,0,0,2044,1,2045,1.0,134,2934@TOP@human_GAPDH_TAA_len41_fa10_ta10_fm10_tm10,g
2935@TOP@human_GAPDH_TAA_len41_fa10_ta10_fm10_tm10*114*t,0,6,0,24560,24566,0.0,114,2935@TOP@human_GAPDH_TAA_len41_fa10_ta10_fm10_tm10,t
2935@TOP@human_GAPDH_TAA_len41_fa10_ta10_fm10_tm10*115*c,0,24692,0,0,24692,0.0,115,2935@TOP@human_GAPDH_TAA_len41_fa10_ta10_fm10_tm10,c
2935@TOP@human_GAPDH_TAA_len41_fa10_ta10_fm10_tm10*116*c,1,24591,0,3,24595,0.0,116,2935@TOP@human_GAPDH_TAA_len41_fa10_ta10_fm10_tm10,c
2935@TOP@human_GAPDH_TAA_len41_fa10_ta10_fm10_tm10*117*a,24563,0,36,0,24599,0.001,117,2935@TOP@human_GAPDH_TAA_len41_fa10_ta10_fm10_tm10,a
2935@TOP@human_GAPDH_TAA_len41_fa10_ta10_fm10_tm10*118*a,24216,0,254,1,24471,0.01,118,2935@TOP@human_GAPDH_TAA_len41_fa10_ta10_fm10_tm10,a
2935@TOP@human_GAPDH_TAA_len41_fa10_ta10_fm10_tm10*119*g,0,1,24405,0,24406,1.0,119,2935@TOP@human_GAPDH_TAA_len41_fa10_ta10_fm10_tm10,g
2935@TOP@human_GAPDH_TAA_len41_fa10_ta10_fm10_tm10*120*g,4,0,24331,3,24338,1.0,120,2935@TOP@human_GAPDH_TAA_len41_fa10_ta10_fm10_tm10,g
2935@TOP@human_GAPDH_TAA_len41_fa10_ta10_fm10_tm10*121*a,24536,1,5,0,24542,0.0,121,2935@TOP@human_GAPDH_TAA_len41_fa10_ta10_fm10_tm10,a
2935@TOP@human_GAPDH_TAA_len41_fa10_ta10_fm10_tm10*122*g,2,0,24592,0,24594,1.0,122,2935@TOP@human_GAPDH_TAA_len41_fa10_ta10_fm10_tm10,g
2935@TOP@human_GAPDH_TAA_len41_fa10_ta10_fm10_tm10*123*t,3,4,4,24225,24236,0.0,123,2935@TOP@human_GAPDH_TAA_len41_fa10_ta10_fm10_tm10,t
2935@TOP@human_GAPDH_TAA_len41_fa10_ta10_fm10_tm10*124*a,23352,0,874,1,24227,0.036,124,2935@TOP@human_GAPDH_TAA_len41_fa10_ta10_fm10_tm10,a
2935@TOP@human_GAPDH_TAA_len41_fa10_ta10_fm10_tm10*125*a,23742,3,376,0,24121,0.016,125,2935@TOP@human_GAPDH_TAA_len41_fa10_ta10_fm10_tm10,a
2935@TOP@human_GAPDH_TAA_len41_fa10_ta10_fm10_tm10*126*g,1,0,24291,1,24293,1.0,126,2935@TOP@human_GAPDH_TAA_len41_fa10_ta10_fm10_tm10,g
2935@TOP@human_GAPDH_TAA_len41_fa10_ta10_fm10_tm10*127*a,24511,4,16,0,24531,0.001,127,2935@TOP@human_GAPDH_TAA_len41_fa10_ta10_fm10_tm10,a
2935@TOP@human_GAPDH_TAA_len41_fa10_ta10_fm10_tm10*128*c,1,24626,3,3,24633,0.0,128,2935@TOP@human_GAPDH_TAA_len41_fa10_ta10_fm10_tm10,c
2935@TOP@human_GAPDH_TAA_len41_fa10_ta10_fm10_tm10*129*c,1,24428,0,2,24431,0.0,129,2935@TOP@human_GAPDH_TAA_len41_fa10_ta10_fm10_tm10,c
2935@TOP@human_GAPDH_TAA_len41_fa10_ta10_fm10_tm10*130*c,4,24564,0,3,24571,0.0,130,2935@TOP@human_GAPDH_TAA_len41_fa10_ta10_fm10_tm10,c
2935@TOP@human_GAPDH_TAA_len41_fa10_ta10_fm10_tm10*131*c,1,24651,0,2,24654,0.0,131,2935@TOP@human_GAPDH_TAA_len41_fa10_ta10_fm10_tm10,c
2935@TOP@human_GAPDH_TAA_len41_fa10_ta10_fm10_tm10*132*t,1,8,3,24309,24321,0.0,132,2935@TOP@human_GAPDH_TAA_len41_fa10_ta10_fm10_tm10,t
2935@TOP@human_GAPDH_TAA_len41_fa10_ta10_fm10_tm10*133*g,0,0,24242,0,24242,1.0,133,2935@TOP@human_GAPDH_TAA_len41_fa10_ta10_fm10_tm10,g
2935@TOP@human_GAPDH_TAA_len41_fa10_ta10_fm10_tm10*134*g,2,5,24339,2,24348,1.0,134,2935@TOP@human_GAPDH_TAA_len41_fa10_ta10_fm10_tm10,g
2936@TOP@human_GAPDH_TAA_len41_fa10_ta10_fm10_tm10*114*t,4,10,0,29900,29914,0.0,114,2936@TOP@human_GAPDH_TAA_len41_fa10_ta10_fm10_tm10,t
2936@TOP@human_GAPDH_TAA_len41_fa10_ta10_fm10_tm10*115*c,2,30059,0,5,30066,0.0,115,2936@TOP@human_GAPDH_TAA_len41_fa10_ta10_fm10_tm10,c
2936@TOP@human_GAPDH_TAA_len41_fa10_ta10_fm10_tm10*116*c,0,29964,0,2,29966,0.0,116,2936@TOP@human_GAPDH_TAA_len41_fa10_ta10_fm10_tm10,c
2936@TOP@human_GAPDH_TAA_len41_fa10_ta10_fm10_tm10*117*a,29914,0,38,1,29953,0.001,117,2936@TOP@human_GAPDH_TAA_len41_fa10_ta10_fm10_tm10,a
2936@TOP@human_GAPDH_TAA_len41_fa10_ta10_fm10_tm10*118*a,29498,0,308,1,29807,0.01,118,2936@TOP@human_GAPDH_TAA_len41_fa10_ta10_fm10_tm10,a
2936@TOP@human_GAPDH_TAA_len41_fa10_ta10_fm10_tm10*119*g,2,0,29724,2,29728,1.0,119,2936@TOP@human_GAPDH_TAA_len41_fa10_ta10_fm10_tm10,g
2936@TOP@human_GAPDH_TAA_len41_fa10_ta10_fm10_tm10*120*g,2,1,29632,2,29637,1.0,120,2936@TOP@human_GAPDH_TAA_len41_fa10_ta10_fm10_tm10,g
2936@TOP@human_GAPDH_TAA_len41_fa10_ta10_fm10_tm10*121*a,29921,1,9,0,29931,0.0,121,2936@TOP@human_GAPDH_TAA_len41_fa10_ta10_fm10_tm10,a
2936@TOP@human_GAPDH_TAA_len41_fa10_ta10_fm10_tm10*122*g,2,0,29963,1,29966,1.0,122,2936@TOP@human_GAPDH_TAA_len41_fa10_ta10_fm10_tm10,g
2936@TOP@human_GAPDH_TAA_len41_fa10_ta10_fm10_tm10*123*t,4,2,2,29558,29566,0.0,123,2936@TOP@human_GAPDH_TAA_len41_fa10_ta10_fm10_tm10,t
2936@TOP@human_GAPDH_TAA_len41_fa10_ta10_fm10_tm10*124*a,24943,2,4560,0,29505,0.155,124,2936@TOP@human_GAPDH_TAA_len41_fa10_ta10_fm10_tm10,a
2936@TOP@human_GAPDH_TAA_len41_fa10_ta10_fm10_tm10*125*a,28811,0,654,1,29466,0.022,125,2936@TOP@human_GAPDH_TAA_len41_fa10_ta10_fm10_tm10,a
2936@TOP@human_GAPDH_TAA_len41_fa10_ta10_fm10_tm10*126*g,0,0,29595,1,29596,1.0,126,2936@TOP@human_GAPDH_TAA_len41_fa10_ta10_fm10_tm10,g
2936@TOP@human_GAPDH_TAA_len41_fa10_ta10_fm10_tm10*127*a,29844,2,14,1,29861,0.0,127,2936@TOP@human_GAPDH_TAA_len41_fa10_ta10_fm10_tm10,a
2936@TOP@human_GAPDH_TAA_len41_fa10_ta10_fm10_tm10*128*c,1,30015,1,2,30019,0.0,128,2936@TOP@human_GAPDH_TAA_len41_fa10_ta10_fm10_tm10,c
2936@TOP@human_GAPDH_TAA_len41_fa10_ta10_fm10_tm10*129*c,1,29816,0,4,29821,0.0,129,2936@TOP@human_GAPDH_TAA_len41_fa10_ta10_fm10_tm10,c
2936@TOP@human_GAPDH_TAA_len41_fa10_ta10_fm10_tm10*130*c,0,29975,0,2,29977,0.0,130,2936@TOP@human_GAPDH_TAA_len41_fa10_ta10_fm10_tm10,c
2936@TOP@human_GAPDH_TAA_len41_fa10_ta10_fm10_tm10*131*c,4,30033,0,0,30037,0.0,131,2936@TOP@human_GAPDH_TAA_len41_fa10_ta10_fm10_tm10,c
2936@TOP@human_GAPDH_TAA_len41_fa10_ta10_fm10_tm10*132*t,6,6,3,29623,29638,0.0,132,2936@TOP@human_GAPDH_TAA_len41_fa10_ta10_fm10_tm10,t
2936@TOP@human_GAPDH_TAA_len41_fa10_ta10_fm10_tm10*133*g,1,1,29582,3,29587,1.0,133,2936@TOP@human_GAPDH_TAA_len41_fa10_ta10_fm10_tm10,g
2936@TOP@human_GAPDH_TAA_len41_fa10_ta10_fm10_tm10*134*g,1,9,29686,5,29701,0.999,134,2936@TOP@human_GAPDH_TAA_len41_fa10_ta10_fm10_tm10,g
2937@TOP@human_GAPDH_TAA_len41_fa10_ta10_fm10_tm10*114*t,0,0,0,2736,2736,0.0,114,2937@TOP@human_GAPDH_TAA_len41_fa10_ta10_fm10_tm10,t
2937@TOP@human_GAPDH_TAA_len41_fa10_ta10_fm10_tm10*115*c,0,2748,0,0,2748,0.0,115,2937@TOP@human_GAPDH_TAA_len41_fa10_ta10_fm10_tm10,c
2937@TOP@human_GAPDH_TAA_len41_fa10_ta10_fm10_tm10*116*c,1,2740,0,0,2741,0.0,116,2937@TOP@human_GAPDH_TAA_len41_fa10_ta10_fm10_tm10,c
2937@TOP@human_GAPDH_TAA_len41_fa10_ta10_fm10_tm10*117*a,2724,0,7,1,2732,0.003,117,2937@TOP@human_GAPDH_TAA_len41_fa10_ta10_fm10_tm10,a
2937@TOP@human_GAPDH_TAA_len41_fa10_ta10_fm10_tm10*118*a,2683,0,45,0,2728,0.016,118,2937@TOP@human_GAPDH_TAA_len41_fa10_ta10_fm10_tm10,a
2937@TOP@human_GAPDH_TAA_len41_fa10_ta10_fm10_tm10*119*g,0,0,2709,0,2709,1.0,119,2937@TOP@human_GAPDH_TAA_len41_fa10_ta10_fm10_tm10,g
2937@TOP@human_GAPDH_TAA_len41_fa10_ta10_fm10_tm10*120*g,0,0,2703,0,2703,1.0,120,2937@TOP@human_GAPDH_TAA_len41_fa10_ta10_fm10_tm10,g
2937@TOP@human_GAPDH_TAA_len41_fa10_ta10_fm10_tm10*121*a,2740,0,0,0,2740,0.0,121,2937@TOP@human_GAPDH_TAA_len41_fa10_ta10_fm10_tm10,a
2937@TOP@human_GAPDH_TAA_len41_fa10_ta10_fm10_tm10*122*g,0,0,2737,0,2737,1.0,122,2937@TOP@human_GAPDH_TAA_len41_fa10_ta10_fm10_tm10,g
2937@TOP@human_GAPDH_TAA_len41_fa10_ta10_fm10_tm10*123*t,1,0,0,2698,2699,0.0,123,2937@TOP@human_GAPDH_TAA_len41_fa10_ta10_fm10_tm10,t
2937@TOP@human_GAPDH_TAA_len41_fa10_ta10_fm10_tm10*124*a,2519,0,160,0,2679,0.06,124,2937@TOP@human_GAPDH_TAA_len41_fa10_ta10_fm10_tm10,a
2937@TOP@human_GAPDH_TAA_len41_fa10_ta10_fm10_tm10*125*a,2607,0,74,0,2681,0.028,125,2937@TOP@human_GAPDH_TAA_len41_fa10_ta10_fm10_tm10,a
2937@TOP@human_GAPDH_TAA_len41_fa10_ta10_fm10_tm10*126*g,0,0,2719,0,2719,1.0,126,2937@TOP@human_GAPDH_TAA_len41_fa10_ta10_fm10_tm10,g
2937@TOP@human_GAPDH_TAA_len41_fa10_ta10_fm10_tm10*127*a,2719,0,6,0,2725,0.002,127,2937@TOP@human_GAPDH_TAA_len41_fa10_ta10_fm10_tm10,a
2937@TOP@human_GAPDH_TAA_len41_fa10_ta10_fm10_tm10*128*c,0,2745,0,0,2745,0.0,128,2937@TOP@human_GAPDH_TAA_len41_fa10_ta10_fm10_tm10,c
2937@TOP@human_GAPDH_TAA_len41_fa10_ta10_fm10_tm10*129*c,0,2723,0,0,2723,0.0,129,2937@TOP@human_GAPDH_TAA_len41_fa10_ta10_fm10_tm10,c
2937@TOP@human_GAPDH_TAA_len41_fa10_ta10_fm10_tm10*130*c,0,2742,0,0,2742,0.0,130,2937@TOP@human_GAPDH_TAA_len41_fa10_ta10_fm10_tm10,c
2937@TOP@human_GAPDH_TAA_len41_fa10_ta10_fm10_tm10*131*c,0,2747,0,0,2747,0.0,131,2937@TOP@human_GAPDH_TAA_len41_fa10_ta10_fm10_tm10,c
2937@TOP@human_GAPDH_TAA_len41_fa10_ta10_fm10_tm10*132*t,1,5,0,2699,2705,0.0,132,2937@TOP@human_GAPDH_TAA_len41_fa10_ta10_fm10_tm10,t
2937@TOP@human_GAPDH_TAA_len41_fa10_ta10_fm10_tm10*133*g,0,0,2702,0,2702,1.0,133,2937@TOP@human_GAPDH_TAA_len41_fa10_ta10_fm10_tm10,g
2937@TOP@human_GAPDH_TAA_len41_fa10_ta10_fm10_tm10*134*g,0,1,2718,0,2719,1.0,134,2937@TOP@human_GAPDH_TAA_len41_fa10_ta10_fm10_tm10,g
2938@TOP@human_GAPDH_TAA_len41_fa10_ta10_fm10_tm10*114*t,0,6,0,11464,11470,0.0,114,2938@TOP@human_GAPDH_TAA_len41_fa10_ta10_fm10_tm10,t
2938@TOP@human_GAPDH_TAA_len41_fa10_ta10_fm10_tm10*115*c,0,11533,0,0,11533,0.0,115,2938@TOP@human_GAPDH_TAA_len41_fa10_ta10_fm10_tm10,c
2938@TOP@human_GAPDH_TAA_len41_fa10_ta10_fm10_tm10*116*c,0,11479,0,0,11479,0.0,116,2938@TOP@human_GAPDH_TAA_len41_fa10_ta10_fm10_tm10,c
2938@TOP@human_GAPDH_TAA_len41_fa10_ta10_fm10_tm10*117*a,11449,1,20,0,11470,0.002,117,2938@TOP@human_GAPDH_TAA_len41_fa10_ta10_fm10_tm10,a
2938@TOP@human_GAPDH_TAA_len41_fa10_ta10_fm10_tm10*118*a,11261,0,147,0,11408,0.013,118,2938@TOP@human_GAPDH_TAA_len41_fa10_ta10_fm10_tm10,a
2938@TOP@human_GAPDH_TAA_len41_fa10_ta10_fm10_tm10*119*g,0,0,11382,0,11382,1.0,119,2938@TOP@human_GAPDH_TAA_len41_fa10_ta10_fm10_tm10,g
2938@TOP@human_GAPDH_TAA_len41_fa10_ta10_fm10_tm10*120*g,0,0,11351,0,11351,1.0,120,2938@TOP@human_GAPDH_TAA_len41_fa10_ta10_fm10_tm10,g
2938@TOP@human_GAPDH_TAA_len41_fa10_ta10_fm10_tm10*121*a,11457,0,4,1,11462,0.0,121,2938@TOP@human_GAPDH_TAA_len41_fa10_ta10_fm10_tm10,a
2938@TOP@human_GAPDH_TAA_len41_fa10_ta10_fm10_tm10*122*g,0,0,11505,0,11505,1.0,122,2938@TOP@human_GAPDH_TAA_len41_fa10_ta10_fm10_tm10,g
2938@TOP@human_GAPDH_TAA_len41_fa10_ta10_fm10_tm10*123*t,2,0,2,11333,11337,0.0,123,2938@TOP@human_GAPDH_TAA_len41_fa10_ta10_fm10_tm10,t
2938@TOP@human_GAPDH_TAA_len41_fa10_ta10_fm10_tm10*124*a,10648,0,679,0,11327,0.06,124,2938@TOP@human_GAPDH_TAA_len41_fa10_ta10_fm10_tm10,a
2938@TOP@human_GAPDH_TAA_len41_fa10_ta10_fm10_tm10*125*a,10924,0,330,2,11256,0.029,125,2938@TOP@human_GAPDH_TAA_len41_fa10_ta10_fm10_tm10,a
2938@TOP@human_GAPDH_TAA_len41_fa10_ta10_fm10_tm10*126*g,0,0,11346,1,11347,1.0,126,2938@TOP@human_GAPDH_TAA_len41_fa10_ta10_fm10_tm10,g
2938@TOP@human_GAPDH_TAA_len41_fa10_ta10_fm10_tm10*127*a,11432,4,9,0,11445,0.001,127,2938@TOP@human_GAPDH_TAA_len41_fa10_ta10_fm10_tm10,a
2938@TOP@human_GAPDH_TAA_len41_fa10_ta10_fm10_tm10*128*c,0,11510,1,0,11511,0.0,128,2938@TOP@human_GAPDH_TAA_len41_fa10_ta10_fm10_tm10,c
2938@TOP@human_GAPDH_TAA_len41_fa10_ta10_fm10_tm10*129*c,1,11415,0,0,11416,0.0,129,2938@TOP@human_GAPDH_TAA_len41_fa10_ta10_fm10_tm10,c
2938@TOP@human_GAPDH_TAA_len41_fa10_ta10_fm10_tm10*130*c,1,11499,0,1,11501,0.0,130,2938@TOP@human_GAPDH_TAA_len41_fa10_ta10_fm10_tm10,c
2938@TOP@human_GAPDH_TAA_len41_fa10_ta10_fm10_tm10*131*c,1,11508,0,2,11511,0.0,131,2938@TOP@human_GAPDH_TAA_len41_fa10_ta10_fm10_tm10,c
2938@TOP@human_GAPDH_TAA_len41_fa10_ta10_fm10_tm10*132*t,3,8,3,11339,11353,0.0,132,2938@TOP@human_GAPDH_TAA_len41_fa10_ta10_fm10_tm10,t
2938@TOP@human_GAPDH_TAA_len41_fa10_ta10_fm10_tm10*133*g,3,0,11333,1,11337,1.0,133,2938@TOP@human_GAPDH_TAA_len41_fa10_ta10_fm10_tm10,g
2938@TOP@human_GAPDH_TAA_len41_fa10_ta10_fm10_tm10*134*g,4,8,11382,1,11395,0.999,134,2938@TOP@human_GAPDH_TAA_len41_fa10_ta10_fm10_tm10,g
2939@TOP@human_GAPDH_TAA_len41_fa10_ta10_fm10_tm10*114*t,0,0,0,1401,1401,0.0,114,2939@TOP@human_GAPDH_TAA_len41_fa10_ta10_fm10_tm10,t
2939@TOP@human_GAPDH_TAA_len41_fa10_ta10_fm10_tm10*115*c,0,1407,0,0,1407,0.0,115,2939@TOP@human_GAPDH_TAA_len41_fa10_ta10_fm10_tm10,c
2939@TOP@human_GAPDH_TAA_len41_fa10_ta10_fm10_tm10*116*c,0,1402,0,0,1402,0.0,116,2939@TOP@human_GAPDH_TAA_len41_fa10_ta10_fm10_tm10,c
2939@TOP@human_GAPDH_TAA_len41_fa10_ta10_fm10_tm10*117*a,1396,0,7,0,1403,0.005,117,2939@TOP@human_GAPDH_TAA_len41_fa10_ta10_fm10_tm10,a
2939@TOP@human_GAPDH_TAA_len41_fa10_ta10_fm10_tm10*118*a,1333,0,58,0,1391,0.042,118,2939@TOP@human_GAPDH_TAA_len41_fa10_ta10_fm10_tm10,a
2939@TOP@human_GAPDH_TAA_len41_fa10_ta10_fm10_tm10*119*g,0,0,1390,0,1390,1.0,119,2939@TOP@human_GAPDH_TAA_len41_fa10_ta10_fm10_tm10,g
2939@TOP@human_GAPDH_TAA_len41_fa10_ta10_fm10_tm10*120*g,0,0,1384,0,1384,1.0,120,2939@TOP@human_GAPDH_TAA_len41_fa10_ta10_fm10_tm10,g
2939@TOP@human_GAPDH_TAA_len41_fa10_ta10_fm10_tm10*121*a,1397,0,1,0,1398,0.001,121,2939@TOP@human_GAPDH_TAA_len41_fa10_ta10_fm10_tm10,a
2939@TOP@human_GAPDH_TAA_len41_fa10_ta10_fm10_tm10*122*g,0,0,1405,0,1405,1.0,122,2939@TOP@human_GAPDH_TAA_len41_fa10_ta10_fm10_tm10,g
2939@TOP@human_GAPDH_TAA_len41_fa10_ta10_fm10_tm10*123*t,1,0,0,1374,1375,0.0,123,2939@TOP@human_GAPDH_TAA_len41_fa10_ta10_fm10_tm10,t
2939@TOP@human_GAPDH_TAA_len41_fa10_ta10_fm10_tm10*124*a,1209,0,168,0,1377,0.122,124,2939@TOP@human_GAPDH_TAA_len41_fa10_ta10_fm10_tm10,a
2939@TOP@human_GAPDH_TAA_len41_fa10_ta10_fm10_tm10*125*a,1274,0,99,0,1373,0.072,125,2939@TOP@human_GAPDH_TAA_len41_fa10_ta10_fm10_tm10,a
2939@TOP@human_GAPDH_TAA_len41_fa10_ta10_fm10_tm10*126*g,0,0,1389,0,1389,1.0,126,2939@TOP@human_GAPDH_TAA_len41_fa10_ta10_fm10_tm10,g
2939@TOP@human_GAPDH_TAA_len41_fa10_ta10_fm10_tm10*127*a,1393,0,1,0,1394,0.001,127,2939@TOP@human_GAPDH_TAA_len41_fa10_ta10_fm10_tm10,a
2939@TOP@human_GAPDH_TAA_len41_fa10_ta10_fm10_tm10*128*c,0,1405,0,0,1405,0.0,128,2939@TOP@human_GAPDH_TAA_len41_fa10_ta10_fm10_tm10,c
2939@TOP@human_GAPDH_TAA_len41_fa10_ta10_fm10_tm10*129*c,0,1387,0,1,1388,0.0,129,2939@TOP@human_GAPDH_TAA_len41_fa10_ta10_fm10_tm10,c
2939@TOP@human_GAPDH_TAA_len41_fa10_ta10_fm10_tm10*130*c,0,1400,0,0,1400,0.0,130,2939@TOP@human_GAPDH_TAA_len41_fa10_ta10_fm10_tm10,c
2939@TOP@human_GAPDH_TAA_len41_fa10_ta10_fm10_tm10*131*c,0,1407,0,0,1407,0.0,131,2939@TOP@human_GAPDH_TAA_len41_fa10_ta10_fm10_tm10,c
2939@TOP@human_GAPDH_TAA_len41_fa10_ta10_fm10_tm10*132*t,0,0,0,1390,1390,0.0,132,2939@TOP@human_GAPDH_TAA_len41_fa10_ta10_fm10_tm10,t
2939@TOP@human_GAPDH_TAA_len41_fa10_ta10_fm10_tm10*133*g,0,0,1392,0,1392,1.0,133,2939@TOP@human_GAPDH_TAA_len41_fa10_ta10_fm10_tm10,g
2939@TOP@human_GAPDH_TAA_len41_fa10_ta10_fm10_tm10*134*g,0,3,1389,0,1392,0.998,134,2939@TOP@human_GAPDH_TAA_len41_fa10_ta10_fm10_tm10,g
2940@TOP@human_GAPDH_TAA_len41_fa10_ta10_fm10_tm10*114*t,0,0,0,2059,2059,0.0,114,2940@TOP@human_GAPDH_TAA_len41_fa10_ta10_fm10_tm10,t
2940@TOP@human_GAPDH_TAA_len41_fa10_ta10_fm10_tm10*115*c,0,2078,0,0,2078,0.0,115,2940@TOP@human_GAPDH_TAA_len41_fa10_ta10_fm10_tm10,c
2940@TOP@human_GAPDH_TAA_len41_fa10_ta10_fm10_tm10*116*c,1,2065,0,0,2066,0.0,116,2940@TOP@human_GAPDH_TAA_len41_fa10_ta10_fm10_tm10,c
2940@TOP@human_GAPDH_TAA_len41_fa10_ta10_fm10_tm10*117*a,2060,0,4,0,2064,0.002,117,2940@TOP@human_GAPDH_TAA_len41_fa10_ta10_fm10_tm10,a
2940@TOP@human_GAPDH_TAA_len41_fa10_ta10_fm10_tm10*118*a,1980,0,75,0,2055,0.036,118,2940@TOP@human_GAPDH_TAA_len41_fa10_ta10_fm10_tm10,a
2940@TOP@human_GAPDH_TAA_len41_fa10_ta10_fm10_tm10*119*g,0,0,2050,0,2050,1.0,119,2940@TOP@human_GAPDH_TAA_len41_fa10_ta10_fm10_tm10,g
2940@TOP@human_GAPDH_TAA_len41_fa10_ta10_fm10_tm10*120*g,0,0,2045,0,2045,1.0,120,2940@TOP@human_GAPDH_TAA_len41_fa10_ta10_fm10_tm10,g
2940@TOP@human_GAPDH_TAA_len41_fa10_ta10_fm10_tm10*121*a,2063,0,2,0,2065,0.001,121,2940@TOP@human_GAPDH_TAA_len41_fa10_ta10_fm10_tm10,a
2940@TOP@human_GAPDH_TAA_len41_fa10_ta10_fm10_tm10*122*g,0,0,2072,0,2072,1.0,122,2940@TOP@human_GAPDH_TAA_len41_fa10_ta10_fm10_tm10,g
2940@TOP@human_GAPDH_TAA_len41_fa10_ta10_fm10_tm10*123*t,0,0,0,2034,2034,0.0,123,2940@TOP@human_GAPDH_TAA_len41_fa10_ta10_fm10_tm10,t
2940@TOP@human_GAPDH_TAA_len41_fa10_ta10_fm10_tm10*124*a,1555,0,488,0,2043,0.239,124,2940@TOP@human_GAPDH_TAA_len41_fa10_ta10_fm10_tm10,a
2940@TOP@human_GAPDH_TAA_len41_fa10_ta10_fm10_tm10*125*a,1805,0,232,0,2037,0.114,125,2940@TOP@human_GAPDH_TAA_len41_fa10_ta10_fm10_tm10,a
2940@TOP@human_GAPDH_TAA_len41_fa10_ta10_fm10_tm10*126*g,0,0,2045,0,2045,1.0,126,2940@TOP@human_GAPDH_TAA_len41_fa10_ta10_fm10_tm10,g
2940@TOP@human_GAPDH_TAA_len41_fa10_ta10_fm10_tm10*127*a,2059,0,6,0,2065,0.003,127,2940@TOP@human_GAPDH_TAA_len41_fa10_ta10_fm10_tm10,a
2940@TOP@human_GAPDH_TAA_len41_fa10_ta10_fm10_tm10*128*c,0,2073,0,0,2073,0.0,128,2940@TOP@human_GAPDH_TAA_len41_fa10_ta10_fm10_tm10,c
2940@TOP@human_GAPDH_TAA_len41_fa10_ta10_fm10_tm10*129*c,0,2044,0,0,2044,0.0,129,2940@TOP@human_GAPDH_TAA_len41_fa10_ta10_fm10_tm10,c
2940@TOP@human_GAPDH_TAA_len41_fa10_ta10_fm10_tm10*130*c,0,2068,0,0,2068,0.0,130,2940@TOP@human_GAPDH_TAA_len41_fa10_ta10_fm10_tm10,c
2940@TOP@human_GAPDH_TAA_len41_fa10_ta10_fm10_tm10*131*c,0,2076,0,0,2076,0.0,131,2940@TOP@human_GAPDH_TAA_len41_fa10_ta10_fm10_tm10,c
2940@TOP@human_GAPDH_TAA_len41_fa10_ta10_fm10_tm10*132*t,0,0,0,2038,2038,0.0,132,2940@TOP@human_GAPDH_TAA_len41_fa10_ta10_fm10_tm10,t
2940@TOP@human_GAPDH_TAA_len41_fa10_ta10_fm10_tm10*133*g,0,0,2042,0,2042,1.0,133,2940@TOP@human_GAPDH_TAA_len41_fa10_ta10_fm10_tm10,g
2940@TOP@human_GAPDH_TAA_len41_fa10_ta10_fm10_tm10*134*g,0,1,2044,0,2045,1.0,134,2940@TOP@human_GAPDH_TAA_len41_fa10_ta10_fm10_tm10,g
2941@TOP@human_GAPDH_TAA_len41_fa10_ta10_fm10_tm10*114*t,1,7,1,39483,39492,0.0,114,2941@TOP@human_GAPDH_TAA_len41_fa10_ta10_fm10_tm10,t
2941@TOP@human_GAPDH_TAA_len41_fa10_ta10_fm10_tm10*115*c,0,39694,0,0,39694,0.0,115,2941@TOP@human_GAPDH_TAA_len41_fa10_ta10_fm10_tm10,c
2941@TOP@human_GAPDH_TAA_len41_fa10_ta10_fm10_tm10*116*c,0,39537,1,1,39539,0.0,116,2941@TOP@human_GAPDH_TAA_len41_fa10_ta10_fm10_tm10,c
2941@TOP@human_GAPDH_TAA_len41_fa10_ta10_fm10_tm10*117*a,39432,0,80,1,39513,0.002,117,2941@TOP@human_GAPDH_TAA_len41_fa10_ta10_fm10_tm10,a
2941@TOP@human_GAPDH_TAA_len41_fa10_ta10_fm10_tm10*118*a,38613,1,745,0,39359,0.019,118,2941@TOP@human_GAPDH_TAA_len41_fa10_ta10_fm10_tm10,a
2941@TOP@human_GAPDH_TAA_len41_fa10_ta10_fm10_tm10*119*g,0,0,39255,4,39259,1.0,119,2941@TOP@human_GAPDH_TAA_len41_fa10_ta10_fm10_tm10,g
2941@TOP@human_GAPDH_TAA_len41_fa10_ta10_fm10_tm10*120*g,1,0,39063,2,39066,1.0,120,2941@TOP@human_GAPDH_TAA_len41_fa10_ta10_fm10_tm10,g
2941@TOP@human_GAPDH_TAA_len41_fa10_ta10_fm10_tm10*121*a,39392,3,108,0,39503,0.003,121,2941@TOP@human_GAPDH_TAA_len41_fa10_ta10_fm10_tm10,a
2941@TOP@human_GAPDH_TAA_len41_fa10_ta10_fm10_tm10*122*g,0,0,39539,0,39539,1.0,122,2941@TOP@human_GAPDH_TAA_len41_fa10_ta10_fm10_tm10,g
2941@TOP@human_GAPDH_TAA_len41_fa10_ta10_fm10_tm10*123*t,7,11,2,38993,39013,0.0,123,2941@TOP@human_GAPDH_TAA_len41_fa10_ta10_fm10_tm10,t
2941@TOP@human_GAPDH_TAA_len41_fa10_ta10_fm10_tm10*124*a,32566,2,6452,0,39020,0.165,124,2941@TOP@human_GAPDH_TAA_len41_fa10_ta10_fm10_tm10,a
2941@TOP@human_GAPDH_TAA_len41_fa10_ta10_fm10_tm10*125*a,38347,3,629,2,38981,0.016,125,2941@TOP@human_GAPDH_TAA_len41_fa10_ta10_fm10_tm10,a
2941@TOP@human_GAPDH_TAA_len41_fa10_ta10_fm10_tm10*126*g,0,0,39048,2,39050,1.0,126,2941@TOP@human_GAPDH_TAA_len41_fa10_ta10_fm10_tm10,g
2941@TOP@human_GAPDH_TAA_len41_fa10_ta10_fm10_tm10*127*a,39309,0,113,1,39423,0.003,127,2941@TOP@human_GAPDH_TAA_len41_fa10_ta10_fm10_tm10,a
2941@TOP@human_GAPDH_TAA_len41_fa10_ta10_fm10_tm10*128*c,0,39605,1,5,39611,0.0,128,2941@TOP@human_GAPDH_TAA_len41_fa10_ta10_fm10_tm10,c
2941@TOP@human_GAPDH_TAA_len41_fa10_ta10_fm10_tm10*129*c,4,39310,0,3,39317,0.0,129,2941@TOP@human_GAPDH_TAA_len41_fa10_ta10_fm10_tm10,c
2941@TOP@human_GAPDH_TAA_len41_fa10_ta10_fm10_tm10*130*c,3,39530,3,2,39538,0.0,130,2941@TOP@human_GAPDH_TAA_len41_fa10_ta10_fm10_tm10,c
2941@TOP@human_GAPDH_TAA_len41_fa10_ta10_fm10_tm10*131*c,1,39614,0,2,39617,0.0,131,2941@TOP@human_GAPDH_TAA_len41_fa10_ta10_fm10_tm10,c
2941@TOP@human_GAPDH_TAA_len41_fa10_ta10_fm10_tm10*132*t,2,6,1,39107,39116,0.0,132,2941@TOP@human_GAPDH_TAA_len41_fa10_ta10_fm10_tm10,t
2941@TOP@human_GAPDH_TAA_len41_fa10_ta10_fm10_tm10*133*g,2,0,38963,3,38968,1.0,133,2941@TOP@human_GAPDH_TAA_len41_fa10_ta10_fm10_tm10,g
2941@TOP@human_GAPDH_TAA_len41_fa10_ta10_fm10_tm10*134*g,2,2,39184,1,39189,1.0,134,2941@TOP@human_GAPDH_TAA_len41_fa10_ta10_fm10_tm10,g
2942@TOP@human_GAPDH_TAA_len41_fa10_ta10_fm10_tm10*114*t,0,1,0,1562,1563,0.0,114,2942@TOP@human_GAPDH_TAA_len41_fa10_ta10_fm10_tm10,t
2942@TOP@human_GAPDH_TAA_len41_fa10_ta10_fm10_tm10*115*c,0,1574,0,0,1574,0.0,115,2942@TOP@human_GAPDH_TAA_len41_fa10_ta10_fm10_tm10,c
2942@TOP@human_GAPDH_TAA_len41_fa10_ta10_fm10_tm10*116*c,1,1568,0,0,1569,0.0,116,2942@TOP@human_GAPDH_TAA_len41_fa10_ta10_fm10_tm10,c
2942@TOP@human_GAPDH_TAA_len41_fa10_ta10_fm10_tm10*117*a,1564,0,5,0,1569,0.003,117,2942@TOP@human_GAPDH_TAA_len41_fa10_ta10_fm10_tm10,a
2942@TOP@human_GAPDH_TAA_len41_fa10_ta10_fm10_tm10*118*a,1470,0,91,0,1561,0.058,118,2942@TOP@human_GAPDH_TAA_len41_fa10_ta10_fm10_tm10,a
2942@TOP@human_GAPDH_TAA_len41_fa10_ta10_fm10_tm10*119*g,0,0,1555,0,1555,1.0,119,2942@TOP@human_GAPDH_TAA_len41_fa10_ta10_fm10_tm10,g
2942@TOP@human_GAPDH_TAA_len41_fa10_ta10_fm10_tm10*120*g,0,0,1557,0,1557,1.0,120,2942@TOP@human_GAPDH_TAA_len41_fa10_ta10_fm10_tm10,g
2942@TOP@human_GAPDH_TAA_len41_fa10_ta10_fm10_tm10*121*a,1562,0,0,0,1562,0.0,121,2942@TOP@human_GAPDH_TAA_len41_fa10_ta10_fm10_tm10,a
2942@TOP@human_GAPDH_TAA_len41_fa10_ta10_fm10_tm10*122*g,0,0,1569,0,1569,1.0,122,2942@TOP@human_GAPDH_TAA_len41_fa10_ta10_fm10_tm10,g
2942@TOP@human_GAPDH_TAA_len41_fa10_ta10_fm10_tm10*123*t,0,0,0,1550,1550,0.0,123,2942@TOP@human_GAPDH_TAA_len41_fa10_ta10_fm10_tm10,t
2942@TOP@human_GAPDH_TAA_len41_fa10_ta10_fm10_tm10*124*a,1364,0,180,0,1544,0.117,124,2942@TOP@human_GAPDH_TAA_len41_fa10_ta10_fm10_tm10,a
2942@TOP@human_GAPDH_TAA_len41_fa10_ta10_fm10_tm10*125*a,1467,0,71,0,1538,0.046,125,2942@TOP@human_GAPDH_TAA_len41_fa10_ta10_fm10_tm10,a
2942@TOP@human_GAPDH_TAA_len41_fa10_ta10_fm10_tm10*126*g,1,0,1554,0,1555,0.999,126,2942@TOP@human_GAPDH_TAA_len41_fa10_ta10_fm10_tm10,g
2942@TOP@human_GAPDH_TAA_len41_fa10_ta10_fm10_tm10*127*a,1560,0,0,0,1560,0.0,127,2942@TOP@human_GAPDH_TAA_len41_fa10_ta10_fm10_tm10,a
2942@TOP@human_GAPDH_TAA_len41_fa10_ta10_fm10_tm10*128*c,0,1572,0,0,1572,0.0,128,2942@TOP@human_GAPDH_TAA_len41_fa10_ta10_fm10_tm10,c
2942@TOP@human_GAPDH_TAA_len41_fa10_ta10_fm10_tm10*129*c,0,1555,0,0,1555,0.0,129,2942@TOP@human_GAPDH_TAA_len41_fa10_ta10_fm10_tm10,c
2942@TOP@human_GAPDH_TAA_len41_fa10_ta10_fm10_tm10*130*c,1,1564,0,0,1565,0.0,130,2942@TOP@human_GAPDH_TAA_len41_fa10_ta10_fm10_tm10,c
2942@TOP@human_GAPDH_TAA_len41_fa10_ta10_fm10_tm10*131*c,0,1572,0,0,1572,0.0,131,2942@TOP@human_GAPDH_TAA_len41_fa10_ta10_fm10_tm10,c
2942@TOP@human_GAPDH_TAA_len41_fa10_ta10_fm10_tm10*132*t,0,0,0,1555,1555,0.0,132,2942@TOP@human_GAPDH_TAA_len41_fa10_ta10_fm10_tm10,t
2942@TOP@human_GAPDH_TAA_len41_fa10_ta10_fm10_tm10*133*g,0,0,1551,0,1551,1.0,133,2942@TOP@human_GAPDH_TAA_len41_fa10_ta10_fm10_tm10,g
2942@TOP@human_GAPDH_TAA_len41_fa10_ta10_fm10_tm10*134*g,0,0,1561,0,1561,1.0,134,2942@TOP@human_GAPDH_TAA_len41_fa10_ta10_fm10_tm10,g
2943@TOP@human_GAPDH_TAA_len41_fa10_ta10_fm10_tm10*114*t,3,1,0,3573,3577,0.0,114,2943@TOP@human_GAPDH_TAA_len41_fa10_ta10_fm10_tm10,t
2943@TOP@human_GAPDH_TAA_len41_fa10_ta10_fm10_tm10*115*c,0,3591,3,1,3595,0.001,115,2943@TOP@human_GAPDH_TAA_len41_fa10_ta10_fm10_tm10,c
2943@TOP@human_GAPDH_TAA_len41_fa10_ta10_fm10_tm10*116*c,0,3578,0,0,3578,0.0,116,2943@TOP@human_GAPDH_TAA_len41_fa10_ta10_fm10_tm10,c
2943@TOP@human_GAPDH_TAA_len41_fa10_ta10_fm10_tm10*117*a,3565,0,7,0,3572,0.002,117,2943@TOP@human_GAPDH_TAA_len41_fa10_ta10_fm10_tm10,a
2943@TOP@human_GAPDH_TAA_len41_fa10_ta10_fm10_tm10*118*a,3444,0,118,0,3562,0.033,118,2943@TOP@human_GAPDH_TAA_len41_fa10_ta10_fm10_tm10,a
2943@TOP@human_GAPDH_TAA_len41_fa10_ta10_fm10_tm10*119*g,0,0,3547,0,3547,1.0,119,2943@TOP@human_GAPDH_TAA_len41_fa10_ta10_fm10_tm10,g
2943@TOP@human_GAPDH_TAA_len41_fa10_ta10_fm10_tm10*120*g,2,0,3535,0,3537,0.999,120,2943@TOP@human_GAPDH_TAA_len41_fa10_ta10_fm10_tm10,g
2943@TOP@human_GAPDH_TAA_len41_fa10_ta10_fm10_tm10*121*a,3570,0,2,0,3572,0.001,121,2943@TOP@human_GAPDH_TAA_len41_fa10_ta10_fm10_tm10,a
2943@TOP@human_GAPDH_TAA_len41_fa10_ta10_fm10_tm10*122*g,0,0,3580,0,3580,1.0,122,2943@TOP@human_GAPDH_TAA_len41_fa10_ta10_fm10_tm10,g
2943@TOP@human_GAPDH_TAA_len41_fa10_ta10_fm10_tm10*123*t,0,3,1,3521,3525,0.0,123,2943@TOP@human_GAPDH_TAA_len41_fa10_ta10_fm10_tm10,t
2943@TOP@human_GAPDH_TAA_len41_fa10_ta10_fm10_tm10*124*a,3309,0,214,0,3523,0.061,124,2943@TOP@human_GAPDH_TAA_len41_fa10_ta10_fm10_tm10,a
2943@TOP@human_GAPDH_TAA_len41_fa10_ta10_fm10_tm10*125*a,3401,0,129,0,3530,0.037,125,2943@TOP@human_GAPDH_TAA_len41_fa10_ta10_fm10_tm10,a
2943@TOP@human_GAPDH_TAA_len41_fa10_ta10_fm10_tm10*126*g,1,0,3530,0,3531,1.0,126,2943@TOP@human_GAPDH_TAA_len41_fa10_ta10_fm10_tm10,g
2943@TOP@human_GAPDH_TAA_len41_fa10_ta10_fm10_tm10*127*a,3571,1,3,0,3575,0.001,127,2943@TOP@human_GAPDH_TAA_len41_fa10_ta10_fm10_tm10,a
2943@TOP@human_GAPDH_TAA_len41_fa10_ta10_fm10_tm10*128*c,0,3582,0,0,3582,0.0,128,2943@TOP@human_GAPDH_TAA_len41_fa10_ta10_fm10_tm10,c
2943@TOP@human_GAPDH_TAA_len41_fa10_ta10_fm10_tm10*129*c,0,3566,0,0,3566,0.0,129,2943@TOP@human_GAPDH_TAA_len41_fa10_ta10_fm10_tm10,c
2943@TOP@human_GAPDH_TAA_len41_fa10_ta10_fm10_tm10*130*c,0,3578,0,0,3578,0.0,130,2943@TOP@human_GAPDH_TAA_len41_fa10_ta10_fm10_tm10,c
2943@TOP@human_GAPDH_TAA_len41_fa10_ta10_fm10_tm10*131*c,0,3587,0,0,3587,0.0,131,2943@TOP@human_GAPDH_TAA_len41_fa10_ta10_fm10_tm10,c
2943@TOP@human_GAPDH_TAA_len41_fa10_ta10_fm10_tm10*132*t,1,0,0,3549,3550,0.0,132,2943@TOP@human_GAPDH_TAA_len41_fa10_ta10_fm10_tm10,t
2943@TOP@human_GAPDH_TAA_len41_fa10_ta10_fm10_tm10*133*g,0,0,3529,0,3529,1.0,133,2943@TOP@human_GAPDH_TAA_len41_fa10_ta10_fm10_tm10,g
2943@TOP@human_GAPDH_TAA_len41_fa10_ta10_fm10_tm10*134*g,0,4,3548,0,3552,0.999,134,2943@TOP@human_GAPDH_TAA_len41_fa10_ta10_fm10_tm10,g
2944@TOP@human_GAPDH_TAA_len41_fa10_ta10_fm10_tm10*114*t,3,7,0,18299,18309,0.0,114,2944@TOP@human_GAPDH_TAA_len41_fa10_ta10_fm10_tm10,t
2944@TOP@human_GAPDH_TAA_len41_fa10_ta10_fm10_tm10*115*c,1,18414,0,0,18415,0.0,115,2944@TOP@human_GAPDH_TAA_len41_fa10_ta10_fm10_tm10,c
2944@TOP@human_GAPDH_TAA_len41_fa10_ta10_fm10_tm10*116*c,0,18346,0,0,18346,0.0,116,2944@TOP@human_GAPDH_TAA_len41_fa10_ta10_fm10_tm10,c
2944@TOP@human_GAPDH_TAA_len41_fa10_ta10_fm10_tm10*117*a,18314,1,24,0,18339,0.001,117,2944@TOP@human_GAPDH_TAA_len41_fa10_ta10_fm10_tm10,a
2944@TOP@human_GAPDH_TAA_len41_fa10_ta10_fm10_tm10*118*a,18029,1,200,0,18230,0.011,118,2944@TOP@human_GAPDH_TAA_len41_fa10_ta10_fm10_tm10,a
2944@TOP@human_GAPDH_TAA_len41_fa10_ta10_fm10_tm10*119*g,1,0,18181,3,18185,1.0,119,2944@TOP@human_GAPDH_TAA_len41_fa10_ta10_fm10_tm10,g
2944@TOP@human_GAPDH_TAA_len41_fa10_ta10_fm10_tm10*120*g,1,1,18140,0,18142,1.0,120,2944@TOP@human_GAPDH_TAA_len41_fa10_ta10_fm10_tm10,g
2944@TOP@human_GAPDH_TAA_len41_fa10_ta10_fm10_tm10*121*a,18299,0,5,0,18304,0.0,121,2944@TOP@human_GAPDH_TAA_len41_fa10_ta10_fm10_tm10,a
2944@TOP@human_GAPDH_TAA_len41_fa10_ta10_fm10_tm10*122*g,1,1,18327,0,18329,1.0,122,2944@TOP@human_GAPDH_TAA_len41_fa10_ta10_fm10_tm10,g
2944@TOP@human_GAPDH_TAA_len41_fa10_ta10_fm10_tm10*123*t,2,3,6,18077,18088,0.0,123,2944@TOP@human_GAPDH_TAA_len41_fa10_ta10_fm10_tm10,t
2944@TOP@human_GAPDH_TAA_len41_fa10_ta10_fm10_tm10*124*a,17523,0,512,0,18035,0.028,124,2944@TOP@human_GAPDH_TAA_len41_fa10_ta10_fm10_tm10,a
2944@TOP@human_GAPDH_TAA_len41_fa10_ta10_fm10_tm10*125*a,17782,0,228,3,18013,0.013,125,2944@TOP@human_GAPDH_TAA_len41_fa10_ta10_fm10_tm10,a
2944@TOP@human_GAPDH_TAA_len41_fa10_ta10_fm10_tm10*126*g,0,0,18090,1,18091,1.0,126,2944@TOP@human_GAPDH_TAA_len41_fa10_ta10_fm10_tm10,g
2944@TOP@human_GAPDH_TAA_len41_fa10_ta10_fm10_tm10*127*a,18259,0,18,1,18278,0.001,127,2944@TOP@human_GAPDH_TAA_len41_fa10_ta10_fm10_tm10,a
2944@TOP@human_GAPDH_TAA_len41_fa10_ta10_fm10_tm10*128*c,0,18371,2,1,18374,0.0,128,2944@TOP@human_GAPDH_TAA_len41_fa10_ta10_fm10_tm10,c
2944@TOP@human_GAPDH_TAA_len41_fa10_ta10_fm10_tm10*129*c,2,18227,0,0,18229,0.0,129,2944@TOP@human_GAPDH_TAA_len41_fa10_ta10_fm10_tm10,c
2944@TOP@human_GAPDH_TAA_len41_fa10_ta10_fm10_tm10*130*c,1,18326,0,0,18327,0.0,130,2944@TOP@human_GAPDH_TAA_len41_fa10_ta10_fm10_tm10,c
2944@TOP@human_GAPDH_TAA_len41_fa10_ta10_fm10_tm10*131*c,1,18380,0,4,18385,0.0,131,2944@TOP@human_GAPDH_TAA_len41_fa10_ta10_fm10_tm10,c
2944@TOP@human_GAPDH_TAA_len41_fa10_ta10_fm10_tm10*132*t,4,4,0,18093,18101,0.0,132,2944@TOP@human_GAPDH_TAA_len41_fa10_ta10_fm10_tm10,t
2944@TOP@human_GAPDH_TAA_len41_fa10_ta10_fm10_tm10*133*g,1,1,18072,1,18075,1.0,133,2944@TOP@human_GAPDH_TAA_len41_fa10_ta10_fm10_tm10,g
2944@TOP@human_GAPDH_TAA_len41_fa10_ta10_fm10_tm10*134*g,0,9,18171,1,18181,0.999,134,2944@TOP@human_GAPDH_TAA_len41_fa10_ta10_fm10_tm10,g
2945@TOP@human_GAPDH_TAA_len41_fa10_ta10_fm10_tm10*114*t,1,0,0,5549,5550,0.0,114,2945@TOP@human_GAPDH_TAA_len41_fa10_ta10_fm10_tm10,t
2945@TOP@human_GAPDH_TAA_len41_fa10_ta10_fm10_tm10*115*c,0,5579,0,0,5579,0.0,115,2945@TOP@human_GAPDH_TAA_len41_fa10_ta10_fm10_tm10,c
2945@TOP@human_GAPDH_TAA_len41_fa10_ta10_fm10_tm10*116*c,0,5556,0,0,5556,0.0,116,2945@TOP@human_GAPDH_TAA_len41_fa10_ta10_fm10_tm10,c
2945@TOP@human_GAPDH_TAA_len41_fa10_ta10_fm10_tm10*117*a,5530,0,30,0,5560,0.005,117,2945@TOP@human_GAPDH_TAA_len41_fa10_ta10_fm10_tm10,a
2945@TOP@human_GAPDH_TAA_len41_fa10_ta10_fm10_tm10*118*a,5174,0,339,0,5513,0.061,118,2945@TOP@human_GAPDH_TAA_len41_fa10_ta10_fm10_tm10,a
2945@TOP@human_GAPDH_TAA_len41_fa10_ta10_fm10_tm10*119*g,0,0,5522,1,5523,1.0,119,2945@TOP@human_GAPDH_TAA_len41_fa10_ta10_fm10_tm10,g
2945@TOP@human_GAPDH_TAA_len41_fa10_ta10_fm10_tm10*120*g,1,0,5478,1,5480,1.0,120,2945@TOP@human_GAPDH_TAA_len41_fa10_ta10_fm10_tm10,g
2945@TOP@human_GAPDH_TAA_len41_fa10_ta10_fm10_tm10*121*a,5549,0,5,0,5554,0.001,121,2945@TOP@human_GAPDH_TAA_len41_fa10_ta10_fm10_tm10,a
2945@TOP@human_GAPDH_TAA_len41_fa10_ta10_fm10_tm10*122*g,0,0,5556,3,5559,0.999,122,2945@TOP@human_GAPDH_TAA_len41_fa10_ta10_fm10_tm10,g
2945@TOP@human_GAPDH_TAA_len41_fa10_ta10_fm10_tm10*123*t,1,2,0,5485,5488,0.0,123,2945@TOP@human_GAPDH_TAA_len41_fa10_ta10_fm10_tm10,t
2945@TOP@human_GAPDH_TAA_len41_fa10_ta10_fm10_tm10*124*a,4999,0,470,0,5469,0.086,124,2945@TOP@human_GAPDH_TAA_len41_fa10_ta10_fm10_tm10,a
2945@TOP@human_GAPDH_TAA_len41_fa10_ta10_fm10_tm10*125*a,5170,0,274,0,5444,0.05,125,2945@TOP@human_GAPDH_TAA_len41_fa10_ta10_fm10_tm10,a
2945@TOP@human_GAPDH_TAA_len41_fa10_ta10_fm10_tm10*126*g,0,0,5470,0,5470,1.0,126,2945@TOP@human_GAPDH_TAA_len41_fa10_ta10_fm10_tm10,g
2945@TOP@human_GAPDH_TAA_len41_fa10_ta10_fm10_tm10*127*a,5531,0,4,0,5535,0.001,127,2945@TOP@human_GAPDH_TAA_len41_fa10_ta10_fm10_tm10,a
2945@TOP@human_GAPDH_TAA_len41_fa10_ta10_fm10_tm10*128*c,5,5562,0,0,5567,0.0,128,2945@TOP@human_GAPDH_TAA_len41_fa10_ta10_fm10_tm10,c
2945@TOP@human_GAPDH_TAA_len41_fa10_ta10_fm10_tm10*129*c,1,5524,0,0,5525,0.0,129,2945@TOP@human_GAPDH_TAA_len41_fa10_ta10_fm10_tm10,c
2945@TOP@human_GAPDH_TAA_len41_fa10_ta10_fm10_tm10*130*c,0,5561,0,1,5562,0.0,130,2945@TOP@human_GAPDH_TAA_len41_fa10_ta10_fm10_tm10,c
2945@TOP@human_GAPDH_TAA_len41_fa10_ta10_fm10_tm10*131*c,3,5567,0,1,5571,0.0,131,2945@TOP@human_GAPDH_TAA_len41_fa10_ta10_fm10_tm10,c
2945@TOP@human_GAPDH_TAA_len41_fa10_ta10_fm10_tm10*132*t,2,2,0,5496,5500,0.0,132,2945@TOP@human_GAPDH_TAA_len41_fa10_ta10_fm10_tm10,t
2945@TOP@human_GAPDH_TAA_len41_fa10_ta10_fm10_tm10*133*g,1,0,5492,0,5493,1.0,133,2945@TOP@human_GAPDH_TAA_len41_fa10_ta10_fm10_tm10,g
2945@TOP@human_GAPDH_TAA_len41_fa10_ta10_fm10_tm10*134*g,0,2,5512,0,5514,1.0,134,2945@TOP@human_GAPDH_TAA_len41_fa10_ta10_fm10_tm10,g
2946@TOP@human_GAPDH_TAA_len41_fa10_ta10_fm10_tm10*114*t,2,0,0,8710,8712,0.0,114,2946@TOP@human_GAPDH_TAA_len41_fa10_ta10_fm10_tm10,t
2946@TOP@human_GAPDH_TAA_len41_fa10_ta10_fm10_tm10*115*c,2,8754,0,0,8756,0.0,115,2946@TOP@human_GAPDH_TAA_len41_fa10_ta10_fm10_tm10,c
2946@TOP@human_GAPDH_TAA_len41_fa10_ta10_fm10_tm10*116*c,0,8721,0,0,8721,0.0,116,2946@TOP@human_GAPDH_TAA_len41_fa10_ta10_fm10_tm10,c
2946@TOP@human_GAPDH_TAA_len41_fa10_ta10_fm10_tm10*117*a,8701,0,25,0,8726,0.003,117,2946@TOP@human_GAPDH_TAA_len41_fa10_ta10_fm10_tm10,a
2946@TOP@human_GAPDH_TAA_len41_fa10_ta10_fm10_tm10*118*a,8183,0,510,0,8693,0.059,118,2946@TOP@human_GAPDH_TAA_len41_fa10_ta10_fm10_tm10,a
2946@TOP@human_GAPDH_TAA_len41_fa10_ta10_fm10_tm10*119*g,0,0,8656,0,8656,1.0,119,2946@TOP@human_GAPDH_TAA_len41_fa10_ta10_fm10_tm10,g
2946@TOP@human_GAPDH_TAA_len41_fa10_ta10_fm10_tm10*120*g,1,0,8628,0,8629,1.0,120,2946@TOP@human_GAPDH_TAA_len41_fa10_ta10_fm10_tm10,g
2946@TOP@human_GAPDH_TAA_len41_fa10_ta10_fm10_tm10*121*a,8701,0,2,0,8703,0.0,121,2946@TOP@human_GAPDH_TAA_len41_fa10_ta10_fm10_tm10,a
2946@TOP@human_GAPDH_TAA_len41_fa10_ta10_fm10_tm10*122*g,0,0,8727,0,8727,1.0,122,2946@TOP@human_GAPDH_TAA_len41_fa10_ta10_fm10_tm10,g
2946@TOP@human_GAPDH_TAA_len41_fa10_ta10_fm10_tm10*123*t,4,0,1,8617,8622,0.0,123,2946@TOP@human_GAPDH_TAA_len41_fa10_ta10_fm10_tm10,t
2946@TOP@human_GAPDH_TAA_len41_fa10_ta10_fm10_tm10*124*a,7552,0,1046,0,8598,0.122,124,2946@TOP@human_GAPDH_TAA_len41_fa10_ta10_fm10_tm10,a
2946@TOP@human_GAPDH_TAA_len41_fa10_ta10_fm10_tm10*125*a,8212,0,370,0,8582,0.043,125,2946@TOP@human_GAPDH_TAA_len41_fa10_ta10_fm10_tm10,a
2946@TOP@human_GAPDH_TAA_len41_fa10_ta10_fm10_tm10*126*g,0,0,8624,1,8625,1.0,126,2946@TOP@human_GAPDH_TAA_len41_fa10_ta10_fm10_tm10,g
2946@TOP@human_GAPDH_TAA_len41_fa10_ta10_fm10_tm10*127*a,8674,0,8,0,8682,0.001,127,2946@TOP@human_GAPDH_TAA_len41_fa10_ta10_fm10_tm10,a
2946@TOP@human_GAPDH_TAA_len41_fa10_ta10_fm10_tm10*128*c,0,8735,4,0,8739,0.0,128,2946@TOP@human_GAPDH_TAA_len41_fa10_ta10_fm10_tm10,c
2946@TOP@human_GAPDH_TAA_len41_fa10_ta10_fm10_tm10*129*c,1,8676,0,0,8677,0.0,129,2946@TOP@human_GAPDH_TAA_len41_fa10_ta10_fm10_tm10,c
2946@TOP@human_GAPDH_TAA_len41_fa10_ta10_fm10_tm10*130*c,2,8724,0,2,8728,0.0,130,2946@TOP@human_GAPDH_TAA_len41_fa10_ta10_fm10_tm10,c
2946@TOP@human_GAPDH_TAA_len41_fa10_ta10_fm10_tm10*131*c,2,8743,0,0,8745,0.0,131,2946@TOP@human_GAPDH_TAA_len41_fa10_ta10_fm10_tm10,c
2946@TOP@human_GAPDH_TAA_len41_fa10_ta10_fm10_tm10*132*t,1,1,0,8618,8620,0.0,132,2946@TOP@human_GAPDH_TAA_len41_fa10_ta10_fm10_tm10,t
2946@TOP@human_GAPDH_TAA_len41_fa10_ta10_fm10_tm10*133*g,0,1,8599,0,8600,1.0,133,2946@TOP@human_GAPDH_TAA_len41_fa10_ta10_fm10_tm10,g
2946@TOP@human_GAPDH_TAA_len41_fa10_ta10_fm10_tm10*134*g,0,1,8651,0,8652,1.0,134,2946@TOP@human_GAPDH_TAA_len41_fa10_ta10_fm10_tm10,g
2947@TOP@human_GAPDH_TAA_len41_fa10_ta10_fm10_tm10*114*t,0,0,0,2034,2034,0.0,114,2947@TOP@human_GAPDH_TAA_len41_fa10_ta10_fm10_tm10,t
2947@TOP@human_GAPDH_TAA_len41_fa10_ta10_fm10_tm10*115*c,0,2053,0,0,2053,0.0,115,2947@TOP@human_GAPDH_TAA_len41_fa10_ta10_fm10_tm10,c
2947@TOP@human_GAPDH_TAA_len41_fa10_ta10_fm10_tm10*116*c,0,2042,0,0,2042,0.0,116,2947@TOP@human_GAPDH_TAA_len41_fa10_ta10_fm10_tm10,c
2947@TOP@human_GAPDH_TAA_len41_fa10_ta10_fm10_tm10*117*a,2026,0,15,0,2041,0.007,117,2947@TOP@human_GAPDH_TAA_len41_fa10_ta10_fm10_tm10,a
2947@TOP@human_GAPDH_TAA_len41_fa10_ta10_fm10_tm10*118*a,1855,0,170,0,2025,0.084,118,2947@TOP@human_GAPDH_TAA_len41_fa10_ta10_fm10_tm10,a
2947@TOP@human_GAPDH_TAA_len41_fa10_ta10_fm10_tm10*119*g,0,0,2029,0,2029,1.0,119,2947@TOP@human_GAPDH_TAA_len41_fa10_ta10_fm10_tm10,g
2947@TOP@human_GAPDH_TAA_len41_fa10_ta10_fm10_tm10*120*g,3,0,2004,0,2007,0.999,120,2947@TOP@human_GAPDH_TAA_len41_fa10_ta10_fm10_tm10,g
2947@TOP@human_GAPDH_TAA_len41_fa10_ta10_fm10_tm10*121*a,2037,0,1,0,2038,0.0,121,2947@TOP@human_GAPDH_TAA_len41_fa10_ta10_fm10_tm10,a
2947@TOP@human_GAPDH_TAA_len41_fa10_ta10_fm10_tm10*122*g,0,0,2042,0,2042,1.0,122,2947@TOP@human_GAPDH_TAA_len41_fa10_ta10_fm10_tm10,g
2947@TOP@human_GAPDH_TAA_len41_fa10_ta10_fm10_tm10*123*t,1,0,0,2003,2004,0.0,123,2947@TOP@human_GAPDH_TAA_len41_fa10_ta10_fm10_tm10,t
2947@TOP@human_GAPDH_TAA_len41_fa10_ta10_fm10_tm10*124*a,1763,0,251,0,2014,0.125,124,2947@TOP@human_GAPDH_TAA_len41_fa10_ta10_fm10_tm10,a
2947@TOP@human_GAPDH_TAA_len41_fa10_ta10_fm10_tm10*125*a,1888,0,97,0,1985,0.049,125,2947@TOP@human_GAPDH_TAA_len41_fa10_ta10_fm10_tm10,a
2947@TOP@human_GAPDH_TAA_len41_fa10_ta10_fm10_tm10*126*g,0,0,2012,0,2012,1.0,126,2947@TOP@human_GAPDH_TAA_len41_fa10_ta10_fm10_tm10,g
2947@TOP@human_GAPDH_TAA_len41_fa10_ta10_fm10_tm10*127*a,2031,0,4,0,2035,0.002,127,2947@TOP@human_GAPDH_TAA_len41_fa10_ta10_fm10_tm10,a
2947@TOP@human_GAPDH_TAA_len41_fa10_ta10_fm10_tm10*128*c,0,2047,0,0,2047,0.0,128,2947@TOP@human_GAPDH_TAA_len41_fa10_ta10_fm10_tm10,c
2947@TOP@human_GAPDH_TAA_len41_fa10_ta10_fm10_tm10*129*c,0,2031,0,0,2031,0.0,129,2947@TOP@human_GAPDH_TAA_len41_fa10_ta10_fm10_tm10,c
2947@TOP@human_GAPDH_TAA_len41_fa10_ta10_fm10_tm10*130*c,0,2047,0,0,2047,0.0,130,2947@TOP@human_GAPDH_TAA_len41_fa10_ta10_fm10_tm10,c
2947@TOP@human_GAPDH_TAA_len41_fa10_ta10_fm10_tm10*131*c,1,2044,0,0,2045,0.0,131,2947@TOP@human_GAPDH_TAA_len41_fa10_ta10_fm10_tm10,c
2947@TOP@human_GAPDH_TAA_len41_fa10_ta10_fm10_tm10*132*t,0,0,0,2007,2007,0.0,132,2947@TOP@human_GAPDH_TAA_len41_fa10_ta10_fm10_tm10,t
2947@TOP@human_GAPDH_TAA_len41_fa10_ta10_fm10_tm10*133*g,0,0,1999,1,2000,1.0,133,2947@TOP@human_GAPDH_TAA_len41_fa10_ta10_fm10_tm10,g
2947@TOP@human_GAPDH_TAA_len41_fa10_ta10_fm10_tm10*134*g,2,0,2017,0,2019,0.999,134,2947@TOP@human_GAPDH_TAA_len41_fa10_ta10_fm10_tm10,g
2948@TOP@human_GAPDH_TAA_len41_fa10_ta10_fm10_tm10*114*t,0,1,0,2747,2748,0.0,114,2948@TOP@human_GAPDH_TAA_len41_fa10_ta10_fm10_tm10,t
2948@TOP@human_GAPDH_TAA_len41_fa10_ta10_fm10_tm10*115*c,1,2753,0,0,2754,0.0,115,2948@TOP@human_GAPDH_TAA_len41_fa10_ta10_fm10_tm10,c
2948@TOP@human_GAPDH_TAA_len41_fa10_ta10_fm10_tm10*116*c,0,2744,0,0,2744,0.0,116,2948@TOP@human_GAPDH_TAA_len41_fa10_ta10_fm10_tm10,c
2948@TOP@human_GAPDH_TAA_len41_fa10_ta10_fm10_tm10*117*a,2715,0,26,0,2741,0.009,117,2948@TOP@human_GAPDH_TAA_len41_fa10_ta10_fm10_tm10,a
2948@TOP@human_GAPDH_TAA_len41_fa10_ta10_fm10_tm10*118*a,2051,0,673,0,2724,0.247,118,2948@TOP@human_GAPDH_TAA_len41_fa10_ta10_fm10_tm10,a
2948@TOP@human_GAPDH_TAA_len41_fa10_ta10_fm10_tm10*119*g,0,0,2722,0,2722,1.0,119,2948@TOP@human_GAPDH_TAA_len41_fa10_ta10_fm10_tm10,g
2948@TOP@human_GAPDH_TAA_len41_fa10_ta10_fm10_tm10*120*g,0,0,2714,0,2714,1.0,120,2948@TOP@human_GAPDH_TAA_len41_fa10_ta10_fm10_tm10,g
2948@TOP@human_GAPDH_TAA_len41_fa10_ta10_fm10_tm10*121*a,2723,0,3,0,2726,0.001,121,2948@TOP@human_GAPDH_TAA_len41_fa10_ta10_fm10_tm10,a
2948@TOP@human_GAPDH_TAA_len41_fa10_ta10_fm10_tm10*122*g,0,0,2747,0,2747,1.0,122,2948@TOP@human_GAPDH_TAA_len41_fa10_ta10_fm10_tm10,g
2948@TOP@human_GAPDH_TAA_len41_fa10_ta10_fm10_tm10*123*t,0,11,0,2703,2714,0.0,123,2948@TOP@human_GAPDH_TAA_len41_fa10_ta10_fm10_tm10,t
2948@TOP@human_GAPDH_TAA_len41_fa10_ta10_fm10_tm10*124*a,1836,0,869,0,2705,0.321,124,2948@TOP@human_GAPDH_TAA_len41_fa10_ta10_fm10_tm10,a
2948@TOP@human_GAPDH_TAA_len41_fa10_ta10_fm10_tm10*125*a,2085,0,624,0,2709,0.23,125,2948@TOP@human_GAPDH_TAA_len41_fa10_ta10_fm10_tm10,a
2948@TOP@human_GAPDH_TAA_len41_fa10_ta10_fm10_tm10*126*g,0,1,2711,0,2712,1.0,126,2948@TOP@human_GAPDH_TAA_len41_fa10_ta10_fm10_tm10,g
2948@TOP@human_GAPDH_TAA_len41_fa10_ta10_fm10_tm10*127*a,2715,0,14,0,2729,0.005,127,2948@TOP@human_GAPDH_TAA_len41_fa10_ta10_fm10_tm10,a
2948@TOP@human_GAPDH_TAA_len41_fa10_ta10_fm10_tm10*128*c,2,2748,0,0,2750,0.0,128,2948@TOP@human_GAPDH_TAA_len41_fa10_ta10_fm10_tm10,c
2948@TOP@human_GAPDH_TAA_len41_fa10_ta10_fm10_tm10*129*c,0,2729,0,0,2729,0.0,129,2948@TOP@human_GAPDH_TAA_len41_fa10_ta10_fm10_tm10,c
2948@TOP@human_GAPDH_TAA_len41_fa10_ta10_fm10_tm10*130*c,2,2742,0,0,2744,0.0,130,2948@TOP@human_GAPDH_TAA_len41_fa10_ta10_fm10_tm10,c
2948@TOP@human_GAPDH_TAA_len41_fa10_ta10_fm10_tm10*131*c,1,2749,0,1,2751,0.0,131,2948@TOP@human_GAPDH_TAA_len41_fa10_ta10_fm10_tm10,c
2948@TOP@human_GAPDH_TAA_len41_fa10_ta10_fm10_tm10*132*t,0,0,0,2709,2709,0.0,132,2948@TOP@human_GAPDH_TAA_len41_fa10_ta10_fm10_tm10,t
2948@TOP@human_GAPDH_TAA_len41_fa10_ta10_fm10_tm10*133*g,1,0,2712,0,2713,1.0,133,2948@TOP@human_GAPDH_TAA_len41_fa10_ta10_fm10_tm10,g
2948@TOP@human_GAPDH_TAA_len41_fa10_ta10_fm10_tm10*134*g,0,0,2732,0,2732,1.0,134,2948@TOP@human_GAPDH_TAA_len41_fa10_ta10_fm10_tm10,g
2949@TOP@human_GAPDH_TAA_len41_fa10_ta10_fm10_tm10*114*t,0,13,0,32925,32938,0.0,114,2949@TOP@human_GAPDH_TAA_len41_fa10_ta10_fm10_tm10,t
2949@TOP@human_GAPDH_TAA_len41_fa10_ta10_fm10_tm10*115*c,1,33113,0,8,33122,0.0,115,2949@TOP@human_GAPDH_TAA_len41_fa10_ta10_fm10_tm10,c
2949@TOP@human_GAPDH_TAA_len41_fa10_ta10_fm10_tm10*116*c,1,33004,0,2,33007,0.0,116,2949@TOP@human_GAPDH_TAA_len41_fa10_ta10_fm10_tm10,c
2949@TOP@human_GAPDH_TAA_len41_fa10_ta10_fm10_tm10*117*a,32879,0,72,0,32951,0.002,117,2949@TOP@human_GAPDH_TAA_len41_fa10_ta10_fm10_tm10,a
2949@TOP@human_GAPDH_TAA_len41_fa10_ta10_fm10_tm10*118*a,31080,2,1692,0,32774,0.052,118,2949@TOP@human_GAPDH_TAA_len41_fa10_ta10_fm10_tm10,a
2949@TOP@human_GAPDH_TAA_len41_fa10_ta10_fm10_tm10*119*g,0,0,32730,1,32731,1.0,119,2949@TOP@human_GAPDH_TAA_len41_fa10_ta10_fm10_tm10,g
2949@TOP@human_GAPDH_TAA_len41_fa10_ta10_fm10_tm10*120*g,1,2,32608,1,32612,1.0,120,2949@TOP@human_GAPDH_TAA_len41_fa10_ta10_fm10_tm10,g
2949@TOP@human_GAPDH_TAA_len41_fa10_ta10_fm10_tm10*121*a,32913,0,15,0,32928,0.0,121,2949@TOP@human_GAPDH_TAA_len41_fa10_ta10_fm10_tm10,a
2949@TOP@human_GAPDH_TAA_len41_fa10_ta10_fm10_tm10*122*g,0,0,32999,0,32999,1.0,122,2949@TOP@human_GAPDH_TAA_len41_fa10_ta10_fm10_tm10,g
2949@TOP@human_GAPDH_TAA_len41_fa10_ta10_fm10_tm10*123*t,3,0,7,32576,32586,0.0,123,2949@TOP@human_GAPDH_TAA_len41_fa10_ta10_fm10_tm10,t
2949@TOP@human_GAPDH_TAA_len41_fa10_ta10_fm10_tm10*124*a,29385,1,3083,0,32469,0.095,124,2949@TOP@human_GAPDH_TAA_len41_fa10_ta10_fm10_tm10,a
2949@TOP@human_GAPDH_TAA_len41_fa10_ta10_fm10_tm10*125*a,31150,2,1238,1,32391,0.038,125,2949@TOP@human_GAPDH_TAA_len41_fa10_ta10_fm10_tm10,a
2949@TOP@human_GAPDH_TAA_len41_fa10_ta10_fm10_tm10*126*g,2,0,32515,0,32517,1.0,126,2949@TOP@human_GAPDH_TAA_len41_fa10_ta10_fm10_tm10,g
2949@TOP@human_GAPDH_TAA_len41_fa10_ta10_fm10_tm10*127*a,32778,1,62,1,32842,0.002,127,2949@TOP@human_GAPDH_TAA_len41_fa10_ta10_fm10_tm10,a
2949@TOP@human_GAPDH_TAA_len41_fa10_ta10_fm10_tm10*128*c,1,33044,8,2,33055,0.0,128,2949@TOP@human_GAPDH_TAA_len41_fa10_ta10_fm10_tm10,c
2949@TOP@human_GAPDH_TAA_len41_fa10_ta10_fm10_tm10*129*c,2,32814,0,0,32816,0.0,129,2949@TOP@human_GAPDH_TAA_len41_fa10_ta10_fm10_tm10,c
2949@TOP@human_GAPDH_TAA_len41_fa10_ta10_fm10_tm10*130*c,6,32997,0,1,33004,0.0,130,2949@TOP@human_GAPDH_TAA_len41_fa10_ta10_fm10_tm10,c
2949@TOP@human_GAPDH_TAA_len41_fa10_ta10_fm10_tm10*131*c,4,33061,0,0,33065,0.0,131,2949@TOP@human_GAPDH_TAA_len41_fa10_ta10_fm10_tm10,c
2949@TOP@human_GAPDH_TAA_len41_fa10_ta10_fm10_tm10*132*t,5,15,0,32592,32612,0.0,132,2949@TOP@human_GAPDH_TAA_len41_fa10_ta10_fm10_tm10,t
2949@TOP@human_GAPDH_TAA_len41_fa10_ta10_fm10_tm10*133*g,1,1,32567,3,32572,1.0,133,2949@TOP@human_GAPDH_TAA_len41_fa10_ta10_fm10_tm10,g
2949@TOP@human_GAPDH_TAA_len41_fa10_ta10_fm10_tm10*134*g,3,1,32680,0,32684,1.0,134,2949@TOP@human_GAPDH_TAA_len41_fa10_ta10_fm10_tm10,g
2950@TOP@human_GAPDH_TAA_len41_fa10_ta10_fm10_tm10*114*t,5,10,0,41497,41512,0.0,114,2950@TOP@human_GAPDH_TAA_len41_fa10_ta10_fm10_tm10,t
2950@TOP@human_GAPDH_TAA_len41_fa10_ta10_fm10_tm10*115*c,0,41762,0,4,41766,0.0,115,2950@TOP@human_GAPDH_TAA_len41_fa10_ta10_fm10_tm10,c
2950@TOP@human_GAPDH_TAA_len41_fa10_ta10_fm10_tm10*116*c,3,41589,0,1,41593,0.0,116,2950@TOP@human_GAPDH_TAA_len41_fa10_ta10_fm10_tm10,c
2950@TOP@human_GAPDH_TAA_len41_fa10_ta10_fm10_tm10*117*a,41447,2,94,0,41543,0.002,117,2950@TOP@human_GAPDH_TAA_len41_fa10_ta10_fm10_tm10,a
2950@TOP@human_GAPDH_TAA_len41_fa10_ta10_fm10_tm10*118*a,39755,1,1538,1,41295,0.037,118,2950@TOP@human_GAPDH_TAA_len41_fa10_ta10_fm10_tm10,a
2950@TOP@human_GAPDH_TAA_len41_fa10_ta10_fm10_tm10*119*g,3,2,41269,2,41276,1.0,119,2950@TOP@human_GAPDH_TAA_len41_fa10_ta10_fm10_tm10,g
2950@TOP@human_GAPDH_TAA_len41_fa10_ta10_fm10_tm10*120*g,2,0,41089,0,41091,1.0,120,2950@TOP@human_GAPDH_TAA_len41_fa10_ta10_fm10_tm10,g
2950@TOP@human_GAPDH_TAA_len41_fa10_ta10_fm10_tm10*121*a,41519,1,4,1,41525,0.0,121,2950@TOP@human_GAPDH_TAA_len41_fa10_ta10_fm10_tm10,a
2950@TOP@human_GAPDH_TAA_len41_fa10_ta10_fm10_tm10*122*g,1,2,41605,0,41608,1.0,122,2950@TOP@human_GAPDH_TAA_len41_fa10_ta10_fm10_tm10,g
2950@TOP@human_GAPDH_TAA_len41_fa10_ta10_fm10_tm10*123*t,5,5,12,40984,41006,0.0,123,2950@TOP@human_GAPDH_TAA_len41_fa10_ta10_fm10_tm10,t
2950@TOP@human_GAPDH_TAA_len41_fa10_ta10_fm10_tm10*124*a,32444,3,8485,1,40933,0.207,124,2950@TOP@human_GAPDH_TAA_len41_fa10_ta10_fm10_tm10,a
2950@TOP@human_GAPDH_TAA_len41_fa10_ta10_fm10_tm10*125*a,38458,3,2363,1,40825,0.058,125,2950@TOP@human_GAPDH_TAA_len41_fa10_ta10_fm10_tm10,a
2950@TOP@human_GAPDH_TAA_len41_fa10_ta10_fm10_tm10*126*g,4,0,41074,4,41082,1.0,126,2950@TOP@human_GAPDH_TAA_len41_fa10_ta10_fm10_tm10,g
2950@TOP@human_GAPDH_TAA_len41_fa10_ta10_fm10_tm10*127*a,41453,2,26,0,41481,0.001,127,2950@TOP@human_GAPDH_TAA_len41_fa10_ta10_fm10_tm10,a
2950@TOP@human_GAPDH_TAA_len41_fa10_ta10_fm10_tm10*128*c,2,41677,8,4,41691,0.0,128,2950@TOP@human_GAPDH_TAA_len41_fa10_ta10_fm10_tm10,c
2950@TOP@human_GAPDH_TAA_len41_fa10_ta10_fm10_tm10*129*c,3,41384,0,1,41388,0.0,129,2950@TOP@human_GAPDH_TAA_len41_fa10_ta10_fm10_tm10,c
2950@TOP@human_GAPDH_TAA_len41_fa10_ta10_fm10_tm10*130*c,2,41619,1,2,41624,0.0,130,2950@TOP@human_GAPDH_TAA_len41_fa10_ta10_fm10_tm10,c
2950@TOP@human_GAPDH_TAA_len41_fa10_ta10_fm10_tm10*131*c,2,41697,0,2,41701,0.0,131,2950@TOP@human_GAPDH_TAA_len41_fa10_ta10_fm10_tm10,c
2950@TOP@human_GAPDH_TAA_len41_fa10_ta10_fm10_tm10*132*t,1,10,0,41032,41043,0.0,132,2950@TOP@human_GAPDH_TAA_len41_fa10_ta10_fm10_tm10,t
2950@TOP@human_GAPDH_TAA_len41_fa10_ta10_fm10_tm10*133*g,2,1,41045,1,41049,1.0,133,2950@TOP@human_GAPDH_TAA_len41_fa10_ta10_fm10_tm10,g
2950@TOP@human_GAPDH_TAA_len41_fa10_ta10_fm10_tm10*134*g,9,4,41227,6,41246,1.0,134,2950@TOP@human_GAPDH_TAA_len41_fa10_ta10_fm10_tm10,g
2951@TOP@human_GAPDH_TAA_len41_fa10_ta10_fm10_tm10*114*t,0,0,0,1813,1813,0.0,114,2951@TOP@human_GAPDH_TAA_len41_fa10_ta10_fm10_tm10,t
2951@TOP@human_GAPDH_TAA_len41_fa10_ta10_fm10_tm10*115*c,0,1819,0,0,1819,0.0,115,2951@TOP@human_GAPDH_TAA_len41_fa10_ta10_fm10_tm10,c
2951@TOP@human_GAPDH_TAA_len41_fa10_ta10_fm10_tm10*116*c,0,1817,0,0,1817,0.0,116,2951@TOP@human_GAPDH_TAA_len41_fa10_ta10_fm10_tm10,c
2951@TOP@human_GAPDH_TAA_len41_fa10_ta10_fm10_tm10*117*a,1786,0,22,0,1808,0.012,117,2951@TOP@human_GAPDH_TAA_len41_fa10_ta10_fm10_tm10,a
2951@TOP@human_GAPDH_TAA_len41_fa10_ta10_fm10_tm10*118*a,1610,0,195,0,1805,0.108,118,2951@TOP@human_GAPDH_TAA_len41_fa10_ta10_fm10_tm10,a
2951@TOP@human_GAPDH_TAA_len41_fa10_ta10_fm10_tm10*119*g,0,0,1802,0,1802,1.0,119,2951@TOP@human_GAPDH_TAA_len41_fa10_ta10_fm10_tm10,g
2951@TOP@human_GAPDH_TAA_len41_fa10_ta10_fm10_tm10*120*g,0,0,1793,0,1793,1.0,120,2951@TOP@human_GAPDH_TAA_len41_fa10_ta10_fm10_tm10,g
2951@TOP@human_GAPDH_TAA_len41_fa10_ta10_fm10_tm10*121*a,1810,0,3,0,1813,0.002,121,2951@TOP@human_GAPDH_TAA_len41_fa10_ta10_fm10_tm10,a
2951@TOP@human_GAPDH_TAA_len41_fa10_ta10_fm10_tm10*122*g,0,0,1813,0,1813,1.0,122,2951@TOP@human_GAPDH_TAA_len41_fa10_ta10_fm10_tm10,g
2951@TOP@human_GAPDH_TAA_len41_fa10_ta10_fm10_tm10*123*t,0,6,1,1782,1789,0.001,123,2951@TOP@human_GAPDH_TAA_len41_fa10_ta10_fm10_tm10,t
2951@TOP@human_GAPDH_TAA_len41_fa10_ta10_fm10_tm10*124*a,1465,0,313,0,1778,0.176,124,2951@TOP@human_GAPDH_TAA_len41_fa10_ta10_fm10_tm10,a
2951@TOP@human_GAPDH_TAA_len41_fa10_ta10_fm10_tm10*125*a,1661,0,128,0,1789,0.072,125,2951@TOP@human_GAPDH_TAA_len41_fa10_ta10_fm10_tm10,a
2951@TOP@human_GAPDH_TAA_len41_fa10_ta10_fm10_tm10*126*g,0,0,1796,0,1796,1.0,126,2951@TOP@human_GAPDH_TAA_len41_fa10_ta10_fm10_tm10,g
2951@TOP@human_GAPDH_TAA_len41_fa10_ta10_fm10_tm10*127*a,1803,0,2,0,1805,0.001,127,2951@TOP@human_GAPDH_TAA_len41_fa10_ta10_fm10_tm10,a
2951@TOP@human_GAPDH_TAA_len41_fa10_ta10_fm10_tm10*128*c,0,1817,0,0,1817,0.0,128,2951@TOP@human_GAPDH_TAA_len41_fa10_ta10_fm10_tm10,c
2951@TOP@human_GAPDH_TAA_len41_fa10_ta10_fm10_tm10*129*c,0,1800,0,0,1800,0.0,129,2951@TOP@human_GAPDH_TAA_len41_fa10_ta10_fm10_tm10,c
2951@TOP@human_GAPDH_TAA_len41_fa10_ta10_fm10_tm10*130*c,0,1817,0,0,1817,0.0,130,2951@TOP@human_GAPDH_TAA_len41_fa10_ta10_fm10_tm10,c
2951@TOP@human_GAPDH_TAA_len41_fa10_ta10_fm10_tm10*131*c,0,1815,0,2,1817,0.0,131,2951@TOP@human_GAPDH_TAA_len41_fa10_ta10_fm10_tm10,c
2951@TOP@human_GAPDH_TAA_len41_fa10_ta10_fm10_tm10*132*t,0,2,0,1785,1787,0.0,132,2951@TOP@human_GAPDH_TAA_len41_fa10_ta10_fm10_tm10,t
2951@TOP@human_GAPDH_TAA_len41_fa10_ta10_fm10_tm10*133*g,0,0,1784,0,1784,1.0,133,2951@TOP@human_GAPDH_TAA_len41_fa10_ta10_fm10_tm10,g
2951@TOP@human_GAPDH_TAA_len41_fa10_ta10_fm10_tm10*134*g,0,0,1793,0,1793,1.0,134,2951@TOP@human_GAPDH_TAA_len41_fa10_ta10_fm10_tm10,g
2952@TOP@human_GAPDH_TAA_len41_fa10_ta10_fm10_tm10*114*t,0,0,0,5174,5174,0.0,114,2952@TOP@human_GAPDH_TAA_len41_fa10_ta10_fm10_tm10,t
2952@TOP@human_GAPDH_TAA_len41_fa10_ta10_fm10_tm10*115*c,0,5211,0,0,5211,0.0,115,2952@TOP@human_GAPDH_TAA_len41_fa10_ta10_fm10_tm10,c
2952@TOP@human_GAPDH_TAA_len41_fa10_ta10_fm10_tm10*116*c,0,5187,0,1,5188,0.0,116,2952@TOP@human_GAPDH_TAA_len41_fa10_ta10_fm10_tm10,c
2952@TOP@human_GAPDH_TAA_len41_fa10_ta10_fm10_tm10*117*a,5145,0,45,0,5190,0.009,117,2952@TOP@human_GAPDH_TAA_len41_fa10_ta10_fm10_tm10,a
2952@TOP@human_GAPDH_TAA_len41_fa10_ta10_fm10_tm10*118*a,4632,1,531,0,5164,0.103,118,2952@TOP@human_GAPDH_TAA_len41_fa10_ta10_fm10_tm10,a
2952@TOP@human_GAPDH_TAA_len41_fa10_ta10_fm10_tm10*119*g,0,0,5136,2,5138,1.0,119,2952@TOP@human_GAPDH_TAA_len41_fa10_ta10_fm10_tm10,g
2952@TOP@human_GAPDH_TAA_len41_fa10_ta10_fm10_tm10*120*g,0,1,5143,0,5144,1.0,120,2952@TOP@human_GAPDH_TAA_len41_fa10_ta10_fm10_tm10,g
2952@TOP@human_GAPDH_TAA_len41_fa10_ta10_fm10_tm10*121*a,5166,0,8,0,5174,0.002,121,2952@TOP@human_GAPDH_TAA_len41_fa10_ta10_fm10_tm10,a
2952@TOP@human_GAPDH_TAA_len41_fa10_ta10_fm10_tm10*122*g,0,0,5182,0,5182,1.0,122,2952@TOP@human_GAPDH_TAA_len41_fa10_ta10_fm10_tm10,g
2952@TOP@human_GAPDH_TAA_len41_fa10_ta10_fm10_tm10*123*t,0,0,0,5123,5123,0.0,123,2952@TOP@human_GAPDH_TAA_len41_fa10_ta10_fm10_tm10,t
2952@TOP@human_GAPDH_TAA_len41_fa10_ta10_fm10_tm10*124*a,4537,0,561,0,5098,0.11,124,2952@TOP@human_GAPDH_TAA_len41_fa10_ta10_fm10_tm10,a
2952@TOP@human_GAPDH_TAA_len41_fa10_ta10_fm10_tm10*125*a,4809,0,286,0,5095,0.056,125,2952@TOP@human_GAPDH_TAA_len41_fa10_ta10_fm10_tm10,a
2952@TOP@human_GAPDH_TAA_len41_fa10_ta10_fm10_tm10*126*g,0,0,5111,0,5111,1.0,126,2952@TOP@human_GAPDH_TAA_len41_fa10_ta10_fm10_tm10,g
2952@TOP@human_GAPDH_TAA_len41_fa10_ta10_fm10_tm10*127*a,5168,1,5,0,5174,0.001,127,2952@TOP@human_GAPDH_TAA_len41_fa10_ta10_fm10_tm10,a
2952@TOP@human_GAPDH_TAA_len41_fa10_ta10_fm10_tm10*128*c,0,5202,0,0,5202,0.0,128,2952@TOP@human_GAPDH_TAA_len41_fa10_ta10_fm10_tm10,c
2952@TOP@human_GAPDH_TAA_len41_fa10_ta10_fm10_tm10*129*c,2,5151,0,4,5157,0.0,129,2952@TOP@human_GAPDH_TAA_len41_fa10_ta10_fm10_tm10,c
2952@TOP@human_GAPDH_TAA_len41_fa10_ta10_fm10_tm10*130*c,0,5188,0,0,5188,0.0,130,2952@TOP@human_GAPDH_TAA_len41_fa10_ta10_fm10_tm10,c
2952@TOP@human_GAPDH_TAA_len41_fa10_ta10_fm10_tm10*131*c,2,5202,0,0,5204,0.0,131,2952@TOP@human_GAPDH_TAA_len41_fa10_ta10_fm10_tm10,c
2952@TOP@human_GAPDH_TAA_len41_fa10_ta10_fm10_tm10*132*t,0,0,0,5140,5140,0.0,132,2952@TOP@human_GAPDH_TAA_len41_fa10_ta10_fm10_tm10,t
2952@TOP@human_GAPDH_TAA_len41_fa10_ta10_fm10_tm10*133*g,0,1,5114,1,5116,1.0,133,2952@TOP@human_GAPDH_TAA_len41_fa10_ta10_fm10_tm10,g
2952@TOP@human_GAPDH_TAA_len41_fa10_ta10_fm10_tm10*134*g,0,0,5135,1,5136,1.0,134,2952@TOP@human_GAPDH_TAA_len41_fa10_ta10_fm10_tm10,g
2953@TOP@human_GAPDH_TAA_len41_fa10_ta10_fm10_tm10*114*t,0,1,0,1571,1572,0.0,114,2953@TOP@human_GAPDH_TAA_len41_fa10_ta10_fm10_tm10,t
2953@TOP@human_GAPDH_TAA_len41_fa10_ta10_fm10_tm10*115*c,0,1586,0,0,1586,0.0,115,2953@TOP@human_GAPDH_TAA_len41_fa10_ta10_fm10_tm10,c
2953@TOP@human_GAPDH_TAA_len41_fa10_ta10_fm10_tm10*116*c,1,1581,0,0,1582,0.0,116,2953@TOP@human_GAPDH_TAA_len41_fa10_ta10_fm10_tm10,c
2953@TOP@human_GAPDH_TAA_len41_fa10_ta10_fm10_tm10*117*a,1341,0,240,0,1581,0.152,117,2953@TOP@human_GAPDH_TAA_len41_fa10_ta10_fm10_tm10,a
2953@TOP@human_GAPDH_TAA_len41_fa10_ta10_fm10_tm10*118*a,1067,0,498,1,1566,0.318,118,2953@TOP@human_GAPDH_TAA_len41_fa10_ta10_fm10_tm10,a
2953@TOP@human_GAPDH_TAA_len41_fa10_ta10_fm10_tm10*119*g,0,0,1565,0,1565,1.0,119,2953@TOP@human_GAPDH_TAA_len41_fa10_ta10_fm10_tm10,g
2953@TOP@human_GAPDH_TAA_len41_fa10_ta10_fm10_tm10*120*g,0,0,1566,0,1566,1.0,120,2953@TOP@human_GAPDH_TAA_len41_fa10_ta10_fm10_tm10,g
2953@TOP@human_GAPDH_TAA_len41_fa10_ta10_fm10_tm10*121*a,1562,0,5,0,1567,0.003,121,2953@TOP@human_GAPDH_TAA_len41_fa10_ta10_fm10_tm10,a
2953@TOP@human_GAPDH_TAA_len41_fa10_ta10_fm10_tm10*122*g,0,0,1583,0,1583,1.0,122,2953@TOP@human_GAPDH_TAA_len41_fa10_ta10_fm10_tm10,g
2953@TOP@human_GAPDH_TAA_len41_fa10_ta10_fm10_tm10*123*t,0,6,0,1560,1566,0.0,123,2953@TOP@human_GAPDH_TAA_len41_fa10_ta10_fm10_tm10,t
2953@TOP@human_GAPDH_TAA_len41_fa10_ta10_fm10_tm10*124*a,1180,0,371,0,1551,0.239,124,2953@TOP@human_GAPDH_TAA_len41_fa10_ta10_fm10_tm10,a
2953@TOP@human_GAPDH_TAA_len41_fa10_ta10_fm10_tm10*125*a,1283,0,263,0,1546,0.17,125,2953@TOP@human_GAPDH_TAA_len41_fa10_ta10_fm10_tm10,a
2953@TOP@human_GAPDH_TAA_len41_fa10_ta10_fm10_tm10*126*g,0,0,1566,0,1566,1.0,126,2953@TOP@human_GAPDH_TAA_len41_fa10_ta10_fm10_tm10,g
2953@TOP@human_GAPDH_TAA_len41_fa10_ta10_fm10_tm10*127*a,1575,0,4,0,1579,0.003,127,2953@TOP@human_GAPDH_TAA_len41_fa10_ta10_fm10_tm10,a
2953@TOP@human_GAPDH_TAA_len41_fa10_ta10_fm10_tm10*128*c,0,1586,1,0,1587,0.001,128,2953@TOP@human_GAPDH_TAA_len41_fa10_ta10_fm10_tm10,c
2953@TOP@human_GAPDH_TAA_len41_fa10_ta10_fm10_tm10*129*c,1,1573,0,0,1574,0.0,129,2953@TOP@human_GAPDH_TAA_len41_fa10_ta10_fm10_tm10,c
2953@TOP@human_GAPDH_TAA_len41_fa10_ta10_fm10_tm10*130*c,0,1576,0,0,1576,0.0,130,2953@TOP@human_GAPDH_TAA_len41_fa10_ta10_fm10_tm10,c
2953@TOP@human_GAPDH_TAA_len41_fa10_ta10_fm10_tm10*131*c,0,1585,0,0,1585,0.0,131,2953@TOP@human_GAPDH_TAA_len41_fa10_ta10_fm10_tm10,c
2953@TOP@human_GAPDH_TAA_len41_fa10_ta10_fm10_tm10*132*t,0,0,0,1570,1570,0.0,132,2953@TOP@human_GAPDH_TAA_len41_fa10_ta10_fm10_tm10,t
2953@TOP@human_GAPDH_TAA_len41_fa10_ta10_fm10_tm10*133*g,1,0,1561,0,1562,0.999,133,2953@TOP@human_GAPDH_TAA_len41_fa10_ta10_fm10_tm10,g
2953@TOP@human_GAPDH_TAA_len41_fa10_ta10_fm10_tm10*134*g,0,0,1568,0,1568,1.0,134,2953@TOP@human_GAPDH_TAA_len41_fa10_ta10_fm10_tm10,g
2954@TOP@human_GAPDH_TAA_len41_fa10_ta10_fm10_tm10*114*t,1,1,0,5441,5443,0.0,114,2954@TOP@human_GAPDH_TAA_len41_fa10_ta10_fm10_tm10,t
2954@TOP@human_GAPDH_TAA_len41_fa10_ta10_fm10_tm10*115*c,0,5481,0,0,5481,0.0,115,2954@TOP@human_GAPDH_TAA_len41_fa10_ta10_fm10_tm10,c
2954@TOP@human_GAPDH_TAA_len41_fa10_ta10_fm10_tm10*116*c,4,5453,0,1,5458,0.0,116,2954@TOP@human_GAPDH_TAA_len41_fa10_ta10_fm10_tm10,c
2954@TOP@human_GAPDH_TAA_len41_fa10_ta10_fm10_tm10*117*a,5356,0,97,0,5453,0.018,117,2954@TOP@human_GAPDH_TAA_len41_fa10_ta10_fm10_tm10,a
2954@TOP@human_GAPDH_TAA_len41_fa10_ta10_fm10_tm10*118*a,4303,0,1117,1,5421,0.206,118,2954@TOP@human_GAPDH_TAA_len41_fa10_ta10_fm10_tm10,a
2954@TOP@human_GAPDH_TAA_len41_fa10_ta10_fm10_tm10*119*g,1,0,5426,1,5428,1.0,119,2954@TOP@human_GAPDH_TAA_len41_fa10_ta10_fm10_tm10,g
2954@TOP@human_GAPDH_TAA_len41_fa10_ta10_fm10_tm10*120*g,0,0,5404,0,5404,1.0,120,2954@TOP@human_GAPDH_TAA_len41_fa10_ta10_fm10_tm10,g
2954@TOP@human_GAPDH_TAA_len41_fa10_ta10_fm10_tm10*121*a,5426,0,11,0,5437,0.002,121,2954@TOP@human_GAPDH_TAA_len41_fa10_ta10_fm10_tm10,a
2954@TOP@human_GAPDH_TAA_len41_fa10_ta10_fm10_tm10*122*g,2,0,5463,0,5465,1.0,122,2954@TOP@human_GAPDH_TAA_len41_fa10_ta10_fm10_tm10,g
2954@TOP@human_GAPDH_TAA_len41_fa10_ta10_fm10_tm10*123*t,0,0,0,5388,5388,0.0,123,2954@TOP@human_GAPDH_TAA_len41_fa10_ta10_fm10_tm10,t
2954@TOP@human_GAPDH_TAA_len41_fa10_ta10_fm10_tm10*124*a,4906,0,449,0,5355,0.084,124,2954@TOP@human_GAPDH_TAA_len41_fa10_ta10_fm10_tm10,a
2954@TOP@human_GAPDH_TAA_len41_fa10_ta10_fm10_tm10*125*a,5179,1,189,0,5369,0.035,125,2954@TOP@human_GAPDH_TAA_len41_fa10_ta10_fm10_tm10,a
2954@TOP@human_GAPDH_TAA_len41_fa10_ta10_fm10_tm10*126*g,0,4,5388,0,5392,0.999,126,2954@TOP@human_GAPDH_TAA_len41_fa10_ta10_fm10_tm10,g
2954@TOP@human_GAPDH_TAA_len41_fa10_ta10_fm10_tm10*127*a,5429,0,4,0,5433,0.001,127,2954@TOP@human_GAPDH_TAA_len41_fa10_ta10_fm10_tm10,a
2954@TOP@human_GAPDH_TAA_len41_fa10_ta10_fm10_tm10*128*c,0,5463,1,0,5464,0.0,128,2954@TOP@human_GAPDH_TAA_len41_fa10_ta10_fm10_tm10,c
2954@TOP@human_GAPDH_TAA_len41_fa10_ta10_fm10_tm10*129*c,5,5417,0,2,5424,0.0,129,2954@TOP@human_GAPDH_TAA_len41_fa10_ta10_fm10_tm10,c
2954@TOP@human_GAPDH_TAA_len41_fa10_ta10_fm10_tm10*130*c,0,5458,0,1,5459,0.0,130,2954@TOP@human_GAPDH_TAA_len41_fa10_ta10_fm10_tm10,c
2954@TOP@human_GAPDH_TAA_len41_fa10_ta10_fm10_tm10*131*c,2,5472,0,0,5474,0.0,131,2954@TOP@human_GAPDH_TAA_len41_fa10_ta10_fm10_tm10,c
2954@TOP@human_GAPDH_TAA_len41_fa10_ta10_fm10_tm10*132*t,1,2,0,5393,5396,0.0,132,2954@TOP@human_GAPDH_TAA_len41_fa10_ta10_fm10_tm10,t
2954@TOP@human_GAPDH_TAA_len41_fa10_ta10_fm10_tm10*133*g,1,0,5396,0,5397,1.0,133,2954@TOP@human_GAPDH_TAA_len41_fa10_ta10_fm10_tm10,g
2954@TOP@human_GAPDH_TAA_len41_fa10_ta10_fm10_tm10*134*g,1,4,5408,1,5414,0.999,134,2954@TOP@human_GAPDH_TAA_len41_fa10_ta10_fm10_tm10,g
2955@TOP@human_GAPDH_TAA_len41_fa10_ta10_fm10_tm10*114*t,2,14,0,30452,30468,0.0,114,2955@TOP@human_GAPDH_TAA_len41_fa10_ta10_fm10_tm10,t
2955@TOP@human_GAPDH_TAA_len41_fa10_ta10_fm10_tm10*115*c,2,30649,0,2,30653,0.0,115,2955@TOP@human_GAPDH_TAA_len41_fa10_ta10_fm10_tm10,c
2955@TOP@human_GAPDH_TAA_len41_fa10_ta10_fm10_tm10*116*c,1,30515,0,1,30517,0.0,116,2955@TOP@human_GAPDH_TAA_len41_fa10_ta10_fm10_tm10,c
2955@TOP@human_GAPDH_TAA_len41_fa10_ta10_fm10_tm10*117*a,30042,0,451,1,30494,0.015,117,2955@TOP@human_GAPDH_TAA_len41_fa10_ta10_fm10_tm10,a
2955@TOP@human_GAPDH_TAA_len41_fa10_ta10_fm10_tm10*118*a,25942,0,4420,2,30364,0.146,118,2955@TOP@human_GAPDH_TAA_len41_fa10_ta10_fm10_tm10,a
2955@TOP@human_GAPDH_TAA_len41_fa10_ta10_fm10_tm10*119*g,0,0,30303,1,30304,1.0,119,2955@TOP@human_GAPDH_TAA_len41_fa10_ta10_fm10_tm10,g
2955@TOP@human_GAPDH_TAA_len41_fa10_ta10_fm10_tm10*120*g,0,1,30205,3,30209,1.0,120,2955@TOP@human_GAPDH_TAA_len41_fa10_ta10_fm10_tm10,g
2955@TOP@human_GAPDH_TAA_len41_fa10_ta10_fm10_tm10*121*a,30417,0,25,0,30442,0.001,121,2955@TOP@human_GAPDH_TAA_len41_fa10_ta10_fm10_tm10,a
2955@TOP@human_GAPDH_TAA_len41_fa10_ta10_fm10_tm10*122*g,6,0,30510,0,30516,1.0,122,2955@TOP@human_GAPDH_TAA_len41_fa10_ta10_fm10_tm10,g
2955@TOP@human_GAPDH_TAA_len41_fa10_ta10_fm10_tm10*123*t,5,1,10,30102,30118,0.0,123,2955@TOP@human_GAPDH_TAA_len41_fa10_ta10_fm10_tm10,t
2955@TOP@human_GAPDH_TAA_len41_fa10_ta10_fm10_tm10*124*a,26815,0,3218,1,30034,0.107,124,2955@TOP@human_GAPDH_TAA_len41_fa10_ta10_fm10_tm10,a
2955@TOP@human_GAPDH_TAA_len41_fa10_ta10_fm10_tm10*125*a,29152,2,864,3,30021,0.029,125,2955@TOP@human_GAPDH_TAA_len41_fa10_ta10_fm10_tm10,a
2955@TOP@human_GAPDH_TAA_len41_fa10_ta10_fm10_tm10*126*g,1,0,30151,0,30152,1.0,126,2955@TOP@human_GAPDH_TAA_len41_fa10_ta10_fm10_tm10,g
2955@TOP@human_GAPDH_TAA_len41_fa10_ta10_fm10_tm10*127*a,30377,0,39,0,30416,0.001,127,2955@TOP@human_GAPDH_TAA_len41_fa10_ta10_fm10_tm10,a
2955@TOP@human_GAPDH_TAA_len41_fa10_ta10_fm10_tm10*128*c,2,30557,1,2,30562,0.0,128,2955@TOP@human_GAPDH_TAA_len41_fa10_ta10_fm10_tm10,c
2955@TOP@human_GAPDH_TAA_len41_fa10_ta10_fm10_tm10*129*c,4,30348,1,0,30353,0.0,129,2955@TOP@human_GAPDH_TAA_len41_fa10_ta10_fm10_tm10,c
2955@TOP@human_GAPDH_TAA_len41_fa10_ta10_fm10_tm10*130*c,0,30510,1,1,30512,0.0,130,2955@TOP@human_GAPDH_TAA_len41_fa10_ta10_fm10_tm10,c
2955@TOP@human_GAPDH_TAA_len41_fa10_ta10_fm10_tm10*131*c,2,30588,0,0,30590,0.0,131,2955@TOP@human_GAPDH_TAA_len41_fa10_ta10_fm10_tm10,c
2955@TOP@human_GAPDH_TAA_len41_fa10_ta10_fm10_tm10*132*t,5,11,0,30169,30185,0.0,132,2955@TOP@human_GAPDH_TAA_len41_fa10_ta10_fm10_tm10,t
2955@TOP@human_GAPDH_TAA_len41_fa10_ta10_fm10_tm10*133*g,3,1,30130,1,30135,1.0,133,2955@TOP@human_GAPDH_TAA_len41_fa10_ta10_fm10_tm10,g
2955@TOP@human_GAPDH_TAA_len41_fa10_ta10_fm10_tm10*134*g,2,2,30248,0,30252,1.0,134,2955@TOP@human_GAPDH_TAA_len41_fa10_ta10_fm10_tm10,g
2956@TOP@human_GAPDH_TAA_len41_fa10_ta10_fm10_tm10*114*t,0,1,0,3381,3382,0.0,114,2956@TOP@human_GAPDH_TAA_len41_fa10_ta10_fm10_tm10,t
2956@TOP@human_GAPDH_TAA_len41_fa10_ta10_fm10_tm10*115*c,0,3414,0,0,3414,0.0,115,2956@TOP@human_GAPDH_TAA_len41_fa10_ta10_fm10_tm10,c
2956@TOP@human_GAPDH_TAA_len41_fa10_ta10_fm10_tm10*116*c,0,3403,0,2,3405,0.0,116,2956@TOP@human_GAPDH_TAA_len41_fa10_ta10_fm10_tm10,c
2956@TOP@human_GAPDH_TAA_len41_fa10_ta10_fm10_tm10*117*a,3393,0,2,0,3395,0.001,117,2956@TOP@human_GAPDH_TAA_len41_fa10_ta10_fm10_tm10,a
2956@TOP@human_GAPDH_TAA_len41_fa10_ta10_fm10_tm10*118*a,3201,0,184,0,3385,0.054,118,2956@TOP@human_GAPDH_TAA_len41_fa10_ta10_fm10_tm10,a
2956@TOP@human_GAPDH_TAA_len41_fa10_ta10_fm10_tm10*119*g,0,0,3371,0,3371,1.0,119,2956@TOP@human_GAPDH_TAA_len41_fa10_ta10_fm10_tm10,g
2956@TOP@human_GAPDH_TAA_len41_fa10_ta10_fm10_tm10*120*g,1,0,3364,0,3365,1.0,120,2956@TOP@human_GAPDH_TAA_len41_fa10_ta10_fm10_tm10,g
2956@TOP@human_GAPDH_TAA_len41_fa10_ta10_fm10_tm10*121*a,3385,0,2,0,3387,0.001,121,2956@TOP@human_GAPDH_TAA_len41_fa10_ta10_fm10_tm10,a
2956@TOP@human_GAPDH_TAA_len41_fa10_ta10_fm10_tm10*122*g,0,0,3407,0,3407,1.0,122,2956@TOP@human_GAPDH_TAA_len41_fa10_ta10_fm10_tm10,g
2956@TOP@human_GAPDH_TAA_len41_fa10_ta10_fm10_tm10*123*t,0,0,1,3367,3368,0.0,123,2956@TOP@human_GAPDH_TAA_len41_fa10_ta10_fm10_tm10,t
2956@TOP@human_GAPDH_TAA_len41_fa10_ta10_fm10_tm10*124*a,2799,0,549,1,3349,0.164,124,2956@TOP@human_GAPDH_TAA_len41_fa10_ta10_fm10_tm10,a
2956@TOP@human_GAPDH_TAA_len41_fa10_ta10_fm10_tm10*125*a,2846,0,495,0,3341,0.148,125,2956@TOP@human_GAPDH_TAA_len41_fa10_ta10_fm10_tm10,a
2956@TOP@human_GAPDH_TAA_len41_fa10_ta10_fm10_tm10*126*g,0,0,3365,0,3365,1.0,126,2956@TOP@human_GAPDH_TAA_len41_fa10_ta10_fm10_tm10,g
2956@TOP@human_GAPDH_TAA_len41_fa10_ta10_fm10_tm10*127*a,3378,0,9,1,3388,0.003,127,2956@TOP@human_GAPDH_TAA_len41_fa10_ta10_fm10_tm10,a
2956@TOP@human_GAPDH_TAA_len41_fa10_ta10_fm10_tm10*128*c,2,3402,0,0,3404,0.0,128,2956@TOP@human_GAPDH_TAA_len41_fa10_ta10_fm10_tm10,c
2956@TOP@human_GAPDH_TAA_len41_fa10_ta10_fm10_tm10*129*c,0,3396,0,0,3396,0.0,129,2956@TOP@human_GAPDH_TAA_len41_fa10_ta10_fm10_tm10,c
2956@TOP@human_GAPDH_TAA_len41_fa10_ta10_fm10_tm10*130*c,0,3405,0,2,3407,0.0,130,2956@TOP@human_GAPDH_TAA_len41_fa10_ta10_fm10_tm10,c
2956@TOP@human_GAPDH_TAA_len41_fa10_ta10_fm10_tm10*131*c,0,3405,0,0,3405,0.0,131,2956@TOP@human_GAPDH_TAA_len41_fa10_ta10_fm10_tm10,c
2956@TOP@human_GAPDH_TAA_len41_fa10_ta10_fm10_tm10*132*t,0,0,0,3363,3363,0.0,132,2956@TOP@human_GAPDH_TAA_len41_fa10_ta10_fm10_tm10,t
2956@TOP@human_GAPDH_TAA_len41_fa10_ta10_fm10_tm10*133*g,0,0,3352,0,3352,1.0,133,2956@TOP@human_GAPDH_TAA_len41_fa10_ta10_fm10_tm10,g
2956@TOP@human_GAPDH_TAA_len41_fa10_ta10_fm10_tm10*134*g,0,0,3381,0,3381,1.0,134,2956@TOP@human_GAPDH_TAA_len41_fa10_ta10_fm10_tm10,g
2957@TOP@human_GAPDH_TAA_len41_fa10_ta10_fm10_tm10*114*t,5,0,0,9719,9724,0.0,114,2957@TOP@human_GAPDH_TAA_len41_fa10_ta10_fm10_tm10,t
2957@TOP@human_GAPDH_TAA_len41_fa10_ta10_fm10_tm10*115*c,0,9782,0,2,9784,0.0,115,2957@TOP@human_GAPDH_TAA_len41_fa10_ta10_fm10_tm10,c
2957@TOP@human_GAPDH_TAA_len41_fa10_ta10_fm10_tm10*116*c,0,9749,0,2,9751,0.0,116,2957@TOP@human_GAPDH_TAA_len41_fa10_ta10_fm10_tm10,c
2957@TOP@human_GAPDH_TAA_len41_fa10_ta10_fm10_tm10*117*a,9718,0,18,0,9736,0.002,117,2957@TOP@human_GAPDH_TAA_len41_fa10_ta10_fm10_tm10,a
2957@TOP@human_GAPDH_TAA_len41_fa10_ta10_fm10_tm10*118*a,9425,0,273,0,9698,0.028,118,2957@TOP@human_GAPDH_TAA_len41_fa10_ta10_fm10_tm10,a
2957@TOP@human_GAPDH_TAA_len41_fa10_ta10_fm10_tm10*119*g,1,1,9641,0,9643,1.0,119,2957@TOP@human_GAPDH_TAA_len41_fa10_ta10_fm10_tm10,g
2957@TOP@human_GAPDH_TAA_len41_fa10_ta10_fm10_tm10*120*g,0,0,9637,0,9637,1.0,120,2957@TOP@human_GAPDH_TAA_len41_fa10_ta10_fm10_tm10,g
2957@TOP@human_GAPDH_TAA_len41_fa10_ta10_fm10_tm10*121*a,9723,0,0,0,9723,0.0,121,2957@TOP@human_GAPDH_TAA_len41_fa10_ta10_fm10_tm10,a
2957@TOP@human_GAPDH_TAA_len41_fa10_ta10_fm10_tm10*122*g,1,0,9738,0,9739,1.0,122,2957@TOP@human_GAPDH_TAA_len41_fa10_ta10_fm10_tm10,g
2957@TOP@human_GAPDH_TAA_len41_fa10_ta10_fm10_tm10*123*t,0,1,1,9612,9614,0.0,123,2957@TOP@human_GAPDH_TAA_len41_fa10_ta10_fm10_tm10,t
2957@TOP@human_GAPDH_TAA_len41_fa10_ta10_fm10_tm10*124*a,7918,0,1693,0,9611,0.176,124,2957@TOP@human_GAPDH_TAA_len41_fa10_ta10_fm10_tm10,a
2957@TOP@human_GAPDH_TAA_len41_fa10_ta10_fm10_tm10*125*a,9229,0,375,0,9604,0.039,125,2957@TOP@human_GAPDH_TAA_len41_fa10_ta10_fm10_tm10,a
2957@TOP@human_GAPDH_TAA_len41_fa10_ta10_fm10_tm10*126*g,0,0,9623,2,9625,1.0,126,2957@TOP@human_GAPDH_TAA_len41_fa10_ta10_fm10_tm10,g
2957@TOP@human_GAPDH_TAA_len41_fa10_ta10_fm10_tm10*127*a,9694,0,7,0,9701,0.001,127,2957@TOP@human_GAPDH_TAA_len41_fa10_ta10_fm10_tm10,a
2957@TOP@human_GAPDH_TAA_len41_fa10_ta10_fm10_tm10*128*c,0,9763,1,1,9765,0.0,128,2957@TOP@human_GAPDH_TAA_len41_fa10_ta10_fm10_tm10,c
2957@TOP@human_GAPDH_TAA_len41_fa10_ta10_fm10_tm10*129*c,0,9699,0,1,9700,0.0,129,2957@TOP@human_GAPDH_TAA_len41_fa10_ta10_fm10_tm10,c
2957@TOP@human_GAPDH_TAA_len41_fa10_ta10_fm10_tm10*130*c,2,9731,0,1,9734,0.0,130,2957@TOP@human_GAPDH_TAA_len41_fa10_ta10_fm10_tm10,c
2957@TOP@human_GAPDH_TAA_len41_fa10_ta10_fm10_tm10*131*c,1,9769,0,1,9771,0.0,131,2957@TOP@human_GAPDH_TAA_len41_fa10_ta10_fm10_tm10,c
2957@TOP@human_GAPDH_TAA_len41_fa10_ta10_fm10_tm10*132*t,0,4,4,9627,9635,0.0,132,2957@TOP@human_GAPDH_TAA_len41_fa10_ta10_fm10_tm10,t
2957@TOP@human_GAPDH_TAA_len41_fa10_ta10_fm10_tm10*133*g,0,0,9632,0,9632,1.0,133,2957@TOP@human_GAPDH_TAA_len41_fa10_ta10_fm10_tm10,g
2957@TOP@human_GAPDH_TAA_len41_fa10_ta10_fm10_tm10*134*g,0,9,9653,1,9663,0.999,134,2957@TOP@human_GAPDH_TAA_len41_fa10_ta10_fm10_tm10,g
2958@TOP@human_GAPDH_TAA_len41_fa10_ta10_fm10_tm10*114*t,0,0,0,644,644,0.0,114,2958@TOP@human_GAPDH_TAA_len41_fa10_ta10_fm10_tm10,t
2958@TOP@human_GAPDH_TAA_len41_fa10_ta10_fm10_tm10*115*c,0,654,0,0,654,0.0,115,2958@TOP@human_GAPDH_TAA_len41_fa10_ta10_fm10_tm10,c
2958@TOP@human_GAPDH_TAA_len41_fa10_ta10_fm10_tm10*116*c,0,644,0,0,644,0.0,116,2958@TOP@human_GAPDH_TAA_len41_fa10_ta10_fm10_tm10,c
2958@TOP@human_GAPDH_TAA_len41_fa10_ta10_fm10_tm10*117*a,649,0,2,0,651,0.003,117,2958@TOP@human_GAPDH_TAA_len41_fa10_ta10_fm10_tm10,a
2958@TOP@human_GAPDH_TAA_len41_fa10_ta10_fm10_tm10*118*a,589,0,54,0,643,0.084,118,2958@TOP@human_GAPDH_TAA_len41_fa10_ta10_fm10_tm10,a
2958@TOP@human_GAPDH_TAA_len41_fa10_ta10_fm10_tm10*119*g,0,0,648,0,648,1.0,119,2958@TOP@human_GAPDH_TAA_len41_fa10_ta10_fm10_tm10,g
2958@TOP@human_GAPDH_TAA_len41_fa10_ta10_fm10_tm10*120*g,0,0,633,0,633,1.0,120,2958@TOP@human_GAPDH_TAA_len41_fa10_ta10_fm10_tm10,g
2958@TOP@human_GAPDH_TAA_len41_fa10_ta10_fm10_tm10*121*a,647,0,0,0,647,0.0,121,2958@TOP@human_GAPDH_TAA_len41_fa10_ta10_fm10_tm10,a
2958@TOP@human_GAPDH_TAA_len41_fa10_ta10_fm10_tm10*122*g,1,0,645,0,646,0.998,122,2958@TOP@human_GAPDH_TAA_len41_fa10_ta10_fm10_tm10,g
2958@TOP@human_GAPDH_TAA_len41_fa10_ta10_fm10_tm10*123*t,0,0,0,644,644,0.0,123,2958@TOP@human_GAPDH_TAA_len41_fa10_ta10_fm10_tm10,t
2958@TOP@human_GAPDH_TAA_len41_fa10_ta10_fm10_tm10*124*a,495,0,141,0,636,0.222,124,2958@TOP@human_GAPDH_TAA_len41_fa10_ta10_fm10_tm10,a
2958@TOP@human_GAPDH_TAA_len41_fa10_ta10_fm10_tm10*125*a,553,0,83,0,636,0.131,125,2958@TOP@human_GAPDH_TAA_len41_fa10_ta10_fm10_tm10,a
2958@TOP@human_GAPDH_TAA_len41_fa10_ta10_fm10_tm10*126*g,0,0,632,0,632,1.0,126,2958@TOP@human_GAPDH_TAA_len41_fa10_ta10_fm10_tm10,g
2958@TOP@human_GAPDH_TAA_len41_fa10_ta10_fm10_tm10*127*a,643,0,2,0,645,0.003,127,2958@TOP@human_GAPDH_TAA_len41_fa10_ta10_fm10_tm10,a
2958@TOP@human_GAPDH_TAA_len41_fa10_ta10_fm10_tm10*128*c,0,649,0,0,649,0.0,128,2958@TOP@human_GAPDH_TAA_len41_fa10_ta10_fm10_tm10,c
2958@TOP@human_GAPDH_TAA_len41_fa10_ta10_fm10_tm10*129*c,0,649,0,0,649,0.0,129,2958@TOP@human_GAPDH_TAA_len41_fa10_ta10_fm10_tm10,c
2958@TOP@human_GAPDH_TAA_len41_fa10_ta10_fm10_tm10*130*c,0,648,0,0,648,0.0,130,2958@TOP@human_GAPDH_TAA_len41_fa10_ta10_fm10_tm10,c
2958@TOP@human_GAPDH_TAA_len41_fa10_ta10_fm10_tm10*131*c,0,650,0,0,650,0.0,131,2958@TOP@human_GAPDH_TAA_len41_fa10_ta10_fm10_tm10,c
2958@TOP@human_GAPDH_TAA_len41_fa10_ta10_fm10_tm10*132*t,0,0,2,644,646,0.003,132,2958@TOP@human_GAPDH_TAA_len41_fa10_ta10_fm10_tm10,t
2958@TOP@human_GAPDH_TAA_len41_fa10_ta10_fm10_tm10*133*g,0,0,641,0,641,1.0,133,2958@TOP@human_GAPDH_TAA_len41_fa10_ta10_fm10_tm10,g
2958@TOP@human_GAPDH_TAA_len41_fa10_ta10_fm10_tm10*134*g,0,0,642,0,642,1.0,134,2958@TOP@human_GAPDH_TAA_len41_fa10_ta10_fm10_tm10,g
2959@TOP@human_GAPDH_TAA_len41_fa10_ta10_fm10_tm10*114*t,0,1,0,2966,2967,0.0,114,2959@TOP@human_GAPDH_TAA_len41_fa10_ta10_fm10_tm10,t
2959@TOP@human_GAPDH_TAA_len41_fa10_ta10_fm10_tm10*115*c,0,2979,0,1,2980,0.0,115,2959@TOP@human_GAPDH_TAA_len41_fa10_ta10_fm10_tm10,c
2959@TOP@human_GAPDH_TAA_len41_fa10_ta10_fm10_tm10*116*c,0,2965,0,0,2965,0.0,116,2959@TOP@human_GAPDH_TAA_len41_fa10_ta10_fm10_tm10,c
2959@TOP@human_GAPDH_TAA_len41_fa10_ta10_fm10_tm10*117*a,2953,0,15,0,2968,0.005,117,2959@TOP@human_GAPDH_TAA_len41_fa10_ta10_fm10_tm10,a
2959@TOP@human_GAPDH_TAA_len41_fa10_ta10_fm10_tm10*118*a,2770,0,176,0,2946,0.06,118,2959@TOP@human_GAPDH_TAA_len41_fa10_ta10_fm10_tm10,a
2959@TOP@human_GAPDH_TAA_len41_fa10_ta10_fm10_tm10*119*g,0,0,2960,0,2960,1.0,119,2959@TOP@human_GAPDH_TAA_len41_fa10_ta10_fm10_tm10,g
2959@TOP@human_GAPDH_TAA_len41_fa10_ta10_fm10_tm10*120*g,0,0,2939,0,2939,1.0,120,2959@TOP@human_GAPDH_TAA_len41_fa10_ta10_fm10_tm10,g
2959@TOP@human_GAPDH_TAA_len41_fa10_ta10_fm10_tm10*121*a,2961,0,2,0,2963,0.001,121,2959@TOP@human_GAPDH_TAA_len41_fa10_ta10_fm10_tm10,a
2959@TOP@human_GAPDH_TAA_len41_fa10_ta10_fm10_tm10*122*g,0,0,2974,0,2974,1.0,122,2959@TOP@human_GAPDH_TAA_len41_fa10_ta10_fm10_tm10,g
2959@TOP@human_GAPDH_TAA_len41_fa10_ta10_fm10_tm10*123*t,0,0,0,2931,2931,0.0,123,2959@TOP@human_GAPDH_TAA_len41_fa10_ta10_fm10_tm10,t
2959@TOP@human_GAPDH_TAA_len41_fa10_ta10_fm10_tm10*124*a,2211,0,718,0,2929,0.245,124,2959@TOP@human_GAPDH_TAA_len41_fa10_ta10_fm10_tm10,a
2959@TOP@human_GAPDH_TAA_len41_fa10_ta10_fm10_tm10*125*a,2668,0,260,0,2928,0.089,125,2959@TOP@human_GAPDH_TAA_len41_fa10_ta10_fm10_tm10,a
2959@TOP@human_GAPDH_TAA_len41_fa10_ta10_fm10_tm10*126*g,1,0,2940,0,2941,1.0,126,2959@TOP@human_GAPDH_TAA_len41_fa10_ta10_fm10_tm10,g
2959@TOP@human_GAPDH_TAA_len41_fa10_ta10_fm10_tm10*127*a,2951,0,3,0,2954,0.001,127,2959@TOP@human_GAPDH_TAA_len41_fa10_ta10_fm10_tm10,a
2959@TOP@human_GAPDH_TAA_len41_fa10_ta10_fm10_tm10*128*c,0,2975,0,0,2975,0.0,128,2959@TOP@human_GAPDH_TAA_len41_fa10_ta10_fm10_tm10,c
2959@TOP@human_GAPDH_TAA_len41_fa10_ta10_fm10_tm10*129*c,0,2958,0,0,2958,0.0,129,2959@TOP@human_GAPDH_TAA_len41_fa10_ta10_fm10_tm10,c
2959@TOP@human_GAPDH_TAA_len41_fa10_ta10_fm10_tm10*130*c,0,2973,0,0,2973,0.0,130,2959@TOP@human_GAPDH_TAA_len41_fa10_ta10_fm10_tm10,c
2959@TOP@human_GAPDH_TAA_len41_fa10_ta10_fm10_tm10*131*c,0,2977,0,1,2978,0.0,131,2959@TOP@human_GAPDH_TAA_len41_fa10_ta10_fm10_tm10,c
2959@TOP@human_GAPDH_TAA_len41_fa10_ta10_fm10_tm10*132*t,0,0,0,2942,2942,0.0,132,2959@TOP@human_GAPDH_TAA_len41_fa10_ta10_fm10_tm10,t
2959@TOP@human_GAPDH_TAA_len41_fa10_ta10_fm10_tm10*133*g,1,0,2937,0,2938,1.0,133,2959@TOP@human_GAPDH_TAA_len41_fa10_ta10_fm10_tm10,g
2959@TOP@human_GAPDH_TAA_len41_fa10_ta10_fm10_tm10*134*g,0,0,2951,0,2951,1.0,134,2959@TOP@human_GAPDH_TAA_len41_fa10_ta10_fm10_tm10,g
2960@TOP@human_GAPDH_TAA_len41_fa10_ta10_fm10_tm10*114*t,4,16,1,70715,70736,0.0,114,2960@TOP@human_GAPDH_TAA_len41_fa10_ta10_fm10_tm10,t
2960@TOP@human_GAPDH_TAA_len41_fa10_ta10_fm10_tm10*115*c,4,71119,0,2,71125,0.0,115,2960@TOP@human_GAPDH_TAA_len41_fa10_ta10_fm10_tm10,c
2960@TOP@human_GAPDH_TAA_len41_fa10_ta10_fm10_tm10*116*c,2,70827,1,6,70836,0.0,116,2960@TOP@human_GAPDH_TAA_len41_fa10_ta10_fm10_tm10,c
2960@TOP@human_GAPDH_TAA_len41_fa10_ta10_fm10_tm10*117*a,70729,0,101,2,70832,0.001,117,2960@TOP@human_GAPDH_TAA_len41_fa10_ta10_fm10_tm10,a
2960@TOP@human_GAPDH_TAA_len41_fa10_ta10_fm10_tm10*118*a,65865,3,4551,3,70422,0.065,118,2960@TOP@human_GAPDH_TAA_len41_fa10_ta10_fm10_tm10,a
2960@TOP@human_GAPDH_TAA_len41_fa10_ta10_fm10_tm10*119*g,4,0,70282,0,70286,1.0,119,2960@TOP@human_GAPDH_TAA_len41_fa10_ta10_fm10_tm10,g
2960@TOP@human_GAPDH_TAA_len41_fa10_ta10_fm10_tm10*120*g,4,2,70013,5,70024,1.0,120,2960@TOP@human_GAPDH_TAA_len41_fa10_ta10_fm10_tm10,g
2960@TOP@human_GAPDH_TAA_len41_fa10_ta10_fm10_tm10*121*a,70689,0,15,4,70708,0.0,121,2960@TOP@human_GAPDH_TAA_len41_fa10_ta10_fm10_tm10,a
2960@TOP@human_GAPDH_TAA_len41_fa10_ta10_fm10_tm10*122*g,3,1,70811,2,70817,1.0,122,2960@TOP@human_GAPDH_TAA_len41_fa10_ta10_fm10_tm10,g
2960@TOP@human_GAPDH_TAA_len41_fa10_ta10_fm10_tm10*123*t,5,25,8,69944,69982,0.0,123,2960@TOP@human_GAPDH_TAA_len41_fa10_ta10_fm10_tm10,t
2960@TOP@human_GAPDH_TAA_len41_fa10_ta10_fm10_tm10*124*a,66200,1,3489,1,69691,0.05,124,2960@TOP@human_GAPDH_TAA_len41_fa10_ta10_fm10_tm10,a
2960@TOP@human_GAPDH_TAA_len41_fa10_ta10_fm10_tm10*125*a,67445,7,2043,7,69502,0.029,125,2960@TOP@human_GAPDH_TAA_len41_fa10_ta10_fm10_tm10,a
2960@TOP@human_GAPDH_TAA_len41_fa10_ta10_fm10_tm10*126*g,3,0,69884,1,69888,1.0,126,2960@TOP@human_GAPDH_TAA_len41_fa10_ta10_fm10_tm10,g
2960@TOP@human_GAPDH_TAA_len41_fa10_ta10_fm10_tm10*127*a,70492,11,48,2,70553,0.001,127,2960@TOP@human_GAPDH_TAA_len41_fa10_ta10_fm10_tm10,a
2960@TOP@human_GAPDH_TAA_len41_fa10_ta10_fm10_tm10*128*c,0,70930,9,1,70940,0.0,128,2960@TOP@human_GAPDH_TAA_len41_fa10_ta10_fm10_tm10,c
2960@TOP@human_GAPDH_TAA_len41_fa10_ta10_fm10_tm10*129*c,4,70408,0,4,70416,0.0,129,2960@TOP@human_GAPDH_TAA_len41_fa10_ta10_fm10_tm10,c
2960@TOP@human_GAPDH_TAA_len41_fa10_ta10_fm10_tm10*130*c,1,70834,0,3,70838,0.0,130,2960@TOP@human_GAPDH_TAA_len41_fa10_ta10_fm10_tm10,c
2960@TOP@human_GAPDH_TAA_len41_fa10_ta10_fm10_tm10*131*c,8,70972,0,9,70989,0.0,131,2960@TOP@human_GAPDH_TAA_len41_fa10_ta10_fm10_tm10,c
2960@TOP@human_GAPDH_TAA_len41_fa10_ta10_fm10_tm10*132*t,4,20,3,69973,70000,0.0,132,2960@TOP@human_GAPDH_TAA_len41_fa10_ta10_fm10_tm10,t
2960@TOP@human_GAPDH_TAA_len41_fa10_ta10_fm10_tm10*133*g,7,1,69825,1,69834,1.0,133,2960@TOP@human_GAPDH_TAA_len41_fa10_ta10_fm10_tm10,g
2960@TOP@human_GAPDH_TAA_len41_fa10_ta10_fm10_tm10*134*g,8,9,70180,3,70200,1.0,134,2960@TOP@human_GAPDH_TAA_len41_fa10_ta10_fm10_tm10,g
2961@TOP@human_GAPDH_TAA_len41_fa10_ta10_fm10_tm10*114*t,3,15,1,46313,46332,0.0,114,2961@TOP@human_GAPDH_TAA_len41_fa10_ta10_fm10_tm10,t
2961@TOP@human_GAPDH_TAA_len41_fa10_ta10_fm10_tm10*115*c,0,46558,2,3,46563,0.0,115,2961@TOP@human_GAPDH_TAA_len41_fa10_ta10_fm10_tm10,c
2961@TOP@human_GAPDH_TAA_len41_fa10_ta10_fm10_tm10*116*c,1,46403,0,7,46411,0.0,116,2961@TOP@human_GAPDH_TAA_len41_fa10_ta10_fm10_tm10,c
2961@TOP@human_GAPDH_TAA_len41_fa10_ta10_fm10_tm10*117*a,46293,0,69,1,46363,0.001,117,2961@TOP@human_GAPDH_TAA_len41_fa10_ta10_fm10_tm10,a
2961@TOP@human_GAPDH_TAA_len41_fa10_ta10_fm10_tm10*118*a,44686,3,1422,5,46116,0.031,118,2961@TOP@human_GAPDH_TAA_len41_fa10_ta10_fm10_tm10,a
2961@TOP@human_GAPDH_TAA_len41_fa10_ta10_fm10_tm10*119*g,2,1,46068,1,46072,1.0,119,2961@TOP@human_GAPDH_TAA_len41_fa10_ta10_fm10_tm10,g
2961@TOP@human_GAPDH_TAA_len41_fa10_ta10_fm10_tm10*120*g,0,2,45890,0,45892,1.0,120,2961@TOP@human_GAPDH_TAA_len41_fa10_ta10_fm10_tm10,g
2961@TOP@human_GAPDH_TAA_len41_fa10_ta10_fm10_tm10*121*a,46334,0,6,0,46340,0.0,121,2961@TOP@human_GAPDH_TAA_len41_fa10_ta10_fm10_tm10,a
2961@TOP@human_GAPDH_TAA_len41_fa10_ta10_fm10_tm10*122*g,3,2,46383,0,46388,1.0,122,2961@TOP@human_GAPDH_TAA_len41_fa10_ta10_fm10_tm10,g
2961@TOP@human_GAPDH_TAA_len41_fa10_ta10_fm10_tm10*123*t,3,4,1,45725,45733,0.0,123,2961@TOP@human_GAPDH_TAA_len41_fa10_ta10_fm10_tm10,t
2961@TOP@human_GAPDH_TAA_len41_fa10_ta10_fm10_tm10*124*a,40098,0,5527,2,45627,0.121,124,2961@TOP@human_GAPDH_TAA_len41_fa10_ta10_fm10_tm10,a
2961@TOP@human_GAPDH_TAA_len41_fa10_ta10_fm10_tm10*125*a,44871,3,787,1,45662,0.017,125,2961@TOP@human_GAPDH_TAA_len41_fa10_ta10_fm10_tm10,a
2961@TOP@human_GAPDH_TAA_len41_fa10_ta10_fm10_tm10*126*g,1,0,45831,1,45833,1.0,126,2961@TOP@human_GAPDH_TAA_len41_fa10_ta10_fm10_tm10,g
2961@TOP@human_GAPDH_TAA_len41_fa10_ta10_fm10_tm10*127*a,46184,3,31,1,46219,0.001,127,2961@TOP@human_GAPDH_TAA_len41_fa10_ta10_fm10_tm10,a
2961@TOP@human_GAPDH_TAA_len41_fa10_ta10_fm10_tm10*128*c,1,46464,6,2,46473,0.0,128,2961@TOP@human_GAPDH_TAA_len41_fa10_ta10_fm10_tm10,c
2961@TOP@human_GAPDH_TAA_len41_fa10_ta10_fm10_tm10*129*c,7,46141,0,4,46152,0.0,129,2961@TOP@human_GAPDH_TAA_len41_fa10_ta10_fm10_tm10,c
2961@TOP@human_GAPDH_TAA_len41_fa10_ta10_fm10_tm10*130*c,0,46402,0,3,46405,0.0,130,2961@TOP@human_GAPDH_TAA_len41_fa10_ta10_fm10_tm10,c
2961@TOP@human_GAPDH_TAA_len41_fa10_ta10_fm10_tm10*131*c,6,46485,0,5,46496,0.0,131,2961@TOP@human_GAPDH_TAA_len41_fa10_ta10_fm10_tm10,c
2961@TOP@human_GAPDH_TAA_len41_fa10_ta10_fm10_tm10*132*t,6,14,1,45832,45853,0.0,132,2961@TOP@human_GAPDH_TAA_len41_fa10_ta10_fm10_tm10,t
2961@TOP@human_GAPDH_TAA_len41_fa10_ta10_fm10_tm10*133*g,3,1,45759,1,45764,1.0,133,2961@TOP@human_GAPDH_TAA_len41_fa10_ta10_fm10_tm10,g
2961@TOP@human_GAPDH_TAA_len41_fa10_ta10_fm10_tm10*134*g,7,7,45966,7,45987,1.0,134,2961@TOP@human_GAPDH_TAA_len41_fa10_ta10_fm10_tm10,g
2962@TOP@human_GAPDH_TAA_len41_fa10_ta10_fm10_tm10*114*t,0,0,0,624,624,0.0,114,2962@TOP@human_GAPDH_TAA_len41_fa10_ta10_fm10_tm10,t
2962@TOP@human_GAPDH_TAA_len41_fa10_ta10_fm10_tm10*115*c,0,634,0,1,635,0.0,115,2962@TOP@human_GAPDH_TAA_len41_fa10_ta10_fm10_tm10,c
2962@TOP@human_GAPDH_TAA_len41_fa10_ta10_fm10_tm10*116*c,0,627,0,0,627,0.0,116,2962@TOP@human_GAPDH_TAA_len41_fa10_ta10_fm10_tm10,c
2962@TOP@human_GAPDH_TAA_len41_fa10_ta10_fm10_tm10*117*a,576,0,54,0,630,0.086,117,2962@TOP@human_GAPDH_TAA_len41_fa10_ta10_fm10_tm10,a
2962@TOP@human_GAPDH_TAA_len41_fa10_ta10_fm10_tm10*118*a,481,1,145,0,627,0.231,118,2962@TOP@human_GAPDH_TAA_len41_fa10_ta10_fm10_tm10,a
2962@TOP@human_GAPDH_TAA_len41_fa10_ta10_fm10_tm10*119*g,0,0,625,0,625,1.0,119,2962@TOP@human_GAPDH_TAA_len41_fa10_ta10_fm10_tm10,g
2962@TOP@human_GAPDH_TAA_len41_fa10_ta10_fm10_tm10*120*g,0,0,621,0,621,1.0,120,2962@TOP@human_GAPDH_TAA_len41_fa10_ta10_fm10_tm10,g
2962@TOP@human_GAPDH_TAA_len41_fa10_ta10_fm10_tm10*121*a,625,0,0,0,625,0.0,121,2962@TOP@human_GAPDH_TAA_len41_fa10_ta10_fm10_tm10,a
2962@TOP@human_GAPDH_TAA_len41_fa10_ta10_fm10_tm10*122*g,0,0,632,0,632,1.0,122,2962@TOP@human_GAPDH_TAA_len41_fa10_ta10_fm10_tm10,g
2962@TOP@human_GAPDH_TAA_len41_fa10_ta10_fm10_tm10*123*t,0,2,0,618,620,0.0,123,2962@TOP@human_GAPDH_TAA_len41_fa10_ta10_fm10_tm10,t
2962@TOP@human_GAPDH_TAA_len41_fa10_ta10_fm10_tm10*124*a,482,0,144,0,626,0.23,124,2962@TOP@human_GAPDH_TAA_len41_fa10_ta10_fm10_tm10,a
2962@TOP@human_GAPDH_TAA_len41_fa10_ta10_fm10_tm10*125*a,499,0,120,0,619,0.194,125,2962@TOP@human_GAPDH_TAA_len41_fa10_ta10_fm10_tm10,a
2962@TOP@human_GAPDH_TAA_len41_fa10_ta10_fm10_tm10*126*g,0,0,618,0,618,1.0,126,2962@TOP@human_GAPDH_TAA_len41_fa10_ta10_fm10_tm10,g
2962@TOP@human_GAPDH_TAA_len41_fa10_ta10_fm10_tm10*127*a,627,0,0,0,627,0.0,127,2962@TOP@human_GAPDH_TAA_len41_fa10_ta10_fm10_tm10,a
2962@TOP@human_GAPDH_TAA_len41_fa10_ta10_fm10_tm10*128*c,0,634,0,0,634,0.0,128,2962@TOP@human_GAPDH_TAA_len41_fa10_ta10_fm10_tm10,c
2962@TOP@human_GAPDH_TAA_len41_fa10_ta10_fm10_tm10*129*c,0,632,0,0,632,0.0,129,2962@TOP@human_GAPDH_TAA_len41_fa10_ta10_fm10_tm10,c
2962@TOP@human_GAPDH_TAA_len41_fa10_ta10_fm10_tm10*130*c,1,630,0,0,631,0.0,130,2962@TOP@human_GAPDH_TAA_len41_fa10_ta10_fm10_tm10,c
2962@TOP@human_GAPDH_TAA_len41_fa10_ta10_fm10_tm10*131*c,0,632,0,0,632,0.0,131,2962@TOP@human_GAPDH_TAA_len41_fa10_ta10_fm10_tm10,c
2962@TOP@human_GAPDH_TAA_len41_fa10_ta10_fm10_tm10*132*t,0,0,0,623,623,0.0,132,2962@TOP@human_GAPDH_TAA_len41_fa10_ta10_fm10_tm10,t
2962@TOP@human_GAPDH_TAA_len41_fa10_ta10_fm10_tm10*133*g,0,0,623,0,623,1.0,133,2962@TOP@human_GAPDH_TAA_len41_fa10_ta10_fm10_tm10,g
2962@TOP@human_GAPDH_TAA_len41_fa10_ta10_fm10_tm10*134*g,0,1,621,0,622,0.998,134,2962@TOP@human_GAPDH_TAA_len41_fa10_ta10_fm10_tm10,g
2963@TOP@human_GAPDH_TAA_len41_fa10_ta10_fm10_tm10*114*t,1,1,0,2329,2331,0.0,114,2963@TOP@human_GAPDH_TAA_len41_fa10_ta10_fm10_tm10,t
2963@TOP@human_GAPDH_TAA_len41_fa10_ta10_fm10_tm10*115*c,0,2350,0,0,2350,0.0,115,2963@TOP@human_GAPDH_TAA_len41_fa10_ta10_fm10_tm10,c
2963@TOP@human_GAPDH_TAA_len41_fa10_ta10_fm10_tm10*116*c,0,2345,0,0,2345,0.0,116,2963@TOP@human_GAPDH_TAA_len41_fa10_ta10_fm10_tm10,c
2963@TOP@human_GAPDH_TAA_len41_fa10_ta10_fm10_tm10*117*a,2253,0,90,0,2343,0.038,117,2963@TOP@human_GAPDH_TAA_len41_fa10_ta10_fm10_tm10,a
2963@TOP@human_GAPDH_TAA_len41_fa10_ta10_fm10_tm10*118*a,1845,0,487,0,2332,0.209,118,2963@TOP@human_GAPDH_TAA_len41_fa10_ta10_fm10_tm10,a
2963@TOP@human_GAPDH_TAA_len41_fa10_ta10_fm10_tm10*119*g,0,0,2326,0,2326,1.0,119,2963@TOP@human_GAPDH_TAA_len41_fa10_ta10_fm10_tm10,g
2963@TOP@human_GAPDH_TAA_len41_fa10_ta10_fm10_tm10*120*g,0,0,2307,0,2307,1.0,120,2963@TOP@human_GAPDH_TAA_len41_fa10_ta10_fm10_tm10,g
2963@TOP@human_GAPDH_TAA_len41_fa10_ta10_fm10_tm10*121*a,2332,0,1,0,2333,0.0,121,2963@TOP@human_GAPDH_TAA_len41_fa10_ta10_fm10_tm10,a
2963@TOP@human_GAPDH_TAA_len41_fa10_ta10_fm10_tm10*122*g,0,3,2337,0,2340,0.999,122,2963@TOP@human_GAPDH_TAA_len41_fa10_ta10_fm10_tm10,g
2963@TOP@human_GAPDH_TAA_len41_fa10_ta10_fm10_tm10*123*t,0,1,0,2319,2320,0.0,123,2963@TOP@human_GAPDH_TAA_len41_fa10_ta10_fm10_tm10,t
2963@TOP@human_GAPDH_TAA_len41_fa10_ta10_fm10_tm10*124*a,1843,0,452,0,2295,0.197,124,2963@TOP@human_GAPDH_TAA_len41_fa10_ta10_fm10_tm10,a
2963@TOP@human_GAPDH_TAA_len41_fa10_ta10_fm10_tm10*125*a,2079,0,229,0,2308,0.099,125,2963@TOP@human_GAPDH_TAA_len41_fa10_ta10_fm10_tm10,a
2963@TOP@human_GAPDH_TAA_len41_fa10_ta10_fm10_tm10*126*g,0,0,2316,0,2316,1.0,126,2963@TOP@human_GAPDH_TAA_len41_fa10_ta10_fm10_tm10,g
2963@TOP@human_GAPDH_TAA_len41_fa10_ta10_fm10_tm10*127*a,2316,2,11,0,2329,0.005,127,2963@TOP@human_GAPDH_TAA_len41_fa10_ta10_fm10_tm10,a
2963@TOP@human_GAPDH_TAA_len41_fa10_ta10_fm10_tm10*128*c,0,2339,0,0,2339,0.0,128,2963@TOP@human_GAPDH_TAA_len41_fa10_ta10_fm10_tm10,c
2963@TOP@human_GAPDH_TAA_len41_fa10_ta10_fm10_tm10*129*c,0,2332,0,0,2332,0.0,129,2963@TOP@human_GAPDH_TAA_len41_fa10_ta10_fm10_tm10,c
2963@TOP@human_GAPDH_TAA_len41_fa10_ta10_fm10_tm10*130*c,0,2344,0,0,2344,0.0,130,2963@TOP@human_GAPDH_TAA_len41_fa10_ta10_fm10_tm10,c
2963@TOP@human_GAPDH_TAA_len41_fa10_ta10_fm10_tm10*131*c,0,2341,0,0,2341,0.0,131,2963@TOP@human_GAPDH_TAA_len41_fa10_ta10_fm10_tm10,c
2963@TOP@human_GAPDH_TAA_len41_fa10_ta10_fm10_tm10*132*t,0,1,0,2306,2307,0.0,132,2963@TOP@human_GAPDH_TAA_len41_fa10_ta10_fm10_tm10,t
2963@TOP@human_GAPDH_TAA_len41_fa10_ta10_fm10_tm10*133*g,0,0,2317,0,2317,1.0,133,2963@TOP@human_GAPDH_TAA_len41_fa10_ta10_fm10_tm10,g
2963@TOP@human_GAPDH_TAA_len41_fa10_ta10_fm10_tm10*134*g,1,0,2321,0,2322,1.0,134,2963@TOP@human_GAPDH_TAA_len41_fa10_ta10_fm10_tm10,g
2964@TOP@human_GAPDH_TAA_len41_fa10_ta10_fm10_tm10*114*t,1,0,0,4596,4597,0.0,114,2964@TOP@human_GAPDH_TAA_len41_fa10_ta10_fm10_tm10,t
2964@TOP@human_GAPDH_TAA_len41_fa10_ta10_fm10_tm10*115*c,0,4637,0,0,4637,0.0,115,2964@TOP@human_GAPDH_TAA_len41_fa10_ta10_fm10_tm10,c
2964@TOP@human_GAPDH_TAA_len41_fa10_ta10_fm10_tm10*116*c,0,4614,0,2,4616,0.0,116,2964@TOP@human_GAPDH_TAA_len41_fa10_ta10_fm10_tm10,c
2964@TOP@human_GAPDH_TAA_len41_fa10_ta10_fm10_tm10*117*a,4509,1,101,0,4611,0.022,117,2964@TOP@human_GAPDH_TAA_len41_fa10_ta10_fm10_tm10,a
2964@TOP@human_GAPDH_TAA_len41_fa10_ta10_fm10_tm10*118*a,3491,0,1110,0,4601,0.241,118,2964@TOP@human_GAPDH_TAA_len41_fa10_ta10_fm10_tm10,a
2964@TOP@human_GAPDH_TAA_len41_fa10_ta10_fm10_tm10*119*g,0,0,4586,0,4586,1.0,119,2964@TOP@human_GAPDH_TAA_len41_fa10_ta10_fm10_tm10,g
2964@TOP@human_GAPDH_TAA_len41_fa10_ta10_fm10_tm10*120*g,2,0,4569,0,4571,1.0,120,2964@TOP@human_GAPDH_TAA_len41_fa10_ta10_fm10_tm10,g
2964@TOP@human_GAPDH_TAA_len41_fa10_ta10_fm10_tm10*121*a,4585,0,7,0,4592,0.002,121,2964@TOP@human_GAPDH_TAA_len41_fa10_ta10_fm10_tm10,a
2964@TOP@human_GAPDH_TAA_len41_fa10_ta10_fm10_tm10*122*g,0,0,4613,0,4613,1.0,122,2964@TOP@human_GAPDH_TAA_len41_fa10_ta10_fm10_tm10,g
2964@TOP@human_GAPDH_TAA_len41_fa10_ta10_fm10_tm10*123*t,1,3,0,4552,4556,0.0,123,2964@TOP@human_GAPDH_TAA_len41_fa10_ta10_fm10_tm10,t
2964@TOP@human_GAPDH_TAA_len41_fa10_ta10_fm10_tm10*124*a,3024,0,1510,1,4535,0.333,124,2964@TOP@human_GAPDH_TAA_len41_fa10_ta10_fm10_tm10,a
2964@TOP@human_GAPDH_TAA_len41_fa10_ta10_fm10_tm10*125*a,3368,0,1184,0,4552,0.26,125,2964@TOP@human_GAPDH_TAA_len41_fa10_ta10_fm10_tm10,a
2964@TOP@human_GAPDH_TAA_len41_fa10_ta10_fm10_tm10*126*g,0,0,4566,0,4566,1.0,126,2964@TOP@human_GAPDH_TAA_len41_fa10_ta10_fm10_tm10,g
2964@TOP@human_GAPDH_TAA_len41_fa10_ta10_fm10_tm10*127*a,4592,0,9,0,4601,0.002,127,2964@TOP@human_GAPDH_TAA_len41_fa10_ta10_fm10_tm10,a
2964@TOP@human_GAPDH_TAA_len41_fa10_ta10_fm10_tm10*128*c,0,4625,0,0,4625,0.0,128,2964@TOP@human_GAPDH_TAA_len41_fa10_ta10_fm10_tm10,c
2964@TOP@human_GAPDH_TAA_len41_fa10_ta10_fm10_tm10*129*c,0,4601,0,0,4601,0.0,129,2964@TOP@human_GAPDH_TAA_len41_fa10_ta10_fm10_tm10,c
2964@TOP@human_GAPDH_TAA_len41_fa10_ta10_fm10_tm10*130*c,0,4627,0,0,4627,0.0,130,2964@TOP@human_GAPDH_TAA_len41_fa10_ta10_fm10_tm10,c
2964@TOP@human_GAPDH_TAA_len41_fa10_ta10_fm10_tm10*131*c,1,4632,0,0,4633,0.0,131,2964@TOP@human_GAPDH_TAA_len41_fa10_ta10_fm10_tm10,c
2964@TOP@human_GAPDH_TAA_len41_fa10_ta10_fm10_tm10*132*t,1,4,0,4569,4574,0.0,132,2964@TOP@human_GAPDH_TAA_len41_fa10_ta10_fm10_tm10,t
2964@TOP@human_GAPDH_TAA_len41_fa10_ta10_fm10_tm10*133*g,0,0,4561,0,4561,1.0,133,2964@TOP@human_GAPDH_TAA_len41_fa10_ta10_fm10_tm10,g
2964@TOP@human_GAPDH_TAA_len41_fa10_ta10_fm10_tm10*134*g,0,6,4579,0,4585,0.999,134,2964@TOP@human_GAPDH_TAA_len41_fa10_ta10_fm10_tm10,g
2965@TOP@human_GAPDH_TAA_len41_fa10_ta10_fm10_tm10*114*t,4,6,0,20689,20699,0.0,114,2965@TOP@human_GAPDH_TAA_len41_fa10_ta10_fm10_tm10,t
2965@TOP@human_GAPDH_TAA_len41_fa10_ta10_fm10_tm10*115*c,2,20797,0,2,20801,0.0,115,2965@TOP@human_GAPDH_TAA_len41_fa10_ta10_fm10_tm10,c
2965@TOP@human_GAPDH_TAA_len41_fa10_ta10_fm10_tm10*116*c,0,20731,0,6,20737,0.0,116,2965@TOP@human_GAPDH_TAA_len41_fa10_ta10_fm10_tm10,c
2965@TOP@human_GAPDH_TAA_len41_fa10_ta10_fm10_tm10*117*a,20564,0,133,0,20697,0.006,117,2965@TOP@human_GAPDH_TAA_len41_fa10_ta10_fm10_tm10,a
2965@TOP@human_GAPDH_TAA_len41_fa10_ta10_fm10_tm10*118*a,18809,1,1783,1,20594,0.087,118,2965@TOP@human_GAPDH_TAA_len41_fa10_ta10_fm10_tm10,a
2965@TOP@human_GAPDH_TAA_len41_fa10_ta10_fm10_tm10*119*g,2,0,20575,0,20577,1.0,119,2965@TOP@human_GAPDH_TAA_len41_fa10_ta10_fm10_tm10,g
2965@TOP@human_GAPDH_TAA_len41_fa10_ta10_fm10_tm10*120*g,1,0,20503,0,20504,1.0,120,2965@TOP@human_GAPDH_TAA_len41_fa10_ta10_fm10_tm10,g
2965@TOP@human_GAPDH_TAA_len41_fa10_ta10_fm10_tm10*121*a,20663,0,16,1,20680,0.001,121,2965@TOP@human_GAPDH_TAA_len41_fa10_ta10_fm10_tm10,a
2965@TOP@human_GAPDH_TAA_len41_fa10_ta10_fm10_tm10*122*g,1,0,20726,2,20729,1.0,122,2965@TOP@human_GAPDH_TAA_len41_fa10_ta10_fm10_tm10,g
2965@TOP@human_GAPDH_TAA_len41_fa10_ta10_fm10_tm10*123*t,0,0,0,20434,20434,0.0,123,2965@TOP@human_GAPDH_TAA_len41_fa10_ta10_fm10_tm10,t
2965@TOP@human_GAPDH_TAA_len41_fa10_ta10_fm10_tm10*124*a,16713,0,3671,0,20384,0.18,124,2965@TOP@human_GAPDH_TAA_len41_fa10_ta10_fm10_tm10,a
2965@TOP@human_GAPDH_TAA_len41_fa10_ta10_fm10_tm10*125*a,19224,3,1168,7,20402,0.057,125,2965@TOP@human_GAPDH_TAA_len41_fa10_ta10_fm10_tm10,a
2965@TOP@human_GAPDH_TAA_len41_fa10_ta10_fm10_tm10*126*g,2,0,20480,1,20483,1.0,126,2965@TOP@human_GAPDH_TAA_len41_fa10_ta10_fm10_tm10,g
2965@TOP@human_GAPDH_TAA_len41_fa10_ta10_fm10_tm10*127*a,20646,2,9,0,20657,0.0,127,2965@TOP@human_GAPDH_TAA_len41_fa10_ta10_fm10_tm10,a
2965@TOP@human_GAPDH_TAA_len41_fa10_ta10_fm10_tm10*128*c,0,20752,0,1,20753,0.0,128,2965@TOP@human_GAPDH_TAA_len41_fa10_ta10_fm10_tm10,c
2965@TOP@human_GAPDH_TAA_len41_fa10_ta10_fm10_tm10*129*c,0,20607,1,0,20608,0.0,129,2965@TOP@human_GAPDH_TAA_len41_fa10_ta10_fm10_tm10,c
2965@TOP@human_GAPDH_TAA_len41_fa10_ta10_fm10_tm10*130*c,0,20700,0,0,20700,0.0,130,2965@TOP@human_GAPDH_TAA_len41_fa10_ta10_fm10_tm10,c
2965@TOP@human_GAPDH_TAA_len41_fa10_ta10_fm10_tm10*131*c,1,20759,0,0,20760,0.0,131,2965@TOP@human_GAPDH_TAA_len41_fa10_ta10_fm10_tm10,c
2965@TOP@human_GAPDH_TAA_len41_fa10_ta10_fm10_tm10*132*t,3,4,5,20483,20495,0.0,132,2965@TOP@human_GAPDH_TAA_len41_fa10_ta10_fm10_tm10,t
2965@TOP@human_GAPDH_TAA_len41_fa10_ta10_fm10_tm10*133*g,1,0,20444,0,20445,1.0,133,2965@TOP@human_GAPDH_TAA_len41_fa10_ta10_fm10_tm10,g
2965@TOP@human_GAPDH_TAA_len41_fa10_ta10_fm10_tm10*134*g,0,4,20528,0,20532,1.0,134,2965@TOP@human_GAPDH_TAA_len41_fa10_ta10_fm10_tm10,g
2966@TOP@human_GAPDH_TAA_len41_fa10_ta10_fm10_tm10*114*t,0,1,0,11618,11619,0.0,114,2966@TOP@human_GAPDH_TAA_len41_fa10_ta10_fm10_tm10,t
2966@TOP@human_GAPDH_TAA_len41_fa10_ta10_fm10_tm10*115*c,0,11677,0,0,11677,0.0,115,2966@TOP@human_GAPDH_TAA_len41_fa10_ta10_fm10_tm10,c
2966@TOP@human_GAPDH_TAA_len41_fa10_ta10_fm10_tm10*116*c,1,11637,0,2,11640,0.0,116,2966@TOP@human_GAPDH_TAA_len41_fa10_ta10_fm10_tm10,c
2966@TOP@human_GAPDH_TAA_len41_fa10_ta10_fm10_tm10*117*a,11560,0,57,1,11618,0.005,117,2966@TOP@human_GAPDH_TAA_len41_fa10_ta10_fm10_tm10,a
2966@TOP@human_GAPDH_TAA_len41_fa10_ta10_fm10_tm10*118*a,10601,1,965,1,11568,0.083,118,2966@TOP@human_GAPDH_TAA_len41_fa10_ta10_fm10_tm10,a
2966@TOP@human_GAPDH_TAA_len41_fa10_ta10_fm10_tm10*119*g,3,0,11519,0,11522,1.0,119,2966@TOP@human_GAPDH_TAA_len41_fa10_ta10_fm10_tm10,g
2966@TOP@human_GAPDH_TAA_len41_fa10_ta10_fm10_tm10*120*g,1,0,11479,0,11480,1.0,120,2966@TOP@human_GAPDH_TAA_len41_fa10_ta10_fm10_tm10,g
2966@TOP@human_GAPDH_TAA_len41_fa10_ta10_fm10_tm10*121*a,11610,0,7,0,11617,0.001,121,2966@TOP@human_GAPDH_TAA_len41_fa10_ta10_fm10_tm10,a
2966@TOP@human_GAPDH_TAA_len41_fa10_ta10_fm10_tm10*122*g,0,0,11628,0,11628,1.0,122,2966@TOP@human_GAPDH_TAA_len41_fa10_ta10_fm10_tm10,g
2966@TOP@human_GAPDH_TAA_len41_fa10_ta10_fm10_tm10*123*t,1,1,1,11476,11479,0.0,123,2966@TOP@human_GAPDH_TAA_len41_fa10_ta10_fm10_tm10,t
2966@TOP@human_GAPDH_TAA_len41_fa10_ta10_fm10_tm10*124*a,10572,0,867,0,11439,0.076,124,2966@TOP@human_GAPDH_TAA_len41_fa10_ta10_fm10_tm10,a
2966@TOP@human_GAPDH_TAA_len41_fa10_ta10_fm10_tm10*125*a,10599,1,805,0,11405,0.071,125,2966@TOP@human_GAPDH_TAA_len41_fa10_ta10_fm10_tm10,a
2966@TOP@human_GAPDH_TAA_len41_fa10_ta10_fm10_tm10*126*g,1,0,11468,0,11469,1.0,126,2966@TOP@human_GAPDH_TAA_len41_fa10_ta10_fm10_tm10,g
2966@TOP@human_GAPDH_TAA_len41_fa10_ta10_fm10_tm10*127*a,11564,0,7,0,11571,0.001,127,2966@TOP@human_GAPDH_TAA_len41_fa10_ta10_fm10_tm10,a
2966@TOP@human_GAPDH_TAA_len41_fa10_ta10_fm10_tm10*128*c,0,11654,1,0,11655,0.0,128,2966@TOP@human_GAPDH_TAA_len41_fa10_ta10_fm10_tm10,c
2966@TOP@human_GAPDH_TAA_len41_fa10_ta10_fm10_tm10*129*c,0,11560,0,2,11562,0.0,129,2966@TOP@human_GAPDH_TAA_len41_fa10_ta10_fm10_tm10,c
2966@TOP@human_GAPDH_TAA_len41_fa10_ta10_fm10_tm10*130*c,1,11630,0,0,11631,0.0,130,2966@TOP@human_GAPDH_TAA_len41_fa10_ta10_fm10_tm10,c
2966@TOP@human_GAPDH_TAA_len41_fa10_ta10_fm10_tm10*131*c,3,11649,1,2,11655,0.0,131,2966@TOP@human_GAPDH_TAA_len41_fa10_ta10_fm10_tm10,c
2966@TOP@human_GAPDH_TAA_len41_fa10_ta10_fm10_tm10*132*t,1,6,2,11486,11495,0.0,132,2966@TOP@human_GAPDH_TAA_len41_fa10_ta10_fm10_tm10,t
2966@TOP@human_GAPDH_TAA_len41_fa10_ta10_fm10_tm10*133*g,0,0,11478,0,11478,1.0,133,2966@TOP@human_GAPDH_TAA_len41_fa10_ta10_fm10_tm10,g
2966@TOP@human_GAPDH_TAA_len41_fa10_ta10_fm10_tm10*134*g,0,3,11509,0,11512,1.0,134,2966@TOP@human_GAPDH_TAA_len41_fa10_ta10_fm10_tm10,g
2967@TOP@human_GAPDH_TAA_len41_fa10_ta10_fm10_tm10*114*t,2,10,0,25799,25811,0.0,114,2967@TOP@human_GAPDH_TAA_len41_fa10_ta10_fm10_tm10,t
2967@TOP@human_GAPDH_TAA_len41_fa10_ta10_fm10_tm10*115*c,0,25961,1,0,25962,0.0,115,2967@TOP@human_GAPDH_TAA_len41_fa10_ta10_fm10_tm10,c
2967@TOP@human_GAPDH_TAA_len41_fa10_ta10_fm10_tm10*116*c,0,25845,0,6,25851,0.0,116,2967@TOP@human_GAPDH_TAA_len41_fa10_ta10_fm10_tm10,c
2967@TOP@human_GAPDH_TAA_len41_fa10_ta10_fm10_tm10*117*a,25797,0,51,0,25848,0.002,117,2967@TOP@human_GAPDH_TAA_len41_fa10_ta10_fm10_tm10,a
2967@TOP@human_GAPDH_TAA_len41_fa10_ta10_fm10_tm10*118*a,25085,0,630,0,25715,0.024,118,2967@TOP@human_GAPDH_TAA_len41_fa10_ta10_fm10_tm10,a
2967@TOP@human_GAPDH_TAA_len41_fa10_ta10_fm10_tm10*119*g,1,0,25653,3,25657,1.0,119,2967@TOP@human_GAPDH_TAA_len41_fa10_ta10_fm10_tm10,g
2967@TOP@human_GAPDH_TAA_len41_fa10_ta10_fm10_tm10*120*g,3,0,25585,1,25589,1.0,120,2967@TOP@human_GAPDH_TAA_len41_fa10_ta10_fm10_tm10,g
2967@TOP@human_GAPDH_TAA_len41_fa10_ta10_fm10_tm10*121*a,25807,0,8,0,25815,0.0,121,2967@TOP@human_GAPDH_TAA_len41_fa10_ta10_fm10_tm10,a
2967@TOP@human_GAPDH_TAA_len41_fa10_ta10_fm10_tm10*122*g,1,0,25851,0,25852,1.0,122,2967@TOP@human_GAPDH_TAA_len41_fa10_ta10_fm10_tm10,g
2967@TOP@human_GAPDH_TAA_len41_fa10_ta10_fm10_tm10*123*t,2,1,3,25478,25484,0.0,123,2967@TOP@human_GAPDH_TAA_len41_fa10_ta10_fm10_tm10,t
2967@TOP@human_GAPDH_TAA_len41_fa10_ta10_fm10_tm10*124*a,24384,0,1087,3,25474,0.043,124,2967@TOP@human_GAPDH_TAA_len41_fa10_ta10_fm10_tm10,a
2967@TOP@human_GAPDH_TAA_len41_fa10_ta10_fm10_tm10*125*a,24844,4,530,1,25379,0.021,125,2967@TOP@human_GAPDH_TAA_len41_fa10_ta10_fm10_tm10,a
2967@TOP@human_GAPDH_TAA_len41_fa10_ta10_fm10_tm10*126*g,1,0,25504,1,25506,1.0,126,2967@TOP@human_GAPDH_TAA_len41_fa10_ta10_fm10_tm10,g
2967@TOP@human_GAPDH_TAA_len41_fa10_ta10_fm10_tm10*127*a,25721,0,22,0,25743,0.001,127,2967@TOP@human_GAPDH_TAA_len41_fa10_ta10_fm10_tm10,a
2967@TOP@human_GAPDH_TAA_len41_fa10_ta10_fm10_tm10*128*c,1,25890,2,3,25896,0.0,128,2967@TOP@human_GAPDH_TAA_len41_fa10_ta10_fm10_tm10,c
2967@TOP@human_GAPDH_TAA_len41_fa10_ta10_fm10_tm10*129*c,1,25727,0,1,25729,0.0,129,2967@TOP@human_GAPDH_TAA_len41_fa10_ta10_fm10_tm10,c
2967@TOP@human_GAPDH_TAA_len41_fa10_ta10_fm10_tm10*130*c,1,25848,1,5,25855,0.0,130,2967@TOP@human_GAPDH_TAA_len41_fa10_ta10_fm10_tm10,c
2967@TOP@human_GAPDH_TAA_len41_fa10_ta10_fm10_tm10*131*c,1,25932,0,0,25933,0.0,131,2967@TOP@human_GAPDH_TAA_len41_fa10_ta10_fm10_tm10,c
2967@TOP@human_GAPDH_TAA_len41_fa10_ta10_fm10_tm10*132*t,0,21,1,25515,25537,0.0,132,2967@TOP@human_GAPDH_TAA_len41_fa10_ta10_fm10_tm10,t
2967@TOP@human_GAPDH_TAA_len41_fa10_ta10_fm10_tm10*133*g,0,0,25517,1,25518,1.0,133,2967@TOP@human_GAPDH_TAA_len41_fa10_ta10_fm10_tm10,g
2967@TOP@human_GAPDH_TAA_len41_fa10_ta10_fm10_tm10*134*g,3,16,25632,1,25652,0.999,134,2967@TOP@human_GAPDH_TAA_len41_fa10_ta10_fm10_tm10,g
2968@TOP@human_GAPDH_TAA_len41_fa10_ta10_fm10_tm10*114*t,2,4,0,11528,11534,0.0,114,2968@TOP@human_GAPDH_TAA_len41_fa10_ta10_fm10_tm10,t
2968@TOP@human_GAPDH_TAA_len41_fa10_ta10_fm10_tm10*115*c,1,11597,0,1,11599,0.0,115,2968@TOP@human_GAPDH_TAA_len41_fa10_ta10_fm10_tm10,c
2968@TOP@human_GAPDH_TAA_len41_fa10_ta10_fm10_tm10*116*c,0,11563,0,0,11563,0.0,116,2968@TOP@human_GAPDH_TAA_len41_fa10_ta10_fm10_tm10,c
2968@TOP@human_GAPDH_TAA_len41_fa10_ta10_fm10_tm10*117*a,11248,0,287,0,11535,0.025,117,2968@TOP@human_GAPDH_TAA_len41_fa10_ta10_fm10_tm10,a
2968@TOP@human_GAPDH_TAA_len41_fa10_ta10_fm10_tm10*118*a,8950,0,2516,0,11466,0.219,118,2968@TOP@human_GAPDH_TAA_len41_fa10_ta10_fm10_tm10,a
2968@TOP@human_GAPDH_TAA_len41_fa10_ta10_fm10_tm10*119*g,1,1,11456,0,11458,1.0,119,2968@TOP@human_GAPDH_TAA_len41_fa10_ta10_fm10_tm10,g
2968@TOP@human_GAPDH_TAA_len41_fa10_ta10_fm10_tm10*120*g,0,0,11427,0,11427,1.0,120,2968@TOP@human_GAPDH_TAA_len41_fa10_ta10_fm10_tm10,g
2968@TOP@human_GAPDH_TAA_len41_fa10_ta10_fm10_tm10*121*a,11467,0,8,0,11475,0.001,121,2968@TOP@human_GAPDH_TAA_len41_fa10_ta10_fm10_tm10,a
2968@TOP@human_GAPDH_TAA_len41_fa10_ta10_fm10_tm10*122*g,1,0,11546,0,11547,1.0,122,2968@TOP@human_GAPDH_TAA_len41_fa10_ta10_fm10_tm10,g
2968@TOP@human_GAPDH_TAA_len41_fa10_ta10_fm10_tm10*123*t,3,0,1,11388,11392,0.0,123,2968@TOP@human_GAPDH_TAA_len41_fa10_ta10_fm10_tm10,t
2968@TOP@human_GAPDH_TAA_len41_fa10_ta10_fm10_tm10*124*a,9222,0,2188,0,11410,0.192,124,2968@TOP@human_GAPDH_TAA_len41_fa10_ta10_fm10_tm10,a
2968@TOP@human_GAPDH_TAA_len41_fa10_ta10_fm10_tm10*125*a,10408,1,945,0,11354,0.083,125,2968@TOP@human_GAPDH_TAA_len41_fa10_ta10_fm10_tm10,a
2968@TOP@human_GAPDH_TAA_len41_fa10_ta10_fm10_tm10*126*g,0,0,11402,0,11402,1.0,126,2968@TOP@human_GAPDH_TAA_len41_fa10_ta10_fm10_tm10,g
2968@TOP@human_GAPDH_TAA_len41_fa10_ta10_fm10_tm10*127*a,11510,1,5,1,11517,0.0,127,2968@TOP@human_GAPDH_TAA_len41_fa10_ta10_fm10_tm10,a
2968@TOP@human_GAPDH_TAA_len41_fa10_ta10_fm10_tm10*128*c,2,11572,0,1,11575,0.0,128,2968@TOP@human_GAPDH_TAA_len41_fa10_ta10_fm10_tm10,c
2968@TOP@human_GAPDH_TAA_len41_fa10_ta10_fm10_tm10*129*c,0,11497,0,0,11497,0.0,129,2968@TOP@human_GAPDH_TAA_len41_fa10_ta10_fm10_tm10,c
2968@TOP@human_GAPDH_TAA_len41_fa10_ta10_fm10_tm10*130*c,2,11558,0,1,11561,0.0,130,2968@TOP@human_GAPDH_TAA_len41_fa10_ta10_fm10_tm10,c
2968@TOP@human_GAPDH_TAA_len41_fa10_ta10_fm10_tm10*131*c,1,11577,0,2,11580,0.0,131,2968@TOP@human_GAPDH_TAA_len41_fa10_ta10_fm10_tm10,c
2968@TOP@human_GAPDH_TAA_len41_fa10_ta10_fm10_tm10*132*t,2,6,0,11427,11435,0.0,132,2968@TOP@human_GAPDH_TAA_len41_fa10_ta10_fm10_tm10,t
2968@TOP@human_GAPDH_TAA_len41_fa10_ta10_fm10_tm10*133*g,1,1,11363,0,11365,1.0,133,2968@TOP@human_GAPDH_TAA_len41_fa10_ta10_fm10_tm10,g
2968@TOP@human_GAPDH_TAA_len41_fa10_ta10_fm10_tm10*134*g,2,2,11463,0,11467,1.0,134,2968@TOP@human_GAPDH_TAA_len41_fa10_ta10_fm10_tm10,g
2969@TOP@human_GAPDH_TAA_len41_fa10_ta10_fm10_tm10*114*t,1,3,0,20229,20233,0.0,114,2969@TOP@human_GAPDH_TAA_len41_fa10_ta10_fm10_tm10,t
2969@TOP@human_GAPDH_TAA_len41_fa10_ta10_fm10_tm10*115*c,0,20339,0,0,20339,0.0,115,2969@TOP@human_GAPDH_TAA_len41_fa10_ta10_fm10_tm10,c
2969@TOP@human_GAPDH_TAA_len41_fa10_ta10_fm10_tm10*116*c,1,20264,0,2,20267,0.0,116,2969@TOP@human_GAPDH_TAA_len41_fa10_ta10_fm10_tm10,c
2969@TOP@human_GAPDH_TAA_len41_fa10_ta10_fm10_tm10*117*a,20180,0,62,0,20242,0.003,117,2969@TOP@human_GAPDH_TAA_len41_fa10_ta10_fm10_tm10,a
2969@TOP@human_GAPDH_TAA_len41_fa10_ta10_fm10_tm10*118*a,17953,0,2186,0,20139,0.109,118,2969@TOP@human_GAPDH_TAA_len41_fa10_ta10_fm10_tm10,a
2969@TOP@human_GAPDH_TAA_len41_fa10_ta10_fm10_tm10*119*g,0,0,20101,0,20101,1.0,119,2969@TOP@human_GAPDH_TAA_len41_fa10_ta10_fm10_tm10,g
2969@TOP@human_GAPDH_TAA_len41_fa10_ta10_fm10_tm10*120*g,4,0,20037,1,20042,1.0,120,2969@TOP@human_GAPDH_TAA_len41_fa10_ta10_fm10_tm10,g
2969@TOP@human_GAPDH_TAA_len41_fa10_ta10_fm10_tm10*121*a,20217,0,8,1,20226,0.0,121,2969@TOP@human_GAPDH_TAA_len41_fa10_ta10_fm10_tm10,a
2969@TOP@human_GAPDH_TAA_len41_fa10_ta10_fm10_tm10*122*g,0,0,20267,1,20268,1.0,122,2969@TOP@human_GAPDH_TAA_len41_fa10_ta10_fm10_tm10,g
2969@TOP@human_GAPDH_TAA_len41_fa10_ta10_fm10_tm10*123*t,1,6,5,20006,20018,0.0,123,2969@TOP@human_GAPDH_TAA_len41_fa10_ta10_fm10_tm10,t
2969@TOP@human_GAPDH_TAA_len41_fa10_ta10_fm10_tm10*124*a,17876,0,2029,1,19906,0.102,124,2969@TOP@human_GAPDH_TAA_len41_fa10_ta10_fm10_tm10,a
2969@TOP@human_GAPDH_TAA_len41_fa10_ta10_fm10_tm10*125*a,19067,1,826,1,19895,0.042,125,2969@TOP@human_GAPDH_TAA_len41_fa10_ta10_fm10_tm10,a
2969@TOP@human_GAPDH_TAA_len41_fa10_ta10_fm10_tm10*126*g,0,1,20039,1,20041,1.0,126,2969@TOP@human_GAPDH_TAA_len41_fa10_ta10_fm10_tm10,g
2969@TOP@human_GAPDH_TAA_len41_fa10_ta10_fm10_tm10*127*a,20121,2,45,0,20168,0.002,127,2969@TOP@human_GAPDH_TAA_len41_fa10_ta10_fm10_tm10,a
2969@TOP@human_GAPDH_TAA_len41_fa10_ta10_fm10_tm10*128*c,0,20307,1,1,20309,0.0,128,2969@TOP@human_GAPDH_TAA_len41_fa10_ta10_fm10_tm10,c
2969@TOP@human_GAPDH_TAA_len41_fa10_ta10_fm10_tm10*129*c,1,20158,0,0,20159,0.0,129,2969@TOP@human_GAPDH_TAA_len41_fa10_ta10_fm10_tm10,c
2969@TOP@human_GAPDH_TAA_len41_fa10_ta10_fm10_tm10*130*c,2,20275,0,2,20279,0.0,130,2969@TOP@human_GAPDH_TAA_len41_fa10_ta10_fm10_tm10,c
2969@TOP@human_GAPDH_TAA_len41_fa10_ta10_fm10_tm10*131*c,2,20304,0,1,20307,0.0,131,2969@TOP@human_GAPDH_TAA_len41_fa10_ta10_fm10_tm10,c
2969@TOP@human_GAPDH_TAA_len41_fa10_ta10_fm10_tm10*132*t,3,6,1,20010,20020,0.0,132,2969@TOP@human_GAPDH_TAA_len41_fa10_ta10_fm10_tm10,t
2969@TOP@human_GAPDH_TAA_len41_fa10_ta10_fm10_tm10*133*g,2,0,19994,0,19996,1.0,133,2969@TOP@human_GAPDH_TAA_len41_fa10_ta10_fm10_tm10,g
2969@TOP@human_GAPDH_TAA_len41_fa10_ta10_fm10_tm10*134*g,0,10,20089,0,20099,1.0,134,2969@TOP@human_GAPDH_TAA_len41_fa10_ta10_fm10_tm10,g
2970@TOP@human_GAPDH_TAA_len41_fa10_ta10_fm10_tm10*114*t,1,2,0,6857,6860,0.0,114,2970@TOP@human_GAPDH_TAA_len41_fa10_ta10_fm10_tm10,t
2970@TOP@human_GAPDH_TAA_len41_fa10_ta10_fm10_tm10*115*c,0,6896,0,2,6898,0.0,115,2970@TOP@human_GAPDH_TAA_len41_fa10_ta10_fm10_tm10,c
2970@TOP@human_GAPDH_TAA_len41_fa10_ta10_fm10_tm10*116*c,0,6874,0,0,6874,0.0,116,2970@TOP@human_GAPDH_TAA_len41_fa10_ta10_fm10_tm10,c
2970@TOP@human_GAPDH_TAA_len41_fa10_ta10_fm10_tm10*117*a,6849,0,13,0,6862,0.002,117,2970@TOP@human_GAPDH_TAA_len41_fa10_ta10_fm10_tm10,a
2970@TOP@human_GAPDH_TAA_len41_fa10_ta10_fm10_tm10*118*a,6596,0,233,1,6830,0.034,118,2970@TOP@human_GAPDH_TAA_len41_fa10_ta10_fm10_tm10,a
2970@TOP@human_GAPDH_TAA_len41_fa10_ta10_fm10_tm10*119*g,0,0,6798,2,6800,1.0,119,2970@TOP@human_GAPDH_TAA_len41_fa10_ta10_fm10_tm10,g
2970@TOP@human_GAPDH_TAA_len41_fa10_ta10_fm10_tm10*120*g,2,0,6802,0,6804,1.0,120,2970@TOP@human_GAPDH_TAA_len41_fa10_ta10_fm10_tm10,g
2970@TOP@human_GAPDH_TAA_len41_fa10_ta10_fm10_tm10*121*a,6858,0,0,0,6858,0.0,121,2970@TOP@human_GAPDH_TAA_len41_fa10_ta10_fm10_tm10,a
2970@TOP@human_GAPDH_TAA_len41_fa10_ta10_fm10_tm10*122*g,0,0,6869,0,6869,1.0,122,2970@TOP@human_GAPDH_TAA_len41_fa10_ta10_fm10_tm10,g
2970@TOP@human_GAPDH_TAA_len41_fa10_ta10_fm10_tm10*123*t,0,0,1,6770,6771,0.0,123,2970@TOP@human_GAPDH_TAA_len41_fa10_ta10_fm10_tm10,t
2970@TOP@human_GAPDH_TAA_len41_fa10_ta10_fm10_tm10*124*a,6522,0,222,0,6744,0.033,124,2970@TOP@human_GAPDH_TAA_len41_fa10_ta10_fm10_tm10,a
2970@TOP@human_GAPDH_TAA_len41_fa10_ta10_fm10_tm10*125*a,6614,0,112,0,6726,0.017,125,2970@TOP@human_GAPDH_TAA_len41_fa10_ta10_fm10_tm10,a
2970@TOP@human_GAPDH_TAA_len41_fa10_ta10_fm10_tm10*126*g,0,0,6783,1,6784,1.0,126,2970@TOP@human_GAPDH_TAA_len41_fa10_ta10_fm10_tm10,g
2970@TOP@human_GAPDH_TAA_len41_fa10_ta10_fm10_tm10*127*a,6842,0,3,0,6845,0.0,127,2970@TOP@human_GAPDH_TAA_len41_fa10_ta10_fm10_tm10,a
2970@TOP@human_GAPDH_TAA_len41_fa10_ta10_fm10_tm10*128*c,0,6878,2,0,6880,0.0,128,2970@TOP@human_GAPDH_TAA_len41_fa10_ta10_fm10_tm10,c
2970@TOP@human_GAPDH_TAA_len41_fa10_ta10_fm10_tm10*129*c,0,6814,7,1,6822,0.001,129,2970@TOP@human_GAPDH_TAA_len41_fa10_ta10_fm10_tm10,c
2970@TOP@human_GAPDH_TAA_len41_fa10_ta10_fm10_tm10*130*c,0,6863,0,0,6863,0.0,130,2970@TOP@human_GAPDH_TAA_len41_fa10_ta10_fm10_tm10,c
2970@TOP@human_GAPDH_TAA_len41_fa10_ta10_fm10_tm10*131*c,1,6883,0,1,6885,0.0,131,2970@TOP@human_GAPDH_TAA_len41_fa10_ta10_fm10_tm10,c
2970@TOP@human_GAPDH_TAA_len41_fa10_ta10_fm10_tm10*132*t,0,0,0,6774,6774,0.0,132,2970@TOP@human_GAPDH_TAA_len41_fa10_ta10_fm10_tm10,t
2970@TOP@human_GAPDH_TAA_len41_fa10_ta10_fm10_tm10*133*g,0,1,6770,0,6771,1.0,133,2970@TOP@human_GAPDH_TAA_len41_fa10_ta10_fm10_tm10,g
2970@TOP@human_GAPDH_TAA_len41_fa10_ta10_fm10_tm10*134*g,1,3,6803,0,6807,0.999,134,2970@TOP@human_GAPDH_TAA_len41_fa10_ta10_fm10_tm10,g
2971@TOP@human_GAPDH_TAA_len41_fa10_ta10_fm10_tm10*114*t,0,4,0,17016,17020,0.0,114,2971@TOP@human_GAPDH_TAA_len41_fa10_ta10_fm10_tm10,t
2971@TOP@human_GAPDH_TAA_len41_fa10_ta10_fm10_tm10*115*c,0,17118,0,1,17119,0.0,115,2971@TOP@human_GAPDH_TAA_len41_fa10_ta10_fm10_tm10,c
2971@TOP@human_GAPDH_TAA_len41_fa10_ta10_fm10_tm10*116*c,1,17045,0,1,17047,0.0,116,2971@TOP@human_GAPDH_TAA_len41_fa10_ta10_fm10_tm10,c
2971@TOP@human_GAPDH_TAA_len41_fa10_ta10_fm10_tm10*117*a,16677,0,352,0,17029,0.021,117,2971@TOP@human_GAPDH_TAA_len41_fa10_ta10_fm10_tm10,a
2971@TOP@human_GAPDH_TAA_len41_fa10_ta10_fm10_tm10*118*a,15646,0,1323,3,16972,0.078,118,2971@TOP@human_GAPDH_TAA_len41_fa10_ta10_fm10_tm10,a
2971@TOP@human_GAPDH_TAA_len41_fa10_ta10_fm10_tm10*119*g,0,0,16901,0,16901,1.0,119,2971@TOP@human_GAPDH_TAA_len41_fa10_ta10_fm10_tm10,g
2971@TOP@human_GAPDH_TAA_len41_fa10_ta10_fm10_tm10*120*g,0,0,16847,1,16848,1.0,120,2971@TOP@human_GAPDH_TAA_len41_fa10_ta10_fm10_tm10,g
2971@TOP@human_GAPDH_TAA_len41_fa10_ta10_fm10_tm10*121*a,17002,1,16,0,17019,0.001,121,2971@TOP@human_GAPDH_TAA_len41_fa10_ta10_fm10_tm10,a
2971@TOP@human_GAPDH_TAA_len41_fa10_ta10_fm10_tm10*122*g,3,0,17034,0,17037,1.0,122,2971@TOP@human_GAPDH_TAA_len41_fa10_ta10_fm10_tm10,g
2971@TOP@human_GAPDH_TAA_len41_fa10_ta10_fm10_tm10*123*t,3,0,1,16828,16832,0.0,123,2971@TOP@human_GAPDH_TAA_len41_fa10_ta10_fm10_tm10,t
2971@TOP@human_GAPDH_TAA_len41_fa10_ta10_fm10_tm10*124*a,15925,0,820,0,16745,0.049,124,2971@TOP@human_GAPDH_TAA_len41_fa10_ta10_fm10_tm10,a
2971@TOP@human_GAPDH_TAA_len41_fa10_ta10_fm10_tm10*125*a,16258,2,441,0,16701,0.026,125,2971@TOP@human_GAPDH_TAA_len41_fa10_ta10_fm10_tm10,a
2971@TOP@human_GAPDH_TAA_len41_fa10_ta10_fm10_tm10*126*g,0,0,16840,0,16840,1.0,126,2971@TOP@human_GAPDH_TAA_len41_fa10_ta10_fm10_tm10,g
2971@TOP@human_GAPDH_TAA_len41_fa10_ta10_fm10_tm10*127*a,16964,4,15,0,16983,0.001,127,2971@TOP@human_GAPDH_TAA_len41_fa10_ta10_fm10_tm10,a
2971@TOP@human_GAPDH_TAA_len41_fa10_ta10_fm10_tm10*128*c,0,17069,2,0,17071,0.0,128,2971@TOP@human_GAPDH_TAA_len41_fa10_ta10_fm10_tm10,c
2971@TOP@human_GAPDH_TAA_len41_fa10_ta10_fm10_tm10*129*c,0,16919,1,2,16922,0.0,129,2971@TOP@human_GAPDH_TAA_len41_fa10_ta10_fm10_tm10,c
2971@TOP@human_GAPDH_TAA_len41_fa10_ta10_fm10_tm10*130*c,1,17041,0,1,17043,0.0,130,2971@TOP@human_GAPDH_TAA_len41_fa10_ta10_fm10_tm10,c
2971@TOP@human_GAPDH_TAA_len41_fa10_ta10_fm10_tm10*131*c,1,17082,0,4,17087,0.0,131,2971@TOP@human_GAPDH_TAA_len41_fa10_ta10_fm10_tm10,c
2971@TOP@human_GAPDH_TAA_len41_fa10_ta10_fm10_tm10*132*t,2,7,4,16820,16833,0.0,132,2971@TOP@human_GAPDH_TAA_len41_fa10_ta10_fm10_tm10,t
2971@TOP@human_GAPDH_TAA_len41_fa10_ta10_fm10_tm10*133*g,1,0,16813,0,16814,1.0,133,2971@TOP@human_GAPDH_TAA_len41_fa10_ta10_fm10_tm10,g
2971@TOP@human_GAPDH_TAA_len41_fa10_ta10_fm10_tm10*134*g,1,6,16852,2,16861,0.999,134,2971@TOP@human_GAPDH_TAA_len41_fa10_ta10_fm10_tm10,g
2972@TOP@human_GAPDH_TAA_len41_fa10_ta10_fm10_tm10*114*t,0,1,0,1438,1439,0.0,114,2972@TOP@human_GAPDH_TAA_len41_fa10_ta10_fm10_tm10,t
2972@TOP@human_GAPDH_TAA_len41_fa10_ta10_fm10_tm10*115*c,0,1450,0,0,1450,0.0,115,2972@TOP@human_GAPDH_TAA_len41_fa10_ta10_fm10_tm10,c
2972@TOP@human_GAPDH_TAA_len41_fa10_ta10_fm10_tm10*116*c,0,1446,0,0,1446,0.0,116,2972@TOP@human_GAPDH_TAA_len41_fa10_ta10_fm10_tm10,c
2972@TOP@human_GAPDH_TAA_len41_fa10_ta10_fm10_tm10*117*a,1299,0,142,0,1441,0.099,117,2972@TOP@human_GAPDH_TAA_len41_fa10_ta10_fm10_tm10,a
2972@TOP@human_GAPDH_TAA_len41_fa10_ta10_fm10_tm10*118*a,631,0,798,1,1430,0.558,118,2972@TOP@human_GAPDH_TAA_len41_fa10_ta10_fm10_tm10,a
2972@TOP@human_GAPDH_TAA_len41_fa10_ta10_fm10_tm10*119*g,0,0,1422,0,1422,1.0,119,2972@TOP@human_GAPDH_TAA_len41_fa10_ta10_fm10_tm10,g
2972@TOP@human_GAPDH_TAA_len41_fa10_ta10_fm10_tm10*120*g,0,0,1428,0,1428,1.0,120,2972@TOP@human_GAPDH_TAA_len41_fa10_ta10_fm10_tm10,g
2972@TOP@human_GAPDH_TAA_len41_fa10_ta10_fm10_tm10*121*a,1417,0,12,0,1429,0.008,121,2972@TOP@human_GAPDH_TAA_len41_fa10_ta10_fm10_tm10,a
2972@TOP@human_GAPDH_TAA_len41_fa10_ta10_fm10_tm10*122*g,0,0,1441,0,1441,1.0,122,2972@TOP@human_GAPDH_TAA_len41_fa10_ta10_fm10_tm10,g
2972@TOP@human_GAPDH_TAA_len41_fa10_ta10_fm10_tm10*123*t,1,2,1,1411,1415,0.001,123,2972@TOP@human_GAPDH_TAA_len41_fa10_ta10_fm10_tm10,t
2972@TOP@human_GAPDH_TAA_len41_fa10_ta10_fm10_tm10*124*a,799,0,618,0,1417,0.436,124,2972@TOP@human_GAPDH_TAA_len41_fa10_ta10_fm10_tm10,a
2972@TOP@human_GAPDH_TAA_len41_fa10_ta10_fm10_tm10*125*a,872,0,564,0,1436,0.393,125,2972@TOP@human_GAPDH_TAA_len41_fa10_ta10_fm10_tm10,a
2972@TOP@human_GAPDH_TAA_len41_fa10_ta10_fm10_tm10*126*g,0,0,1422,0,1422,1.0,126,2972@TOP@human_GAPDH_TAA_len41_fa10_ta10_fm10_tm10,g
2972@TOP@human_GAPDH_TAA_len41_fa10_ta10_fm10_tm10*127*a,1437,0,2,0,1439,0.001,127,2972@TOP@human_GAPDH_TAA_len41_fa10_ta10_fm10_tm10,a
2972@TOP@human_GAPDH_TAA_len41_fa10_ta10_fm10_tm10*128*c,0,1443,0,0,1443,0.0,128,2972@TOP@human_GAPDH_TAA_len41_fa10_ta10_fm10_tm10,c
2972@TOP@human_GAPDH_TAA_len41_fa10_ta10_fm10_tm10*129*c,0,1436,0,0,1436,0.0,129,2972@TOP@human_GAPDH_TAA_len41_fa10_ta10_fm10_tm10,c
2972@TOP@human_GAPDH_TAA_len41_fa10_ta10_fm10_tm10*130*c,0,1439,0,0,1439,0.0,130,2972@TOP@human_GAPDH_TAA_len41_fa10_ta10_fm10_tm10,c
2972@TOP@human_GAPDH_TAA_len41_fa10_ta10_fm10_tm10*131*c,0,1445,0,0,1445,0.0,131,2972@TOP@human_GAPDH_TAA_len41_fa10_ta10_fm10_tm10,c
2972@TOP@human_GAPDH_TAA_len41_fa10_ta10_fm10_tm10*132*t,0,0,0,1423,1423,0.0,132,2972@TOP@human_GAPDH_TAA_len41_fa10_ta10_fm10_tm10,t
2972@TOP@human_GAPDH_TAA_len41_fa10_ta10_fm10_tm10*133*g,0,0,1423,0,1423,1.0,133,2972@TOP@human_GAPDH_TAA_len41_fa10_ta10_fm10_tm10,g
2972@TOP@human_GAPDH_TAA_len41_fa10_ta10_fm10_tm10*134*g,0,1,1427,0,1428,0.999,134,2972@TOP@human_GAPDH_TAA_len41_fa10_ta10_fm10_tm10,g
2973@TOP@human_GAPDH_TAA_len41_fa10_ta10_fm10_tm10*114*t,1,0,0,2971,2972,0.0,114,2973@TOP@human_GAPDH_TAA_len41_fa10_ta10_fm10_tm10,t
2973@TOP@human_GAPDH_TAA_len41_fa10_ta10_fm10_tm10*115*c,0,2992,0,0,2992,0.0,115,2973@TOP@human_GAPDH_TAA_len41_fa10_ta10_fm10_tm10,c
2973@TOP@human_GAPDH_TAA_len41_fa10_ta10_fm10_tm10*116*c,0,2978,0,0,2978,0.0,116,2973@TOP@human_GAPDH_TAA_len41_fa10_ta10_fm10_tm10,c
2973@TOP@human_GAPDH_TAA_len41_fa10_ta10_fm10_tm10*117*a,2858,0,117,0,2975,0.039,117,2973@TOP@human_GAPDH_TAA_len41_fa10_ta10_fm10_tm10,a
2973@TOP@human_GAPDH_TAA_len41_fa10_ta10_fm10_tm10*118*a,2074,0,884,0,2958,0.299,118,2973@TOP@human_GAPDH_TAA_len41_fa10_ta10_fm10_tm10,a
2973@TOP@human_GAPDH_TAA_len41_fa10_ta10_fm10_tm10*119*g,0,0,2948,0,2948,1.0,119,2973@TOP@human_GAPDH_TAA_len41_fa10_ta10_fm10_tm10,g
2973@TOP@human_GAPDH_TAA_len41_fa10_ta10_fm10_tm10*120*g,0,0,2950,0,2950,1.0,120,2973@TOP@human_GAPDH_TAA_len41_fa10_ta10_fm10_tm10,g
2973@TOP@human_GAPDH_TAA_len41_fa10_ta10_fm10_tm10*121*a,2966,0,3,0,2969,0.001,121,2973@TOP@human_GAPDH_TAA_len41_fa10_ta10_fm10_tm10,a
2973@TOP@human_GAPDH_TAA_len41_fa10_ta10_fm10_tm10*122*g,0,0,2982,0,2982,1.0,122,2973@TOP@human_GAPDH_TAA_len41_fa10_ta10_fm10_tm10,g
2973@TOP@human_GAPDH_TAA_len41_fa10_ta10_fm10_tm10*123*t,0,0,0,2923,2923,0.0,123,2973@TOP@human_GAPDH_TAA_len41_fa10_ta10_fm10_tm10,t
2973@TOP@human_GAPDH_TAA_len41_fa10_ta10_fm10_tm10*124*a,2255,0,677,0,2932,0.231,124,2973@TOP@human_GAPDH_TAA_len41_fa10_ta10_fm10_tm10,a
2973@TOP@human_GAPDH_TAA_len41_fa10_ta10_fm10_tm10*125*a,2567,0,352,0,2919,0.121,125,2973@TOP@human_GAPDH_TAA_len41_fa10_ta10_fm10_tm10,a
2973@TOP@human_GAPDH_TAA_len41_fa10_ta10_fm10_tm10*126*g,0,0,2940,0,2940,1.0,126,2973@TOP@human_GAPDH_TAA_len41_fa10_ta10_fm10_tm10,g
2973@TOP@human_GAPDH_TAA_len41_fa10_ta10_fm10_tm10*127*a,2969,0,7,0,2976,0.002,127,2973@TOP@human_GAPDH_TAA_len41_fa10_ta10_fm10_tm10,a
2973@TOP@human_GAPDH_TAA_len41_fa10_ta10_fm10_tm10*128*c,0,2979,0,0,2979,0.0,128,2973@TOP@human_GAPDH_TAA_len41_fa10_ta10_fm10_tm10,c
2973@TOP@human_GAPDH_TAA_len41_fa10_ta10_fm10_tm10*129*c,1,2960,0,0,2961,0.0,129,2973@TOP@human_GAPDH_TAA_len41_fa10_ta10_fm10_tm10,c
2973@TOP@human_GAPDH_TAA_len41_fa10_ta10_fm10_tm10*130*c,0,2976,0,0,2976,0.0,130,2973@TOP@human_GAPDH_TAA_len41_fa10_ta10_fm10_tm10,c
2973@TOP@human_GAPDH_TAA_len41_fa10_ta10_fm10_tm10*131*c,0,2990,0,0,2990,0.0,131,2973@TOP@human_GAPDH_TAA_len41_fa10_ta10_fm10_tm10,c
2973@TOP@human_GAPDH_TAA_len41_fa10_ta10_fm10_tm10*132*t,0,0,0,2945,2945,0.0,132,2973@TOP@human_GAPDH_TAA_len41_fa10_ta10_fm10_tm10,t
2973@TOP@human_GAPDH_TAA_len41_fa10_ta10_fm10_tm10*133*g,0,0,2940,0,2940,1.0,133,2973@TOP@human_GAPDH_TAA_len41_fa10_ta10_fm10_tm10,g
2973@TOP@human_GAPDH_TAA_len41_fa10_ta10_fm10_tm10*134*g,0,0,2950,0,2950,1.0,134,2973@TOP@human_GAPDH_TAA_len41_fa10_ta10_fm10_tm10,g
2974@TOP@human_GAPDH_TAA_len41_fa10_ta10_fm10_tm10*114*t,0,0,0,873,873,0.0,114,2974@TOP@human_GAPDH_TAA_len41_fa10_ta10_fm10_tm10,t
2974@TOP@human_GAPDH_TAA_len41_fa10_ta10_fm10_tm10*115*c,0,883,0,0,883,0.0,115,2974@TOP@human_GAPDH_TAA_len41_fa10_ta10_fm10_tm10,c
2974@TOP@human_GAPDH_TAA_len41_fa10_ta10_fm10_tm10*116*c,0,873,0,0,873,0.0,116,2974@TOP@human_GAPDH_TAA_len41_fa10_ta10_fm10_tm10,c
2974@TOP@human_GAPDH_TAA_len41_fa10_ta10_fm10_tm10*117*a,838,0,40,0,878,0.046,117,2974@TOP@human_GAPDH_TAA_len41_fa10_ta10_fm10_tm10,a
2974@TOP@human_GAPDH_TAA_len41_fa10_ta10_fm10_tm10*118*a,773,0,100,0,873,0.115,118,2974@TOP@human_GAPDH_TAA_len41_fa10_ta10_fm10_tm10,a
2974@TOP@human_GAPDH_TAA_len41_fa10_ta10_fm10_tm10*119*g,0,0,874,0,874,1.0,119,2974@TOP@human_GAPDH_TAA_len41_fa10_ta10_fm10_tm10,g
2974@TOP@human_GAPDH_TAA_len41_fa10_ta10_fm10_tm10*120*g,0,0,859,0,859,1.0,120,2974@TOP@human_GAPDH_TAA_len41_fa10_ta10_fm10_tm10,g
2974@TOP@human_GAPDH_TAA_len41_fa10_ta10_fm10_tm10*121*a,876,0,1,0,877,0.001,121,2974@TOP@human_GAPDH_TAA_len41_fa10_ta10_fm10_tm10,a
2974@TOP@human_GAPDH_TAA_len41_fa10_ta10_fm10_tm10*122*g,0,1,876,0,877,0.999,122,2974@TOP@human_GAPDH_TAA_len41_fa10_ta10_fm10_tm10,g
2974@TOP@human_GAPDH_TAA_len41_fa10_ta10_fm10_tm10*123*t,0,0,0,870,870,0.0,123,2974@TOP@human_GAPDH_TAA_len41_fa10_ta10_fm10_tm10,t
2974@TOP@human_GAPDH_TAA_len41_fa10_ta10_fm10_tm10*124*a,776,0,90,0,866,0.104,124,2974@TOP@human_GAPDH_TAA_len41_fa10_ta10_fm10_tm10,a
2974@TOP@human_GAPDH_TAA_len41_fa10_ta10_fm10_tm10*125*a,807,0,47,0,854,0.055,125,2974@TOP@human_GAPDH_TAA_len41_fa10_ta10_fm10_tm10,a
2974@TOP@human_GAPDH_TAA_len41_fa10_ta10_fm10_tm10*126*g,0,0,859,0,859,1.0,126,2974@TOP@human_GAPDH_TAA_len41_fa10_ta10_fm10_tm10,g
2974@TOP@human_GAPDH_TAA_len41_fa10_ta10_fm10_tm10*127*a,874,0,0,0,874,0.0,127,2974@TOP@human_GAPDH_TAA_len41_fa10_ta10_fm10_tm10,a
2974@TOP@human_GAPDH_TAA_len41_fa10_ta10_fm10_tm10*128*c,0,882,0,0,882,0.0,128,2974@TOP@human_GAPDH_TAA_len41_fa10_ta10_fm10_tm10,c
2974@TOP@human_GAPDH_TAA_len41_fa10_ta10_fm10_tm10*129*c,0,871,0,0,871,0.0,129,2974@TOP@human_GAPDH_TAA_len41_fa10_ta10_fm10_tm10,c
2974@TOP@human_GAPDH_TAA_len41_fa10_ta10_fm10_tm10*130*c,0,875,0,0,875,0.0,130,2974@TOP@human_GAPDH_TAA_len41_fa10_ta10_fm10_tm10,c
2974@TOP@human_GAPDH_TAA_len41_fa10_ta10_fm10_tm10*131*c,0,877,0,0,877,0.0,131,2974@TOP@human_GAPDH_TAA_len41_fa10_ta10_fm10_tm10,c
2974@TOP@human_GAPDH_TAA_len41_fa10_ta10_fm10_tm10*132*t,0,0,0,870,870,0.0,132,2974@TOP@human_GAPDH_TAA_len41_fa10_ta10_fm10_tm10,t
2974@TOP@human_GAPDH_TAA_len41_fa10_ta10_fm10_tm10*133*g,0,0,855,0,855,1.0,133,2974@TOP@human_GAPDH_TAA_len41_fa10_ta10_fm10_tm10,g
2974@TOP@human_GAPDH_TAA_len41_fa10_ta10_fm10_tm10*134*g,0,0,865,0,865,1.0,134,2974@TOP@human_GAPDH_TAA_len41_fa10_ta10_fm10_tm10,g
2975@TOP@human_GAPDH_TAA_len41_fa10_ta10_fm10_tm10*114*t,0,0,0,1182,1182,0.0,114,2975@TOP@human_GAPDH_TAA_len41_fa10_ta10_fm10_tm10,t
2975@TOP@human_GAPDH_TAA_len41_fa10_ta10_fm10_tm10*115*c,0,1192,0,0,1192,0.0,115,2975@TOP@human_GAPDH_TAA_len41_fa10_ta10_fm10_tm10,c
2975@TOP@human_GAPDH_TAA_len41_fa10_ta10_fm10_tm10*116*c,0,1190,0,0,1190,0.0,116,2975@TOP@human_GAPDH_TAA_len41_fa10_ta10_fm10_tm10,c
2975@TOP@human_GAPDH_TAA_len41_fa10_ta10_fm10_tm10*117*a,1122,0,60,0,1182,0.051,117,2975@TOP@human_GAPDH_TAA_len41_fa10_ta10_fm10_tm10,a
2975@TOP@human_GAPDH_TAA_len41_fa10_ta10_fm10_tm10*118*a,945,0,237,0,1182,0.201,118,2975@TOP@human_GAPDH_TAA_len41_fa10_ta10_fm10_tm10,a
2975@TOP@human_GAPDH_TAA_len41_fa10_ta10_fm10_tm10*119*g,0,0,1169,0,1169,1.0,119,2975@TOP@human_GAPDH_TAA_len41_fa10_ta10_fm10_tm10,g
2975@TOP@human_GAPDH_TAA_len41_fa10_ta10_fm10_tm10*120*g,0,1,1169,0,1170,0.999,120,2975@TOP@human_GAPDH_TAA_len41_fa10_ta10_fm10_tm10,g
2975@TOP@human_GAPDH_TAA_len41_fa10_ta10_fm10_tm10*121*a,1176,0,2,0,1178,0.002,121,2975@TOP@human_GAPDH_TAA_len41_fa10_ta10_fm10_tm10,a
2975@TOP@human_GAPDH_TAA_len41_fa10_ta10_fm10_tm10*122*g,3,0,1183,0,1186,0.997,122,2975@TOP@human_GAPDH_TAA_len41_fa10_ta10_fm10_tm10,g
2975@TOP@human_GAPDH_TAA_len41_fa10_ta10_fm10_tm10*123*t,1,0,0,1170,1171,0.0,123,2975@TOP@human_GAPDH_TAA_len41_fa10_ta10_fm10_tm10,t
2975@TOP@human_GAPDH_TAA_len41_fa10_ta10_fm10_tm10*124*a,1073,0,92,0,1165,0.079,124,2975@TOP@human_GAPDH_TAA_len41_fa10_ta10_fm10_tm10,a
2975@TOP@human_GAPDH_TAA_len41_fa10_ta10_fm10_tm10*125*a,1120,0,41,0,1161,0.035,125,2975@TOP@human_GAPDH_TAA_len41_fa10_ta10_fm10_tm10,a
2975@TOP@human_GAPDH_TAA_len41_fa10_ta10_fm10_tm10*126*g,0,0,1174,0,1174,1.0,126,2975@TOP@human_GAPDH_TAA_len41_fa10_ta10_fm10_tm10,g
2975@TOP@human_GAPDH_TAA_len41_fa10_ta10_fm10_tm10*127*a,1184,0,2,1,1187,0.002,127,2975@TOP@human_GAPDH_TAA_len41_fa10_ta10_fm10_tm10,a
2975@TOP@human_GAPDH_TAA_len41_fa10_ta10_fm10_tm10*128*c,0,1189,0,0,1189,0.0,128,2975@TOP@human_GAPDH_TAA_len41_fa10_ta10_fm10_tm10,c
2975@TOP@human_GAPDH_TAA_len41_fa10_ta10_fm10_tm10*129*c,1,1179,0,1,1181,0.0,129,2975@TOP@human_GAPDH_TAA_len41_fa10_ta10_fm10_tm10,c
2975@TOP@human_GAPDH_TAA_len41_fa10_ta10_fm10_tm10*130*c,0,1184,0,0,1184,0.0,130,2975@TOP@human_GAPDH_TAA_len41_fa10_ta10_fm10_tm10,c
2975@TOP@human_GAPDH_TAA_len41_fa10_ta10_fm10_tm10*131*c,0,1190,0,0,1190,0.0,131,2975@TOP@human_GAPDH_TAA_len41_fa10_ta10_fm10_tm10,c
2975@TOP@human_GAPDH_TAA_len41_fa10_ta10_fm10_tm10*132*t,0,0,0,1177,1177,0.0,132,2975@TOP@human_GAPDH_TAA_len41_fa10_ta10_fm10_tm10,t
2975@TOP@human_GAPDH_TAA_len41_fa10_ta10_fm10_tm10*133*g,0,0,1166,0,1166,1.0,133,2975@TOP@human_GAPDH_TAA_len41_fa10_ta10_fm10_tm10,g
2975@TOP@human_GAPDH_TAA_len41_fa10_ta10_fm10_tm10*134*g,0,1,1179,0,1180,0.999,134,2975@TOP@human_GAPDH_TAA_len41_fa10_ta10_fm10_tm10,g
2976@TOP@human_GAPDH_TAA_len41_fa10_ta10_fm10_tm10*114*t,0,0,0,926,926,0.0,114,2976@TOP@human_GAPDH_TAA_len41_fa10_ta10_fm10_tm10,t
2976@TOP@human_GAPDH_TAA_len41_fa10_ta10_fm10_tm10*115*c,0,934,0,0,934,0.0,115,2976@TOP@human_GAPDH_TAA_len41_fa10_ta10_fm10_tm10,c
2976@TOP@human_GAPDH_TAA_len41_fa10_ta10_fm10_tm10*116*c,0,930,0,0,930,0.0,116,2976@TOP@human_GAPDH_TAA_len41_fa10_ta10_fm10_tm10,c
2976@TOP@human_GAPDH_TAA_len41_fa10_ta10_fm10_tm10*117*a,899,0,36,0,935,0.039,117,2976@TOP@human_GAPDH_TAA_len41_fa10_ta10_fm10_tm10,a
2976@TOP@human_GAPDH_TAA_len41_fa10_ta10_fm10_tm10*118*a,859,0,66,0,925,0.071,118,2976@TOP@human_GAPDH_TAA_len41_fa10_ta10_fm10_tm10,a
2976@TOP@human_GAPDH_TAA_len41_fa10_ta10_fm10_tm10*119*g,0,0,918,0,918,1.0,119,2976@TOP@human_GAPDH_TAA_len41_fa10_ta10_fm10_tm10,g
2976@TOP@human_GAPDH_TAA_len41_fa10_ta10_fm10_tm10*120*g,0,0,907,0,907,1.0,120,2976@TOP@human_GAPDH_TAA_len41_fa10_ta10_fm10_tm10,g
2976@TOP@human_GAPDH_TAA_len41_fa10_ta10_fm10_tm10*121*a,927,0,0,0,927,0.0,121,2976@TOP@human_GAPDH_TAA_len41_fa10_ta10_fm10_tm10,a
2976@TOP@human_GAPDH_TAA_len41_fa10_ta10_fm10_tm10*122*g,0,0,934,0,934,1.0,122,2976@TOP@human_GAPDH_TAA_len41_fa10_ta10_fm10_tm10,g
2976@TOP@human_GAPDH_TAA_len41_fa10_ta10_fm10_tm10*123*t,0,0,2,910,912,0.002,123,2976@TOP@human_GAPDH_TAA_len41_fa10_ta10_fm10_tm10,t
2976@TOP@human_GAPDH_TAA_len41_fa10_ta10_fm10_tm10*124*a,773,0,146,0,919,0.159,124,2976@TOP@human_GAPDH_TAA_len41_fa10_ta10_fm10_tm10,a
2976@TOP@human_GAPDH_TAA_len41_fa10_ta10_fm10_tm10*125*a,853,0,63,0,916,0.069,125,2976@TOP@human_GAPDH_TAA_len41_fa10_ta10_fm10_tm10,a
2976@TOP@human_GAPDH_TAA_len41_fa10_ta10_fm10_tm10*126*g,0,0,915,0,915,1.0,126,2976@TOP@human_GAPDH_TAA_len41_fa10_ta10_fm10_tm10,g
2976@TOP@human_GAPDH_TAA_len41_fa10_ta10_fm10_tm10*127*a,923,0,3,0,926,0.003,127,2976@TOP@human_GAPDH_TAA_len41_fa10_ta10_fm10_tm10,a
2976@TOP@human_GAPDH_TAA_len41_fa10_ta10_fm10_tm10*128*c,0,936,0,0,936,0.0,128,2976@TOP@human_GAPDH_TAA_len41_fa10_ta10_fm10_tm10,c
2976@TOP@human_GAPDH_TAA_len41_fa10_ta10_fm10_tm10*129*c,0,931,0,0,931,0.0,129,2976@TOP@human_GAPDH_TAA_len41_fa10_ta10_fm10_tm10,c
2976@TOP@human_GAPDH_TAA_len41_fa10_ta10_fm10_tm10*130*c,0,930,0,0,930,0.0,130,2976@TOP@human_GAPDH_TAA_len41_fa10_ta10_fm10_tm10,c
2976@TOP@human_GAPDH_TAA_len41_fa10_ta10_fm10_tm10*131*c,0,932,0,0,932,0.0,131,2976@TOP@human_GAPDH_TAA_len41_fa10_ta10_fm10_tm10,c
2976@TOP@human_GAPDH_TAA_len41_fa10_ta10_fm10_tm10*132*t,0,0,0,910,910,0.0,132,2976@TOP@human_GAPDH_TAA_len41_fa10_ta10_fm10_tm10,t
2976@TOP@human_GAPDH_TAA_len41_fa10_ta10_fm10_tm10*133*g,0,0,916,0,916,1.0,133,2976@TOP@human_GAPDH_TAA_len41_fa10_ta10_fm10_tm10,g
2976@TOP@human_GAPDH_TAA_len41_fa10_ta10_fm10_tm10*134*g,0,0,926,0,926,1.0,134,2976@TOP@human_GAPDH_TAA_len41_fa10_ta10_fm10_tm10,g
2977@TOP@human_GAPDH_TAA_len41_fa10_ta10_fm10_tm10*114*t,0,0,0,1800,1800,0.0,114,2977@TOP@human_GAPDH_TAA_len41_fa10_ta10_fm10_tm10,t
2977@TOP@human_GAPDH_TAA_len41_fa10_ta10_fm10_tm10*115*c,0,1813,0,0,1813,0.0,115,2977@TOP@human_GAPDH_TAA_len41_fa10_ta10_fm10_tm10,c
2977@TOP@human_GAPDH_TAA_len41_fa10_ta10_fm10_tm10*116*c,0,1804,0,0,1804,0.0,116,2977@TOP@human_GAPDH_TAA_len41_fa10_ta10_fm10_tm10,c
2977@TOP@human_GAPDH_TAA_len41_fa10_ta10_fm10_tm10*117*a,1721,0,84,0,1805,0.047,117,2977@TOP@human_GAPDH_TAA_len41_fa10_ta10_fm10_tm10,a
2977@TOP@human_GAPDH_TAA_len41_fa10_ta10_fm10_tm10*118*a,1517,0,285,0,1802,0.158,118,2977@TOP@human_GAPDH_TAA_len41_fa10_ta10_fm10_tm10,a
2977@TOP@human_GAPDH_TAA_len41_fa10_ta10_fm10_tm10*119*g,0,0,1790,0,1790,1.0,119,2977@TOP@human_GAPDH_TAA_len41_fa10_ta10_fm10_tm10,g
2977@TOP@human_GAPDH_TAA_len41_fa10_ta10_fm10_tm10*120*g,0,0,1785,0,1785,1.0,120,2977@TOP@human_GAPDH_TAA_len41_fa10_ta10_fm10_tm10,g
2977@TOP@human_GAPDH_TAA_len41_fa10_ta10_fm10_tm10*121*a,1801,0,0,0,1801,0.0,121,2977@TOP@human_GAPDH_TAA_len41_fa10_ta10_fm10_tm10,a
2977@TOP@human_GAPDH_TAA_len41_fa10_ta10_fm10_tm10*122*g,0,0,1807,0,1807,1.0,122,2977@TOP@human_GAPDH_TAA_len41_fa10_ta10_fm10_tm10,g
2977@TOP@human_GAPDH_TAA_len41_fa10_ta10_fm10_tm10*123*t,1,0,0,1779,1780,0.0,123,2977@TOP@human_GAPDH_TAA_len41_fa10_ta10_fm10_tm10,t
2977@TOP@human_GAPDH_TAA_len41_fa10_ta10_fm10_tm10*124*a,1504,0,271,0,1775,0.153,124,2977@TOP@human_GAPDH_TAA_len41_fa10_ta10_fm10_tm10,a
2977@TOP@human_GAPDH_TAA_len41_fa10_ta10_fm10_tm10*125*a,1695,0,94,0,1789,0.053,125,2977@TOP@human_GAPDH_TAA_len41_fa10_ta10_fm10_tm10,a
2977@TOP@human_GAPDH_TAA_len41_fa10_ta10_fm10_tm10*126*g,0,0,1780,0,1780,1.0,126,2977@TOP@human_GAPDH_TAA_len41_fa10_ta10_fm10_tm10,g
2977@TOP@human_GAPDH_TAA_len41_fa10_ta10_fm10_tm10*127*a,1797,0,5,1,1803,0.003,127,2977@TOP@human_GAPDH_TAA_len41_fa10_ta10_fm10_tm10,a
2977@TOP@human_GAPDH_TAA_len41_fa10_ta10_fm10_tm10*128*c,0,1809,0,0,1809,0.0,128,2977@TOP@human_GAPDH_TAA_len41_fa10_ta10_fm10_tm10,c
2977@TOP@human_GAPDH_TAA_len41_fa10_ta10_fm10_tm10*129*c,0,1786,0,0,1786,0.0,129,2977@TOP@human_GAPDH_TAA_len41_fa10_ta10_fm10_tm10,c
2977@TOP@human_GAPDH_TAA_len41_fa10_ta10_fm10_tm10*130*c,0,1807,0,0,1807,0.0,130,2977@TOP@human_GAPDH_TAA_len41_fa10_ta10_fm10_tm10,c
2977@TOP@human_GAPDH_TAA_len41_fa10_ta10_fm10_tm10*131*c,0,1808,0,0,1808,0.0,131,2977@TOP@human_GAPDH_TAA_len41_fa10_ta10_fm10_tm10,c
2977@TOP@human_GAPDH_TAA_len41_fa10_ta10_fm10_tm10*132*t,0,1,0,1774,1775,0.0,132,2977@TOP@human_GAPDH_TAA_len41_fa10_ta10_fm10_tm10,t
2977@TOP@human_GAPDH_TAA_len41_fa10_ta10_fm10_tm10*133*g,0,0,1781,0,1781,1.0,133,2977@TOP@human_GAPDH_TAA_len41_fa10_ta10_fm10_tm10,g
2977@TOP@human_GAPDH_TAA_len41_fa10_ta10_fm10_tm10*134*g,0,1,1781,0,1782,0.999,134,2977@TOP@human_GAPDH_TAA_len41_fa10_ta10_fm10_tm10,g
2978@TOP@human_GAPDH_TAA_len41_fa10_ta10_fm10_tm10*114*t,0,4,0,12316,12320,0.0,114,2978@TOP@human_GAPDH_TAA_len41_fa10_ta10_fm10_tm10,t
2978@TOP@human_GAPDH_TAA_len41_fa10_ta10_fm10_tm10*115*c,0,12410,0,3,12413,0.0,115,2978@TOP@human_GAPDH_TAA_len41_fa10_ta10_fm10_tm10,c
2978@TOP@human_GAPDH_TAA_len41_fa10_ta10_fm10_tm10*116*c,1,12359,0,1,12361,0.0,116,2978@TOP@human_GAPDH_TAA_len41_fa10_ta10_fm10_tm10,c
2978@TOP@human_GAPDH_TAA_len41_fa10_ta10_fm10_tm10*117*a,12165,0,191,0,12356,0.015,117,2978@TOP@human_GAPDH_TAA_len41_fa10_ta10_fm10_tm10,a
2978@TOP@human_GAPDH_TAA_len41_fa10_ta10_fm10_tm10*118*a,10352,0,1915,0,12267,0.156,118,2978@TOP@human_GAPDH_TAA_len41_fa10_ta10_fm10_tm10,a
2978@TOP@human_GAPDH_TAA_len41_fa10_ta10_fm10_tm10*119*g,0,0,12265,2,12267,1.0,119,2978@TOP@human_GAPDH_TAA_len41_fa10_ta10_fm10_tm10,g
2978@TOP@human_GAPDH_TAA_len41_fa10_ta10_fm10_tm10*120*g,4,0,12229,0,12233,1.0,120,2978@TOP@human_GAPDH_TAA_len41_fa10_ta10_fm10_tm10,g
2978@TOP@human_GAPDH_TAA_len41_fa10_ta10_fm10_tm10*121*a,12265,0,35,1,12301,0.003,121,2978@TOP@human_GAPDH_TAA_len41_fa10_ta10_fm10_tm10,a
2978@TOP@human_GAPDH_TAA_len41_fa10_ta10_fm10_tm10*122*g,0,1,12369,0,12370,1.0,122,2978@TOP@human_GAPDH_TAA_len41_fa10_ta10_fm10_tm10,g
2978@TOP@human_GAPDH_TAA_len41_fa10_ta10_fm10_tm10*123*t,5,2,1,12178,12186,0.0,123,2978@TOP@human_GAPDH_TAA_len41_fa10_ta10_fm10_tm10,t
2978@TOP@human_GAPDH_TAA_len41_fa10_ta10_fm10_tm10*124*a,11390,1,732,2,12125,0.06,124,2978@TOP@human_GAPDH_TAA_len41_fa10_ta10_fm10_tm10,a
2978@TOP@human_GAPDH_TAA_len41_fa10_ta10_fm10_tm10*125*a,11306,1,804,0,12111,0.066,125,2978@TOP@human_GAPDH_TAA_len41_fa10_ta10_fm10_tm10,a
2978@TOP@human_GAPDH_TAA_len41_fa10_ta10_fm10_tm10*126*g,0,0,12177,0,12177,1.0,126,2978@TOP@human_GAPDH_TAA_len41_fa10_ta10_fm10_tm10,g
2978@TOP@human_GAPDH_TAA_len41_fa10_ta10_fm10_tm10*127*a,12285,0,17,0,12302,0.001,127,2978@TOP@human_GAPDH_TAA_len41_fa10_ta10_fm10_tm10,a
2978@TOP@human_GAPDH_TAA_len41_fa10_ta10_fm10_tm10*128*c,0,12382,2,0,12384,0.0,128,2978@TOP@human_GAPDH_TAA_len41_fa10_ta10_fm10_tm10,c
2978@TOP@human_GAPDH_TAA_len41_fa10_ta10_fm10_tm10*129*c,3,12298,0,2,12303,0.0,129,2978@TOP@human_GAPDH_TAA_len41_fa10_ta10_fm10_tm10,c
2978@TOP@human_GAPDH_TAA_len41_fa10_ta10_fm10_tm10*130*c,0,12372,0,0,12372,0.0,130,2978@TOP@human_GAPDH_TAA_len41_fa10_ta10_fm10_tm10,c
2978@TOP@human_GAPDH_TAA_len41_fa10_ta10_fm10_tm10*131*c,1,12371,0,2,12374,0.0,131,2978@TOP@human_GAPDH_TAA_len41_fa10_ta10_fm10_tm10,c
2978@TOP@human_GAPDH_TAA_len41_fa10_ta10_fm10_tm10*132*t,3,6,5,12205,12219,0.0,132,2978@TOP@human_GAPDH_TAA_len41_fa10_ta10_fm10_tm10,t
2978@TOP@human_GAPDH_TAA_len41_fa10_ta10_fm10_tm10*133*g,1,0,12184,0,12185,1.0,133,2978@TOP@human_GAPDH_TAA_len41_fa10_ta10_fm10_tm10,g
2978@TOP@human_GAPDH_TAA_len41_fa10_ta10_fm10_tm10*134*g,0,3,12265,1,12269,1.0,134,2978@TOP@human_GAPDH_TAA_len41_fa10_ta10_fm10_tm10,g
2979@TOP@human_GAPDH_TAA_len41_fa10_ta10_fm10_tm10*114*t,1,10,1,18614,18626,0.0,114,2979@TOP@human_GAPDH_TAA_len41_fa10_ta10_fm10_tm10,t
2979@TOP@human_GAPDH_TAA_len41_fa10_ta10_fm10_tm10*115*c,0,18731,1,0,18732,0.0,115,2979@TOP@human_GAPDH_TAA_len41_fa10_ta10_fm10_tm10,c
2979@TOP@human_GAPDH_TAA_len41_fa10_ta10_fm10_tm10*116*c,1,18650,0,1,18652,0.0,116,2979@TOP@human_GAPDH_TAA_len41_fa10_ta10_fm10_tm10,c
2979@TOP@human_GAPDH_TAA_len41_fa10_ta10_fm10_tm10*117*a,18472,0,157,0,18629,0.008,117,2979@TOP@human_GAPDH_TAA_len41_fa10_ta10_fm10_tm10,a
2979@TOP@human_GAPDH_TAA_len41_fa10_ta10_fm10_tm10*118*a,14209,0,4325,3,18537,0.233,118,2979@TOP@human_GAPDH_TAA_len41_fa10_ta10_fm10_tm10,a
2979@TOP@human_GAPDH_TAA_len41_fa10_ta10_fm10_tm10*119*g,0,0,18520,0,18520,1.0,119,2979@TOP@human_GAPDH_TAA_len41_fa10_ta10_fm10_tm10,g
2979@TOP@human_GAPDH_TAA_len41_fa10_ta10_fm10_tm10*120*g,4,0,18445,0,18449,1.0,120,2979@TOP@human_GAPDH_TAA_len41_fa10_ta10_fm10_tm10,g
2979@TOP@human_GAPDH_TAA_len41_fa10_ta10_fm10_tm10*121*a,18530,0,20,0,18550,0.001,121,2979@TOP@human_GAPDH_TAA_len41_fa10_ta10_fm10_tm10,a
2979@TOP@human_GAPDH_TAA_len41_fa10_ta10_fm10_tm10*122*g,1,0,18667,0,18668,1.0,122,2979@TOP@human_GAPDH_TAA_len41_fa10_ta10_fm10_tm10,g
2979@TOP@human_GAPDH_TAA_len41_fa10_ta10_fm10_tm10*123*t,3,3,0,18429,18435,0.0,123,2979@TOP@human_GAPDH_TAA_len41_fa10_ta10_fm10_tm10,t
2979@TOP@human_GAPDH_TAA_len41_fa10_ta10_fm10_tm10*124*a,15373,0,2974,0,18347,0.162,124,2979@TOP@human_GAPDH_TAA_len41_fa10_ta10_fm10_tm10,a
2979@TOP@human_GAPDH_TAA_len41_fa10_ta10_fm10_tm10*125*a,16756,1,1620,1,18378,0.088,125,2979@TOP@human_GAPDH_TAA_len41_fa10_ta10_fm10_tm10,a
2979@TOP@human_GAPDH_TAA_len41_fa10_ta10_fm10_tm10*126*g,0,0,18434,1,18435,1.0,126,2979@TOP@human_GAPDH_TAA_len41_fa10_ta10_fm10_tm10,g
2979@TOP@human_GAPDH_TAA_len41_fa10_ta10_fm10_tm10*127*a,18554,1,19,1,18575,0.001,127,2979@TOP@human_GAPDH_TAA_len41_fa10_ta10_fm10_tm10,a
2979@TOP@human_GAPDH_TAA_len41_fa10_ta10_fm10_tm10*128*c,1,18685,1,0,18687,0.0,128,2979@TOP@human_GAPDH_TAA_len41_fa10_ta10_fm10_tm10,c
2979@TOP@human_GAPDH_TAA_len41_fa10_ta10_fm10_tm10*129*c,1,18575,0,1,18577,0.0,129,2979@TOP@human_GAPDH_TAA_len41_fa10_ta10_fm10_tm10,c
2979@TOP@human_GAPDH_TAA_len41_fa10_ta10_fm10_tm10*130*c,1,18658,0,0,18659,0.0,130,2979@TOP@human_GAPDH_TAA_len41_fa10_ta10_fm10_tm10,c
2979@TOP@human_GAPDH_TAA_len41_fa10_ta10_fm10_tm10*131*c,0,18698,2,4,18704,0.0,131,2979@TOP@human_GAPDH_TAA_len41_fa10_ta10_fm10_tm10,c
2979@TOP@human_GAPDH_TAA_len41_fa10_ta10_fm10_tm10*132*t,1,1,2,18439,18443,0.0,132,2979@TOP@human_GAPDH_TAA_len41_fa10_ta10_fm10_tm10,t
2979@TOP@human_GAPDH_TAA_len41_fa10_ta10_fm10_tm10*133*g,2,0,18435,1,18438,1.0,133,2979@TOP@human_GAPDH_TAA_len41_fa10_ta10_fm10_tm10,g
2979@TOP@human_GAPDH_TAA_len41_fa10_ta10_fm10_tm10*134*g,2,0,18480,0,18482,1.0,134,2979@TOP@human_GAPDH_TAA_len41_fa10_ta10_fm10_tm10,g
2980@TOP@human_GAPDH_TAA_len41_fa10_ta10_fm10_tm10*114*t,0,1,0,636,637,0.0,114,2980@TOP@human_GAPDH_TAA_len41_fa10_ta10_fm10_tm10,t
2980@TOP@human_GAPDH_TAA_len41_fa10_ta10_fm10_tm10*115*c,0,639,0,0,639,0.0,115,2980@TOP@human_GAPDH_TAA_len41_fa10_ta10_fm10_tm10,c
2980@TOP@human_GAPDH_TAA_len41_fa10_ta10_fm10_tm10*116*c,0,636,0,0,636,0.0,116,2980@TOP@human_GAPDH_TAA_len41_fa10_ta10_fm10_tm10,c
2980@TOP@human_GAPDH_TAA_len41_fa10_ta10_fm10_tm10*117*a,625,0,8,0,633,0.013,117,2980@TOP@human_GAPDH_TAA_len41_fa10_ta10_fm10_tm10,a
2980@TOP@human_GAPDH_TAA_len41_fa10_ta10_fm10_tm10*118*a,577,1,49,0,627,0.078,118,2980@TOP@human_GAPDH_TAA_len41_fa10_ta10_fm10_tm10,a
2980@TOP@human_GAPDH_TAA_len41_fa10_ta10_fm10_tm10*119*g,0,0,630,0,630,1.0,119,2980@TOP@human_GAPDH_TAA_len41_fa10_ta10_fm10_tm10,g
2980@TOP@human_GAPDH_TAA_len41_fa10_ta10_fm10_tm10*120*g,0,0,628,0,628,1.0,120,2980@TOP@human_GAPDH_TAA_len41_fa10_ta10_fm10_tm10,g
2980@TOP@human_GAPDH_TAA_len41_fa10_ta10_fm10_tm10*121*a,635,0,1,0,636,0.002,121,2980@TOP@human_GAPDH_TAA_len41_fa10_ta10_fm10_tm10,a
2980@TOP@human_GAPDH_TAA_len41_fa10_ta10_fm10_tm10*122*g,0,0,631,0,631,1.0,122,2980@TOP@human_GAPDH_TAA_len41_fa10_ta10_fm10_tm10,g
2980@TOP@human_GAPDH_TAA_len41_fa10_ta10_fm10_tm10*123*t,0,0,0,629,629,0.0,123,2980@TOP@human_GAPDH_TAA_len41_fa10_ta10_fm10_tm10,t
2980@TOP@human_GAPDH_TAA_len41_fa10_ta10_fm10_tm10*124*a,584,0,44,0,628,0.07,124,2980@TOP@human_GAPDH_TAA_len41_fa10_ta10_fm10_tm10,a
2980@TOP@human_GAPDH_TAA_len41_fa10_ta10_fm10_tm10*125*a,584,0,42,0,626,0.067,125,2980@TOP@human_GAPDH_TAA_len41_fa10_ta10_fm10_tm10,a
2980@TOP@human_GAPDH_TAA_len41_fa10_ta10_fm10_tm10*126*g,0,0,627,0,627,1.0,126,2980@TOP@human_GAPDH_TAA_len41_fa10_ta10_fm10_tm10,g
2980@TOP@human_GAPDH_TAA_len41_fa10_ta10_fm10_tm10*127*a,631,0,1,0,632,0.002,127,2980@TOP@human_GAPDH_TAA_len41_fa10_ta10_fm10_tm10,a
2980@TOP@human_GAPDH_TAA_len41_fa10_ta10_fm10_tm10*128*c,0,639,0,0,639,0.0,128,2980@TOP@human_GAPDH_TAA_len41_fa10_ta10_fm10_tm10,c
2980@TOP@human_GAPDH_TAA_len41_fa10_ta10_fm10_tm10*129*c,0,634,0,0,634,0.0,129,2980@TOP@human_GAPDH_TAA_len41_fa10_ta10_fm10_tm10,c
2980@TOP@human_GAPDH_TAA_len41_fa10_ta10_fm10_tm10*130*c,0,640,0,0,640,0.0,130,2980@TOP@human_GAPDH_TAA_len41_fa10_ta10_fm10_tm10,c
2980@TOP@human_GAPDH_TAA_len41_fa10_ta10_fm10_tm10*131*c,0,636,0,0,636,0.0,131,2980@TOP@human_GAPDH_TAA_len41_fa10_ta10_fm10_tm10,c
2980@TOP@human_GAPDH_TAA_len41_fa10_ta10_fm10_tm10*132*t,0,0,0,629,629,0.0,132,2980@TOP@human_GAPDH_TAA_len41_fa10_ta10_fm10_tm10,t
2980@TOP@human_GAPDH_TAA_len41_fa10_ta10_fm10_tm10*133*g,0,0,626,0,626,1.0,133,2980@TOP@human_GAPDH_TAA_len41_fa10_ta10_fm10_tm10,g
2980@TOP@human_GAPDH_TAA_len41_fa10_ta10_fm10_tm10*134*g,0,0,633,0,633,1.0,134,2980@TOP@human_GAPDH_TAA_len41_fa10_ta10_fm10_tm10,g
2981@TOP@human_GAPDH_TAA_len41_fa10_ta10_fm10_tm10*114*t,1,1,0,4740,4742,0.0,114,2981@TOP@human_GAPDH_TAA_len41_fa10_ta10_fm10_tm10,t
2981@TOP@human_GAPDH_TAA_len41_fa10_ta10_fm10_tm10*115*c,0,4769,0,0,4769,0.0,115,2981@TOP@human_GAPDH_TAA_len41_fa10_ta10_fm10_tm10,c
2981@TOP@human_GAPDH_TAA_len41_fa10_ta10_fm10_tm10*116*c,0,4748,0,0,4748,0.0,116,2981@TOP@human_GAPDH_TAA_len41_fa10_ta10_fm10_tm10,c
2981@TOP@human_GAPDH_TAA_len41_fa10_ta10_fm10_tm10*117*a,4674,0,79,0,4753,0.017,117,2981@TOP@human_GAPDH_TAA_len41_fa10_ta10_fm10_tm10,a
2981@TOP@human_GAPDH_TAA_len41_fa10_ta10_fm10_tm10*118*a,4082,0,644,0,4726,0.136,118,2981@TOP@human_GAPDH_TAA_len41_fa10_ta10_fm10_tm10,a
2981@TOP@human_GAPDH_TAA_len41_fa10_ta10_fm10_tm10*119*g,0,0,4720,0,4720,1.0,119,2981@TOP@human_GAPDH_TAA_len41_fa10_ta10_fm10_tm10,g
2981@TOP@human_GAPDH_TAA_len41_fa10_ta10_fm10_tm10*120*g,2,0,4702,2,4706,0.999,120,2981@TOP@human_GAPDH_TAA_len41_fa10_ta10_fm10_tm10,g
2981@TOP@human_GAPDH_TAA_len41_fa10_ta10_fm10_tm10*121*a,4741,0,2,0,4743,0.0,121,2981@TOP@human_GAPDH_TAA_len41_fa10_ta10_fm10_tm10,a
2981@TOP@human_GAPDH_TAA_len41_fa10_ta10_fm10_tm10*122*g,0,0,4748,0,4748,1.0,122,2981@TOP@human_GAPDH_TAA_len41_fa10_ta10_fm10_tm10,g
2981@TOP@human_GAPDH_TAA_len41_fa10_ta10_fm10_tm10*123*t,0,0,0,4680,4680,0.0,123,2981@TOP@human_GAPDH_TAA_len41_fa10_ta10_fm10_tm10,t
2981@TOP@human_GAPDH_TAA_len41_fa10_ta10_fm10_tm10*124*a,4263,0,435,0,4698,0.093,124,2981@TOP@human_GAPDH_TAA_len41_fa10_ta10_fm10_tm10,a
2981@TOP@human_GAPDH_TAA_len41_fa10_ta10_fm10_tm10*125*a,4345,0,347,0,4692,0.074,125,2981@TOP@human_GAPDH_TAA_len41_fa10_ta10_fm10_tm10,a
2981@TOP@human_GAPDH_TAA_len41_fa10_ta10_fm10_tm10*126*g,0,0,4698,0,4698,1.0,126,2981@TOP@human_GAPDH_TAA_len41_fa10_ta10_fm10_tm10,g
2981@TOP@human_GAPDH_TAA_len41_fa10_ta10_fm10_tm10*127*a,4724,0,7,0,4731,0.001,127,2981@TOP@human_GAPDH_TAA_len41_fa10_ta10_fm10_tm10,a
2981@TOP@human_GAPDH_TAA_len41_fa10_ta10_fm10_tm10*128*c,0,4761,2,0,4763,0.0,128,2981@TOP@human_GAPDH_TAA_len41_fa10_ta10_fm10_tm10,c
2981@TOP@human_GAPDH_TAA_len41_fa10_ta10_fm10_tm10*129*c,0,4721,0,0,4721,0.0,129,2981@TOP@human_GAPDH_TAA_len41_fa10_ta10_fm10_tm10,c
2981@TOP@human_GAPDH_TAA_len41_fa10_ta10_fm10_tm10*130*c,0,4751,0,0,4751,0.0,130,2981@TOP@human_GAPDH_TAA_len41_fa10_ta10_fm10_tm10,c
2981@TOP@human_GAPDH_TAA_len41_fa10_ta10_fm10_tm10*131*c,1,4764,0,0,4765,0.0,131,2981@TOP@human_GAPDH_TAA_len41_fa10_ta10_fm10_tm10,c
2981@TOP@human_GAPDH_TAA_len41_fa10_ta10_fm10_tm10*132*t,0,1,0,4708,4709,0.0,132,2981@TOP@human_GAPDH_TAA_len41_fa10_ta10_fm10_tm10,t
2981@TOP@human_GAPDH_TAA_len41_fa10_ta10_fm10_tm10*133*g,0,0,4690,0,4690,1.0,133,2981@TOP@human_GAPDH_TAA_len41_fa10_ta10_fm10_tm10,g
2981@TOP@human_GAPDH_TAA_len41_fa10_ta10_fm10_tm10*134*g,0,1,4711,0,4712,1.0,134,2981@TOP@human_GAPDH_TAA_len41_fa10_ta10_fm10_tm10,g
2982@TOP@human_GAPDH_TAA_len41_fa10_ta10_fm10_tm10*114*t,1,5,0,25408,25414,0.0,114,2982@TOP@human_GAPDH_TAA_len41_fa10_ta10_fm10_tm10,t
2982@TOP@human_GAPDH_TAA_len41_fa10_ta10_fm10_tm10*115*c,0,25567,0,2,25569,0.0,115,2982@TOP@human_GAPDH_TAA_len41_fa10_ta10_fm10_tm10,c
2982@TOP@human_GAPDH_TAA_len41_fa10_ta10_fm10_tm10*116*c,2,25461,0,2,25465,0.0,116,2982@TOP@human_GAPDH_TAA_len41_fa10_ta10_fm10_tm10,c
2982@TOP@human_GAPDH_TAA_len41_fa10_ta10_fm10_tm10*117*a,25378,0,79,0,25457,0.003,117,2982@TOP@human_GAPDH_TAA_len41_fa10_ta10_fm10_tm10,a
2982@TOP@human_GAPDH_TAA_len41_fa10_ta10_fm10_tm10*118*a,21796,0,3508,0,25304,0.139,118,2982@TOP@human_GAPDH_TAA_len41_fa10_ta10_fm10_tm10,a
2982@TOP@human_GAPDH_TAA_len41_fa10_ta10_fm10_tm10*119*g,2,0,25262,1,25265,1.0,119,2982@TOP@human_GAPDH_TAA_len41_fa10_ta10_fm10_tm10,g
2982@TOP@human_GAPDH_TAA_len41_fa10_ta10_fm10_tm10*120*g,1,1,25174,1,25177,1.0,120,2982@TOP@human_GAPDH_TAA_len41_fa10_ta10_fm10_tm10,g
2982@TOP@human_GAPDH_TAA_len41_fa10_ta10_fm10_tm10*121*a,25398,0,13,0,25411,0.001,121,2982@TOP@human_GAPDH_TAA_len41_fa10_ta10_fm10_tm10,a
2982@TOP@human_GAPDH_TAA_len41_fa10_ta10_fm10_tm10*122*g,1,0,25467,1,25469,1.0,122,2982@TOP@human_GAPDH_TAA_len41_fa10_ta10_fm10_tm10,g
2982@TOP@human_GAPDH_TAA_len41_fa10_ta10_fm10_tm10*123*t,5,2,3,25172,25182,0.0,123,2982@TOP@human_GAPDH_TAA_len41_fa10_ta10_fm10_tm10,t
2982@TOP@human_GAPDH_TAA_len41_fa10_ta10_fm10_tm10*124*a,23479,0,1586,1,25066,0.063,124,2982@TOP@human_GAPDH_TAA_len41_fa10_ta10_fm10_tm10,a
2982@TOP@human_GAPDH_TAA_len41_fa10_ta10_fm10_tm10*125*a,24489,2,474,1,24966,0.019,125,2982@TOP@human_GAPDH_TAA_len41_fa10_ta10_fm10_tm10,a
2982@TOP@human_GAPDH_TAA_len41_fa10_ta10_fm10_tm10*126*g,1,0,25154,1,25156,1.0,126,2982@TOP@human_GAPDH_TAA_len41_fa10_ta10_fm10_tm10,g
2982@TOP@human_GAPDH_TAA_len41_fa10_ta10_fm10_tm10*127*a,25378,0,19,1,25398,0.001,127,2982@TOP@human_GAPDH_TAA_len41_fa10_ta10_fm10_tm10,a
2982@TOP@human_GAPDH_TAA_len41_fa10_ta10_fm10_tm10*128*c,0,25521,2,0,25523,0.0,128,2982@TOP@human_GAPDH_TAA_len41_fa10_ta10_fm10_tm10,c
2982@TOP@human_GAPDH_TAA_len41_fa10_ta10_fm10_tm10*129*c,1,25348,0,3,25352,0.0,129,2982@TOP@human_GAPDH_TAA_len41_fa10_ta10_fm10_tm10,c
2982@TOP@human_GAPDH_TAA_len41_fa10_ta10_fm10_tm10*130*c,1,25461,1,0,25463,0.0,130,2982@TOP@human_GAPDH_TAA_len41_fa10_ta10_fm10_tm10,c
2982@TOP@human_GAPDH_TAA_len41_fa10_ta10_fm10_tm10*131*c,0,25528,0,2,25530,0.0,131,2982@TOP@human_GAPDH_TAA_len41_fa10_ta10_fm10_tm10,c
2982@TOP@human_GAPDH_TAA_len41_fa10_ta10_fm10_tm10*132*t,2,4,4,25167,25177,0.0,132,2982@TOP@human_GAPDH_TAA_len41_fa10_ta10_fm10_tm10,t
2982@TOP@human_GAPDH_TAA_len41_fa10_ta10_fm10_tm10*133*g,0,0,25082,1,25083,1.0,133,2982@TOP@human_GAPDH_TAA_len41_fa10_ta10_fm10_tm10,g
2982@TOP@human_GAPDH_TAA_len41_fa10_ta10_fm10_tm10*134*g,1,3,25259,3,25266,1.0,134,2982@TOP@human_GAPDH_TAA_len41_fa10_ta10_fm10_tm10,g
2983@TOP@human_GAPDH_TAA_len41_fa10_ta10_fm10_tm10*114*t,1,1,0,13073,13075,0.0,114,2983@TOP@human_GAPDH_TAA_len41_fa10_ta10_fm10_tm10,t
2983@TOP@human_GAPDH_TAA_len41_fa10_ta10_fm10_tm10*115*c,0,13173,0,0,13173,0.0,115,2983@TOP@human_GAPDH_TAA_len41_fa10_ta10_fm10_tm10,c
2983@TOP@human_GAPDH_TAA_len41_fa10_ta10_fm10_tm10*116*c,0,13130,0,0,13130,0.0,116,2983@TOP@human_GAPDH_TAA_len41_fa10_ta10_fm10_tm10,c
2983@TOP@human_GAPDH_TAA_len41_fa10_ta10_fm10_tm10*117*a,13072,0,33,0,13105,0.003,117,2983@TOP@human_GAPDH_TAA_len41_fa10_ta10_fm10_tm10,a
2983@TOP@human_GAPDH_TAA_len41_fa10_ta10_fm10_tm10*118*a,12602,1,436,1,13040,0.033,118,2983@TOP@human_GAPDH_TAA_len41_fa10_ta10_fm10_tm10,a
2983@TOP@human_GAPDH_TAA_len41_fa10_ta10_fm10_tm10*119*g,1,1,13003,0,13005,1.0,119,2983@TOP@human_GAPDH_TAA_len41_fa10_ta10_fm10_tm10,g
2983@TOP@human_GAPDH_TAA_len41_fa10_ta10_fm10_tm10*120*g,1,0,12937,0,12938,1.0,120,2983@TOP@human_GAPDH_TAA_len41_fa10_ta10_fm10_tm10,g
2983@TOP@human_GAPDH_TAA_len41_fa10_ta10_fm10_tm10*121*a,13114,0,4,0,13118,0.0,121,2983@TOP@human_GAPDH_TAA_len41_fa10_ta10_fm10_tm10,a
2983@TOP@human_GAPDH_TAA_len41_fa10_ta10_fm10_tm10*122*g,2,0,13115,0,13117,1.0,122,2983@TOP@human_GAPDH_TAA_len41_fa10_ta10_fm10_tm10,g
2983@TOP@human_GAPDH_TAA_len41_fa10_ta10_fm10_tm10*123*t,1,5,3,12916,12925,0.0,123,2983@TOP@human_GAPDH_TAA_len41_fa10_ta10_fm10_tm10,t
2983@TOP@human_GAPDH_TAA_len41_fa10_ta10_fm10_tm10*124*a,11599,0,1283,0,12882,0.1,124,2983@TOP@human_GAPDH_TAA_len41_fa10_ta10_fm10_tm10,a
2983@TOP@human_GAPDH_TAA_len41_fa10_ta10_fm10_tm10*125*a,11679,0,1203,1,12883,0.093,125,2983@TOP@human_GAPDH_TAA_len41_fa10_ta10_fm10_tm10,a
2983@TOP@human_GAPDH_TAA_len41_fa10_ta10_fm10_tm10*126*g,0,0,12924,2,12926,1.0,126,2983@TOP@human_GAPDH_TAA_len41_fa10_ta10_fm10_tm10,g
2983@TOP@human_GAPDH_TAA_len41_fa10_ta10_fm10_tm10*127*a,13052,0,13,0,13065,0.001,127,2983@TOP@human_GAPDH_TAA_len41_fa10_ta10_fm10_tm10,a
2983@TOP@human_GAPDH_TAA_len41_fa10_ta10_fm10_tm10*128*c,0,13135,0,0,13135,0.0,128,2983@TOP@human_GAPDH_TAA_len41_fa10_ta10_fm10_tm10,c
2983@TOP@human_GAPDH_TAA_len41_fa10_ta10_fm10_tm10*129*c,1,13016,1,0,13018,0.0,129,2983@TOP@human_GAPDH_TAA_len41_fa10_ta10_fm10_tm10,c
2983@TOP@human_GAPDH_TAA_len41_fa10_ta10_fm10_tm10*130*c,0,13119,0,2,13121,0.0,130,2983@TOP@human_GAPDH_TAA_len41_fa10_ta10_fm10_tm10,c
2983@TOP@human_GAPDH_TAA_len41_fa10_ta10_fm10_tm10*131*c,1,13148,0,5,13154,0.0,131,2983@TOP@human_GAPDH_TAA_len41_fa10_ta10_fm10_tm10,c
2983@TOP@human_GAPDH_TAA_len41_fa10_ta10_fm10_tm10*132*t,1,6,0,12937,12944,0.0,132,2983@TOP@human_GAPDH_TAA_len41_fa10_ta10_fm10_tm10,t
2983@TOP@human_GAPDH_TAA_len41_fa10_ta10_fm10_tm10*133*g,0,0,12931,0,12931,1.0,133,2983@TOP@human_GAPDH_TAA_len41_fa10_ta10_fm10_tm10,g
2983@TOP@human_GAPDH_TAA_len41_fa10_ta10_fm10_tm10*134*g,2,2,12983,3,12990,0.999,134,2983@TOP@human_GAPDH_TAA_len41_fa10_ta10_fm10_tm10,g
2984@TOP@human_GAPDH_TAA_len41_fa10_ta10_fm10_tm10*114*t,6,10,0,22644,22660,0.0,114,2984@TOP@human_GAPDH_TAA_len41_fa10_ta10_fm10_tm10,t
2984@TOP@human_GAPDH_TAA_len41_fa10_ta10_fm10_tm10*115*c,0,22768,0,1,22769,0.0,115,2984@TOP@human_GAPDH_TAA_len41_fa10_ta10_fm10_tm10,c
2984@TOP@human_GAPDH_TAA_len41_fa10_ta10_fm10_tm10*116*c,0,22662,0,0,22662,0.0,116,2984@TOP@human_GAPDH_TAA_len41_fa10_ta10_fm10_tm10,c
2984@TOP@human_GAPDH_TAA_len41_fa10_ta10_fm10_tm10*117*a,22626,0,37,0,22663,0.002,117,2984@TOP@human_GAPDH_TAA_len41_fa10_ta10_fm10_tm10,a
2984@TOP@human_GAPDH_TAA_len41_fa10_ta10_fm10_tm10*118*a,22117,1,437,1,22556,0.019,118,2984@TOP@human_GAPDH_TAA_len41_fa10_ta10_fm10_tm10,a
2984@TOP@human_GAPDH_TAA_len41_fa10_ta10_fm10_tm10*119*g,0,0,22503,2,22505,1.0,119,2984@TOP@human_GAPDH_TAA_len41_fa10_ta10_fm10_tm10,g
2984@TOP@human_GAPDH_TAA_len41_fa10_ta10_fm10_tm10*120*g,0,0,22460,0,22460,1.0,120,2984@TOP@human_GAPDH_TAA_len41_fa10_ta10_fm10_tm10,g
2984@TOP@human_GAPDH_TAA_len41_fa10_ta10_fm10_tm10*121*a,22640,0,20,1,22661,0.001,121,2984@TOP@human_GAPDH_TAA_len41_fa10_ta10_fm10_tm10,a
2984@TOP@human_GAPDH_TAA_len41_fa10_ta10_fm10_tm10*122*g,2,0,22687,0,22689,1.0,122,2984@TOP@human_GAPDH_TAA_len41_fa10_ta10_fm10_tm10,g
2984@TOP@human_GAPDH_TAA_len41_fa10_ta10_fm10_tm10*123*t,1,1,1,22401,22404,0.0,123,2984@TOP@human_GAPDH_TAA_len41_fa10_ta10_fm10_tm10,t
2984@TOP@human_GAPDH_TAA_len41_fa10_ta10_fm10_tm10*124*a,17428,1,4941,1,22371,0.221,124,2984@TOP@human_GAPDH_TAA_len41_fa10_ta10_fm10_tm10,a
2984@TOP@human_GAPDH_TAA_len41_fa10_ta10_fm10_tm10*125*a,21143,3,1172,0,22318,0.053,125,2984@TOP@human_GAPDH_TAA_len41_fa10_ta10_fm10_tm10,a
2984@TOP@human_GAPDH_TAA_len41_fa10_ta10_fm10_tm10*126*g,3,1,22454,0,22458,1.0,126,2984@TOP@human_GAPDH_TAA_len41_fa10_ta10_fm10_tm10,g
2984@TOP@human_GAPDH_TAA_len41_fa10_ta10_fm10_tm10*127*a,22607,4,7,0,22618,0.0,127,2984@TOP@human_GAPDH_TAA_len41_fa10_ta10_fm10_tm10,a
2984@TOP@human_GAPDH_TAA_len41_fa10_ta10_fm10_tm10*128*c,1,22721,0,0,22722,0.0,128,2984@TOP@human_GAPDH_TAA_len41_fa10_ta10_fm10_tm10,c
2984@TOP@human_GAPDH_TAA_len41_fa10_ta10_fm10_tm10*129*c,2,22586,0,1,22589,0.0,129,2984@TOP@human_GAPDH_TAA_len41_fa10_ta10_fm10_tm10,c
2984@TOP@human_GAPDH_TAA_len41_fa10_ta10_fm10_tm10*130*c,2,22667,0,1,22670,0.0,130,2984@TOP@human_GAPDH_TAA_len41_fa10_ta10_fm10_tm10,c
2984@TOP@human_GAPDH_TAA_len41_fa10_ta10_fm10_tm10*131*c,0,22722,0,2,22724,0.0,131,2984@TOP@human_GAPDH_TAA_len41_fa10_ta10_fm10_tm10,c
2984@TOP@human_GAPDH_TAA_len41_fa10_ta10_fm10_tm10*132*t,5,12,3,22403,22423,0.0,132,2984@TOP@human_GAPDH_TAA_len41_fa10_ta10_fm10_tm10,t
2984@TOP@human_GAPDH_TAA_len41_fa10_ta10_fm10_tm10*133*g,2,0,22378,0,22380,1.0,133,2984@TOP@human_GAPDH_TAA_len41_fa10_ta10_fm10_tm10,g
2984@TOP@human_GAPDH_TAA_len41_fa10_ta10_fm10_tm10*134*g,0,2,22491,2,22495,1.0,134,2984@TOP@human_GAPDH_TAA_len41_fa10_ta10_fm10_tm10,g
2985@TOP@human_GAPDH_TAA_len41_fa10_ta10_fm10_tm10*114*t,0,8,0,32726,32734,0.0,114,2985@TOP@human_GAPDH_TAA_len41_fa10_ta10_fm10_tm10,t
2985@TOP@human_GAPDH_TAA_len41_fa10_ta10_fm10_tm10*115*c,1,32901,0,4,32906,0.0,115,2985@TOP@human_GAPDH_TAA_len41_fa10_ta10_fm10_tm10,c
2985@TOP@human_GAPDH_TAA_len41_fa10_ta10_fm10_tm10*116*c,4,32770,0,2,32776,0.0,116,2985@TOP@human_GAPDH_TAA_len41_fa10_ta10_fm10_tm10,c
2985@TOP@human_GAPDH_TAA_len41_fa10_ta10_fm10_tm10*117*a,32645,0,127,0,32772,0.004,117,2985@TOP@human_GAPDH_TAA_len41_fa10_ta10_fm10_tm10,a
2985@TOP@human_GAPDH_TAA_len41_fa10_ta10_fm10_tm10*118*a,31073,0,1520,4,32597,0.047,118,2985@TOP@human_GAPDH_TAA_len41_fa10_ta10_fm10_tm10,a
2985@TOP@human_GAPDH_TAA_len41_fa10_ta10_fm10_tm10*119*g,3,2,32522,6,32533,1.0,119,2985@TOP@human_GAPDH_TAA_len41_fa10_ta10_fm10_tm10,g
2985@TOP@human_GAPDH_TAA_len41_fa10_ta10_fm10_tm10*120*g,6,0,32411,0,32417,1.0,120,2985@TOP@human_GAPDH_TAA_len41_fa10_ta10_fm10_tm10,g
2985@TOP@human_GAPDH_TAA_len41_fa10_ta10_fm10_tm10*121*a,32713,0,34,0,32747,0.001,121,2985@TOP@human_GAPDH_TAA_len41_fa10_ta10_fm10_tm10,a
2985@TOP@human_GAPDH_TAA_len41_fa10_ta10_fm10_tm10*122*g,1,0,32775,0,32776,1.0,122,2985@TOP@human_GAPDH_TAA_len41_fa10_ta10_fm10_tm10,g
2985@TOP@human_GAPDH_TAA_len41_fa10_ta10_fm10_tm10*123*t,4,1,3,32378,32386,0.0,123,2985@TOP@human_GAPDH_TAA_len41_fa10_ta10_fm10_tm10,t
2985@TOP@human_GAPDH_TAA_len41_fa10_ta10_fm10_tm10*124*a,30806,4,1452,0,32262,0.045,124,2985@TOP@human_GAPDH_TAA_len41_fa10_ta10_fm10_tm10,a
2985@TOP@human_GAPDH_TAA_len41_fa10_ta10_fm10_tm10*125*a,31681,2,504,0,32187,0.016,125,2985@TOP@human_GAPDH_TAA_len41_fa10_ta10_fm10_tm10,a
2985@TOP@human_GAPDH_TAA_len41_fa10_ta10_fm10_tm10*126*g,2,1,32347,1,32351,1.0,126,2985@TOP@human_GAPDH_TAA_len41_fa10_ta10_fm10_tm10,g
2985@TOP@human_GAPDH_TAA_len41_fa10_ta10_fm10_tm10*127*a,32569,0,64,0,32633,0.002,127,2985@TOP@human_GAPDH_TAA_len41_fa10_ta10_fm10_tm10,a
2985@TOP@human_GAPDH_TAA_len41_fa10_ta10_fm10_tm10*128*c,1,32825,2,0,32828,0.0,128,2985@TOP@human_GAPDH_TAA_len41_fa10_ta10_fm10_tm10,c
2985@TOP@human_GAPDH_TAA_len41_fa10_ta10_fm10_tm10*129*c,3,32605,0,1,32609,0.0,129,2985@TOP@human_GAPDH_TAA_len41_fa10_ta10_fm10_tm10,c
2985@TOP@human_GAPDH_TAA_len41_fa10_ta10_fm10_tm10*130*c,1,32765,0,1,32767,0.0,130,2985@TOP@human_GAPDH_TAA_len41_fa10_ta10_fm10_tm10,c
2985@TOP@human_GAPDH_TAA_len41_fa10_ta10_fm10_tm10*131*c,4,32845,0,1,32850,0.0,131,2985@TOP@human_GAPDH_TAA_len41_fa10_ta10_fm10_tm10,c
2985@TOP@human_GAPDH_TAA_len41_fa10_ta10_fm10_tm10*132*t,2,6,3,32398,32409,0.0,132,2985@TOP@human_GAPDH_TAA_len41_fa10_ta10_fm10_tm10,t
2985@TOP@human_GAPDH_TAA_len41_fa10_ta10_fm10_tm10*133*g,2,0,32334,1,32337,1.0,133,2985@TOP@human_GAPDH_TAA_len41_fa10_ta10_fm10_tm10,g
2985@TOP@human_GAPDH_TAA_len41_fa10_ta10_fm10_tm10*134*g,2,16,32492,2,32512,0.999,134,2985@TOP@human_GAPDH_TAA_len41_fa10_ta10_fm10_tm10,g
2986@TOP@human_GAPDH_TAA_len41_fa10_ta10_fm10_tm10*114*t,0,1,0,1941,1942,0.0,114,2986@TOP@human_GAPDH_TAA_len41_fa10_ta10_fm10_tm10,t
2986@TOP@human_GAPDH_TAA_len41_fa10_ta10_fm10_tm10*115*c,0,1951,7,0,1958,0.004,115,2986@TOP@human_GAPDH_TAA_len41_fa10_ta10_fm10_tm10,c
2986@TOP@human_GAPDH_TAA_len41_fa10_ta10_fm10_tm10*116*c,7,1944,0,0,1951,0.0,116,2986@TOP@human_GAPDH_TAA_len41_fa10_ta10_fm10_tm10,c
2986@TOP@human_GAPDH_TAA_len41_fa10_ta10_fm10_tm10*117*a,1915,0,33,0,1948,0.017,117,2986@TOP@human_GAPDH_TAA_len41_fa10_ta10_fm10_tm10,a
2986@TOP@human_GAPDH_TAA_len41_fa10_ta10_fm10_tm10*118*a,1797,0,145,0,1942,0.075,118,2986@TOP@human_GAPDH_TAA_len41_fa10_ta10_fm10_tm10,a
2986@TOP@human_GAPDH_TAA_len41_fa10_ta10_fm10_tm10*119*g,5,0,1932,0,1937,0.997,119,2986@TOP@human_GAPDH_TAA_len41_fa10_ta10_fm10_tm10,g
2986@TOP@human_GAPDH_TAA_len41_fa10_ta10_fm10_tm10*120*g,0,0,1927,0,1927,1.0,120,2986@TOP@human_GAPDH_TAA_len41_fa10_ta10_fm10_tm10,g
2986@TOP@human_GAPDH_TAA_len41_fa10_ta10_fm10_tm10*121*a,1882,0,67,0,1949,0.034,121,2986@TOP@human_GAPDH_TAA_len41_fa10_ta10_fm10_tm10,a
2986@TOP@human_GAPDH_TAA_len41_fa10_ta10_fm10_tm10*122*g,0,0,1950,0,1950,1.0,122,2986@TOP@human_GAPDH_TAA_len41_fa10_ta10_fm10_tm10,g
2986@TOP@human_GAPDH_TAA_len41_fa10_ta10_fm10_tm10*123*t,0,0,0,1920,1920,0.0,123,2986@TOP@human_GAPDH_TAA_len41_fa10_ta10_fm10_tm10,t
2986@TOP@human_GAPDH_TAA_len41_fa10_ta10_fm10_tm10*124*a,1392,0,542,0,1934,0.28,124,2986@TOP@human_GAPDH_TAA_len41_fa10_ta10_fm10_tm10,a
2986@TOP@human_GAPDH_TAA_len41_fa10_ta10_fm10_tm10*125*a,1686,0,222,0,1908,0.116,125,2986@TOP@human_GAPDH_TAA_len41_fa10_ta10_fm10_tm10,a
2986@TOP@human_GAPDH_TAA_len41_fa10_ta10_fm10_tm10*126*g,0,0,1933,1,1934,0.999,126,2986@TOP@human_GAPDH_TAA_len41_fa10_ta10_fm10_tm10,g
2986@TOP@human_GAPDH_TAA_len41_fa10_ta10_fm10_tm10*127*a,1944,0,0,0,1944,0.0,127,2986@TOP@human_GAPDH_TAA_len41_fa10_ta10_fm10_tm10,a
2986@TOP@human_GAPDH_TAA_len41_fa10_ta10_fm10_tm10*128*c,0,1944,2,0,1946,0.001,128,2986@TOP@human_GAPDH_TAA_len41_fa10_ta10_fm10_tm10,c
2986@TOP@human_GAPDH_TAA_len41_fa10_ta10_fm10_tm10*129*c,0,1941,0,0,1941,0.0,129,2986@TOP@human_GAPDH_TAA_len41_fa10_ta10_fm10_tm10,c
2986@TOP@human_GAPDH_TAA_len41_fa10_ta10_fm10_tm10*130*c,0,1948,0,1,1949,0.0,130,2986@TOP@human_GAPDH_TAA_len41_fa10_ta10_fm10_tm10,c
2986@TOP@human_GAPDH_TAA_len41_fa10_ta10_fm10_tm10*131*c,0,1951,0,0,1951,0.0,131,2986@TOP@human_GAPDH_TAA_len41_fa10_ta10_fm10_tm10,c
2986@TOP@human_GAPDH_TAA_len41_fa10_ta10_fm10_tm10*132*t,0,2,0,1914,1916,0.0,132,2986@TOP@human_GAPDH_TAA_len41_fa10_ta10_fm10_tm10,t
2986@TOP@human_GAPDH_TAA_len41_fa10_ta10_fm10_tm10*133*g,0,0,1928,0,1928,1.0,133,2986@TOP@human_GAPDH_TAA_len41_fa10_ta10_fm10_tm10,g
2986@TOP@human_GAPDH_TAA_len41_fa10_ta10_fm10_tm10*134*g,0,0,1932,0,1932,1.0,134,2986@TOP@human_GAPDH_TAA_len41_fa10_ta10_fm10_tm10,g
2987@TOP@human_GAPDH_TAA_len41_fa10_ta10_fm10_tm10*114*t,2,6,0,22471,22479,0.0,114,2987@TOP@human_GAPDH_TAA_len41_fa10_ta10_fm10_tm10,t
2987@TOP@human_GAPDH_TAA_len41_fa10_ta10_fm10_tm10*115*c,0,22608,0,0,22608,0.0,115,2987@TOP@human_GAPDH_TAA_len41_fa10_ta10_fm10_tm10,c
2987@TOP@human_GAPDH_TAA_len41_fa10_ta10_fm10_tm10*116*c,0,22507,0,1,22508,0.0,116,2987@TOP@human_GAPDH_TAA_len41_fa10_ta10_fm10_tm10,c
2987@TOP@human_GAPDH_TAA_len41_fa10_ta10_fm10_tm10*117*a,22348,0,134,0,22482,0.006,117,2987@TOP@human_GAPDH_TAA_len41_fa10_ta10_fm10_tm10,a
2987@TOP@human_GAPDH_TAA_len41_fa10_ta10_fm10_tm10*118*a,19930,0,2485,3,22418,0.111,118,2987@TOP@human_GAPDH_TAA_len41_fa10_ta10_fm10_tm10,a
2987@TOP@human_GAPDH_TAA_len41_fa10_ta10_fm10_tm10*119*g,1,1,22322,0,22324,1.0,119,2987@TOP@human_GAPDH_TAA_len41_fa10_ta10_fm10_tm10,g
2987@TOP@human_GAPDH_TAA_len41_fa10_ta10_fm10_tm10*120*g,1,0,22236,0,22237,1.0,120,2987@TOP@human_GAPDH_TAA_len41_fa10_ta10_fm10_tm10,g
2987@TOP@human_GAPDH_TAA_len41_fa10_ta10_fm10_tm10*121*a,22482,1,7,0,22490,0.0,121,2987@TOP@human_GAPDH_TAA_len41_fa10_ta10_fm10_tm10,a
2987@TOP@human_GAPDH_TAA_len41_fa10_ta10_fm10_tm10*122*g,4,3,22523,0,22530,1.0,122,2987@TOP@human_GAPDH_TAA_len41_fa10_ta10_fm10_tm10,g
2987@TOP@human_GAPDH_TAA_len41_fa10_ta10_fm10_tm10*123*t,2,1,0,22211,22214,0.0,123,2987@TOP@human_GAPDH_TAA_len41_fa10_ta10_fm10_tm10,t
2987@TOP@human_GAPDH_TAA_len41_fa10_ta10_fm10_tm10*124*a,20139,0,2029,0,22168,0.092,124,2987@TOP@human_GAPDH_TAA_len41_fa10_ta10_fm10_tm10,a
2987@TOP@human_GAPDH_TAA_len41_fa10_ta10_fm10_tm10*125*a,21191,4,914,3,22112,0.041,125,2987@TOP@human_GAPDH_TAA_len41_fa10_ta10_fm10_tm10,a
2987@TOP@human_GAPDH_TAA_len41_fa10_ta10_fm10_tm10*126*g,3,0,22220,1,22224,1.0,126,2987@TOP@human_GAPDH_TAA_len41_fa10_ta10_fm10_tm10,g
2987@TOP@human_GAPDH_TAA_len41_fa10_ta10_fm10_tm10*127*a,22418,1,19,0,22438,0.001,127,2987@TOP@human_GAPDH_TAA_len41_fa10_ta10_fm10_tm10,a
2987@TOP@human_GAPDH_TAA_len41_fa10_ta10_fm10_tm10*128*c,0,22557,1,1,22559,0.0,128,2987@TOP@human_GAPDH_TAA_len41_fa10_ta10_fm10_tm10,c
2987@TOP@human_GAPDH_TAA_len41_fa10_ta10_fm10_tm10*129*c,0,22392,0,0,22392,0.0,129,2987@TOP@human_GAPDH_TAA_len41_fa10_ta10_fm10_tm10,c
2987@TOP@human_GAPDH_TAA_len41_fa10_ta10_fm10_tm10*130*c,1,22507,0,2,22510,0.0,130,2987@TOP@human_GAPDH_TAA_len41_fa10_ta10_fm10_tm10,c
2987@TOP@human_GAPDH_TAA_len41_fa10_ta10_fm10_tm10*131*c,0,22565,0,0,22565,0.0,131,2987@TOP@human_GAPDH_TAA_len41_fa10_ta10_fm10_tm10,c
2987@TOP@human_GAPDH_TAA_len41_fa10_ta10_fm10_tm10*132*t,3,8,4,22266,22281,0.0,132,2987@TOP@human_GAPDH_TAA_len41_fa10_ta10_fm10_tm10,t
2987@TOP@human_GAPDH_TAA_len41_fa10_ta10_fm10_tm10*133*g,0,0,22166,2,22168,1.0,133,2987@TOP@human_GAPDH_TAA_len41_fa10_ta10_fm10_tm10,g
2987@TOP@human_GAPDH_TAA_len41_fa10_ta10_fm10_tm10*134*g,2,3,22321,0,22326,1.0,134,2987@TOP@human_GAPDH_TAA_len41_fa10_ta10_fm10_tm10,g
2988@TOP@human_GAPDH_TAA_len41_fa10_ta10_fm10_tm10*114*t,4,11,0,39913,39928,0.0,114,2988@TOP@human_GAPDH_TAA_len41_fa10_ta10_fm10_tm10,t
2988@TOP@human_GAPDH_TAA_len41_fa10_ta10_fm10_tm10*115*c,1,40118,0,2,40121,0.0,115,2988@TOP@human_GAPDH_TAA_len41_fa10_ta10_fm10_tm10,c
2988@TOP@human_GAPDH_TAA_len41_fa10_ta10_fm10_tm10*116*c,1,39974,0,2,39977,0.0,116,2988@TOP@human_GAPDH_TAA_len41_fa10_ta10_fm10_tm10,c
2988@TOP@human_GAPDH_TAA_len41_fa10_ta10_fm10_tm10*117*a,39802,1,155,0,39958,0.004,117,2988@TOP@human_GAPDH_TAA_len41_fa10_ta10_fm10_tm10,a
2988@TOP@human_GAPDH_TAA_len41_fa10_ta10_fm10_tm10*118*a,35052,1,4675,6,39734,0.118,118,2988@TOP@human_GAPDH_TAA_len41_fa10_ta10_fm10_tm10,a
2988@TOP@human_GAPDH_TAA_len41_fa10_ta10_fm10_tm10*119*g,4,2,39655,1,39662,1.0,119,2988@TOP@human_GAPDH_TAA_len41_fa10_ta10_fm10_tm10,g
2988@TOP@human_GAPDH_TAA_len41_fa10_ta10_fm10_tm10*120*g,6,2,39595,1,39604,1.0,120,2988@TOP@human_GAPDH_TAA_len41_fa10_ta10_fm10_tm10,g
2988@TOP@human_GAPDH_TAA_len41_fa10_ta10_fm10_tm10*121*a,39881,0,22,2,39905,0.001,121,2988@TOP@human_GAPDH_TAA_len41_fa10_ta10_fm10_tm10,a
2988@TOP@human_GAPDH_TAA_len41_fa10_ta10_fm10_tm10*122*g,3,1,39985,1,39990,1.0,122,2988@TOP@human_GAPDH_TAA_len41_fa10_ta10_fm10_tm10,g
2988@TOP@human_GAPDH_TAA_len41_fa10_ta10_fm10_tm10*123*t,8,4,4,39484,39500,0.0,123,2988@TOP@human_GAPDH_TAA_len41_fa10_ta10_fm10_tm10,t
2988@TOP@human_GAPDH_TAA_len41_fa10_ta10_fm10_tm10*124*a,32018,0,7383,0,39401,0.187,124,2988@TOP@human_GAPDH_TAA_len41_fa10_ta10_fm10_tm10,a
2988@TOP@human_GAPDH_TAA_len41_fa10_ta10_fm10_tm10*125*a,37839,2,1509,4,39354,0.038,125,2988@TOP@human_GAPDH_TAA_len41_fa10_ta10_fm10_tm10,a
2988@TOP@human_GAPDH_TAA_len41_fa10_ta10_fm10_tm10*126*g,2,0,39523,4,39529,1.0,126,2988@TOP@human_GAPDH_TAA_len41_fa10_ta10_fm10_tm10,g
2988@TOP@human_GAPDH_TAA_len41_fa10_ta10_fm10_tm10*127*a,39840,1,24,0,39865,0.001,127,2988@TOP@human_GAPDH_TAA_len41_fa10_ta10_fm10_tm10,a
2988@TOP@human_GAPDH_TAA_len41_fa10_ta10_fm10_tm10*128*c,0,40041,2,2,40045,0.0,128,2988@TOP@human_GAPDH_TAA_len41_fa10_ta10_fm10_tm10,c
2988@TOP@human_GAPDH_TAA_len41_fa10_ta10_fm10_tm10*129*c,2,39789,0,1,39792,0.0,129,2988@TOP@human_GAPDH_TAA_len41_fa10_ta10_fm10_tm10,c
2988@TOP@human_GAPDH_TAA_len41_fa10_ta10_fm10_tm10*130*c,8,39991,0,1,40000,0.0,130,2988@TOP@human_GAPDH_TAA_len41_fa10_ta10_fm10_tm10,c
2988@TOP@human_GAPDH_TAA_len41_fa10_ta10_fm10_tm10*131*c,2,40066,0,3,40071,0.0,131,2988@TOP@human_GAPDH_TAA_len41_fa10_ta10_fm10_tm10,c
2988@TOP@human_GAPDH_TAA_len41_fa10_ta10_fm10_tm10*132*t,1,8,2,39545,39556,0.0,132,2988@TOP@human_GAPDH_TAA_len41_fa10_ta10_fm10_tm10,t
2988@TOP@human_GAPDH_TAA_len41_fa10_ta10_fm10_tm10*133*g,0,0,39431,3,39434,1.0,133,2988@TOP@human_GAPDH_TAA_len41_fa10_ta10_fm10_tm10,g
2988@TOP@human_GAPDH_TAA_len41_fa10_ta10_fm10_tm10*134*g,5,4,39646,0,39655,1.0,134,2988@TOP@human_GAPDH_TAA_len41_fa10_ta10_fm10_tm10,g
2989@TOP@human_GAPDH_TAA_len41_fa10_ta10_fm10_tm10*114*t,3,13,1,31290,31307,0.0,114,2989@TOP@human_GAPDH_TAA_len41_fa10_ta10_fm10_tm10,t
2989@TOP@human_GAPDH_TAA_len41_fa10_ta10_fm10_tm10*115*c,0,31455,0,0,31455,0.0,115,2989@TOP@human_GAPDH_TAA_len41_fa10_ta10_fm10_tm10,c
2989@TOP@human_GAPDH_TAA_len41_fa10_ta10_fm10_tm10*116*c,0,31346,0,4,31350,0.0,116,2989@TOP@human_GAPDH_TAA_len41_fa10_ta10_fm10_tm10,c
2989@TOP@human_GAPDH_TAA_len41_fa10_ta10_fm10_tm10*117*a,31236,0,94,0,31330,0.003,117,2989@TOP@human_GAPDH_TAA_len41_fa10_ta10_fm10_tm10,a
2989@TOP@human_GAPDH_TAA_len41_fa10_ta10_fm10_tm10*118*a,29273,0,1920,0,31193,0.062,118,2989@TOP@human_GAPDH_TAA_len41_fa10_ta10_fm10_tm10,a
2989@TOP@human_GAPDH_TAA_len41_fa10_ta10_fm10_tm10*119*g,3,0,31111,0,31114,1.0,119,2989@TOP@human_GAPDH_TAA_len41_fa10_ta10_fm10_tm10,g
2989@TOP@human_GAPDH_TAA_len41_fa10_ta10_fm10_tm10*120*g,2,2,31036,1,31041,1.0,120,2989@TOP@human_GAPDH_TAA_len41_fa10_ta10_fm10_tm10,g
2989@TOP@human_GAPDH_TAA_len41_fa10_ta10_fm10_tm10*121*a,31308,0,15,0,31323,0.0,121,2989@TOP@human_GAPDH_TAA_len41_fa10_ta10_fm10_tm10,a
2989@TOP@human_GAPDH_TAA_len41_fa10_ta10_fm10_tm10*122*g,0,0,31349,0,31349,1.0,122,2989@TOP@human_GAPDH_TAA_len41_fa10_ta10_fm10_tm10,g
2989@TOP@human_GAPDH_TAA_len41_fa10_ta10_fm10_tm10*123*t,5,2,4,30972,30983,0.0,123,2989@TOP@human_GAPDH_TAA_len41_fa10_ta10_fm10_tm10,t
2989@TOP@human_GAPDH_TAA_len41_fa10_ta10_fm10_tm10*124*a,29771,0,982,0,30753,0.032,124,2989@TOP@human_GAPDH_TAA_len41_fa10_ta10_fm10_tm10,a
2989@TOP@human_GAPDH_TAA_len41_fa10_ta10_fm10_tm10*125*a,22194,2,8599,0,30795,0.279,125,2989@TOP@human_GAPDH_TAA_len41_fa10_ta10_fm10_tm10,a
2989@TOP@human_GAPDH_TAA_len41_fa10_ta10_fm10_tm10*126*g,1,0,30956,0,30957,1.0,126,2989@TOP@human_GAPDH_TAA_len41_fa10_ta10_fm10_tm10,g
2989@TOP@human_GAPDH_TAA_len41_fa10_ta10_fm10_tm10*127*a,31221,3,42,0,31266,0.001,127,2989@TOP@human_GAPDH_TAA_len41_fa10_ta10_fm10_tm10,a
2989@TOP@human_GAPDH_TAA_len41_fa10_ta10_fm10_tm10*128*c,0,31396,2,0,31398,0.0,128,2989@TOP@human_GAPDH_TAA_len41_fa10_ta10_fm10_tm10,c
2989@TOP@human_GAPDH_TAA_len41_fa10_ta10_fm10_tm10*129*c,1,31167,0,2,31170,0.0,129,2989@TOP@human_GAPDH_TAA_len41_fa10_ta10_fm10_tm10,c
2989@TOP@human_GAPDH_TAA_len41_fa10_ta10_fm10_tm10*130*c,0,31342,0,1,31343,0.0,130,2989@TOP@human_GAPDH_TAA_len41_fa10_ta10_fm10_tm10,c
2989@TOP@human_GAPDH_TAA_len41_fa10_ta10_fm10_tm10*131*c,1,31403,0,3,31407,0.0,131,2989@TOP@human_GAPDH_TAA_len41_fa10_ta10_fm10_tm10,c
2989@TOP@human_GAPDH_TAA_len41_fa10_ta10_fm10_tm10*132*t,0,13,0,30993,31006,0.0,132,2989@TOP@human_GAPDH_TAA_len41_fa10_ta10_fm10_tm10,t
2989@TOP@human_GAPDH_TAA_len41_fa10_ta10_fm10_tm10*133*g,0,0,30957,0,30957,1.0,133,2989@TOP@human_GAPDH_TAA_len41_fa10_ta10_fm10_tm10,g
2989@TOP@human_GAPDH_TAA_len41_fa10_ta10_fm10_tm10*134*g,4,0,31103,0,31107,1.0,134,2989@TOP@human_GAPDH_TAA_len41_fa10_ta10_fm10_tm10,g
2990@TOP@human_GAPDH_TAA_len41_fa10_ta10_fm10_tm10*114*t,3,4,3,29506,29516,0.0,114,2990@TOP@human_GAPDH_TAA_len41_fa10_ta10_fm10_tm10,t
2990@TOP@human_GAPDH_TAA_len41_fa10_ta10_fm10_tm10*115*c,0,29679,0,2,29681,0.0,115,2990@TOP@human_GAPDH_TAA_len41_fa10_ta10_fm10_tm10,c
2990@TOP@human_GAPDH_TAA_len41_fa10_ta10_fm10_tm10*116*c,0,29589,0,0,29589,0.0,116,2990@TOP@human_GAPDH_TAA_len41_fa10_ta10_fm10_tm10,c
2990@TOP@human_GAPDH_TAA_len41_fa10_ta10_fm10_tm10*117*a,29529,0,21,0,29550,0.001,117,2990@TOP@human_GAPDH_TAA_len41_fa10_ta10_fm10_tm10,a
2990@TOP@human_GAPDH_TAA_len41_fa10_ta10_fm10_tm10*118*a,28823,1,546,0,29370,0.019,118,2990@TOP@human_GAPDH_TAA_len41_fa10_ta10_fm10_tm10,a
2990@TOP@human_GAPDH_TAA_len41_fa10_ta10_fm10_tm10*119*g,2,1,29305,5,29313,1.0,119,2990@TOP@human_GAPDH_TAA_len41_fa10_ta10_fm10_tm10,g
2990@TOP@human_GAPDH_TAA_len41_fa10_ta10_fm10_tm10*120*g,1,0,29269,0,29270,1.0,120,2990@TOP@human_GAPDH_TAA_len41_fa10_ta10_fm10_tm10,g
2990@TOP@human_GAPDH_TAA_len41_fa10_ta10_fm10_tm10*121*a,29487,0,10,0,29497,0.0,121,2990@TOP@human_GAPDH_TAA_len41_fa10_ta10_fm10_tm10,a
2990@TOP@human_GAPDH_TAA_len41_fa10_ta10_fm10_tm10*122*g,0,1,29551,0,29552,1.0,122,2990@TOP@human_GAPDH_TAA_len41_fa10_ta10_fm10_tm10,g
2990@TOP@human_GAPDH_TAA_len41_fa10_ta10_fm10_tm10*123*t,3,1,3,29122,29129,0.0,123,2990@TOP@human_GAPDH_TAA_len41_fa10_ta10_fm10_tm10,t
2990@TOP@human_GAPDH_TAA_len41_fa10_ta10_fm10_tm10*124*a,28337,1,765,1,29104,0.026,124,2990@TOP@human_GAPDH_TAA_len41_fa10_ta10_fm10_tm10,a
2990@TOP@human_GAPDH_TAA_len41_fa10_ta10_fm10_tm10*125*a,28060,2,993,3,29058,0.034,125,2990@TOP@human_GAPDH_TAA_len41_fa10_ta10_fm10_tm10,a
2990@TOP@human_GAPDH_TAA_len41_fa10_ta10_fm10_tm10*126*g,0,1,29167,0,29168,1.0,126,2990@TOP@human_GAPDH_TAA_len41_fa10_ta10_fm10_tm10,g
2990@TOP@human_GAPDH_TAA_len41_fa10_ta10_fm10_tm10*127*a,29439,0,14,0,29453,0.0,127,2990@TOP@human_GAPDH_TAA_len41_fa10_ta10_fm10_tm10,a
2990@TOP@human_GAPDH_TAA_len41_fa10_ta10_fm10_tm10*128*c,4,29625,2,4,29635,0.0,128,2990@TOP@human_GAPDH_TAA_len41_fa10_ta10_fm10_tm10,c
2990@TOP@human_GAPDH_TAA_len41_fa10_ta10_fm10_tm10*129*c,1,29383,0,3,29387,0.0,129,2990@TOP@human_GAPDH_TAA_len41_fa10_ta10_fm10_tm10,c
2990@TOP@human_GAPDH_TAA_len41_fa10_ta10_fm10_tm10*130*c,3,29572,0,0,29575,0.0,130,2990@TOP@human_GAPDH_TAA_len41_fa10_ta10_fm10_tm10,c
2990@TOP@human_GAPDH_TAA_len41_fa10_ta10_fm10_tm10*131*c,2,29640,0,1,29643,0.0,131,2990@TOP@human_GAPDH_TAA_len41_fa10_ta10_fm10_tm10,c
2990@TOP@human_GAPDH_TAA_len41_fa10_ta10_fm10_tm10*132*t,1,7,1,29187,29196,0.0,132,2990@TOP@human_GAPDH_TAA_len41_fa10_ta10_fm10_tm10,t
2990@TOP@human_GAPDH_TAA_len41_fa10_ta10_fm10_tm10*133*g,1,1,29186,2,29190,1.0,133,2990@TOP@human_GAPDH_TAA_len41_fa10_ta10_fm10_tm10,g
2990@TOP@human_GAPDH_TAA_len41_fa10_ta10_fm10_tm10*134*g,0,3,29345,0,29348,1.0,134,2990@TOP@human_GAPDH_TAA_len41_fa10_ta10_fm10_tm10,g
2991@TOP@human_GAPDH_TAA_len41_fa10_ta10_fm10_tm10*114*t,1,0,1,9593,9595,0.0,114,2991@TOP@human_GAPDH_TAA_len41_fa10_ta10_fm10_tm10,t
2991@TOP@human_GAPDH_TAA_len41_fa10_ta10_fm10_tm10*115*c,0,9649,0,0,9649,0.0,115,2991@TOP@human_GAPDH_TAA_len41_fa10_ta10_fm10_tm10,c
2991@TOP@human_GAPDH_TAA_len41_fa10_ta10_fm10_tm10*116*c,1,9605,0,0,9606,0.0,116,2991@TOP@human_GAPDH_TAA_len41_fa10_ta10_fm10_tm10,c
2991@TOP@human_GAPDH_TAA_len41_fa10_ta10_fm10_tm10*117*a,9579,0,21,0,9600,0.002,117,2991@TOP@human_GAPDH_TAA_len41_fa10_ta10_fm10_tm10,a
2991@TOP@human_GAPDH_TAA_len41_fa10_ta10_fm10_tm10*118*a,9405,0,144,0,9549,0.015,118,2991@TOP@human_GAPDH_TAA_len41_fa10_ta10_fm10_tm10,a
2991@TOP@human_GAPDH_TAA_len41_fa10_ta10_fm10_tm10*119*g,1,0,9544,0,9545,1.0,119,2991@TOP@human_GAPDH_TAA_len41_fa10_ta10_fm10_tm10,g
2991@TOP@human_GAPDH_TAA_len41_fa10_ta10_fm10_tm10*120*g,0,1,9522,0,9523,1.0,120,2991@TOP@human_GAPDH_TAA_len41_fa10_ta10_fm10_tm10,g
2991@TOP@human_GAPDH_TAA_len41_fa10_ta10_fm10_tm10*121*a,9594,0,6,0,9600,0.001,121,2991@TOP@human_GAPDH_TAA_len41_fa10_ta10_fm10_tm10,a
2991@TOP@human_GAPDH_TAA_len41_fa10_ta10_fm10_tm10*122*g,0,0,9621,0,9621,1.0,122,2991@TOP@human_GAPDH_TAA_len41_fa10_ta10_fm10_tm10,g
2991@TOP@human_GAPDH_TAA_len41_fa10_ta10_fm10_tm10*123*t,3,2,0,9495,9500,0.0,123,2991@TOP@human_GAPDH_TAA_len41_fa10_ta10_fm10_tm10,t
2991@TOP@human_GAPDH_TAA_len41_fa10_ta10_fm10_tm10*124*a,6028,0,3438,0,9466,0.363,124,2991@TOP@human_GAPDH_TAA_len41_fa10_ta10_fm10_tm10,a
2991@TOP@human_GAPDH_TAA_len41_fa10_ta10_fm10_tm10*125*a,6683,0,2797,3,9483,0.295,125,2991@TOP@human_GAPDH_TAA_len41_fa10_ta10_fm10_tm10,a
2991@TOP@human_GAPDH_TAA_len41_fa10_ta10_fm10_tm10*126*g,0,1,9502,0,9503,1.0,126,2991@TOP@human_GAPDH_TAA_len41_fa10_ta10_fm10_tm10,g
2991@TOP@human_GAPDH_TAA_len41_fa10_ta10_fm10_tm10*127*a,9591,0,6,0,9597,0.001,127,2991@TOP@human_GAPDH_TAA_len41_fa10_ta10_fm10_tm10,a
2991@TOP@human_GAPDH_TAA_len41_fa10_ta10_fm10_tm10*128*c,0,9629,0,0,9629,0.0,128,2991@TOP@human_GAPDH_TAA_len41_fa10_ta10_fm10_tm10,c
2991@TOP@human_GAPDH_TAA_len41_fa10_ta10_fm10_tm10*129*c,0,9591,0,1,9592,0.0,129,2991@TOP@human_GAPDH_TAA_len41_fa10_ta10_fm10_tm10,c
2991@TOP@human_GAPDH_TAA_len41_fa10_ta10_fm10_tm10*130*c,0,9623,0,1,9624,0.0,130,2991@TOP@human_GAPDH_TAA_len41_fa10_ta10_fm10_tm10,c
2991@TOP@human_GAPDH_TAA_len41_fa10_ta10_fm10_tm10*131*c,5,9631,0,1,9637,0.0,131,2991@TOP@human_GAPDH_TAA_len41_fa10_ta10_fm10_tm10,c
2991@TOP@human_GAPDH_TAA_len41_fa10_ta10_fm10_tm10*132*t,0,1,0,9520,9521,0.0,132,2991@TOP@human_GAPDH_TAA_len41_fa10_ta10_fm10_tm10,t
2991@TOP@human_GAPDH_TAA_len41_fa10_ta10_fm10_tm10*133*g,0,0,9508,0,9508,1.0,133,2991@TOP@human_GAPDH_TAA_len41_fa10_ta10_fm10_tm10,g
2991@TOP@human_GAPDH_TAA_len41_fa10_ta10_fm10_tm10*134*g,0,3,9537,0,9540,1.0,134,2991@TOP@human_GAPDH_TAA_len41_fa10_ta10_fm10_tm10,g
2992@TOP@human_GAPDH_TAA_len41_fa10_ta10_fm10_tm10*114*t,6,4,0,36993,37003,0.0,114,2992@TOP@human_GAPDH_TAA_len41_fa10_ta10_fm10_tm10,t
2992@TOP@human_GAPDH_TAA_len41_fa10_ta10_fm10_tm10*115*c,1,37229,1,0,37231,0.0,115,2992@TOP@human_GAPDH_TAA_len41_fa10_ta10_fm10_tm10,c
2992@TOP@human_GAPDH_TAA_len41_fa10_ta10_fm10_tm10*116*c,0,37075,0,1,37076,0.0,116,2992@TOP@human_GAPDH_TAA_len41_fa10_ta10_fm10_tm10,c
2992@TOP@human_GAPDH_TAA_len41_fa10_ta10_fm10_tm10*117*a,37026,0,44,0,37070,0.001,117,2992@TOP@human_GAPDH_TAA_len41_fa10_ta10_fm10_tm10,a
2992@TOP@human_GAPDH_TAA_len41_fa10_ta10_fm10_tm10*118*a,36441,1,406,7,36855,0.011,118,2992@TOP@human_GAPDH_TAA_len41_fa10_ta10_fm10_tm10,a
2992@TOP@human_GAPDH_TAA_len41_fa10_ta10_fm10_tm10*119*g,0,1,36809,0,36810,1.0,119,2992@TOP@human_GAPDH_TAA_len41_fa10_ta10_fm10_tm10,g
2992@TOP@human_GAPDH_TAA_len41_fa10_ta10_fm10_tm10*120*g,5,0,36655,0,36660,1.0,120,2992@TOP@human_GAPDH_TAA_len41_fa10_ta10_fm10_tm10,g
2992@TOP@human_GAPDH_TAA_len41_fa10_ta10_fm10_tm10*121*a,36977,0,42,1,37020,0.001,121,2992@TOP@human_GAPDH_TAA_len41_fa10_ta10_fm10_tm10,a
2992@TOP@human_GAPDH_TAA_len41_fa10_ta10_fm10_tm10*122*g,3,0,37076,0,37079,1.0,122,2992@TOP@human_GAPDH_TAA_len41_fa10_ta10_fm10_tm10,g
2992@TOP@human_GAPDH_TAA_len41_fa10_ta10_fm10_tm10*123*t,7,3,6,36625,36641,0.0,123,2992@TOP@human_GAPDH_TAA_len41_fa10_ta10_fm10_tm10,t
2992@TOP@human_GAPDH_TAA_len41_fa10_ta10_fm10_tm10*124*a,26191,1,10366,0,36558,0.284,124,2992@TOP@human_GAPDH_TAA_len41_fa10_ta10_fm10_tm10,a
2992@TOP@human_GAPDH_TAA_len41_fa10_ta10_fm10_tm10*125*a,33279,2,3263,2,36546,0.089,125,2992@TOP@human_GAPDH_TAA_len41_fa10_ta10_fm10_tm10,a
2992@TOP@human_GAPDH_TAA_len41_fa10_ta10_fm10_tm10*126*g,0,0,36658,0,36658,1.0,126,2992@TOP@human_GAPDH_TAA_len41_fa10_ta10_fm10_tm10,g
2992@TOP@human_GAPDH_TAA_len41_fa10_ta10_fm10_tm10*127*a,36973,0,13,2,36988,0.0,127,2992@TOP@human_GAPDH_TAA_len41_fa10_ta10_fm10_tm10,a
2992@TOP@human_GAPDH_TAA_len41_fa10_ta10_fm10_tm10*128*c,2,37108,2,3,37115,0.0,128,2992@TOP@human_GAPDH_TAA_len41_fa10_ta10_fm10_tm10,c
2992@TOP@human_GAPDH_TAA_len41_fa10_ta10_fm10_tm10*129*c,2,36889,0,2,36893,0.0,129,2992@TOP@human_GAPDH_TAA_len41_fa10_ta10_fm10_tm10,c
2992@TOP@human_GAPDH_TAA_len41_fa10_ta10_fm10_tm10*130*c,1,37075,0,1,37077,0.0,130,2992@TOP@human_GAPDH_TAA_len41_fa10_ta10_fm10_tm10,c
2992@TOP@human_GAPDH_TAA_len41_fa10_ta10_fm10_tm10*131*c,2,37166,0,3,37171,0.0,131,2992@TOP@human_GAPDH_TAA_len41_fa10_ta10_fm10_tm10,c
2992@TOP@human_GAPDH_TAA_len41_fa10_ta10_fm10_tm10*132*t,2,11,4,36654,36671,0.0,132,2992@TOP@human_GAPDH_TAA_len41_fa10_ta10_fm10_tm10,t
2992@TOP@human_GAPDH_TAA_len41_fa10_ta10_fm10_tm10*133*g,1,1,36557,3,36562,1.0,133,2992@TOP@human_GAPDH_TAA_len41_fa10_ta10_fm10_tm10,g
2992@TOP@human_GAPDH_TAA_len41_fa10_ta10_fm10_tm10*134*g,0,5,36755,4,36764,1.0,134,2992@TOP@human_GAPDH_TAA_len41_fa10_ta10_fm10_tm10,g
2993@TOP@human_GAPDH_TAA_len41_fa10_ta10_fm10_tm10*114*t,3,15,0,28640,28658,0.0,114,2993@TOP@human_GAPDH_TAA_len41_fa10_ta10_fm10_tm10,t
2993@TOP@human_GAPDH_TAA_len41_fa10_ta10_fm10_tm10*115*c,1,28820,0,2,28823,0.0,115,2993@TOP@human_GAPDH_TAA_len41_fa10_ta10_fm10_tm10,c
2993@TOP@human_GAPDH_TAA_len41_fa10_ta10_fm10_tm10*116*c,1,28711,0,1,28713,0.0,116,2993@TOP@human_GAPDH_TAA_len41_fa10_ta10_fm10_tm10,c
2993@TOP@human_GAPDH_TAA_len41_fa10_ta10_fm10_tm10*117*a,28609,0,99,0,28708,0.003,117,2993@TOP@human_GAPDH_TAA_len41_fa10_ta10_fm10_tm10,a
2993@TOP@human_GAPDH_TAA_len41_fa10_ta10_fm10_tm10*118*a,27446,0,1089,1,28536,0.038,118,2993@TOP@human_GAPDH_TAA_len41_fa10_ta10_fm10_tm10,a
2993@TOP@human_GAPDH_TAA_len41_fa10_ta10_fm10_tm10*119*g,3,0,28453,0,28456,1.0,119,2993@TOP@human_GAPDH_TAA_len41_fa10_ta10_fm10_tm10,g
2993@TOP@human_GAPDH_TAA_len41_fa10_ta10_fm10_tm10*120*g,0,1,28406,0,28407,1.0,120,2993@TOP@human_GAPDH_TAA_len41_fa10_ta10_fm10_tm10,g
2993@TOP@human_GAPDH_TAA_len41_fa10_ta10_fm10_tm10*121*a,28650,0,12,1,28663,0.0,121,2993@TOP@human_GAPDH_TAA_len41_fa10_ta10_fm10_tm10,a
2993@TOP@human_GAPDH_TAA_len41_fa10_ta10_fm10_tm10*122*g,2,0,28719,0,28721,1.0,122,2993@TOP@human_GAPDH_TAA_len41_fa10_ta10_fm10_tm10,g
2993@TOP@human_GAPDH_TAA_len41_fa10_ta10_fm10_tm10*123*t,3,6,0,28349,28358,0.0,123,2993@TOP@human_GAPDH_TAA_len41_fa10_ta10_fm10_tm10,t
2993@TOP@human_GAPDH_TAA_len41_fa10_ta10_fm10_tm10*124*a,25408,0,2853,1,28262,0.101,124,2993@TOP@human_GAPDH_TAA_len41_fa10_ta10_fm10_tm10,a
2993@TOP@human_GAPDH_TAA_len41_fa10_ta10_fm10_tm10*125*a,27451,0,755,1,28207,0.027,125,2993@TOP@human_GAPDH_TAA_len41_fa10_ta10_fm10_tm10,a
2993@TOP@human_GAPDH_TAA_len41_fa10_ta10_fm10_tm10*126*g,0,0,28373,2,28375,1.0,126,2993@TOP@human_GAPDH_TAA_len41_fa10_ta10_fm10_tm10,g
2993@TOP@human_GAPDH_TAA_len41_fa10_ta10_fm10_tm10*127*a,28568,6,36,0,28610,0.001,127,2993@TOP@human_GAPDH_TAA_len41_fa10_ta10_fm10_tm10,a
2993@TOP@human_GAPDH_TAA_len41_fa10_ta10_fm10_tm10*128*c,0,28755,5,0,28760,0.0,128,2993@TOP@human_GAPDH_TAA_len41_fa10_ta10_fm10_tm10,c
2993@TOP@human_GAPDH_TAA_len41_fa10_ta10_fm10_tm10*129*c,1,28499,0,3,28503,0.0,129,2993@TOP@human_GAPDH_TAA_len41_fa10_ta10_fm10_tm10,c
2993@TOP@human_GAPDH_TAA_len41_fa10_ta10_fm10_tm10*130*c,5,28704,0,0,28709,0.0,130,2993@TOP@human_GAPDH_TAA_len41_fa10_ta10_fm10_tm10,c
2993@TOP@human_GAPDH_TAA_len41_fa10_ta10_fm10_tm10*131*c,2,28764,0,3,28769,0.0,131,2993@TOP@human_GAPDH_TAA_len41_fa10_ta10_fm10_tm10,c
2993@TOP@human_GAPDH_TAA_len41_fa10_ta10_fm10_tm10*132*t,3,9,1,28373,28386,0.0,132,2993@TOP@human_GAPDH_TAA_len41_fa10_ta10_fm10_tm10,t
2993@TOP@human_GAPDH_TAA_len41_fa10_ta10_fm10_tm10*133*g,1,1,28305,5,28312,1.0,133,2993@TOP@human_GAPDH_TAA_len41_fa10_ta10_fm10_tm10,g
2993@TOP@human_GAPDH_TAA_len41_fa10_ta10_fm10_tm10*134*g,5,2,28431,0,28438,1.0,134,2993@TOP@human_GAPDH_TAA_len41_fa10_ta10_fm10_tm10,g
2994@TOP@human_GAPDH_TAA_len41_fa10_ta10_fm10_tm10*114*t,2,6,0,26993,27001,0.0,114,2994@TOP@human_GAPDH_TAA_len41_fa10_ta10_fm10_tm10,t
2994@TOP@human_GAPDH_TAA_len41_fa10_ta10_fm10_tm10*115*c,0,27146,0,0,27146,0.0,115,2994@TOP@human_GAPDH_TAA_len41_fa10_ta10_fm10_tm10,c
2994@TOP@human_GAPDH_TAA_len41_fa10_ta10_fm10_tm10*116*c,0,27006,0,0,27006,0.0,116,2994@TOP@human_GAPDH_TAA_len41_fa10_ta10_fm10_tm10,c
2994@TOP@human_GAPDH_TAA_len41_fa10_ta10_fm10_tm10*117*a,26975,1,33,1,27010,0.001,117,2994@TOP@human_GAPDH_TAA_len41_fa10_ta10_fm10_tm10,a
2994@TOP@human_GAPDH_TAA_len41_fa10_ta10_fm10_tm10*118*a,26545,0,337,0,26882,0.013,118,2994@TOP@human_GAPDH_TAA_len41_fa10_ta10_fm10_tm10,a
2994@TOP@human_GAPDH_TAA_len41_fa10_ta10_fm10_tm10*119*g,3,0,26848,1,26852,1.0,119,2994@TOP@human_GAPDH_TAA_len41_fa10_ta10_fm10_tm10,g
2994@TOP@human_GAPDH_TAA_len41_fa10_ta10_fm10_tm10*120*g,2,1,26746,0,26749,1.0,120,2994@TOP@human_GAPDH_TAA_len41_fa10_ta10_fm10_tm10,g
2994@TOP@human_GAPDH_TAA_len41_fa10_ta10_fm10_tm10*121*a,27006,0,19,0,27025,0.001,121,2994@TOP@human_GAPDH_TAA_len41_fa10_ta10_fm10_tm10,a
2994@TOP@human_GAPDH_TAA_len41_fa10_ta10_fm10_tm10*122*g,1,0,27069,0,27070,1.0,122,2994@TOP@human_GAPDH_TAA_len41_fa10_ta10_fm10_tm10,g
2994@TOP@human_GAPDH_TAA_len41_fa10_ta10_fm10_tm10*123*t,3,0,2,26691,26696,0.0,123,2994@TOP@human_GAPDH_TAA_len41_fa10_ta10_fm10_tm10,t
2994@TOP@human_GAPDH_TAA_len41_fa10_ta10_fm10_tm10*124*a,18256,1,8440,0,26697,0.316,124,2994@TOP@human_GAPDH_TAA_len41_fa10_ta10_fm10_tm10,a
2994@TOP@human_GAPDH_TAA_len41_fa10_ta10_fm10_tm10*125*a,24283,2,2406,1,26692,0.09,125,2994@TOP@human_GAPDH_TAA_len41_fa10_ta10_fm10_tm10,a
2994@TOP@human_GAPDH_TAA_len41_fa10_ta10_fm10_tm10*126*g,7,1,26710,2,26720,1.0,126,2994@TOP@human_GAPDH_TAA_len41_fa10_ta10_fm10_tm10,g
2994@TOP@human_GAPDH_TAA_len41_fa10_ta10_fm10_tm10*127*a,26940,8,15,0,26963,0.001,127,2994@TOP@human_GAPDH_TAA_len41_fa10_ta10_fm10_tm10,a
2994@TOP@human_GAPDH_TAA_len41_fa10_ta10_fm10_tm10*128*c,0,27103,2,0,27105,0.0,128,2994@TOP@human_GAPDH_TAA_len41_fa10_ta10_fm10_tm10,c
2994@TOP@human_GAPDH_TAA_len41_fa10_ta10_fm10_tm10*129*c,1,26940,0,1,26942,0.0,129,2994@TOP@human_GAPDH_TAA_len41_fa10_ta10_fm10_tm10,c
2994@TOP@human_GAPDH_TAA_len41_fa10_ta10_fm10_tm10*130*c,4,27045,0,0,27049,0.0,130,2994@TOP@human_GAPDH_TAA_len41_fa10_ta10_fm10_tm10,c
2994@TOP@human_GAPDH_TAA_len41_fa10_ta10_fm10_tm10*131*c,0,27083,1,4,27088,0.0,131,2994@TOP@human_GAPDH_TAA_len41_fa10_ta10_fm10_tm10,c
2994@TOP@human_GAPDH_TAA_len41_fa10_ta10_fm10_tm10*132*t,2,11,3,26725,26741,0.0,132,2994@TOP@human_GAPDH_TAA_len41_fa10_ta10_fm10_tm10,t
2994@TOP@human_GAPDH_TAA_len41_fa10_ta10_fm10_tm10*133*g,0,2,26685,1,26688,1.0,133,2994@TOP@human_GAPDH_TAA_len41_fa10_ta10_fm10_tm10,g
2994@TOP@human_GAPDH_TAA_len41_fa10_ta10_fm10_tm10*134*g,5,9,26832,1,26847,0.999,134,2994@TOP@human_GAPDH_TAA_len41_fa10_ta10_fm10_tm10,g
2995@TOP@human_GAPDH_TAA_len41_fa10_ta10_fm10_tm10*114*t,0,0,0,2038,2038,0.0,114,2995@TOP@human_GAPDH_TAA_len41_fa10_ta10_fm10_tm10,t
2995@TOP@human_GAPDH_TAA_len41_fa10_ta10_fm10_tm10*115*c,0,2056,0,0,2056,0.0,115,2995@TOP@human_GAPDH_TAA_len41_fa10_ta10_fm10_tm10,c
2995@TOP@human_GAPDH_TAA_len41_fa10_ta10_fm10_tm10*116*c,0,2043,0,0,2043,0.0,116,2995@TOP@human_GAPDH_TAA_len41_fa10_ta10_fm10_tm10,c
2995@TOP@human_GAPDH_TAA_len41_fa10_ta10_fm10_tm10*117*a,2037,1,8,0,2046,0.004,117,2995@TOP@human_GAPDH_TAA_len41_fa10_ta10_fm10_tm10,a
2995@TOP@human_GAPDH_TAA_len41_fa10_ta10_fm10_tm10*118*a,1942,0,94,0,2036,0.046,118,2995@TOP@human_GAPDH_TAA_len41_fa10_ta10_fm10_tm10,a
2995@TOP@human_GAPDH_TAA_len41_fa10_ta10_fm10_tm10*119*g,0,0,2024,0,2024,1.0,119,2995@TOP@human_GAPDH_TAA_len41_fa10_ta10_fm10_tm10,g
2995@TOP@human_GAPDH_TAA_len41_fa10_ta10_fm10_tm10*120*g,0,0,2006,0,2006,1.0,120,2995@TOP@human_GAPDH_TAA_len41_fa10_ta10_fm10_tm10,g
2995@TOP@human_GAPDH_TAA_len41_fa10_ta10_fm10_tm10*121*a,2034,0,1,0,2035,0.0,121,2995@TOP@human_GAPDH_TAA_len41_fa10_ta10_fm10_tm10,a
2995@TOP@human_GAPDH_TAA_len41_fa10_ta10_fm10_tm10*122*g,0,0,2041,0,2041,1.0,122,2995@TOP@human_GAPDH_TAA_len41_fa10_ta10_fm10_tm10,g
2995@TOP@human_GAPDH_TAA_len41_fa10_ta10_fm10_tm10*123*t,0,0,0,2021,2021,0.0,123,2995@TOP@human_GAPDH_TAA_len41_fa10_ta10_fm10_tm10,t
2995@TOP@human_GAPDH_TAA_len41_fa10_ta10_fm10_tm10*124*a,1816,0,187,0,2003,0.093,124,2995@TOP@human_GAPDH_TAA_len41_fa10_ta10_fm10_tm10,a
2995@TOP@human_GAPDH_TAA_len41_fa10_ta10_fm10_tm10*125*a,1933,0,71,0,2004,0.035,125,2995@TOP@human_GAPDH_TAA_len41_fa10_ta10_fm10_tm10,a
2995@TOP@human_GAPDH_TAA_len41_fa10_ta10_fm10_tm10*126*g,0,0,2001,1,2002,1.0,126,2995@TOP@human_GAPDH_TAA_len41_fa10_ta10_fm10_tm10,g
2995@TOP@human_GAPDH_TAA_len41_fa10_ta10_fm10_tm10*127*a,2034,0,5,0,2039,0.002,127,2995@TOP@human_GAPDH_TAA_len41_fa10_ta10_fm10_tm10,a
2995@TOP@human_GAPDH_TAA_len41_fa10_ta10_fm10_tm10*128*c,0,2044,0,0,2044,0.0,128,2995@TOP@human_GAPDH_TAA_len41_fa10_ta10_fm10_tm10,c
2995@TOP@human_GAPDH_TAA_len41_fa10_ta10_fm10_tm10*129*c,0,2024,0,0,2024,0.0,129,2995@TOP@human_GAPDH_TAA_len41_fa10_ta10_fm10_tm10,c
2995@TOP@human_GAPDH_TAA_len41_fa10_ta10_fm10_tm10*130*c,0,2036,0,0,2036,0.0,130,2995@TOP@human_GAPDH_TAA_len41_fa10_ta10_fm10_tm10,c
2995@TOP@human_GAPDH_TAA_len41_fa10_ta10_fm10_tm10*131*c,2,2044,0,0,2046,0.0,131,2995@TOP@human_GAPDH_TAA_len41_fa10_ta10_fm10_tm10,c
2995@TOP@human_GAPDH_TAA_len41_fa10_ta10_fm10_tm10*132*t,0,0,0,2012,2012,0.0,132,2995@TOP@human_GAPDH_TAA_len41_fa10_ta10_fm10_tm10,t
2995@TOP@human_GAPDH_TAA_len41_fa10_ta10_fm10_tm10*133*g,0,0,2020,0,2020,1.0,133,2995@TOP@human_GAPDH_TAA_len41_fa10_ta10_fm10_tm10,g
2995@TOP@human_GAPDH_TAA_len41_fa10_ta10_fm10_tm10*134*g,0,2,2010,0,2012,0.999,134,2995@TOP@human_GAPDH_TAA_len41_fa10_ta10_fm10_tm10,g
2996@TOP@human_GAPDH_TAA_len41_fa10_ta10_fm10_tm10*114*t,0,1,0,6642,6643,0.0,114,2996@TOP@human_GAPDH_TAA_len41_fa10_ta10_fm10_tm10,t
2996@TOP@human_GAPDH_TAA_len41_fa10_ta10_fm10_tm10*115*c,0,6678,0,0,6678,0.0,115,2996@TOP@human_GAPDH_TAA_len41_fa10_ta10_fm10_tm10,c
2996@TOP@human_GAPDH_TAA_len41_fa10_ta10_fm10_tm10*116*c,1,6653,0,1,6655,0.0,116,2996@TOP@human_GAPDH_TAA_len41_fa10_ta10_fm10_tm10,c
2996@TOP@human_GAPDH_TAA_len41_fa10_ta10_fm10_tm10*117*a,6603,0,43,0,6646,0.006,117,2996@TOP@human_GAPDH_TAA_len41_fa10_ta10_fm10_tm10,a
2996@TOP@human_GAPDH_TAA_len41_fa10_ta10_fm10_tm10*118*a,5707,0,910,0,6617,0.138,118,2996@TOP@human_GAPDH_TAA_len41_fa10_ta10_fm10_tm10,a
2996@TOP@human_GAPDH_TAA_len41_fa10_ta10_fm10_tm10*119*g,0,0,6605,0,6605,1.0,119,2996@TOP@human_GAPDH_TAA_len41_fa10_ta10_fm10_tm10,g
2996@TOP@human_GAPDH_TAA_len41_fa10_ta10_fm10_tm10*120*g,0,1,6579,0,6580,1.0,120,2996@TOP@human_GAPDH_TAA_len41_fa10_ta10_fm10_tm10,g
2996@TOP@human_GAPDH_TAA_len41_fa10_ta10_fm10_tm10*121*a,6631,0,7,1,6639,0.001,121,2996@TOP@human_GAPDH_TAA_len41_fa10_ta10_fm10_tm10,a
2996@TOP@human_GAPDH_TAA_len41_fa10_ta10_fm10_tm10*122*g,2,0,6647,0,6649,1.0,122,2996@TOP@human_GAPDH_TAA_len41_fa10_ta10_fm10_tm10,g
2996@TOP@human_GAPDH_TAA_len41_fa10_ta10_fm10_tm10*123*t,0,0,2,6564,6566,0.0,123,2996@TOP@human_GAPDH_TAA_len41_fa10_ta10_fm10_tm10,t
2996@TOP@human_GAPDH_TAA_len41_fa10_ta10_fm10_tm10*124*a,6276,0,237,0,6513,0.036,124,2996@TOP@human_GAPDH_TAA_len41_fa10_ta10_fm10_tm10,a
2996@TOP@human_GAPDH_TAA_len41_fa10_ta10_fm10_tm10*125*a,6264,1,261,0,6526,0.04,125,2996@TOP@human_GAPDH_TAA_len41_fa10_ta10_fm10_tm10,a
2996@TOP@human_GAPDH_TAA_len41_fa10_ta10_fm10_tm10*126*g,0,0,6562,0,6562,1.0,126,2996@TOP@human_GAPDH_TAA_len41_fa10_ta10_fm10_tm10,g
2996@TOP@human_GAPDH_TAA_len41_fa10_ta10_fm10_tm10*127*a,6599,0,8,0,6607,0.001,127,2996@TOP@human_GAPDH_TAA_len41_fa10_ta10_fm10_tm10,a
2996@TOP@human_GAPDH_TAA_len41_fa10_ta10_fm10_tm10*128*c,0,6670,1,0,6671,0.0,128,2996@TOP@human_GAPDH_TAA_len41_fa10_ta10_fm10_tm10,c
2996@TOP@human_GAPDH_TAA_len41_fa10_ta10_fm10_tm10*129*c,0,6604,0,0,6604,0.0,129,2996@TOP@human_GAPDH_TAA_len41_fa10_ta10_fm10_tm10,c
2996@TOP@human_GAPDH_TAA_len41_fa10_ta10_fm10_tm10*130*c,2,6658,0,0,6660,0.0,130,2996@TOP@human_GAPDH_TAA_len41_fa10_ta10_fm10_tm10,c
2996@TOP@human_GAPDH_TAA_len41_fa10_ta10_fm10_tm10*131*c,0,6672,0,0,6672,0.0,131,2996@TOP@human_GAPDH_TAA_len41_fa10_ta10_fm10_tm10,c
2996@TOP@human_GAPDH_TAA_len41_fa10_ta10_fm10_tm10*132*t,2,1,0,6590,6593,0.0,132,2996@TOP@human_GAPDH_TAA_len41_fa10_ta10_fm10_tm10,t
2996@TOP@human_GAPDH_TAA_len41_fa10_ta10_fm10_tm10*133*g,0,2,6546,1,6549,1.0,133,2996@TOP@human_GAPDH_TAA_len41_fa10_ta10_fm10_tm10,g
2996@TOP@human_GAPDH_TAA_len41_fa10_ta10_fm10_tm10*134*g,0,2,6591,4,6597,0.999,134,2996@TOP@human_GAPDH_TAA_len41_fa10_ta10_fm10_tm10,g
2997@TOP@human_GAPDH_TAA_len41_fa10_ta10_fm10_tm10*114*t,1,2,0,2381,2384,0.0,114,2997@TOP@human_GAPDH_TAA_len41_fa10_ta10_fm10_tm10,t
2997@TOP@human_GAPDH_TAA_len41_fa10_ta10_fm10_tm10*115*c,0,2401,1,0,2402,0.0,115,2997@TOP@human_GAPDH_TAA_len41_fa10_ta10_fm10_tm10,c
2997@TOP@human_GAPDH_TAA_len41_fa10_ta10_fm10_tm10*116*c,0,2396,0,0,2396,0.0,116,2997@TOP@human_GAPDH_TAA_len41_fa10_ta10_fm10_tm10,c
2997@TOP@human_GAPDH_TAA_len41_fa10_ta10_fm10_tm10*117*a,2373,0,17,0,2390,0.007,117,2997@TOP@human_GAPDH_TAA_len41_fa10_ta10_fm10_tm10,a
2997@TOP@human_GAPDH_TAA_len41_fa10_ta10_fm10_tm10*118*a,2156,0,221,2,2379,0.093,118,2997@TOP@human_GAPDH_TAA_len41_fa10_ta10_fm10_tm10,a
2997@TOP@human_GAPDH_TAA_len41_fa10_ta10_fm10_tm10*119*g,0,0,2375,0,2375,1.0,119,2997@TOP@human_GAPDH_TAA_len41_fa10_ta10_fm10_tm10,g
2997@TOP@human_GAPDH_TAA_len41_fa10_ta10_fm10_tm10*120*g,1,0,2364,0,2365,1.0,120,2997@TOP@human_GAPDH_TAA_len41_fa10_ta10_fm10_tm10,g
2997@TOP@human_GAPDH_TAA_len41_fa10_ta10_fm10_tm10*121*a,2386,0,0,0,2386,0.0,121,2997@TOP@human_GAPDH_TAA_len41_fa10_ta10_fm10_tm10,a
2997@TOP@human_GAPDH_TAA_len41_fa10_ta10_fm10_tm10*122*g,0,0,2393,1,2394,1.0,122,2997@TOP@human_GAPDH_TAA_len41_fa10_ta10_fm10_tm10,g
2997@TOP@human_GAPDH_TAA_len41_fa10_ta10_fm10_tm10*123*t,0,0,0,2356,2356,0.0,123,2997@TOP@human_GAPDH_TAA_len41_fa10_ta10_fm10_tm10,t
2997@TOP@human_GAPDH_TAA_len41_fa10_ta10_fm10_tm10*124*a,2078,0,293,0,2371,0.124,124,2997@TOP@human_GAPDH_TAA_len41_fa10_ta10_fm10_tm10,a
2997@TOP@human_GAPDH_TAA_len41_fa10_ta10_fm10_tm10*125*a,2234,0,115,0,2349,0.049,125,2997@TOP@human_GAPDH_TAA_len41_fa10_ta10_fm10_tm10,a
2997@TOP@human_GAPDH_TAA_len41_fa10_ta10_fm10_tm10*126*g,0,0,2353,1,2354,1.0,126,2997@TOP@human_GAPDH_TAA_len41_fa10_ta10_fm10_tm10,g
2997@TOP@human_GAPDH_TAA_len41_fa10_ta10_fm10_tm10*127*a,2386,1,1,0,2388,0.0,127,2997@TOP@human_GAPDH_TAA_len41_fa10_ta10_fm10_tm10,a
2997@TOP@human_GAPDH_TAA_len41_fa10_ta10_fm10_tm10*128*c,0,2387,0,3,2390,0.0,128,2997@TOP@human_GAPDH_TAA_len41_fa10_ta10_fm10_tm10,c
2997@TOP@human_GAPDH_TAA_len41_fa10_ta10_fm10_tm10*129*c,0,2380,0,0,2380,0.0,129,2997@TOP@human_GAPDH_TAA_len41_fa10_ta10_fm10_tm10,c
2997@TOP@human_GAPDH_TAA_len41_fa10_ta10_fm10_tm10*130*c,1,2385,0,0,2386,0.0,130,2997@TOP@human_GAPDH_TAA_len41_fa10_ta10_fm10_tm10,c
2997@TOP@human_GAPDH_TAA_len41_fa10_ta10_fm10_tm10*131*c,1,2398,0,1,2400,0.0,131,2997@TOP@human_GAPDH_TAA_len41_fa10_ta10_fm10_tm10,c
2997@TOP@human_GAPDH_TAA_len41_fa10_ta10_fm10_tm10*132*t,0,0,1,2352,2353,0.0,132,2997@TOP@human_GAPDH_TAA_len41_fa10_ta10_fm10_tm10,t
2997@TOP@human_GAPDH_TAA_len41_fa10_ta10_fm10_tm10*133*g,0,0,2356,0,2356,1.0,133,2997@TOP@human_GAPDH_TAA_len41_fa10_ta10_fm10_tm10,g
2997@TOP@human_GAPDH_TAA_len41_fa10_ta10_fm10_tm10*134*g,0,1,2365,0,2366,1.0,134,2997@TOP@human_GAPDH_TAA_len41_fa10_ta10_fm10_tm10,g
2998@TOP@human_GAPDH_TAA_len41_fa10_ta10_fm10_tm10*114*t,4,7,0,25586,25597,0.0,114,2998@TOP@human_GAPDH_TAA_len41_fa10_ta10_fm10_tm10,t
2998@TOP@human_GAPDH_TAA_len41_fa10_ta10_fm10_tm10*115*c,0,25712,1,4,25717,0.0,115,2998@TOP@human_GAPDH_TAA_len41_fa10_ta10_fm10_tm10,c
2998@TOP@human_GAPDH_TAA_len41_fa10_ta10_fm10_tm10*116*c,1,25611,0,1,25613,0.0,116,2998@TOP@human_GAPDH_TAA_len41_fa10_ta10_fm10_tm10,c
2998@TOP@human_GAPDH_TAA_len41_fa10_ta10_fm10_tm10*117*a,25262,0,346,0,25608,0.014,117,2998@TOP@human_GAPDH_TAA_len41_fa10_ta10_fm10_tm10,a
2998@TOP@human_GAPDH_TAA_len41_fa10_ta10_fm10_tm10*118*a,24919,0,567,1,25487,0.022,118,2998@TOP@human_GAPDH_TAA_len41_fa10_ta10_fm10_tm10,a
2998@TOP@human_GAPDH_TAA_len41_fa10_ta10_fm10_tm10*119*g,0,0,25427,4,25431,1.0,119,2998@TOP@human_GAPDH_TAA_len41_fa10_ta10_fm10_tm10,g
2998@TOP@human_GAPDH_TAA_len41_fa10_ta10_fm10_tm10*120*g,2,0,25326,0,25328,1.0,120,2998@TOP@human_GAPDH_TAA_len41_fa10_ta10_fm10_tm10,g
2998@TOP@human_GAPDH_TAA_len41_fa10_ta10_fm10_tm10*121*a,25591,0,6,0,25597,0.0,121,2998@TOP@human_GAPDH_TAA_len41_fa10_ta10_fm10_tm10,a
2998@TOP@human_GAPDH_TAA_len41_fa10_ta10_fm10_tm10*122*g,3,0,25621,0,25624,1.0,122,2998@TOP@human_GAPDH_TAA_len41_fa10_ta10_fm10_tm10,g
2998@TOP@human_GAPDH_TAA_len41_fa10_ta10_fm10_tm10*123*t,2,0,7,25298,25307,0.0,123,2998@TOP@human_GAPDH_TAA_len41_fa10_ta10_fm10_tm10,t
2998@TOP@human_GAPDH_TAA_len41_fa10_ta10_fm10_tm10*124*a,23461,0,1754,0,25215,0.07,124,2998@TOP@human_GAPDH_TAA_len41_fa10_ta10_fm10_tm10,a
2998@TOP@human_GAPDH_TAA_len41_fa10_ta10_fm10_tm10*125*a,24555,1,602,3,25161,0.024,125,2998@TOP@human_GAPDH_TAA_len41_fa10_ta10_fm10_tm10,a
2998@TOP@human_GAPDH_TAA_len41_fa10_ta10_fm10_tm10*126*g,2,0,25257,2,25261,1.0,126,2998@TOP@human_GAPDH_TAA_len41_fa10_ta10_fm10_tm10,g
2998@TOP@human_GAPDH_TAA_len41_fa10_ta10_fm10_tm10*127*a,25489,5,29,0,25523,0.001,127,2998@TOP@human_GAPDH_TAA_len41_fa10_ta10_fm10_tm10,a
2998@TOP@human_GAPDH_TAA_len41_fa10_ta10_fm10_tm10*128*c,0,25647,2,1,25650,0.0,128,2998@TOP@human_GAPDH_TAA_len41_fa10_ta10_fm10_tm10,c
2998@TOP@human_GAPDH_TAA_len41_fa10_ta10_fm10_tm10*129*c,0,25470,0,0,25470,0.0,129,2998@TOP@human_GAPDH_TAA_len41_fa10_ta10_fm10_tm10,c
2998@TOP@human_GAPDH_TAA_len41_fa10_ta10_fm10_tm10*130*c,0,25613,0,2,25615,0.0,130,2998@TOP@human_GAPDH_TAA_len41_fa10_ta10_fm10_tm10,c
2998@TOP@human_GAPDH_TAA_len41_fa10_ta10_fm10_tm10*131*c,2,25668,0,3,25673,0.0,131,2998@TOP@human_GAPDH_TAA_len41_fa10_ta10_fm10_tm10,c
2998@TOP@human_GAPDH_TAA_len41_fa10_ta10_fm10_tm10*132*t,4,5,0,25304,25313,0.0,132,2998@TOP@human_GAPDH_TAA_len41_fa10_ta10_fm10_tm10,t
2998@TOP@human_GAPDH_TAA_len41_fa10_ta10_fm10_tm10*133*g,2,1,25307,0,25310,1.0,133,2998@TOP@human_GAPDH_TAA_len41_fa10_ta10_fm10_tm10,g
2998@TOP@human_GAPDH_TAA_len41_fa10_ta10_fm10_tm10*134*g,2,5,25380,1,25388,1.0,134,2998@TOP@human_GAPDH_TAA_len41_fa10_ta10_fm10_tm10,g
2999@TOP@human_GAPDH_TAA_len41_fa10_ta10_fm10_tm10*114*t,0,1,0,1790,1791,0.0,114,2999@TOP@human_GAPDH_TAA_len41_fa10_ta10_fm10_tm10,t
2999@TOP@human_GAPDH_TAA_len41_fa10_ta10_fm10_tm10*115*c,0,1802,0,0,1802,0.0,115,2999@TOP@human_GAPDH_TAA_len41_fa10_ta10_fm10_tm10,c
2999@TOP@human_GAPDH_TAA_len41_fa10_ta10_fm10_tm10*116*c,0,1795,0,0,1795,0.0,116,2999@TOP@human_GAPDH_TAA_len41_fa10_ta10_fm10_tm10,c
2999@TOP@human_GAPDH_TAA_len41_fa10_ta10_fm10_tm10*117*a,1774,0,24,0,1798,0.013,117,2999@TOP@human_GAPDH_TAA_len41_fa10_ta10_fm10_tm10,a
2999@TOP@human_GAPDH_TAA_len41_fa10_ta10_fm10_tm10*118*a,1547,0,226,0,1773,0.127,118,2999@TOP@human_GAPDH_TAA_len41_fa10_ta10_fm10_tm10,a
2999@TOP@human_GAPDH_TAA_len41_fa10_ta10_fm10_tm10*119*g,0,0,1781,0,1781,1.0,119,2999@TOP@human_GAPDH_TAA_len41_fa10_ta10_fm10_tm10,g
2999@TOP@human_GAPDH_TAA_len41_fa10_ta10_fm10_tm10*120*g,1,0,1762,0,1763,0.999,120,2999@TOP@human_GAPDH_TAA_len41_fa10_ta10_fm10_tm10,g
2999@TOP@human_GAPDH_TAA_len41_fa10_ta10_fm10_tm10*121*a,1773,0,9,0,1782,0.005,121,2999@TOP@human_GAPDH_TAA_len41_fa10_ta10_fm10_tm10,a
2999@TOP@human_GAPDH_TAA_len41_fa10_ta10_fm10_tm10*122*g,0,0,1786,0,1786,1.0,122,2999@TOP@human_GAPDH_TAA_len41_fa10_ta10_fm10_tm10,g
2999@TOP@human_GAPDH_TAA_len41_fa10_ta10_fm10_tm10*123*t,0,0,0,1748,1748,0.0,123,2999@TOP@human_GAPDH_TAA_len41_fa10_ta10_fm10_tm10,t
2999@TOP@human_GAPDH_TAA_len41_fa10_ta10_fm10_tm10*124*a,1484,0,286,0,1770,0.162,124,2999@TOP@human_GAPDH_TAA_len41_fa10_ta10_fm10_tm10,a
2999@TOP@human_GAPDH_TAA_len41_fa10_ta10_fm10_tm10*125*a,1565,0,195,0,1760,0.111,125,2999@TOP@human_GAPDH_TAA_len41_fa10_ta10_fm10_tm10,a
2999@TOP@human_GAPDH_TAA_len41_fa10_ta10_fm10_tm10*126*g,0,0,1774,0,1774,1.0,126,2999@TOP@human_GAPDH_TAA_len41_fa10_ta10_fm10_tm10,g
2999@TOP@human_GAPDH_TAA_len41_fa10_ta10_fm10_tm10*127*a,1784,0,3,0,1787,0.002,127,2999@TOP@human_GAPDH_TAA_len41_fa10_ta10_fm10_tm10,a
2999@TOP@human_GAPDH_TAA_len41_fa10_ta10_fm10_tm10*128*c,0,1797,0,0,1797,0.0,128,2999@TOP@human_GAPDH_TAA_len41_fa10_ta10_fm10_tm10,c
2999@TOP@human_GAPDH_TAA_len41_fa10_ta10_fm10_tm10*129*c,0,1790,0,0,1790,0.0,129,2999@TOP@human_GAPDH_TAA_len41_fa10_ta10_fm10_tm10,c
2999@TOP@human_GAPDH_TAA_len41_fa10_ta10_fm10_tm10*130*c,0,1794,0,0,1794,0.0,130,2999@TOP@human_GAPDH_TAA_len41_fa10_ta10_fm10_tm10,c
2999@TOP@human_GAPDH_TAA_len41_fa10_ta10_fm10_tm10*131*c,0,1801,0,1,1802,0.0,131,2999@TOP@human_GAPDH_TAA_len41_fa10_ta10_fm10_tm10,c
2999@TOP@human_GAPDH_TAA_len41_fa10_ta10_fm10_tm10*132*t,1,0,0,1770,1771,0.0,132,2999@TOP@human_GAPDH_TAA_len41_fa10_ta10_fm10_tm10,t
2999@TOP@human_GAPDH_TAA_len41_fa10_ta10_fm10_tm10*133*g,0,0,1767,0,1767,1.0,133,2999@TOP@human_GAPDH_TAA_len41_fa10_ta10_fm10_tm10,g
2999@TOP@human_GAPDH_TAA_len41_fa10_ta10_fm10_tm10*134*g,0,0,1770,5,1775,0.997,134,2999@TOP@human_GAPDH_TAA_len41_fa10_ta10_fm10_tm10,g
3000@TOP@human_GAPDH_TAA_len41_fa10_ta10_fm10_tm10*114*t,0,0,0,2327,2327,0.0,114,3000@TOP@human_GAPDH_TAA_len41_fa10_ta10_fm10_tm10,t
3000@TOP@human_GAPDH_TAA_len41_fa10_ta10_fm10_tm10*115*c,0,2343,0,0,2343,0.0,115,3000@TOP@human_GAPDH_TAA_len41_fa10_ta10_fm10_tm10,c
3000@TOP@human_GAPDH_TAA_len41_fa10_ta10_fm10_tm10*116*c,0,2328,0,0,2328,0.0,116,3000@TOP@human_GAPDH_TAA_len41_fa10_ta10_fm10_tm10,c
3000@TOP@human_GAPDH_TAA_len41_fa10_ta10_fm10_tm10*117*a,2014,0,316,0,2330,0.136,117,3000@TOP@human_GAPDH_TAA_len41_fa10_ta10_fm10_tm10,a
3000@TOP@human_GAPDH_TAA_len41_fa10_ta10_fm10_tm10*118*a,1308,0,1008,0,2316,0.435,118,3000@TOP@human_GAPDH_TAA_len41_fa10_ta10_fm10_tm10,a
3000@TOP@human_GAPDH_TAA_len41_fa10_ta10_fm10_tm10*119*g,0,0,2314,0,2314,1.0,119,3000@TOP@human_GAPDH_TAA_len41_fa10_ta10_fm10_tm10,g
3000@TOP@human_GAPDH_TAA_len41_fa10_ta10_fm10_tm10*120*g,0,0,2317,0,2317,1.0,120,3000@TOP@human_GAPDH_TAA_len41_fa10_ta10_fm10_tm10,g
3000@TOP@human_GAPDH_TAA_len41_fa10_ta10_fm10_tm10*121*a,2312,0,3,0,2315,0.001,121,3000@TOP@human_GAPDH_TAA_len41_fa10_ta10_fm10_tm10,a
3000@TOP@human_GAPDH_TAA_len41_fa10_ta10_fm10_tm10*122*g,0,0,2331,0,2331,1.0,122,3000@TOP@human_GAPDH_TAA_len41_fa10_ta10_fm10_tm10,g
3000@TOP@human_GAPDH_TAA_len41_fa10_ta10_fm10_tm10*123*t,0,2,1,2302,2305,0.0,123,3000@TOP@human_GAPDH_TAA_len41_fa10_ta10_fm10_tm10,t
3000@TOP@human_GAPDH_TAA_len41_fa10_ta10_fm10_tm10*124*a,1542,0,752,1,2295,0.328,124,3000@TOP@human_GAPDH_TAA_len41_fa10_ta10_fm10_tm10,a
3000@TOP@human_GAPDH_TAA_len41_fa10_ta10_fm10_tm10*125*a,1464,0,829,1,2294,0.361,125,3000@TOP@human_GAPDH_TAA_len41_fa10_ta10_fm10_tm10,a
3000@TOP@human_GAPDH_TAA_len41_fa10_ta10_fm10_tm10*126*g,0,0,2313,0,2313,1.0,126,3000@TOP@human_GAPDH_TAA_len41_fa10_ta10_fm10_tm10,g
3000@TOP@human_GAPDH_TAA_len41_fa10_ta10_fm10_tm10*127*a,2324,0,4,2,2330,0.002,127,3000@TOP@human_GAPDH_TAA_len41_fa10_ta10_fm10_tm10,a
3000@TOP@human_GAPDH_TAA_len41_fa10_ta10_fm10_tm10*128*c,0,2336,0,1,2337,0.0,128,3000@TOP@human_GAPDH_TAA_len41_fa10_ta10_fm10_tm10,c
3000@TOP@human_GAPDH_TAA_len41_fa10_ta10_fm10_tm10*129*c,0,2324,0,0,2324,0.0,129,3000@TOP@human_GAPDH_TAA_len41_fa10_ta10_fm10_tm10,c
3000@TOP@human_GAPDH_TAA_len41_fa10_ta10_fm10_tm10*130*c,0,2328,0,0,2328,0.0,130,3000@TOP@human_GAPDH_TAA_len41_fa10_ta10_fm10_tm10,c
3000@TOP@human_GAPDH_TAA_len41_fa10_ta10_fm10_tm10*131*c,0,2341,0,0,2341,0.0,131,3000@TOP@human_GAPDH_TAA_len41_fa10_ta10_fm10_tm10,c
3000@TOP@human_GAPDH_TAA_len41_fa10_ta10_fm10_tm10*132*t,0,1,1,2314,2316,0.0,132,3000@TOP@human_GAPDH_TAA_len41_fa10_ta10_fm10_tm10,t
3000@TOP@human_GAPDH_TAA_len41_fa10_ta10_fm10_tm10*133*g,0,0,2299,0,2299,1.0,133,3000@TOP@human_GAPDH_TAA_len41_fa10_ta10_fm10_tm10,g
3000@TOP@human_GAPDH_TAA_len41_fa10_ta10_fm10_tm10*134*g,0,0,2317,0,2317,1.0,134,3000@TOP@human_GAPDH_TAA_len41_fa10_ta10_fm10_tm10,g
3001@TOP@human_GAPDH_TAA_len41_fa10_ta10_fm10_tm10*114*t,0,3,0,7504,7507,0.0,114,3001@TOP@human_GAPDH_TAA_len41_fa10_ta10_fm10_tm10,t
3001@TOP@human_GAPDH_TAA_len41_fa10_ta10_fm10_tm10*115*c,0,7554,0,0,7554,0.0,115,3001@TOP@human_GAPDH_TAA_len41_fa10_ta10_fm10_tm10,c
3001@TOP@human_GAPDH_TAA_len41_fa10_ta10_fm10_tm10*116*c,0,7524,0,1,7525,0.0,116,3001@TOP@human_GAPDH_TAA_len41_fa10_ta10_fm10_tm10,c
3001@TOP@human_GAPDH_TAA_len41_fa10_ta10_fm10_tm10*117*a,7068,0,449,0,7517,0.06,117,3001@TOP@human_GAPDH_TAA_len41_fa10_ta10_fm10_tm10,a
3001@TOP@human_GAPDH_TAA_len41_fa10_ta10_fm10_tm10*118*a,5586,0,1879,0,7465,0.252,118,3001@TOP@human_GAPDH_TAA_len41_fa10_ta10_fm10_tm10,a
3001@TOP@human_GAPDH_TAA_len41_fa10_ta10_fm10_tm10*119*g,3,0,7458,0,7461,1.0,119,3001@TOP@human_GAPDH_TAA_len41_fa10_ta10_fm10_tm10,g
3001@TOP@human_GAPDH_TAA_len41_fa10_ta10_fm10_tm10*120*g,0,0,7450,0,7450,1.0,120,3001@TOP@human_GAPDH_TAA_len41_fa10_ta10_fm10_tm10,g
3001@TOP@human_GAPDH_TAA_len41_fa10_ta10_fm10_tm10*121*a,7497,0,1,0,7498,0.0,121,3001@TOP@human_GAPDH_TAA_len41_fa10_ta10_fm10_tm10,a
3001@TOP@human_GAPDH_TAA_len41_fa10_ta10_fm10_tm10*122*g,0,0,7516,0,7516,1.0,122,3001@TOP@human_GAPDH_TAA_len41_fa10_ta10_fm10_tm10,g
3001@TOP@human_GAPDH_TAA_len41_fa10_ta10_fm10_tm10*123*t,0,1,1,7422,7424,0.0,123,3001@TOP@human_GAPDH_TAA_len41_fa10_ta10_fm10_tm10,t
3001@TOP@human_GAPDH_TAA_len41_fa10_ta10_fm10_tm10*124*a,5498,0,1928,0,7426,0.26,124,3001@TOP@human_GAPDH_TAA_len41_fa10_ta10_fm10_tm10,a
3001@TOP@human_GAPDH_TAA_len41_fa10_ta10_fm10_tm10*125*a,6450,0,934,0,7384,0.126,125,3001@TOP@human_GAPDH_TAA_len41_fa10_ta10_fm10_tm10,a
3001@TOP@human_GAPDH_TAA_len41_fa10_ta10_fm10_tm10*126*g,2,0,7416,0,7418,1.0,126,3001@TOP@human_GAPDH_TAA_len41_fa10_ta10_fm10_tm10,g
3001@TOP@human_GAPDH_TAA_len41_fa10_ta10_fm10_tm10*127*a,7475,0,19,0,7494,0.003,127,3001@TOP@human_GAPDH_TAA_len41_fa10_ta10_fm10_tm10,a
3001@TOP@human_GAPDH_TAA_len41_fa10_ta10_fm10_tm10*128*c,1,7530,2,0,7533,0.0,128,3001@TOP@human_GAPDH_TAA_len41_fa10_ta10_fm10_tm10,c
3001@TOP@human_GAPDH_TAA_len41_fa10_ta10_fm10_tm10*129*c,0,7492,0,0,7492,0.0,129,3001@TOP@human_GAPDH_TAA_len41_fa10_ta10_fm10_tm10,c
3001@TOP@human_GAPDH_TAA_len41_fa10_ta10_fm10_tm10*130*c,0,7528,0,0,7528,0.0,130,3001@TOP@human_GAPDH_TAA_len41_fa10_ta10_fm10_tm10,c
3001@TOP@human_GAPDH_TAA_len41_fa10_ta10_fm10_tm10*131*c,1,7536,0,3,7540,0.0,131,3001@TOP@human_GAPDH_TAA_len41_fa10_ta10_fm10_tm10,c
3001@TOP@human_GAPDH_TAA_len41_fa10_ta10_fm10_tm10*132*t,0,0,1,7461,7462,0.0,132,3001@TOP@human_GAPDH_TAA_len41_fa10_ta10_fm10_tm10,t
3001@TOP@human_GAPDH_TAA_len41_fa10_ta10_fm10_tm10*133*g,2,0,7447,0,7449,1.0,133,3001@TOP@human_GAPDH_TAA_len41_fa10_ta10_fm10_tm10,g
3001@TOP@human_GAPDH_TAA_len41_fa10_ta10_fm10_tm10*134*g,1,1,7452,0,7454,1.0,134,3001@TOP@human_GAPDH_TAA_len41_fa10_ta10_fm10_tm10,g
3002@TOP@human_GAPDH_TAA_len41_fa10_ta10_fm10_tm10*114*t,0,0,0,1690,1690,0.0,114,3002@TOP@human_GAPDH_TAA_len41_fa10_ta10_fm10_tm10,t
3002@TOP@human_GAPDH_TAA_len41_fa10_ta10_fm10_tm10*115*c,0,1696,0,0,1696,0.0,115,3002@TOP@human_GAPDH_TAA_len41_fa10_ta10_fm10_tm10,c
3002@TOP@human_GAPDH_TAA_len41_fa10_ta10_fm10_tm10*116*c,0,1689,0,0,1689,0.0,116,3002@TOP@human_GAPDH_TAA_len41_fa10_ta10_fm10_tm10,c
3002@TOP@human_GAPDH_TAA_len41_fa10_ta10_fm10_tm10*117*a,1689,0,4,0,1693,0.002,117,3002@TOP@human_GAPDH_TAA_len41_fa10_ta10_fm10_tm10,a
3002@TOP@human_GAPDH_TAA_len41_fa10_ta10_fm10_tm10*118*a,1567,0,114,0,1681,0.068,118,3002@TOP@human_GAPDH_TAA_len41_fa10_ta10_fm10_tm10,a
3002@TOP@human_GAPDH_TAA_len41_fa10_ta10_fm10_tm10*119*g,0,0,1677,0,1677,1.0,119,3002@TOP@human_GAPDH_TAA_len41_fa10_ta10_fm10_tm10,g
3002@TOP@human_GAPDH_TAA_len41_fa10_ta10_fm10_tm10*120*g,0,0,1671,0,1671,1.0,120,3002@TOP@human_GAPDH_TAA_len41_fa10_ta10_fm10_tm10,g
3002@TOP@human_GAPDH_TAA_len41_fa10_ta10_fm10_tm10*121*a,1689,0,2,0,1691,0.001,121,3002@TOP@human_GAPDH_TAA_len41_fa10_ta10_fm10_tm10,a
3002@TOP@human_GAPDH_TAA_len41_fa10_ta10_fm10_tm10*122*g,0,0,1683,0,1683,1.0,122,3002@TOP@human_GAPDH_TAA_len41_fa10_ta10_fm10_tm10,g
3002@TOP@human_GAPDH_TAA_len41_fa10_ta10_fm10_tm10*123*t,0,0,0,1677,1677,0.0,123,3002@TOP@human_GAPDH_TAA_len41_fa10_ta10_fm10_tm10,t
3002@TOP@human_GAPDH_TAA_len41_fa10_ta10_fm10_tm10*124*a,1348,0,325,0,1673,0.194,124,3002@TOP@human_GAPDH_TAA_len41_fa10_ta10_fm10_tm10,a
3002@TOP@human_GAPDH_TAA_len41_fa10_ta10_fm10_tm10*125*a,1490,0,168,1,1659,0.101,125,3002@TOP@human_GAPDH_TAA_len41_fa10_ta10_fm10_tm10,a
3002@TOP@human_GAPDH_TAA_len41_fa10_ta10_fm10_tm10*126*g,0,0,1669,0,1669,1.0,126,3002@TOP@human_GAPDH_TAA_len41_fa10_ta10_fm10_tm10,g
3002@TOP@human_GAPDH_TAA_len41_fa10_ta10_fm10_tm10*127*a,1676,0,7,0,1683,0.004,127,3002@TOP@human_GAPDH_TAA_len41_fa10_ta10_fm10_tm10,a
3002@TOP@human_GAPDH_TAA_len41_fa10_ta10_fm10_tm10*128*c,0,1691,0,0,1691,0.0,128,3002@TOP@human_GAPDH_TAA_len41_fa10_ta10_fm10_tm10,c
3002@TOP@human_GAPDH_TAA_len41_fa10_ta10_fm10_tm10*129*c,0,1679,0,0,1679,0.0,129,3002@TOP@human_GAPDH_TAA_len41_fa10_ta10_fm10_tm10,c
3002@TOP@human_GAPDH_TAA_len41_fa10_ta10_fm10_tm10*130*c,0,1686,0,0,1686,0.0,130,3002@TOP@human_GAPDH_TAA_len41_fa10_ta10_fm10_tm10,c
3002@TOP@human_GAPDH_TAA_len41_fa10_ta10_fm10_tm10*131*c,0,1696,0,0,1696,0.0,131,3002@TOP@human_GAPDH_TAA_len41_fa10_ta10_fm10_tm10,c
3002@TOP@human_GAPDH_TAA_len41_fa10_ta10_fm10_tm10*132*t,0,1,0,1668,1669,0.0,132,3002@TOP@human_GAPDH_TAA_len41_fa10_ta10_fm10_tm10,t
3002@TOP@human_GAPDH_TAA_len41_fa10_ta10_fm10_tm10*133*g,0,0,1675,0,1675,1.0,133,3002@TOP@human_GAPDH_TAA_len41_fa10_ta10_fm10_tm10,g
3002@TOP@human_GAPDH_TAA_len41_fa10_ta10_fm10_tm10*134*g,0,0,1673,0,1673,1.0,134,3002@TOP@human_GAPDH_TAA_len41_fa10_ta10_fm10_tm10,g
3003@TOP@human_GAPDH_TAA_len41_fa10_ta10_fm10_tm10*114*t,0,1,0,3447,3448,0.0,114,3003@TOP@human_GAPDH_TAA_len41_fa10_ta10_fm10_tm10,t
3003@TOP@human_GAPDH_TAA_len41_fa10_ta10_fm10_tm10*115*c,0,3466,0,0,3466,0.0,115,3003@TOP@human_GAPDH_TAA_len41_fa10_ta10_fm10_tm10,c
3003@TOP@human_GAPDH_TAA_len41_fa10_ta10_fm10_tm10*116*c,0,3457,0,0,3457,0.0,116,3003@TOP@human_GAPDH_TAA_len41_fa10_ta10_fm10_tm10,c
3003@TOP@human_GAPDH_TAA_len41_fa10_ta10_fm10_tm10*117*a,3430,0,15,0,3445,0.004,117,3003@TOP@human_GAPDH_TAA_len41_fa10_ta10_fm10_tm10,a
3003@TOP@human_GAPDH_TAA_len41_fa10_ta10_fm10_tm10*118*a,3205,1,227,0,3433,0.066,118,3003@TOP@human_GAPDH_TAA_len41_fa10_ta10_fm10_tm10,a
3003@TOP@human_GAPDH_TAA_len41_fa10_ta10_fm10_tm10*119*g,3,0,3415,0,3418,0.999,119,3003@TOP@human_GAPDH_TAA_len41_fa10_ta10_fm10_tm10,g
3003@TOP@human_GAPDH_TAA_len41_fa10_ta10_fm10_tm10*120*g,0,0,3408,0,3408,1.0,120,3003@TOP@human_GAPDH_TAA_len41_fa10_ta10_fm10_tm10,g
3003@TOP@human_GAPDH_TAA_len41_fa10_ta10_fm10_tm10*121*a,3454,0,0,0,3454,0.0,121,3003@TOP@human_GAPDH_TAA_len41_fa10_ta10_fm10_tm10,a
3003@TOP@human_GAPDH_TAA_len41_fa10_ta10_fm10_tm10*122*g,0,0,3461,0,3461,1.0,122,3003@TOP@human_GAPDH_TAA_len41_fa10_ta10_fm10_tm10,g
3003@TOP@human_GAPDH_TAA_len41_fa10_ta10_fm10_tm10*123*t,0,0,0,3412,3412,0.0,123,3003@TOP@human_GAPDH_TAA_len41_fa10_ta10_fm10_tm10,t
3003@TOP@human_GAPDH_TAA_len41_fa10_ta10_fm10_tm10*124*a,2996,0,394,0,3390,0.116,124,3003@TOP@human_GAPDH_TAA_len41_fa10_ta10_fm10_tm10,a
3003@TOP@human_GAPDH_TAA_len41_fa10_ta10_fm10_tm10*125*a,3207,0,173,0,3380,0.051,125,3003@TOP@human_GAPDH_TAA_len41_fa10_ta10_fm10_tm10,a
3003@TOP@human_GAPDH_TAA_len41_fa10_ta10_fm10_tm10*126*g,0,0,3396,1,3397,1.0,126,3003@TOP@human_GAPDH_TAA_len41_fa10_ta10_fm10_tm10,g
3003@TOP@human_GAPDH_TAA_len41_fa10_ta10_fm10_tm10*127*a,3447,0,0,0,3447,0.0,127,3003@TOP@human_GAPDH_TAA_len41_fa10_ta10_fm10_tm10,a
3003@TOP@human_GAPDH_TAA_len41_fa10_ta10_fm10_tm10*128*c,0,3461,2,2,3465,0.001,128,3003@TOP@human_GAPDH_TAA_len41_fa10_ta10_fm10_tm10,c
3003@TOP@human_GAPDH_TAA_len41_fa10_ta10_fm10_tm10*129*c,0,3440,0,5,3445,0.0,129,3003@TOP@human_GAPDH_TAA_len41_fa10_ta10_fm10_tm10,c
3003@TOP@human_GAPDH_TAA_len41_fa10_ta10_fm10_tm10*130*c,0,3448,0,0,3448,0.0,130,3003@TOP@human_GAPDH_TAA_len41_fa10_ta10_fm10_tm10,c
3003@TOP@human_GAPDH_TAA_len41_fa10_ta10_fm10_tm10*131*c,2,3457,0,0,3459,0.0,131,3003@TOP@human_GAPDH_TAA_len41_fa10_ta10_fm10_tm10,c
3003@TOP@human_GAPDH_TAA_len41_fa10_ta10_fm10_tm10*132*t,0,0,0,3405,3405,0.0,132,3003@TOP@human_GAPDH_TAA_len41_fa10_ta10_fm10_tm10,t
3003@TOP@human_GAPDH_TAA_len41_fa10_ta10_fm10_tm10*133*g,0,0,3412,0,3412,1.0,133,3003@TOP@human_GAPDH_TAA_len41_fa10_ta10_fm10_tm10,g
3003@TOP@human_GAPDH_TAA_len41_fa10_ta10_fm10_tm10*134*g,0,0,3437,0,3437,1.0,134,3003@TOP@human_GAPDH_TAA_len41_fa10_ta10_fm10_tm10,g
3004@TOP@human_GAPDH_TAA_len41_fa10_ta10_fm10_tm10*114*t,0,0,0,3382,3382,0.0,114,3004@TOP@human_GAPDH_TAA_len41_fa10_ta10_fm10_tm10,t
3004@TOP@human_GAPDH_TAA_len41_fa10_ta10_fm10_tm10*115*c,0,3403,0,0,3403,0.0,115,3004@TOP@human_GAPDH_TAA_len41_fa10_ta10_fm10_tm10,c
3004@TOP@human_GAPDH_TAA_len41_fa10_ta10_fm10_tm10*116*c,0,3385,0,0,3385,0.0,116,3004@TOP@human_GAPDH_TAA_len41_fa10_ta10_fm10_tm10,c
3004@TOP@human_GAPDH_TAA_len41_fa10_ta10_fm10_tm10*117*a,3325,0,60,0,3385,0.018,117,3004@TOP@human_GAPDH_TAA_len41_fa10_ta10_fm10_tm10,a
3004@TOP@human_GAPDH_TAA_len41_fa10_ta10_fm10_tm10*118*a,2263,0,1103,0,3366,0.328,118,3004@TOP@human_GAPDH_TAA_len41_fa10_ta10_fm10_tm10,a
3004@TOP@human_GAPDH_TAA_len41_fa10_ta10_fm10_tm10*119*g,3,0,3354,0,3357,0.999,119,3004@TOP@human_GAPDH_TAA_len41_fa10_ta10_fm10_tm10,g
3004@TOP@human_GAPDH_TAA_len41_fa10_ta10_fm10_tm10*120*g,0,0,3348,0,3348,1.0,120,3004@TOP@human_GAPDH_TAA_len41_fa10_ta10_fm10_tm10,g
3004@TOP@human_GAPDH_TAA_len41_fa10_ta10_fm10_tm10*121*a,3378,0,2,0,3380,0.001,121,3004@TOP@human_GAPDH_TAA_len41_fa10_ta10_fm10_tm10,a
3004@TOP@human_GAPDH_TAA_len41_fa10_ta10_fm10_tm10*122*g,0,0,3383,0,3383,1.0,122,3004@TOP@human_GAPDH_TAA_len41_fa10_ta10_fm10_tm10,g
3004@TOP@human_GAPDH_TAA_len41_fa10_ta10_fm10_tm10*123*t,1,1,1,3334,3337,0.0,123,3004@TOP@human_GAPDH_TAA_len41_fa10_ta10_fm10_tm10,t
3004@TOP@human_GAPDH_TAA_len41_fa10_ta10_fm10_tm10*124*a,3092,0,247,0,3339,0.074,124,3004@TOP@human_GAPDH_TAA_len41_fa10_ta10_fm10_tm10,a
3004@TOP@human_GAPDH_TAA_len41_fa10_ta10_fm10_tm10*125*a,3223,0,110,0,3333,0.033,125,3004@TOP@human_GAPDH_TAA_len41_fa10_ta10_fm10_tm10,a
3004@TOP@human_GAPDH_TAA_len41_fa10_ta10_fm10_tm10*126*g,0,0,3334,0,3334,1.0,126,3004@TOP@human_GAPDH_TAA_len41_fa10_ta10_fm10_tm10,g
3004@TOP@human_GAPDH_TAA_len41_fa10_ta10_fm10_tm10*127*a,3363,0,4,0,3367,0.001,127,3004@TOP@human_GAPDH_TAA_len41_fa10_ta10_fm10_tm10,a
3004@TOP@human_GAPDH_TAA_len41_fa10_ta10_fm10_tm10*128*c,0,3396,0,0,3396,0.0,128,3004@TOP@human_GAPDH_TAA_len41_fa10_ta10_fm10_tm10,c
3004@TOP@human_GAPDH_TAA_len41_fa10_ta10_fm10_tm10*129*c,0,3364,0,0,3364,0.0,129,3004@TOP@human_GAPDH_TAA_len41_fa10_ta10_fm10_tm10,c
3004@TOP@human_GAPDH_TAA_len41_fa10_ta10_fm10_tm10*130*c,0,3390,0,0,3390,0.0,130,3004@TOP@human_GAPDH_TAA_len41_fa10_ta10_fm10_tm10,c
3004@TOP@human_GAPDH_TAA_len41_fa10_ta10_fm10_tm10*131*c,0,3394,0,0,3394,0.0,131,3004@TOP@human_GAPDH_TAA_len41_fa10_ta10_fm10_tm10,c
3004@TOP@human_GAPDH_TAA_len41_fa10_ta10_fm10_tm10*132*t,1,0,1,3345,3347,0.0,132,3004@TOP@human_GAPDH_TAA_len41_fa10_ta10_fm10_tm10,t
3004@TOP@human_GAPDH_TAA_len41_fa10_ta10_fm10_tm10*133*g,0,0,3342,0,3342,1.0,133,3004@TOP@human_GAPDH_TAA_len41_fa10_ta10_fm10_tm10,g
3004@TOP@human_GAPDH_TAA_len41_fa10_ta10_fm10_tm10*134*g,0,3,3346,0,3349,0.999,134,3004@TOP@human_GAPDH_TAA_len41_fa10_ta10_fm10_tm10,g
3005@TOP@human_GAPDH_TAA_len41_fa10_ta10_fm10_tm10*114*t,0,2,0,4943,4945,0.0,114,3005@TOP@human_GAPDH_TAA_len41_fa10_ta10_fm10_tm10,t
3005@TOP@human_GAPDH_TAA_len41_fa10_ta10_fm10_tm10*115*c,0,4972,0,0,4972,0.0,115,3005@TOP@human_GAPDH_TAA_len41_fa10_ta10_fm10_tm10,c
3005@TOP@human_GAPDH_TAA_len41_fa10_ta10_fm10_tm10*116*c,0,4961,0,0,4961,0.0,116,3005@TOP@human_GAPDH_TAA_len41_fa10_ta10_fm10_tm10,c
3005@TOP@human_GAPDH_TAA_len41_fa10_ta10_fm10_tm10*117*a,4733,0,213,1,4947,0.043,117,3005@TOP@human_GAPDH_TAA_len41_fa10_ta10_fm10_tm10,a
3005@TOP@human_GAPDH_TAA_len41_fa10_ta10_fm10_tm10*118*a,3631,1,1288,0,4920,0.262,118,3005@TOP@human_GAPDH_TAA_len41_fa10_ta10_fm10_tm10,a
3005@TOP@human_GAPDH_TAA_len41_fa10_ta10_fm10_tm10*119*g,0,0,4910,0,4910,1.0,119,3005@TOP@human_GAPDH_TAA_len41_fa10_ta10_fm10_tm10,g
3005@TOP@human_GAPDH_TAA_len41_fa10_ta10_fm10_tm10*120*g,0,0,4904,0,4904,1.0,120,3005@TOP@human_GAPDH_TAA_len41_fa10_ta10_fm10_tm10,g
3005@TOP@human_GAPDH_TAA_len41_fa10_ta10_fm10_tm10*121*a,4913,1,15,0,4929,0.003,121,3005@TOP@human_GAPDH_TAA_len41_fa10_ta10_fm10_tm10,a
3005@TOP@human_GAPDH_TAA_len41_fa10_ta10_fm10_tm10*122*g,0,1,4953,0,4954,1.0,122,3005@TOP@human_GAPDH_TAA_len41_fa10_ta10_fm10_tm10,g
3005@TOP@human_GAPDH_TAA_len41_fa10_ta10_fm10_tm10*123*t,1,1,0,4896,4898,0.0,123,3005@TOP@human_GAPDH_TAA_len41_fa10_ta10_fm10_tm10,t
3005@TOP@human_GAPDH_TAA_len41_fa10_ta10_fm10_tm10*124*a,3469,0,1441,1,4911,0.293,124,3005@TOP@human_GAPDH_TAA_len41_fa10_ta10_fm10_tm10,a
3005@TOP@human_GAPDH_TAA_len41_fa10_ta10_fm10_tm10*125*a,4594,0,301,0,4895,0.061,125,3005@TOP@human_GAPDH_TAA_len41_fa10_ta10_fm10_tm10,a
3005@TOP@human_GAPDH_TAA_len41_fa10_ta10_fm10_tm10*126*g,0,2,4898,0,4900,1.0,126,3005@TOP@human_GAPDH_TAA_len41_fa10_ta10_fm10_tm10,g
3005@TOP@human_GAPDH_TAA_len41_fa10_ta10_fm10_tm10*127*a,4923,0,5,0,4928,0.001,127,3005@TOP@human_GAPDH_TAA_len41_fa10_ta10_fm10_tm10,a
3005@TOP@human_GAPDH_TAA_len41_fa10_ta10_fm10_tm10*128*c,1,4958,0,0,4959,0.0,128,3005@TOP@human_GAPDH_TAA_len41_fa10_ta10_fm10_tm10,c
3005@TOP@human_GAPDH_TAA_len41_fa10_ta10_fm10_tm10*129*c,0,4926,0,0,4926,0.0,129,3005@TOP@human_GAPDH_TAA_len41_fa10_ta10_fm10_tm10,c
3005@TOP@human_GAPDH_TAA_len41_fa10_ta10_fm10_tm10*130*c,1,4951,0,0,4952,0.0,130,3005@TOP@human_GAPDH_TAA_len41_fa10_ta10_fm10_tm10,c
3005@TOP@human_GAPDH_TAA_len41_fa10_ta10_fm10_tm10*131*c,0,4962,0,0,4962,0.0,131,3005@TOP@human_GAPDH_TAA_len41_fa10_ta10_fm10_tm10,c
3005@TOP@human_GAPDH_TAA_len41_fa10_ta10_fm10_tm10*132*t,1,1,0,4889,4891,0.0,132,3005@TOP@human_GAPDH_TAA_len41_fa10_ta10_fm10_tm10,t
3005@TOP@human_GAPDH_TAA_len41_fa10_ta10_fm10_tm10*133*g,0,1,4891,0,4892,1.0,133,3005@TOP@human_GAPDH_TAA_len41_fa10_ta10_fm10_tm10,g
3005@TOP@human_GAPDH_TAA_len41_fa10_ta10_fm10_tm10*134*g,0,1,4896,0,4897,1.0,134,3005@TOP@human_GAPDH_TAA_len41_fa10_ta10_fm10_tm10,g
3006@TOP@human_GAPDH_TAA_len41_fa10_ta10_fm10_tm10*114*t,0,0,0,1908,1908,0.0,114,3006@TOP@human_GAPDH_TAA_len41_fa10_ta10_fm10_tm10,t
3006@TOP@human_GAPDH_TAA_len41_fa10_ta10_fm10_tm10*115*c,0,1917,0,0,1917,0.0,115,3006@TOP@human_GAPDH_TAA_len41_fa10_ta10_fm10_tm10,c
3006@TOP@human_GAPDH_TAA_len41_fa10_ta10_fm10_tm10*116*c,0,1905,0,0,1905,0.0,116,3006@TOP@human_GAPDH_TAA_len41_fa10_ta10_fm10_tm10,c
3006@TOP@human_GAPDH_TAA_len41_fa10_ta10_fm10_tm10*117*a,1868,1,28,1,1898,0.015,117,3006@TOP@human_GAPDH_TAA_len41_fa10_ta10_fm10_tm10,a
3006@TOP@human_GAPDH_TAA_len41_fa10_ta10_fm10_tm10*118*a,1340,0,554,0,1894,0.293,118,3006@TOP@human_GAPDH_TAA_len41_fa10_ta10_fm10_tm10,a
3006@TOP@human_GAPDH_TAA_len41_fa10_ta10_fm10_tm10*119*g,0,0,1901,0,1901,1.0,119,3006@TOP@human_GAPDH_TAA_len41_fa10_ta10_fm10_tm10,g
3006@TOP@human_GAPDH_TAA_len41_fa10_ta10_fm10_tm10*120*g,0,0,1876,0,1876,1.0,120,3006@TOP@human_GAPDH_TAA_len41_fa10_ta10_fm10_tm10,g
3006@TOP@human_GAPDH_TAA_len41_fa10_ta10_fm10_tm10*121*a,1896,0,2,0,1898,0.001,121,3006@TOP@human_GAPDH_TAA_len41_fa10_ta10_fm10_tm10,a
3006@TOP@human_GAPDH_TAA_len41_fa10_ta10_fm10_tm10*122*g,0,0,1907,0,1907,1.0,122,3006@TOP@human_GAPDH_TAA_len41_fa10_ta10_fm10_tm10,g
3006@TOP@human_GAPDH_TAA_len41_fa10_ta10_fm10_tm10*123*t,0,5,0,1881,1886,0.0,123,3006@TOP@human_GAPDH_TAA_len41_fa10_ta10_fm10_tm10,t
3006@TOP@human_GAPDH_TAA_len41_fa10_ta10_fm10_tm10*124*a,1453,0,426,0,1879,0.227,124,3006@TOP@human_GAPDH_TAA_len41_fa10_ta10_fm10_tm10,a
3006@TOP@human_GAPDH_TAA_len41_fa10_ta10_fm10_tm10*125*a,1520,1,354,0,1875,0.189,125,3006@TOP@human_GAPDH_TAA_len41_fa10_ta10_fm10_tm10,a
3006@TOP@human_GAPDH_TAA_len41_fa10_ta10_fm10_tm10*126*g,0,0,1877,0,1877,1.0,126,3006@TOP@human_GAPDH_TAA_len41_fa10_ta10_fm10_tm10,g
3006@TOP@human_GAPDH_TAA_len41_fa10_ta10_fm10_tm10*127*a,1894,0,5,0,1899,0.003,127,3006@TOP@human_GAPDH_TAA_len41_fa10_ta10_fm10_tm10,a
3006@TOP@human_GAPDH_TAA_len41_fa10_ta10_fm10_tm10*128*c,0,1908,0,0,1908,0.0,128,3006@TOP@human_GAPDH_TAA_len41_fa10_ta10_fm10_tm10,c
3006@TOP@human_GAPDH_TAA_len41_fa10_ta10_fm10_tm10*129*c,0,1888,0,0,1888,0.0,129,3006@TOP@human_GAPDH_TAA_len41_fa10_ta10_fm10_tm10,c
3006@TOP@human_GAPDH_TAA_len41_fa10_ta10_fm10_tm10*130*c,0,1909,0,0,1909,0.0,130,3006@TOP@human_GAPDH_TAA_len41_fa10_ta10_fm10_tm10,c
3006@TOP@human_GAPDH_TAA_len41_fa10_ta10_fm10_tm10*131*c,1,1910,0,0,1911,0.0,131,3006@TOP@human_GAPDH_TAA_len41_fa10_ta10_fm10_tm10,c
3006@TOP@human_GAPDH_TAA_len41_fa10_ta10_fm10_tm10*132*t,0,0,0,1889,1889,0.0,132,3006@TOP@human_GAPDH_TAA_len41_fa10_ta10_fm10_tm10,t
3006@TOP@human_GAPDH_TAA_len41_fa10_ta10_fm10_tm10*133*g,0,0,1884,0,1884,1.0,133,3006@TOP@human_GAPDH_TAA_len41_fa10_ta10_fm10_tm10,g
3006@TOP@human_GAPDH_TAA_len41_fa10_ta10_fm10_tm10*134*g,0,0,1889,0,1889,1.0,134,3006@TOP@human_GAPDH_TAA_len41_fa10_ta10_fm10_tm10,g
3007@TOP@human_GAPDH_TAA_len41_fa10_ta10_fm10_tm10*114*t,1,5,0,6905,6911,0.0,114,3007@TOP@human_GAPDH_TAA_len41_fa10_ta10_fm10_tm10,t
3007@TOP@human_GAPDH_TAA_len41_fa10_ta10_fm10_tm10*115*c,0,6943,0,1,6944,0.0,115,3007@TOP@human_GAPDH_TAA_len41_fa10_ta10_fm10_tm10,c
3007@TOP@human_GAPDH_TAA_len41_fa10_ta10_fm10_tm10*116*c,0,6918,0,2,6920,0.0,116,3007@TOP@human_GAPDH_TAA_len41_fa10_ta10_fm10_tm10,c
3007@TOP@human_GAPDH_TAA_len41_fa10_ta10_fm10_tm10*117*a,6865,0,50,0,6915,0.007,117,3007@TOP@human_GAPDH_TAA_len41_fa10_ta10_fm10_tm10,a
3007@TOP@human_GAPDH_TAA_len41_fa10_ta10_fm10_tm10*118*a,6179,0,695,0,6874,0.101,118,3007@TOP@human_GAPDH_TAA_len41_fa10_ta10_fm10_tm10,a
3007@TOP@human_GAPDH_TAA_len41_fa10_ta10_fm10_tm10*119*g,0,0,6833,0,6833,1.0,119,3007@TOP@human_GAPDH_TAA_len41_fa10_ta10_fm10_tm10,g
3007@TOP@human_GAPDH_TAA_len41_fa10_ta10_fm10_tm10*120*g,0,0,6849,0,6849,1.0,120,3007@TOP@human_GAPDH_TAA_len41_fa10_ta10_fm10_tm10,g
3007@TOP@human_GAPDH_TAA_len41_fa10_ta10_fm10_tm10*121*a,6903,0,6,0,6909,0.001,121,3007@TOP@human_GAPDH_TAA_len41_fa10_ta10_fm10_tm10,a
3007@TOP@human_GAPDH_TAA_len41_fa10_ta10_fm10_tm10*122*g,0,1,6913,0,6914,1.0,122,3007@TOP@human_GAPDH_TAA_len41_fa10_ta10_fm10_tm10,g
3007@TOP@human_GAPDH_TAA_len41_fa10_ta10_fm10_tm10*123*t,1,1,0,6817,6819,0.0,123,3007@TOP@human_GAPDH_TAA_len41_fa10_ta10_fm10_tm10,t
3007@TOP@human_GAPDH_TAA_len41_fa10_ta10_fm10_tm10*124*a,5965,1,851,0,6817,0.125,124,3007@TOP@human_GAPDH_TAA_len41_fa10_ta10_fm10_tm10,a
3007@TOP@human_GAPDH_TAA_len41_fa10_ta10_fm10_tm10*125*a,6441,0,350,0,6791,0.052,125,3007@TOP@human_GAPDH_TAA_len41_fa10_ta10_fm10_tm10,a
3007@TOP@human_GAPDH_TAA_len41_fa10_ta10_fm10_tm10*126*g,1,0,6825,1,6827,1.0,126,3007@TOP@human_GAPDH_TAA_len41_fa10_ta10_fm10_tm10,g
3007@TOP@human_GAPDH_TAA_len41_fa10_ta10_fm10_tm10*127*a,6900,0,4,0,6904,0.001,127,3007@TOP@human_GAPDH_TAA_len41_fa10_ta10_fm10_tm10,a
3007@TOP@human_GAPDH_TAA_len41_fa10_ta10_fm10_tm10*128*c,0,6932,1,0,6933,0.0,128,3007@TOP@human_GAPDH_TAA_len41_fa10_ta10_fm10_tm10,c
3007@TOP@human_GAPDH_TAA_len41_fa10_ta10_fm10_tm10*129*c,0,6869,0,0,6869,0.0,129,3007@TOP@human_GAPDH_TAA_len41_fa10_ta10_fm10_tm10,c
3007@TOP@human_GAPDH_TAA_len41_fa10_ta10_fm10_tm10*130*c,2,6913,0,0,6915,0.0,130,3007@TOP@human_GAPDH_TAA_len41_fa10_ta10_fm10_tm10,c
3007@TOP@human_GAPDH_TAA_len41_fa10_ta10_fm10_tm10*131*c,0,6933,0,1,6934,0.0,131,3007@TOP@human_GAPDH_TAA_len41_fa10_ta10_fm10_tm10,c
3007@TOP@human_GAPDH_TAA_len41_fa10_ta10_fm10_tm10*132*t,0,0,4,6836,6840,0.001,132,3007@TOP@human_GAPDH_TAA_len41_fa10_ta10_fm10_tm10,t
3007@TOP@human_GAPDH_TAA_len41_fa10_ta10_fm10_tm10*133*g,1,1,6794,0,6796,1.0,133,3007@TOP@human_GAPDH_TAA_len41_fa10_ta10_fm10_tm10,g
3007@TOP@human_GAPDH_TAA_len41_fa10_ta10_fm10_tm10*134*g,0,0,6864,0,6864,1.0,134,3007@TOP@human_GAPDH_TAA_len41_fa10_ta10_fm10_tm10,g
3008@TOP@human_GAPDH_TAA_len41_fa10_ta10_fm10_tm10*114*t,0,0,0,1196,1196,0.0,114,3008@TOP@human_GAPDH_TAA_len41_fa10_ta10_fm10_tm10,t
3008@TOP@human_GAPDH_TAA_len41_fa10_ta10_fm10_tm10*115*c,0,1207,0,0,1207,0.0,115,3008@TOP@human_GAPDH_TAA_len41_fa10_ta10_fm10_tm10,c
3008@TOP@human_GAPDH_TAA_len41_fa10_ta10_fm10_tm10*116*c,2,1200,0,0,1202,0.0,116,3008@TOP@human_GAPDH_TAA_len41_fa10_ta10_fm10_tm10,c
3008@TOP@human_GAPDH_TAA_len41_fa10_ta10_fm10_tm10*117*a,1187,0,8,0,1195,0.007,117,3008@TOP@human_GAPDH_TAA_len41_fa10_ta10_fm10_tm10,a
3008@TOP@human_GAPDH_TAA_len41_fa10_ta10_fm10_tm10*118*a,1117,0,81,0,1198,0.068,118,3008@TOP@human_GAPDH_TAA_len41_fa10_ta10_fm10_tm10,a
3008@TOP@human_GAPDH_TAA_len41_fa10_ta10_fm10_tm10*119*g,0,0,1201,0,1201,1.0,119,3008@TOP@human_GAPDH_TAA_len41_fa10_ta10_fm10_tm10,g
3008@TOP@human_GAPDH_TAA_len41_fa10_ta10_fm10_tm10*120*g,0,0,1191,0,1191,1.0,120,3008@TOP@human_GAPDH_TAA_len41_fa10_ta10_fm10_tm10,g
3008@TOP@human_GAPDH_TAA_len41_fa10_ta10_fm10_tm10*121*a,1204,0,0,0,1204,0.0,121,3008@TOP@human_GAPDH_TAA_len41_fa10_ta10_fm10_tm10,a
3008@TOP@human_GAPDH_TAA_len41_fa10_ta10_fm10_tm10*122*g,0,0,1203,0,1203,1.0,122,3008@TOP@human_GAPDH_TAA_len41_fa10_ta10_fm10_tm10,g
3008@TOP@human_GAPDH_TAA_len41_fa10_ta10_fm10_tm10*123*t,0,0,0,1183,1183,0.0,123,3008@TOP@human_GAPDH_TAA_len41_fa10_ta10_fm10_tm10,t
3008@TOP@human_GAPDH_TAA_len41_fa10_ta10_fm10_tm10*124*a,1054,0,130,0,1184,0.11,124,3008@TOP@human_GAPDH_TAA_len41_fa10_ta10_fm10_tm10,a
3008@TOP@human_GAPDH_TAA_len41_fa10_ta10_fm10_tm10*125*a,1118,0,62,0,1180,0.053,125,3008@TOP@human_GAPDH_TAA_len41_fa10_ta10_fm10_tm10,a
3008@TOP@human_GAPDH_TAA_len41_fa10_ta10_fm10_tm10*126*g,0,0,1194,0,1194,1.0,126,3008@TOP@human_GAPDH_TAA_len41_fa10_ta10_fm10_tm10,g
3008@TOP@human_GAPDH_TAA_len41_fa10_ta10_fm10_tm10*127*a,1196,0,0,0,1196,0.0,127,3008@TOP@human_GAPDH_TAA_len41_fa10_ta10_fm10_tm10,a
3008@TOP@human_GAPDH_TAA_len41_fa10_ta10_fm10_tm10*128*c,0,1204,0,0,1204,0.0,128,3008@TOP@human_GAPDH_TAA_len41_fa10_ta10_fm10_tm10,c
3008@TOP@human_GAPDH_TAA_len41_fa10_ta10_fm10_tm10*129*c,0,1196,0,0,1196,0.0,129,3008@TOP@human_GAPDH_TAA_len41_fa10_ta10_fm10_tm10,c
3008@TOP@human_GAPDH_TAA_len41_fa10_ta10_fm10_tm10*130*c,0,1206,0,1,1207,0.0,130,3008@TOP@human_GAPDH_TAA_len41_fa10_ta10_fm10_tm10,c
3008@TOP@human_GAPDH_TAA_len41_fa10_ta10_fm10_tm10*131*c,0,1203,0,0,1203,0.0,131,3008@TOP@human_GAPDH_TAA_len41_fa10_ta10_fm10_tm10,c
3008@TOP@human_GAPDH_TAA_len41_fa10_ta10_fm10_tm10*132*t,1,0,0,1181,1182,0.0,132,3008@TOP@human_GAPDH_TAA_len41_fa10_ta10_fm10_tm10,t
3008@TOP@human_GAPDH_TAA_len41_fa10_ta10_fm10_tm10*133*g,1,0,1191,0,1192,0.999,133,3008@TOP@human_GAPDH_TAA_len41_fa10_ta10_fm10_tm10,g
3008@TOP@human_GAPDH_TAA_len41_fa10_ta10_fm10_tm10*134*g,0,0,1189,0,1189,1.0,134,3008@TOP@human_GAPDH_TAA_len41_fa10_ta10_fm10_tm10,g
3009@TOP@human_GAPDH_TAA_len41_fa10_ta10_fm10_tm10*114*t,0,0,0,1540,1540,0.0,114,3009@TOP@human_GAPDH_TAA_len41_fa10_ta10_fm10_tm10,t
3009@TOP@human_GAPDH_TAA_len41_fa10_ta10_fm10_tm10*115*c,0,1546,0,0,1546,0.0,115,3009@TOP@human_GAPDH_TAA_len41_fa10_ta10_fm10_tm10,c
3009@TOP@human_GAPDH_TAA_len41_fa10_ta10_fm10_tm10*116*c,0,1538,0,2,1540,0.0,116,3009@TOP@human_GAPDH_TAA_len41_fa10_ta10_fm10_tm10,c
3009@TOP@human_GAPDH_TAA_len41_fa10_ta10_fm10_tm10*117*a,1517,0,21,0,1538,0.014,117,3009@TOP@human_GAPDH_TAA_len41_fa10_ta10_fm10_tm10,a
3009@TOP@human_GAPDH_TAA_len41_fa10_ta10_fm10_tm10*118*a,1299,0,233,0,1532,0.152,118,3009@TOP@human_GAPDH_TAA_len41_fa10_ta10_fm10_tm10,a
3009@TOP@human_GAPDH_TAA_len41_fa10_ta10_fm10_tm10*119*g,0,0,1531,0,1531,1.0,119,3009@TOP@human_GAPDH_TAA_len41_fa10_ta10_fm10_tm10,g
3009@TOP@human_GAPDH_TAA_len41_fa10_ta10_fm10_tm10*120*g,0,0,1521,0,1521,1.0,120,3009@TOP@human_GAPDH_TAA_len41_fa10_ta10_fm10_tm10,g
3009@TOP@human_GAPDH_TAA_len41_fa10_ta10_fm10_tm10*121*a,1536,0,3,0,1539,0.002,121,3009@TOP@human_GAPDH_TAA_len41_fa10_ta10_fm10_tm10,a
3009@TOP@human_GAPDH_TAA_len41_fa10_ta10_fm10_tm10*122*g,0,0,1539,0,1539,1.0,122,3009@TOP@human_GAPDH_TAA_len41_fa10_ta10_fm10_tm10,g
3009@TOP@human_GAPDH_TAA_len41_fa10_ta10_fm10_tm10*123*t,0,0,0,1518,1518,0.0,123,3009@TOP@human_GAPDH_TAA_len41_fa10_ta10_fm10_tm10,t
3009@TOP@human_GAPDH_TAA_len41_fa10_ta10_fm10_tm10*124*a,1269,0,255,0,1524,0.167,124,3009@TOP@human_GAPDH_TAA_len41_fa10_ta10_fm10_tm10,a
3009@TOP@human_GAPDH_TAA_len41_fa10_ta10_fm10_tm10*125*a,1465,0,59,0,1524,0.039,125,3009@TOP@human_GAPDH_TAA_len41_fa10_ta10_fm10_tm10,a
3009@TOP@human_GAPDH_TAA_len41_fa10_ta10_fm10_tm10*126*g,0,0,1515,0,1515,1.0,126,3009@TOP@human_GAPDH_TAA_len41_fa10_ta10_fm10_tm10,g
3009@TOP@human_GAPDH_TAA_len41_fa10_ta10_fm10_tm10*127*a,1539,0,1,0,1540,0.001,127,3009@TOP@human_GAPDH_TAA_len41_fa10_ta10_fm10_tm10,a
3009@TOP@human_GAPDH_TAA_len41_fa10_ta10_fm10_tm10*128*c,0,1541,0,0,1541,0.0,128,3009@TOP@human_GAPDH_TAA_len41_fa10_ta10_fm10_tm10,c
3009@TOP@human_GAPDH_TAA_len41_fa10_ta10_fm10_tm10*129*c,0,1534,0,0,1534,0.0,129,3009@TOP@human_GAPDH_TAA_len41_fa10_ta10_fm10_tm10,c
3009@TOP@human_GAPDH_TAA_len41_fa10_ta10_fm10_tm10*130*c,0,1539,0,2,1541,0.0,130,3009@TOP@human_GAPDH_TAA_len41_fa10_ta10_fm10_tm10,c
3009@TOP@human_GAPDH_TAA_len41_fa10_ta10_fm10_tm10*131*c,1,1544,0,0,1545,0.0,131,3009@TOP@human_GAPDH_TAA_len41_fa10_ta10_fm10_tm10,c
3009@TOP@human_GAPDH_TAA_len41_fa10_ta10_fm10_tm10*132*t,0,0,0,1528,1528,0.0,132,3009@TOP@human_GAPDH_TAA_len41_fa10_ta10_fm10_tm10,t
3009@TOP@human_GAPDH_TAA_len41_fa10_ta10_fm10_tm10*133*g,0,0,1528,0,1528,1.0,133,3009@TOP@human_GAPDH_TAA_len41_fa10_ta10_fm10_tm10,g
3009@TOP@human_GAPDH_TAA_len41_fa10_ta10_fm10_tm10*134*g,0,1,1527,0,1528,0.999,134,3009@TOP@human_GAPDH_TAA_len41_fa10_ta10_fm10_tm10,g
3010@TOP@human_GAPDH_TAA_len41_fa10_ta10_fm10_tm10*114*t,0,0,0,1657,1657,0.0,114,3010@TOP@human_GAPDH_TAA_len41_fa10_ta10_fm10_tm10,t
3010@TOP@human_GAPDH_TAA_len41_fa10_ta10_fm10_tm10*115*c,0,1662,0,1,1663,0.0,115,3010@TOP@human_GAPDH_TAA_len41_fa10_ta10_fm10_tm10,c
3010@TOP@human_GAPDH_TAA_len41_fa10_ta10_fm10_tm10*116*c,0,1655,0,0,1655,0.0,116,3010@TOP@human_GAPDH_TAA_len41_fa10_ta10_fm10_tm10,c
3010@TOP@human_GAPDH_TAA_len41_fa10_ta10_fm10_tm10*117*a,1638,0,13,0,1651,0.008,117,3010@TOP@human_GAPDH_TAA_len41_fa10_ta10_fm10_tm10,a
3010@TOP@human_GAPDH_TAA_len41_fa10_ta10_fm10_tm10*118*a,1525,0,123,0,1648,0.075,118,3010@TOP@human_GAPDH_TAA_len41_fa10_ta10_fm10_tm10,a
3010@TOP@human_GAPDH_TAA_len41_fa10_ta10_fm10_tm10*119*g,0,0,1643,0,1643,1.0,119,3010@TOP@human_GAPDH_TAA_len41_fa10_ta10_fm10_tm10,g
3010@TOP@human_GAPDH_TAA_len41_fa10_ta10_fm10_tm10*120*g,0,0,1641,0,1641,1.0,120,3010@TOP@human_GAPDH_TAA_len41_fa10_ta10_fm10_tm10,g
3010@TOP@human_GAPDH_TAA_len41_fa10_ta10_fm10_tm10*121*a,1647,0,3,0,1650,0.002,121,3010@TOP@human_GAPDH_TAA_len41_fa10_ta10_fm10_tm10,a
3010@TOP@human_GAPDH_TAA_len41_fa10_ta10_fm10_tm10*122*g,0,0,1660,0,1660,1.0,122,3010@TOP@human_GAPDH_TAA_len41_fa10_ta10_fm10_tm10,g
3010@TOP@human_GAPDH_TAA_len41_fa10_ta10_fm10_tm10*123*t,0,1,0,1638,1639,0.0,123,3010@TOP@human_GAPDH_TAA_len41_fa10_ta10_fm10_tm10,t
3010@TOP@human_GAPDH_TAA_len41_fa10_ta10_fm10_tm10*124*a,1522,0,107,0,1629,0.066,124,3010@TOP@human_GAPDH_TAA_len41_fa10_ta10_fm10_tm10,a
3010@TOP@human_GAPDH_TAA_len41_fa10_ta10_fm10_tm10*125*a,1540,1,83,0,1624,0.051,125,3010@TOP@human_GAPDH_TAA_len41_fa10_ta10_fm10_tm10,a
3010@TOP@human_GAPDH_TAA_len41_fa10_ta10_fm10_tm10*126*g,3,0,1636,0,1639,0.998,126,3010@TOP@human_GAPDH_TAA_len41_fa10_ta10_fm10_tm10,g
3010@TOP@human_GAPDH_TAA_len41_fa10_ta10_fm10_tm10*127*a,1648,0,1,0,1649,0.001,127,3010@TOP@human_GAPDH_TAA_len41_fa10_ta10_fm10_tm10,a
3010@TOP@human_GAPDH_TAA_len41_fa10_ta10_fm10_tm10*128*c,1,1658,0,0,1659,0.0,128,3010@TOP@human_GAPDH_TAA_len41_fa10_ta10_fm10_tm10,c
3010@TOP@human_GAPDH_TAA_len41_fa10_ta10_fm10_tm10*129*c,0,1655,0,0,1655,0.0,129,3010@TOP@human_GAPDH_TAA_len41_fa10_ta10_fm10_tm10,c
3010@TOP@human_GAPDH_TAA_len41_fa10_ta10_fm10_tm10*130*c,0,1655,0,0,1655,0.0,130,3010@TOP@human_GAPDH_TAA_len41_fa10_ta10_fm10_tm10,c
3010@TOP@human_GAPDH_TAA_len41_fa10_ta10_fm10_tm10*131*c,1,1658,0,0,1659,0.0,131,3010@TOP@human_GAPDH_TAA_len41_fa10_ta10_fm10_tm10,c
3010@TOP@human_GAPDH_TAA_len41_fa10_ta10_fm10_tm10*132*t,1,0,0,1641,1642,0.0,132,3010@TOP@human_GAPDH_TAA_len41_fa10_ta10_fm10_tm10,t
3010@TOP@human_GAPDH_TAA_len41_fa10_ta10_fm10_tm10*133*g,0,0,1635,0,1635,1.0,133,3010@TOP@human_GAPDH_TAA_len41_fa10_ta10_fm10_tm10,g
3010@TOP@human_GAPDH_TAA_len41_fa10_ta10_fm10_tm10*134*g,0,1,1643,0,1644,0.999,134,3010@TOP@human_GAPDH_TAA_len41_fa10_ta10_fm10_tm10,g
3011@TOP@human_GAPDH_TAA_len41_fa10_ta10_fm10_tm10*114*t,0,2,0,2607,2609,0.0,114,3011@TOP@human_GAPDH_TAA_len41_fa10_ta10_fm10_tm10,t
3011@TOP@human_GAPDH_TAA_len41_fa10_ta10_fm10_tm10*115*c,0,2625,0,0,2625,0.0,115,3011@TOP@human_GAPDH_TAA_len41_fa10_ta10_fm10_tm10,c
3011@TOP@human_GAPDH_TAA_len41_fa10_ta10_fm10_tm10*116*c,0,2615,0,0,2615,0.0,116,3011@TOP@human_GAPDH_TAA_len41_fa10_ta10_fm10_tm10,c
3011@TOP@human_GAPDH_TAA_len41_fa10_ta10_fm10_tm10*117*a,2555,0,59,0,2614,0.023,117,3011@TOP@human_GAPDH_TAA_len41_fa10_ta10_fm10_tm10,a
3011@TOP@human_GAPDH_TAA_len41_fa10_ta10_fm10_tm10*118*a,2079,0,511,1,2591,0.197,118,3011@TOP@human_GAPDH_TAA_len41_fa10_ta10_fm10_tm10,a
3011@TOP@human_GAPDH_TAA_len41_fa10_ta10_fm10_tm10*119*g,0,0,2592,0,2592,1.0,119,3011@TOP@human_GAPDH_TAA_len41_fa10_ta10_fm10_tm10,g
3011@TOP@human_GAPDH_TAA_len41_fa10_ta10_fm10_tm10*120*g,0,0,2588,0,2588,1.0,120,3011@TOP@human_GAPDH_TAA_len41_fa10_ta10_fm10_tm10,g
3011@TOP@human_GAPDH_TAA_len41_fa10_ta10_fm10_tm10*121*a,2598,0,7,0,2605,0.003,121,3011@TOP@human_GAPDH_TAA_len41_fa10_ta10_fm10_tm10,a
3011@TOP@human_GAPDH_TAA_len41_fa10_ta10_fm10_tm10*122*g,0,0,2617,0,2617,1.0,122,3011@TOP@human_GAPDH_TAA_len41_fa10_ta10_fm10_tm10,g
3011@TOP@human_GAPDH_TAA_len41_fa10_ta10_fm10_tm10*123*t,1,0,0,2576,2577,0.0,123,3011@TOP@human_GAPDH_TAA_len41_fa10_ta10_fm10_tm10,t
3011@TOP@human_GAPDH_TAA_len41_fa10_ta10_fm10_tm10*124*a,2435,0,116,0,2551,0.045,124,3011@TOP@human_GAPDH_TAA_len41_fa10_ta10_fm10_tm10,a
3011@TOP@human_GAPDH_TAA_len41_fa10_ta10_fm10_tm10*125*a,2417,1,144,0,2562,0.056,125,3011@TOP@human_GAPDH_TAA_len41_fa10_ta10_fm10_tm10,a
3011@TOP@human_GAPDH_TAA_len41_fa10_ta10_fm10_tm10*126*g,0,0,2585,0,2585,1.0,126,3011@TOP@human_GAPDH_TAA_len41_fa10_ta10_fm10_tm10,g
3011@TOP@human_GAPDH_TAA_len41_fa10_ta10_fm10_tm10*127*a,2597,0,5,0,2602,0.002,127,3011@TOP@human_GAPDH_TAA_len41_fa10_ta10_fm10_tm10,a
3011@TOP@human_GAPDH_TAA_len41_fa10_ta10_fm10_tm10*128*c,0,2612,1,0,2613,0.0,128,3011@TOP@human_GAPDH_TAA_len41_fa10_ta10_fm10_tm10,c
3011@TOP@human_GAPDH_TAA_len41_fa10_ta10_fm10_tm10*129*c,0,2602,0,0,2602,0.0,129,3011@TOP@human_GAPDH_TAA_len41_fa10_ta10_fm10_tm10,c
3011@TOP@human_GAPDH_TAA_len41_fa10_ta10_fm10_tm10*130*c,0,2614,0,0,2614,0.0,130,3011@TOP@human_GAPDH_TAA_len41_fa10_ta10_fm10_tm10,c
3011@TOP@human_GAPDH_TAA_len41_fa10_ta10_fm10_tm10*131*c,1,2619,0,0,2620,0.0,131,3011@TOP@human_GAPDH_TAA_len41_fa10_ta10_fm10_tm10,c
3011@TOP@human_GAPDH_TAA_len41_fa10_ta10_fm10_tm10*132*t,0,0,0,2571,2571,0.0,132,3011@TOP@human_GAPDH_TAA_len41_fa10_ta10_fm10_tm10,t
3011@TOP@human_GAPDH_TAA_len41_fa10_ta10_fm10_tm10*133*g,0,0,2575,0,2575,1.0,133,3011@TOP@human_GAPDH_TAA_len41_fa10_ta10_fm10_tm10,g
3011@TOP@human_GAPDH_TAA_len41_fa10_ta10_fm10_tm10*134*g,0,5,2578,0,2583,0.998,134,3011@TOP@human_GAPDH_TAA_len41_fa10_ta10_fm10_tm10,g
3012@TOP@human_GAPDH_TAA_len41_fa10_ta10_fm10_tm10*114*t,5,9,0,33723,33737,0.0,114,3012@TOP@human_GAPDH_TAA_len41_fa10_ta10_fm10_tm10,t
3012@TOP@human_GAPDH_TAA_len41_fa10_ta10_fm10_tm10*115*c,1,33935,0,3,33939,0.0,115,3012@TOP@human_GAPDH_TAA_len41_fa10_ta10_fm10_tm10,c
3012@TOP@human_GAPDH_TAA_len41_fa10_ta10_fm10_tm10*116*c,0,33782,0,0,33782,0.0,116,3012@TOP@human_GAPDH_TAA_len41_fa10_ta10_fm10_tm10,c
3012@TOP@human_GAPDH_TAA_len41_fa10_ta10_fm10_tm10*117*a,33696,1,82,0,33779,0.002,117,3012@TOP@human_GAPDH_TAA_len41_fa10_ta10_fm10_tm10,a
3012@TOP@human_GAPDH_TAA_len41_fa10_ta10_fm10_tm10*118*a,32997,0,580,0,33577,0.017,118,3012@TOP@human_GAPDH_TAA_len41_fa10_ta10_fm10_tm10,a
3012@TOP@human_GAPDH_TAA_len41_fa10_ta10_fm10_tm10*119*g,0,0,33520,3,33523,1.0,119,3012@TOP@human_GAPDH_TAA_len41_fa10_ta10_fm10_tm10,g
3012@TOP@human_GAPDH_TAA_len41_fa10_ta10_fm10_tm10*120*g,2,1,33397,1,33401,1.0,120,3012@TOP@human_GAPDH_TAA_len41_fa10_ta10_fm10_tm10,g
3012@TOP@human_GAPDH_TAA_len41_fa10_ta10_fm10_tm10*121*a,33697,0,7,0,33704,0.0,121,3012@TOP@human_GAPDH_TAA_len41_fa10_ta10_fm10_tm10,a
3012@TOP@human_GAPDH_TAA_len41_fa10_ta10_fm10_tm10*122*g,3,0,33796,3,33802,1.0,122,3012@TOP@human_GAPDH_TAA_len41_fa10_ta10_fm10_tm10,g
3012@TOP@human_GAPDH_TAA_len41_fa10_ta10_fm10_tm10*123*t,3,5,8,33318,33334,0.0,123,3012@TOP@human_GAPDH_TAA_len41_fa10_ta10_fm10_tm10,t
3012@TOP@human_GAPDH_TAA_len41_fa10_ta10_fm10_tm10*124*a,27512,0,5767,0,33279,0.173,124,3012@TOP@human_GAPDH_TAA_len41_fa10_ta10_fm10_tm10,a
3012@TOP@human_GAPDH_TAA_len41_fa10_ta10_fm10_tm10*125*a,32322,0,909,6,33237,0.027,125,3012@TOP@human_GAPDH_TAA_len41_fa10_ta10_fm10_tm10,a
3012@TOP@human_GAPDH_TAA_len41_fa10_ta10_fm10_tm10*126*g,4,0,33346,1,33351,1.0,126,3012@TOP@human_GAPDH_TAA_len41_fa10_ta10_fm10_tm10,g
3012@TOP@human_GAPDH_TAA_len41_fa10_ta10_fm10_tm10*127*a,33656,5,18,0,33679,0.001,127,3012@TOP@human_GAPDH_TAA_len41_fa10_ta10_fm10_tm10,a
3012@TOP@human_GAPDH_TAA_len41_fa10_ta10_fm10_tm10*128*c,2,33855,1,0,33858,0.0,128,3012@TOP@human_GAPDH_TAA_len41_fa10_ta10_fm10_tm10,c
3012@TOP@human_GAPDH_TAA_len41_fa10_ta10_fm10_tm10*129*c,2,33612,0,1,33615,0.0,129,3012@TOP@human_GAPDH_TAA_len41_fa10_ta10_fm10_tm10,c
3012@TOP@human_GAPDH_TAA_len41_fa10_ta10_fm10_tm10*130*c,4,33825,0,0,33829,0.0,130,3012@TOP@human_GAPDH_TAA_len41_fa10_ta10_fm10_tm10,c
3012@TOP@human_GAPDH_TAA_len41_fa10_ta10_fm10_tm10*131*c,0,33860,0,3,33863,0.0,131,3012@TOP@human_GAPDH_TAA_len41_fa10_ta10_fm10_tm10,c
3012@TOP@human_GAPDH_TAA_len41_fa10_ta10_fm10_tm10*132*t,2,3,2,33351,33358,0.0,132,3012@TOP@human_GAPDH_TAA_len41_fa10_ta10_fm10_tm10,t
3012@TOP@human_GAPDH_TAA_len41_fa10_ta10_fm10_tm10*133*g,1,0,33312,2,33315,1.0,133,3012@TOP@human_GAPDH_TAA_len41_fa10_ta10_fm10_tm10,g
3012@TOP@human_GAPDH_TAA_len41_fa10_ta10_fm10_tm10*134*g,2,8,33478,2,33490,1.0,134,3012@TOP@human_GAPDH_TAA_len41_fa10_ta10_fm10_tm10,g
3013@TOP@human_GAPDH_TAA_len41_fa10_ta10_fm10_tm10*114*t,0,0,0,1654,1654,0.0,114,3013@TOP@human_GAPDH_TAA_len41_fa10_ta10_fm10_tm10,t
3013@TOP@human_GAPDH_TAA_len41_fa10_ta10_fm10_tm10*115*c,0,1676,0,0,1676,0.0,115,3013@TOP@human_GAPDH_TAA_len41_fa10_ta10_fm10_tm10,c
3013@TOP@human_GAPDH_TAA_len41_fa10_ta10_fm10_tm10*116*c,0,1662,0,0,1662,0.0,116,3013@TOP@human_GAPDH_TAA_len41_fa10_ta10_fm10_tm10,c
3013@TOP@human_GAPDH_TAA_len41_fa10_ta10_fm10_tm10*117*a,1637,0,23,0,1660,0.014,117,3013@TOP@human_GAPDH_TAA_len41_fa10_ta10_fm10_tm10,a
3013@TOP@human_GAPDH_TAA_len41_fa10_ta10_fm10_tm10*118*a,1431,0,216,0,1647,0.131,118,3013@TOP@human_GAPDH_TAA_len41_fa10_ta10_fm10_tm10,a
3013@TOP@human_GAPDH_TAA_len41_fa10_ta10_fm10_tm10*119*g,0,0,1639,0,1639,1.0,119,3013@TOP@human_GAPDH_TAA_len41_fa10_ta10_fm10_tm10,g
3013@TOP@human_GAPDH_TAA_len41_fa10_ta10_fm10_tm10*120*g,1,0,1641,0,1642,0.999,120,3013@TOP@human_GAPDH_TAA_len41_fa10_ta10_fm10_tm10,g
3013@TOP@human_GAPDH_TAA_len41_fa10_ta10_fm10_tm10*121*a,1650,0,1,0,1651,0.001,121,3013@TOP@human_GAPDH_TAA_len41_fa10_ta10_fm10_tm10,a
3013@TOP@human_GAPDH_TAA_len41_fa10_ta10_fm10_tm10*122*g,0,0,1662,0,1662,1.0,122,3013@TOP@human_GAPDH_TAA_len41_fa10_ta10_fm10_tm10,g
3013@TOP@human_GAPDH_TAA_len41_fa10_ta10_fm10_tm10*123*t,0,0,0,1639,1639,0.0,123,3013@TOP@human_GAPDH_TAA_len41_fa10_ta10_fm10_tm10,t
3013@TOP@human_GAPDH_TAA_len41_fa10_ta10_fm10_tm10*124*a,1357,0,271,0,1628,0.166,124,3013@TOP@human_GAPDH_TAA_len41_fa10_ta10_fm10_tm10,a
3013@TOP@human_GAPDH_TAA_len41_fa10_ta10_fm10_tm10*125*a,1519,0,110,0,1629,0.068,125,3013@TOP@human_GAPDH_TAA_len41_fa10_ta10_fm10_tm10,a
3013@TOP@human_GAPDH_TAA_len41_fa10_ta10_fm10_tm10*126*g,0,0,1642,0,1642,1.0,126,3013@TOP@human_GAPDH_TAA_len41_fa10_ta10_fm10_tm10,g
3013@TOP@human_GAPDH_TAA_len41_fa10_ta10_fm10_tm10*127*a,1646,0,3,0,1649,0.002,127,3013@TOP@human_GAPDH_TAA_len41_fa10_ta10_fm10_tm10,a
3013@TOP@human_GAPDH_TAA_len41_fa10_ta10_fm10_tm10*128*c,1,1669,0,0,1670,0.0,128,3013@TOP@human_GAPDH_TAA_len41_fa10_ta10_fm10_tm10,c
3013@TOP@human_GAPDH_TAA_len41_fa10_ta10_fm10_tm10*129*c,0,1647,0,0,1647,0.0,129,3013@TOP@human_GAPDH_TAA_len41_fa10_ta10_fm10_tm10,c
3013@TOP@human_GAPDH_TAA_len41_fa10_ta10_fm10_tm10*130*c,0,1661,0,0,1661,0.0,130,3013@TOP@human_GAPDH_TAA_len41_fa10_ta10_fm10_tm10,c
3013@TOP@human_GAPDH_TAA_len41_fa10_ta10_fm10_tm10*131*c,0,1671,0,0,1671,0.0,131,3013@TOP@human_GAPDH_TAA_len41_fa10_ta10_fm10_tm10,c
3013@TOP@human_GAPDH_TAA_len41_fa10_ta10_fm10_tm10*132*t,1,0,0,1643,1644,0.0,132,3013@TOP@human_GAPDH_TAA_len41_fa10_ta10_fm10_tm10,t
3013@TOP@human_GAPDH_TAA_len41_fa10_ta10_fm10_tm10*133*g,0,0,1632,0,1632,1.0,133,3013@TOP@human_GAPDH_TAA_len41_fa10_ta10_fm10_tm10,g
3013@TOP@human_GAPDH_TAA_len41_fa10_ta10_fm10_tm10*134*g,0,1,1648,0,1649,0.999,134,3013@TOP@human_GAPDH_TAA_len41_fa10_ta10_fm10_tm10,g
3014@TOP@human_GAPDH_TAA_len41_fa10_ta10_fm10_tm10*114*t,0,0,0,951,951,0.0,114,3014@TOP@human_GAPDH_TAA_len41_fa10_ta10_fm10_tm10,t
3014@TOP@human_GAPDH_TAA_len41_fa10_ta10_fm10_tm10*115*c,0,955,0,0,955,0.0,115,3014@TOP@human_GAPDH_TAA_len41_fa10_ta10_fm10_tm10,c
3014@TOP@human_GAPDH_TAA_len41_fa10_ta10_fm10_tm10*116*c,0,952,0,0,952,0.0,116,3014@TOP@human_GAPDH_TAA_len41_fa10_ta10_fm10_tm10,c
3014@TOP@human_GAPDH_TAA_len41_fa10_ta10_fm10_tm10*117*a,941,0,9,0,950,0.009,117,3014@TOP@human_GAPDH_TAA_len41_fa10_ta10_fm10_tm10,a
3014@TOP@human_GAPDH_TAA_len41_fa10_ta10_fm10_tm10*118*a,771,0,175,0,946,0.185,118,3014@TOP@human_GAPDH_TAA_len41_fa10_ta10_fm10_tm10,a
3014@TOP@human_GAPDH_TAA_len41_fa10_ta10_fm10_tm10*119*g,0,0,935,0,935,1.0,119,3014@TOP@human_GAPDH_TAA_len41_fa10_ta10_fm10_tm10,g
3014@TOP@human_GAPDH_TAA_len41_fa10_ta10_fm10_tm10*120*g,0,0,937,0,937,1.0,120,3014@TOP@human_GAPDH_TAA_len41_fa10_ta10_fm10_tm10,g
3014@TOP@human_GAPDH_TAA_len41_fa10_ta10_fm10_tm10*121*a,945,0,3,0,948,0.003,121,3014@TOP@human_GAPDH_TAA_len41_fa10_ta10_fm10_tm10,a
3014@TOP@human_GAPDH_TAA_len41_fa10_ta10_fm10_tm10*122*g,0,0,950,0,950,1.0,122,3014@TOP@human_GAPDH_TAA_len41_fa10_ta10_fm10_tm10,g
3014@TOP@human_GAPDH_TAA_len41_fa10_ta10_fm10_tm10*123*t,0,0,0,936,936,0.0,123,3014@TOP@human_GAPDH_TAA_len41_fa10_ta10_fm10_tm10,t
3014@TOP@human_GAPDH_TAA_len41_fa10_ta10_fm10_tm10*124*a,788,0,144,0,932,0.155,124,3014@TOP@human_GAPDH_TAA_len41_fa10_ta10_fm10_tm10,a
3014@TOP@human_GAPDH_TAA_len41_fa10_ta10_fm10_tm10*125*a,810,0,124,0,934,0.133,125,3014@TOP@human_GAPDH_TAA_len41_fa10_ta10_fm10_tm10,a
3014@TOP@human_GAPDH_TAA_len41_fa10_ta10_fm10_tm10*126*g,0,0,934,0,934,1.0,126,3014@TOP@human_GAPDH_TAA_len41_fa10_ta10_fm10_tm10,g
3014@TOP@human_GAPDH_TAA_len41_fa10_ta10_fm10_tm10*127*a,940,0,1,0,941,0.001,127,3014@TOP@human_GAPDH_TAA_len41_fa10_ta10_fm10_tm10,a
3014@TOP@human_GAPDH_TAA_len41_fa10_ta10_fm10_tm10*128*c,0,952,0,0,952,0.0,128,3014@TOP@human_GAPDH_TAA_len41_fa10_ta10_fm10_tm10,c
3014@TOP@human_GAPDH_TAA_len41_fa10_ta10_fm10_tm10*129*c,0,936,0,0,936,0.0,129,3014@TOP@human_GAPDH_TAA_len41_fa10_ta10_fm10_tm10,c
3014@TOP@human_GAPDH_TAA_len41_fa10_ta10_fm10_tm10*130*c,0,947,0,0,947,0.0,130,3014@TOP@human_GAPDH_TAA_len41_fa10_ta10_fm10_tm10,c
3014@TOP@human_GAPDH_TAA_len41_fa10_ta10_fm10_tm10*131*c,0,956,0,0,956,0.0,131,3014@TOP@human_GAPDH_TAA_len41_fa10_ta10_fm10_tm10,c
3014@TOP@human_GAPDH_TAA_len41_fa10_ta10_fm10_tm10*132*t,0,0,0,941,941,0.0,132,3014@TOP@human_GAPDH_TAA_len41_fa10_ta10_fm10_tm10,t
3014@TOP@human_GAPDH_TAA_len41_fa10_ta10_fm10_tm10*133*g,0,0,935,2,937,0.998,133,3014@TOP@human_GAPDH_TAA_len41_fa10_ta10_fm10_tm10,g
3014@TOP@human_GAPDH_TAA_len41_fa10_ta10_fm10_tm10*134*g,0,0,941,0,941,1.0,134,3014@TOP@human_GAPDH_TAA_len41_fa10_ta10_fm10_tm10,g
3015@TOP@human_GAPDH_TAA_len41_fa10_ta10_fm10_tm10*114*t,0,1,0,2780,2781,0.0,114,3015@TOP@human_GAPDH_TAA_len41_fa10_ta10_fm10_tm10,t
3015@TOP@human_GAPDH_TAA_len41_fa10_ta10_fm10_tm10*115*c,0,2802,0,0,2802,0.0,115,3015@TOP@human_GAPDH_TAA_len41_fa10_ta10_fm10_tm10,c
3015@TOP@human_GAPDH_TAA_len41_fa10_ta10_fm10_tm10*116*c,0,2788,0,0,2788,0.0,116,3015@TOP@human_GAPDH_TAA_len41_fa10_ta10_fm10_tm10,c
3015@TOP@human_GAPDH_TAA_len41_fa10_ta10_fm10_tm10*117*a,2779,0,9,0,2788,0.003,117,3015@TOP@human_GAPDH_TAA_len41_fa10_ta10_fm10_tm10,a
3015@TOP@human_GAPDH_TAA_len41_fa10_ta10_fm10_tm10*118*a,2342,0,432,0,2774,0.156,118,3015@TOP@human_GAPDH_TAA_len41_fa10_ta10_fm10_tm10,a
3015@TOP@human_GAPDH_TAA_len41_fa10_ta10_fm10_tm10*119*g,0,0,2768,1,2769,1.0,119,3015@TOP@human_GAPDH_TAA_len41_fa10_ta10_fm10_tm10,g
3015@TOP@human_GAPDH_TAA_len41_fa10_ta10_fm10_tm10*120*g,1,0,2767,0,2768,1.0,120,3015@TOP@human_GAPDH_TAA_len41_fa10_ta10_fm10_tm10,g
3015@TOP@human_GAPDH_TAA_len41_fa10_ta10_fm10_tm10*121*a,2783,0,7,0,2790,0.003,121,3015@TOP@human_GAPDH_TAA_len41_fa10_ta10_fm10_tm10,a
3015@TOP@human_GAPDH_TAA_len41_fa10_ta10_fm10_tm10*122*g,0,0,2791,0,2791,1.0,122,3015@TOP@human_GAPDH_TAA_len41_fa10_ta10_fm10_tm10,g
3015@TOP@human_GAPDH_TAA_len41_fa10_ta10_fm10_tm10*123*t,2,0,1,2754,2757,0.0,123,3015@TOP@human_GAPDH_TAA_len41_fa10_ta10_fm10_tm10,t
3015@TOP@human_GAPDH_TAA_len41_fa10_ta10_fm10_tm10*124*a,2138,0,616,0,2754,0.224,124,3015@TOP@human_GAPDH_TAA_len41_fa10_ta10_fm10_tm10,a
3015@TOP@human_GAPDH_TAA_len41_fa10_ta10_fm10_tm10*125*a,2395,0,356,0,2751,0.129,125,3015@TOP@human_GAPDH_TAA_len41_fa10_ta10_fm10_tm10,a
3015@TOP@human_GAPDH_TAA_len41_fa10_ta10_fm10_tm10*126*g,0,0,2762,0,2762,1.0,126,3015@TOP@human_GAPDH_TAA_len41_fa10_ta10_fm10_tm10,g
3015@TOP@human_GAPDH_TAA_len41_fa10_ta10_fm10_tm10*127*a,2778,0,9,1,2788,0.003,127,3015@TOP@human_GAPDH_TAA_len41_fa10_ta10_fm10_tm10,a
3015@TOP@human_GAPDH_TAA_len41_fa10_ta10_fm10_tm10*128*c,0,2794,1,0,2795,0.0,128,3015@TOP@human_GAPDH_TAA_len41_fa10_ta10_fm10_tm10,c
3015@TOP@human_GAPDH_TAA_len41_fa10_ta10_fm10_tm10*129*c,0,2779,0,0,2779,0.0,129,3015@TOP@human_GAPDH_TAA_len41_fa10_ta10_fm10_tm10,c
3015@TOP@human_GAPDH_TAA_len41_fa10_ta10_fm10_tm10*130*c,0,2791,0,0,2791,0.0,130,3015@TOP@human_GAPDH_TAA_len41_fa10_ta10_fm10_tm10,c
3015@TOP@human_GAPDH_TAA_len41_fa10_ta10_fm10_tm10*131*c,1,2795,0,0,2796,0.0,131,3015@TOP@human_GAPDH_TAA_len41_fa10_ta10_fm10_tm10,c
3015@TOP@human_GAPDH_TAA_len41_fa10_ta10_fm10_tm10*132*t,0,0,1,2754,2755,0.0,132,3015@TOP@human_GAPDH_TAA_len41_fa10_ta10_fm10_tm10,t
3015@TOP@human_GAPDH_TAA_len41_fa10_ta10_fm10_tm10*133*g,0,0,2742,0,2742,1.0,133,3015@TOP@human_GAPDH_TAA_len41_fa10_ta10_fm10_tm10,g
3015@TOP@human_GAPDH_TAA_len41_fa10_ta10_fm10_tm10*134*g,1,0,2758,0,2759,1.0,134,3015@TOP@human_GAPDH_TAA_len41_fa10_ta10_fm10_tm10,g
3016@TOP@human_GAPDH_TAA_len41_fa10_ta10_fm10_tm10*114*t,8,11,1,43464,43484,0.0,114,3016@TOP@human_GAPDH_TAA_len41_fa10_ta10_fm10_tm10,t
3016@TOP@human_GAPDH_TAA_len41_fa10_ta10_fm10_tm10*115*c,0,43740,0,3,43743,0.0,115,3016@TOP@human_GAPDH_TAA_len41_fa10_ta10_fm10_tm10,c
3016@TOP@human_GAPDH_TAA_len41_fa10_ta10_fm10_tm10*116*c,0,43589,0,2,43591,0.0,116,3016@TOP@human_GAPDH_TAA_len41_fa10_ta10_fm10_tm10,c
3016@TOP@human_GAPDH_TAA_len41_fa10_ta10_fm10_tm10*117*a,43524,0,59,1,43584,0.001,117,3016@TOP@human_GAPDH_TAA_len41_fa10_ta10_fm10_tm10,a
3016@TOP@human_GAPDH_TAA_len41_fa10_ta10_fm10_tm10*118*a,42893,0,461,3,43357,0.011,118,3016@TOP@human_GAPDH_TAA_len41_fa10_ta10_fm10_tm10,a
3016@TOP@human_GAPDH_TAA_len41_fa10_ta10_fm10_tm10*119*g,2,0,43252,2,43256,1.0,119,3016@TOP@human_GAPDH_TAA_len41_fa10_ta10_fm10_tm10,g
3016@TOP@human_GAPDH_TAA_len41_fa10_ta10_fm10_tm10*120*g,1,1,43114,0,43116,1.0,120,3016@TOP@human_GAPDH_TAA_len41_fa10_ta10_fm10_tm10,g
3016@TOP@human_GAPDH_TAA_len41_fa10_ta10_fm10_tm10*121*a,43536,0,13,1,43550,0.0,121,3016@TOP@human_GAPDH_TAA_len41_fa10_ta10_fm10_tm10,a
3016@TOP@human_GAPDH_TAA_len41_fa10_ta10_fm10_tm10*122*g,3,0,43579,0,43582,1.0,122,3016@TOP@human_GAPDH_TAA_len41_fa10_ta10_fm10_tm10,g
3016@TOP@human_GAPDH_TAA_len41_fa10_ta10_fm10_tm10*123*t,3,4,6,42994,43007,0.0,123,3016@TOP@human_GAPDH_TAA_len41_fa10_ta10_fm10_tm10,t
3016@TOP@human_GAPDH_TAA_len41_fa10_ta10_fm10_tm10*124*a,38983,1,3960,0,42944,0.092,124,3016@TOP@human_GAPDH_TAA_len41_fa10_ta10_fm10_tm10,a
3016@TOP@human_GAPDH_TAA_len41_fa10_ta10_fm10_tm10*125*a,42033,3,841,5,42882,0.02,125,3016@TOP@human_GAPDH_TAA_len41_fa10_ta10_fm10_tm10,a
3016@TOP@human_GAPDH_TAA_len41_fa10_ta10_fm10_tm10*126*g,4,1,43029,1,43035,1.0,126,3016@TOP@human_GAPDH_TAA_len41_fa10_ta10_fm10_tm10,g
3016@TOP@human_GAPDH_TAA_len41_fa10_ta10_fm10_tm10*127*a,43302,4,39,1,43346,0.001,127,3016@TOP@human_GAPDH_TAA_len41_fa10_ta10_fm10_tm10,a
3016@TOP@human_GAPDH_TAA_len41_fa10_ta10_fm10_tm10*128*c,2,43636,4,4,43646,0.0,128,3016@TOP@human_GAPDH_TAA_len41_fa10_ta10_fm10_tm10,c
3016@TOP@human_GAPDH_TAA_len41_fa10_ta10_fm10_tm10*129*c,5,43320,0,5,43330,0.0,129,3016@TOP@human_GAPDH_TAA_len41_fa10_ta10_fm10_tm10,c
3016@TOP@human_GAPDH_TAA_len41_fa10_ta10_fm10_tm10*130*c,5,43575,0,6,43586,0.0,130,3016@TOP@human_GAPDH_TAA_len41_fa10_ta10_fm10_tm10,c
3016@TOP@human_GAPDH_TAA_len41_fa10_ta10_fm10_tm10*131*c,5,43659,1,0,43665,0.0,131,3016@TOP@human_GAPDH_TAA_len41_fa10_ta10_fm10_tm10,c
3016@TOP@human_GAPDH_TAA_len41_fa10_ta10_fm10_tm10*132*t,9,16,11,43072,43108,0.0,132,3016@TOP@human_GAPDH_TAA_len41_fa10_ta10_fm10_tm10,t
3016@TOP@human_GAPDH_TAA_len41_fa10_ta10_fm10_tm10*133*g,4,0,42974,4,42982,1.0,133,3016@TOP@human_GAPDH_TAA_len41_fa10_ta10_fm10_tm10,g
3016@TOP@human_GAPDH_TAA_len41_fa10_ta10_fm10_tm10*134*g,5,4,43205,5,43219,1.0,134,3016@TOP@human_GAPDH_TAA_len41_fa10_ta10_fm10_tm10,g
3017@TOP@human_GAPDH_TAA_len41_fa10_ta10_fm10_tm10*114*t,2,11,0,32312,32325,0.0,114,3017@TOP@human_GAPDH_TAA_len41_fa10_ta10_fm10_tm10,t
3017@TOP@human_GAPDH_TAA_len41_fa10_ta10_fm10_tm10*115*c,1,32512,0,3,32516,0.0,115,3017@TOP@human_GAPDH_TAA_len41_fa10_ta10_fm10_tm10,c
3017@TOP@human_GAPDH_TAA_len41_fa10_ta10_fm10_tm10*116*c,2,32371,0,2,32375,0.0,116,3017@TOP@human_GAPDH_TAA_len41_fa10_ta10_fm10_tm10,c
3017@TOP@human_GAPDH_TAA_len41_fa10_ta10_fm10_tm10*117*a,32318,1,54,1,32374,0.002,117,3017@TOP@human_GAPDH_TAA_len41_fa10_ta10_fm10_tm10,a
3017@TOP@human_GAPDH_TAA_len41_fa10_ta10_fm10_tm10*118*a,31883,0,322,2,32207,0.01,118,3017@TOP@human_GAPDH_TAA_len41_fa10_ta10_fm10_tm10,a
3017@TOP@human_GAPDH_TAA_len41_fa10_ta10_fm10_tm10*119*g,2,0,32129,0,32131,1.0,119,3017@TOP@human_GAPDH_TAA_len41_fa10_ta10_fm10_tm10,g
3017@TOP@human_GAPDH_TAA_len41_fa10_ta10_fm10_tm10*120*g,0,1,32003,1,32005,1.0,120,3017@TOP@human_GAPDH_TAA_len41_fa10_ta10_fm10_tm10,g
3017@TOP@human_GAPDH_TAA_len41_fa10_ta10_fm10_tm10*121*a,32319,0,10,1,32330,0.0,121,3017@TOP@human_GAPDH_TAA_len41_fa10_ta10_fm10_tm10,a
3017@TOP@human_GAPDH_TAA_len41_fa10_ta10_fm10_tm10*122*g,2,0,32373,1,32376,1.0,122,3017@TOP@human_GAPDH_TAA_len41_fa10_ta10_fm10_tm10,g
3017@TOP@human_GAPDH_TAA_len41_fa10_ta10_fm10_tm10*123*t,2,0,2,31975,31979,0.0,123,3017@TOP@human_GAPDH_TAA_len41_fa10_ta10_fm10_tm10,t
3017@TOP@human_GAPDH_TAA_len41_fa10_ta10_fm10_tm10*124*a,25473,1,6410,3,31887,0.201,124,3017@TOP@human_GAPDH_TAA_len41_fa10_ta10_fm10_tm10,a
3017@TOP@human_GAPDH_TAA_len41_fa10_ta10_fm10_tm10*125*a,30718,3,1149,1,31871,0.036,125,3017@TOP@human_GAPDH_TAA_len41_fa10_ta10_fm10_tm10,a
3017@TOP@human_GAPDH_TAA_len41_fa10_ta10_fm10_tm10*126*g,1,1,31982,1,31985,1.0,126,3017@TOP@human_GAPDH_TAA_len41_fa10_ta10_fm10_tm10,g
3017@TOP@human_GAPDH_TAA_len41_fa10_ta10_fm10_tm10*127*a,32255,1,23,0,32279,0.001,127,3017@TOP@human_GAPDH_TAA_len41_fa10_ta10_fm10_tm10,a
3017@TOP@human_GAPDH_TAA_len41_fa10_ta10_fm10_tm10*128*c,1,32417,4,1,32423,0.0,128,3017@TOP@human_GAPDH_TAA_len41_fa10_ta10_fm10_tm10,c
3017@TOP@human_GAPDH_TAA_len41_fa10_ta10_fm10_tm10*129*c,1,32214,0,0,32215,0.0,129,3017@TOP@human_GAPDH_TAA_len41_fa10_ta10_fm10_tm10,c
3017@TOP@human_GAPDH_TAA_len41_fa10_ta10_fm10_tm10*130*c,0,32370,1,0,32371,0.0,130,3017@TOP@human_GAPDH_TAA_len41_fa10_ta10_fm10_tm10,c
3017@TOP@human_GAPDH_TAA_len41_fa10_ta10_fm10_tm10*131*c,4,32455,0,1,32460,0.0,131,3017@TOP@human_GAPDH_TAA_len41_fa10_ta10_fm10_tm10,c
3017@TOP@human_GAPDH_TAA_len41_fa10_ta10_fm10_tm10*132*t,0,6,3,31992,32001,0.0,132,3017@TOP@human_GAPDH_TAA_len41_fa10_ta10_fm10_tm10,t
3017@TOP@human_GAPDH_TAA_len41_fa10_ta10_fm10_tm10*133*g,1,1,31976,1,31979,1.0,133,3017@TOP@human_GAPDH_TAA_len41_fa10_ta10_fm10_tm10,g
3017@TOP@human_GAPDH_TAA_len41_fa10_ta10_fm10_tm10*134*g,3,7,32089,0,32099,1.0,134,3017@TOP@human_GAPDH_TAA_len41_fa10_ta10_fm10_tm10,g
3018@TOP@human_GAPDH_TAA_len41_fa10_ta10_fm10_tm10*114*t,1,9,0,23398,23408,0.0,114,3018@TOP@human_GAPDH_TAA_len41_fa10_ta10_fm10_tm10,t
3018@TOP@human_GAPDH_TAA_len41_fa10_ta10_fm10_tm10*115*c,0,23535,0,1,23536,0.0,115,3018@TOP@human_GAPDH_TAA_len41_fa10_ta10_fm10_tm10,c
3018@TOP@human_GAPDH_TAA_len41_fa10_ta10_fm10_tm10*116*c,1,23444,0,1,23446,0.0,116,3018@TOP@human_GAPDH_TAA_len41_fa10_ta10_fm10_tm10,c
3018@TOP@human_GAPDH_TAA_len41_fa10_ta10_fm10_tm10*117*a,23389,0,36,1,23426,0.002,117,3018@TOP@human_GAPDH_TAA_len41_fa10_ta10_fm10_tm10,a
3018@TOP@human_GAPDH_TAA_len41_fa10_ta10_fm10_tm10*118*a,22979,0,322,0,23301,0.014,118,3018@TOP@human_GAPDH_TAA_len41_fa10_ta10_fm10_tm10,a
3018@TOP@human_GAPDH_TAA_len41_fa10_ta10_fm10_tm10*119*g,2,0,23241,1,23244,1.0,119,3018@TOP@human_GAPDH_TAA_len41_fa10_ta10_fm10_tm10,g
3018@TOP@human_GAPDH_TAA_len41_fa10_ta10_fm10_tm10*120*g,2,0,23169,1,23172,1.0,120,3018@TOP@human_GAPDH_TAA_len41_fa10_ta10_fm10_tm10,g
3018@TOP@human_GAPDH_TAA_len41_fa10_ta10_fm10_tm10*121*a,23404,0,10,0,23414,0.0,121,3018@TOP@human_GAPDH_TAA_len41_fa10_ta10_fm10_tm10,a
3018@TOP@human_GAPDH_TAA_len41_fa10_ta10_fm10_tm10*122*g,1,1,23437,2,23441,1.0,122,3018@TOP@human_GAPDH_TAA_len41_fa10_ta10_fm10_tm10,g
3018@TOP@human_GAPDH_TAA_len41_fa10_ta10_fm10_tm10*123*t,2,2,1,23136,23141,0.0,123,3018@TOP@human_GAPDH_TAA_len41_fa10_ta10_fm10_tm10,t
3018@TOP@human_GAPDH_TAA_len41_fa10_ta10_fm10_tm10*124*a,21005,0,2054,2,23061,0.089,124,3018@TOP@human_GAPDH_TAA_len41_fa10_ta10_fm10_tm10,a
3018@TOP@human_GAPDH_TAA_len41_fa10_ta10_fm10_tm10*125*a,21879,0,1166,2,23047,0.051,125,3018@TOP@human_GAPDH_TAA_len41_fa10_ta10_fm10_tm10,a
3018@TOP@human_GAPDH_TAA_len41_fa10_ta10_fm10_tm10*126*g,3,0,23126,1,23130,1.0,126,3018@TOP@human_GAPDH_TAA_len41_fa10_ta10_fm10_tm10,g
3018@TOP@human_GAPDH_TAA_len41_fa10_ta10_fm10_tm10*127*a,23344,1,10,0,23355,0.0,127,3018@TOP@human_GAPDH_TAA_len41_fa10_ta10_fm10_tm10,a
3018@TOP@human_GAPDH_TAA_len41_fa10_ta10_fm10_tm10*128*c,1,23473,3,0,23477,0.0,128,3018@TOP@human_GAPDH_TAA_len41_fa10_ta10_fm10_tm10,c
3018@TOP@human_GAPDH_TAA_len41_fa10_ta10_fm10_tm10*129*c,1,23339,0,4,23344,0.0,129,3018@TOP@human_GAPDH_TAA_len41_fa10_ta10_fm10_tm10,c
3018@TOP@human_GAPDH_TAA_len41_fa10_ta10_fm10_tm10*130*c,1,23435,0,0,23436,0.0,130,3018@TOP@human_GAPDH_TAA_len41_fa10_ta10_fm10_tm10,c
3018@TOP@human_GAPDH_TAA_len41_fa10_ta10_fm10_tm10*131*c,1,23489,0,4,23494,0.0,131,3018@TOP@human_GAPDH_TAA_len41_fa10_ta10_fm10_tm10,c
3018@TOP@human_GAPDH_TAA_len41_fa10_ta10_fm10_tm10*132*t,4,4,0,23194,23202,0.0,132,3018@TOP@human_GAPDH_TAA_len41_fa10_ta10_fm10_tm10,t
3018@TOP@human_GAPDH_TAA_len41_fa10_ta10_fm10_tm10*133*g,5,1,23132,3,23141,1.0,133,3018@TOP@human_GAPDH_TAA_len41_fa10_ta10_fm10_tm10,g
3018@TOP@human_GAPDH_TAA_len41_fa10_ta10_fm10_tm10*134*g,3,3,23243,1,23250,1.0,134,3018@TOP@human_GAPDH_TAA_len41_fa10_ta10_fm10_tm10,g
3019@TOP@human_GAPDH_TAA_len41_fa10_ta10_fm10_tm10*114*t,1,10,0,25385,25396,0.0,114,3019@TOP@human_GAPDH_TAA_len41_fa10_ta10_fm10_tm10,t
3019@TOP@human_GAPDH_TAA_len41_fa10_ta10_fm10_tm10*115*c,0,25513,1,2,25516,0.0,115,3019@TOP@human_GAPDH_TAA_len41_fa10_ta10_fm10_tm10,c
3019@TOP@human_GAPDH_TAA_len41_fa10_ta10_fm10_tm10*116*c,0,25443,0,1,25444,0.0,116,3019@TOP@human_GAPDH_TAA_len41_fa10_ta10_fm10_tm10,c
3019@TOP@human_GAPDH_TAA_len41_fa10_ta10_fm10_tm10*117*a,25408,0,25,0,25433,0.001,117,3019@TOP@human_GAPDH_TAA_len41_fa10_ta10_fm10_tm10,a
3019@TOP@human_GAPDH_TAA_len41_fa10_ta10_fm10_tm10*118*a,25026,0,269,0,25295,0.011,118,3019@TOP@human_GAPDH_TAA_len41_fa10_ta10_fm10_tm10,a
3019@TOP@human_GAPDH_TAA_len41_fa10_ta10_fm10_tm10*119*g,4,0,25226,0,25230,1.0,119,3019@TOP@human_GAPDH_TAA_len41_fa10_ta10_fm10_tm10,g
3019@TOP@human_GAPDH_TAA_len41_fa10_ta10_fm10_tm10*120*g,1,0,25142,0,25143,1.0,120,3019@TOP@human_GAPDH_TAA_len41_fa10_ta10_fm10_tm10,g
3019@TOP@human_GAPDH_TAA_len41_fa10_ta10_fm10_tm10*121*a,25370,0,2,0,25372,0.0,121,3019@TOP@human_GAPDH_TAA_len41_fa10_ta10_fm10_tm10,a
3019@TOP@human_GAPDH_TAA_len41_fa10_ta10_fm10_tm10*122*g,2,0,25403,1,25406,1.0,122,3019@TOP@human_GAPDH_TAA_len41_fa10_ta10_fm10_tm10,g
3019@TOP@human_GAPDH_TAA_len41_fa10_ta10_fm10_tm10*123*t,1,2,4,25106,25113,0.0,123,3019@TOP@human_GAPDH_TAA_len41_fa10_ta10_fm10_tm10,t
3019@TOP@human_GAPDH_TAA_len41_fa10_ta10_fm10_tm10*124*a,19228,0,5845,1,25074,0.233,124,3019@TOP@human_GAPDH_TAA_len41_fa10_ta10_fm10_tm10,a
3019@TOP@human_GAPDH_TAA_len41_fa10_ta10_fm10_tm10*125*a,23927,0,1140,6,25073,0.045,125,3019@TOP@human_GAPDH_TAA_len41_fa10_ta10_fm10_tm10,a
3019@TOP@human_GAPDH_TAA_len41_fa10_ta10_fm10_tm10*126*g,2,0,25126,2,25130,1.0,126,3019@TOP@human_GAPDH_TAA_len41_fa10_ta10_fm10_tm10,g
3019@TOP@human_GAPDH_TAA_len41_fa10_ta10_fm10_tm10*127*a,25321,0,14,0,25335,0.001,127,3019@TOP@human_GAPDH_TAA_len41_fa10_ta10_fm10_tm10,a
3019@TOP@human_GAPDH_TAA_len41_fa10_ta10_fm10_tm10*128*c,2,25457,2,1,25462,0.0,128,3019@TOP@human_GAPDH_TAA_len41_fa10_ta10_fm10_tm10,c
3019@TOP@human_GAPDH_TAA_len41_fa10_ta10_fm10_tm10*129*c,2,25269,0,1,25272,0.0,129,3019@TOP@human_GAPDH_TAA_len41_fa10_ta10_fm10_tm10,c
3019@TOP@human_GAPDH_TAA_len41_fa10_ta10_fm10_tm10*130*c,0,25418,0,2,25420,0.0,130,3019@TOP@human_GAPDH_TAA_len41_fa10_ta10_fm10_tm10,c
3019@TOP@human_GAPDH_TAA_len41_fa10_ta10_fm10_tm10*131*c,4,25486,0,1,25491,0.0,131,3019@TOP@human_GAPDH_TAA_len41_fa10_ta10_fm10_tm10,c
3019@TOP@human_GAPDH_TAA_len41_fa10_ta10_fm10_tm10*132*t,5,3,0,25137,25145,0.0,132,3019@TOP@human_GAPDH_TAA_len41_fa10_ta10_fm10_tm10,t
3019@TOP@human_GAPDH_TAA_len41_fa10_ta10_fm10_tm10*133*g,1,2,25094,0,25097,1.0,133,3019@TOP@human_GAPDH_TAA_len41_fa10_ta10_fm10_tm10,g
3019@TOP@human_GAPDH_TAA_len41_fa10_ta10_fm10_tm10*134*g,1,6,25204,0,25211,1.0,134,3019@TOP@human_GAPDH_TAA_len41_fa10_ta10_fm10_tm10,g
3020@TOP@human_GAPDH_TAA_len41_fa10_ta10_fm10_tm10*114*t,2,1,0,7104,7107,0.0,114,3020@TOP@human_GAPDH_TAA_len41_fa10_ta10_fm10_tm10,t
3020@TOP@human_GAPDH_TAA_len41_fa10_ta10_fm10_tm10*115*c,0,7143,0,0,7143,0.0,115,3020@TOP@human_GAPDH_TAA_len41_fa10_ta10_fm10_tm10,c
3020@TOP@human_GAPDH_TAA_len41_fa10_ta10_fm10_tm10*116*c,0,7112,0,4,7116,0.0,116,3020@TOP@human_GAPDH_TAA_len41_fa10_ta10_fm10_tm10,c
3020@TOP@human_GAPDH_TAA_len41_fa10_ta10_fm10_tm10*117*a,7058,0,50,0,7108,0.007,117,3020@TOP@human_GAPDH_TAA_len41_fa10_ta10_fm10_tm10,a
3020@TOP@human_GAPDH_TAA_len41_fa10_ta10_fm10_tm10*118*a,4899,0,2172,0,7071,0.307,118,3020@TOP@human_GAPDH_TAA_len41_fa10_ta10_fm10_tm10,a
3020@TOP@human_GAPDH_TAA_len41_fa10_ta10_fm10_tm10*119*g,0,0,7052,1,7053,1.0,119,3020@TOP@human_GAPDH_TAA_len41_fa10_ta10_fm10_tm10,g
3020@TOP@human_GAPDH_TAA_len41_fa10_ta10_fm10_tm10*120*g,0,0,7052,0,7052,1.0,120,3020@TOP@human_GAPDH_TAA_len41_fa10_ta10_fm10_tm10,g
3020@TOP@human_GAPDH_TAA_len41_fa10_ta10_fm10_tm10*121*a,7083,0,2,0,7085,0.0,121,3020@TOP@human_GAPDH_TAA_len41_fa10_ta10_fm10_tm10,a
3020@TOP@human_GAPDH_TAA_len41_fa10_ta10_fm10_tm10*122*g,0,0,7120,1,7121,1.0,122,3020@TOP@human_GAPDH_TAA_len41_fa10_ta10_fm10_tm10,g
3020@TOP@human_GAPDH_TAA_len41_fa10_ta10_fm10_tm10*123*t,0,6,1,7004,7011,0.0,123,3020@TOP@human_GAPDH_TAA_len41_fa10_ta10_fm10_tm10,t
3020@TOP@human_GAPDH_TAA_len41_fa10_ta10_fm10_tm10*124*a,5802,0,1185,1,6988,0.17,124,3020@TOP@human_GAPDH_TAA_len41_fa10_ta10_fm10_tm10,a
3020@TOP@human_GAPDH_TAA_len41_fa10_ta10_fm10_tm10*125*a,6105,0,882,1,6988,0.126,125,3020@TOP@human_GAPDH_TAA_len41_fa10_ta10_fm10_tm10,a
3020@TOP@human_GAPDH_TAA_len41_fa10_ta10_fm10_tm10*126*g,0,0,7036,3,7039,1.0,126,3020@TOP@human_GAPDH_TAA_len41_fa10_ta10_fm10_tm10,g
3020@TOP@human_GAPDH_TAA_len41_fa10_ta10_fm10_tm10*127*a,7068,2,9,0,7079,0.001,127,3020@TOP@human_GAPDH_TAA_len41_fa10_ta10_fm10_tm10,a
3020@TOP@human_GAPDH_TAA_len41_fa10_ta10_fm10_tm10*128*c,0,7128,1,0,7129,0.0,128,3020@TOP@human_GAPDH_TAA_len41_fa10_ta10_fm10_tm10,c
3020@TOP@human_GAPDH_TAA_len41_fa10_ta10_fm10_tm10*129*c,2,7079,0,0,7081,0.0,129,3020@TOP@human_GAPDH_TAA_len41_fa10_ta10_fm10_tm10,c
3020@TOP@human_GAPDH_TAA_len41_fa10_ta10_fm10_tm10*130*c,0,7118,0,0,7118,0.0,130,3020@TOP@human_GAPDH_TAA_len41_fa10_ta10_fm10_tm10,c
3020@TOP@human_GAPDH_TAA_len41_fa10_ta10_fm10_tm10*131*c,0,7130,0,0,7130,0.0,131,3020@TOP@human_GAPDH_TAA_len41_fa10_ta10_fm10_tm10,c
3020@TOP@human_GAPDH_TAA_len41_fa10_ta10_fm10_tm10*132*t,2,4,0,7036,7042,0.0,132,3020@TOP@human_GAPDH_TAA_len41_fa10_ta10_fm10_tm10,t
3020@TOP@human_GAPDH_TAA_len41_fa10_ta10_fm10_tm10*133*g,1,0,7024,2,7027,1.0,133,3020@TOP@human_GAPDH_TAA_len41_fa10_ta10_fm10_tm10,g
3020@TOP@human_GAPDH_TAA_len41_fa10_ta10_fm10_tm10*134*g,1,1,7059,1,7062,1.0,134,3020@TOP@human_GAPDH_TAA_len41_fa10_ta10_fm10_tm10,g
3021@TOP@human_GAPDH_TAA_len41_fa10_ta10_fm10_tm10*114*t,3,4,0,37860,37867,0.0,114,3021@TOP@human_GAPDH_TAA_len41_fa10_ta10_fm10_tm10,t
3021@TOP@human_GAPDH_TAA_len41_fa10_ta10_fm10_tm10*115*c,1,38055,0,1,38057,0.0,115,3021@TOP@human_GAPDH_TAA_len41_fa10_ta10_fm10_tm10,c
3021@TOP@human_GAPDH_TAA_len41_fa10_ta10_fm10_tm10*116*c,1,37879,0,2,37882,0.0,116,3021@TOP@human_GAPDH_TAA_len41_fa10_ta10_fm10_tm10,c
3021@TOP@human_GAPDH_TAA_len41_fa10_ta10_fm10_tm10*117*a,37796,0,61,0,37857,0.002,117,3021@TOP@human_GAPDH_TAA_len41_fa10_ta10_fm10_tm10,a
3021@TOP@human_GAPDH_TAA_len41_fa10_ta10_fm10_tm10*118*a,34155,0,3528,3,37686,0.094,118,3021@TOP@human_GAPDH_TAA_len41_fa10_ta10_fm10_tm10,a
3021@TOP@human_GAPDH_TAA_len41_fa10_ta10_fm10_tm10*119*g,3,0,37605,7,37615,1.0,119,3021@TOP@human_GAPDH_TAA_len41_fa10_ta10_fm10_tm10,g
3021@TOP@human_GAPDH_TAA_len41_fa10_ta10_fm10_tm10*120*g,0,0,37497,3,37500,1.0,120,3021@TOP@human_GAPDH_TAA_len41_fa10_ta10_fm10_tm10,g
3021@TOP@human_GAPDH_TAA_len41_fa10_ta10_fm10_tm10*121*a,37801,0,12,1,37814,0.0,121,3021@TOP@human_GAPDH_TAA_len41_fa10_ta10_fm10_tm10,a
3021@TOP@human_GAPDH_TAA_len41_fa10_ta10_fm10_tm10*122*g,1,0,37921,0,37922,1.0,122,3021@TOP@human_GAPDH_TAA_len41_fa10_ta10_fm10_tm10,g
3021@TOP@human_GAPDH_TAA_len41_fa10_ta10_fm10_tm10*123*t,3,2,8,37325,37338,0.0,123,3021@TOP@human_GAPDH_TAA_len41_fa10_ta10_fm10_tm10,t
3021@TOP@human_GAPDH_TAA_len41_fa10_ta10_fm10_tm10*124*a,32709,1,4580,2,37292,0.123,124,3021@TOP@human_GAPDH_TAA_len41_fa10_ta10_fm10_tm10,a
3021@TOP@human_GAPDH_TAA_len41_fa10_ta10_fm10_tm10*125*a,36468,1,788,1,37258,0.021,125,3021@TOP@human_GAPDH_TAA_len41_fa10_ta10_fm10_tm10,a
3021@TOP@human_GAPDH_TAA_len41_fa10_ta10_fm10_tm10*126*g,0,1,37404,2,37407,1.0,126,3021@TOP@human_GAPDH_TAA_len41_fa10_ta10_fm10_tm10,g
3021@TOP@human_GAPDH_TAA_len41_fa10_ta10_fm10_tm10*127*a,37708,0,22,0,37730,0.001,127,3021@TOP@human_GAPDH_TAA_len41_fa10_ta10_fm10_tm10,a
3021@TOP@human_GAPDH_TAA_len41_fa10_ta10_fm10_tm10*128*c,5,37961,1,1,37968,0.0,128,3021@TOP@human_GAPDH_TAA_len41_fa10_ta10_fm10_tm10,c
3021@TOP@human_GAPDH_TAA_len41_fa10_ta10_fm10_tm10*129*c,1,37687,0,5,37693,0.0,129,3021@TOP@human_GAPDH_TAA_len41_fa10_ta10_fm10_tm10,c
3021@TOP@human_GAPDH_TAA_len41_fa10_ta10_fm10_tm10*130*c,7,37905,0,0,37912,0.0,130,3021@TOP@human_GAPDH_TAA_len41_fa10_ta10_fm10_tm10,c
3021@TOP@human_GAPDH_TAA_len41_fa10_ta10_fm10_tm10*131*c,4,37993,0,5,38002,0.0,131,3021@TOP@human_GAPDH_TAA_len41_fa10_ta10_fm10_tm10,c
3021@TOP@human_GAPDH_TAA_len41_fa10_ta10_fm10_tm10*132*t,3,8,6,37443,37460,0.0,132,3021@TOP@human_GAPDH_TAA_len41_fa10_ta10_fm10_tm10,t
3021@TOP@human_GAPDH_TAA_len41_fa10_ta10_fm10_tm10*133*g,8,1,37362,0,37371,1.0,133,3021@TOP@human_GAPDH_TAA_len41_fa10_ta10_fm10_tm10,g
3021@TOP@human_GAPDH_TAA_len41_fa10_ta10_fm10_tm10*134*g,2,1,37584,0,37587,1.0,134,3021@TOP@human_GAPDH_TAA_len41_fa10_ta10_fm10_tm10,g
3022@TOP@human_GAPDH_TAA_len41_fa10_ta10_fm10_tm10*114*t,1,6,0,18618,18625,0.0,114,3022@TOP@human_GAPDH_TAA_len41_fa10_ta10_fm10_tm10,t
3022@TOP@human_GAPDH_TAA_len41_fa10_ta10_fm10_tm10*115*c,0,18735,0,2,18737,0.0,115,3022@TOP@human_GAPDH_TAA_len41_fa10_ta10_fm10_tm10,c
3022@TOP@human_GAPDH_TAA_len41_fa10_ta10_fm10_tm10*116*c,0,18663,0,0,18663,0.0,116,3022@TOP@human_GAPDH_TAA_len41_fa10_ta10_fm10_tm10,c
3022@TOP@human_GAPDH_TAA_len41_fa10_ta10_fm10_tm10*117*a,18606,0,50,0,18656,0.003,117,3022@TOP@human_GAPDH_TAA_len41_fa10_ta10_fm10_tm10,a
3022@TOP@human_GAPDH_TAA_len41_fa10_ta10_fm10_tm10*118*a,16428,1,2150,0,18579,0.116,118,3022@TOP@human_GAPDH_TAA_len41_fa10_ta10_fm10_tm10,a
3022@TOP@human_GAPDH_TAA_len41_fa10_ta10_fm10_tm10*119*g,3,0,18495,0,18498,1.0,119,3022@TOP@human_GAPDH_TAA_len41_fa10_ta10_fm10_tm10,g
3022@TOP@human_GAPDH_TAA_len41_fa10_ta10_fm10_tm10*120*g,1,0,18467,0,18468,1.0,120,3022@TOP@human_GAPDH_TAA_len41_fa10_ta10_fm10_tm10,g
3022@TOP@human_GAPDH_TAA_len41_fa10_ta10_fm10_tm10*121*a,18622,0,10,0,18632,0.001,121,3022@TOP@human_GAPDH_TAA_len41_fa10_ta10_fm10_tm10,a
3022@TOP@human_GAPDH_TAA_len41_fa10_ta10_fm10_tm10*122*g,0,1,18675,0,18676,1.0,122,3022@TOP@human_GAPDH_TAA_len41_fa10_ta10_fm10_tm10,g
3022@TOP@human_GAPDH_TAA_len41_fa10_ta10_fm10_tm10*123*t,2,0,3,18391,18396,0.0,123,3022@TOP@human_GAPDH_TAA_len41_fa10_ta10_fm10_tm10,t
3022@TOP@human_GAPDH_TAA_len41_fa10_ta10_fm10_tm10*124*a,14726,2,3688,1,18417,0.2,124,3022@TOP@human_GAPDH_TAA_len41_fa10_ta10_fm10_tm10,a
3022@TOP@human_GAPDH_TAA_len41_fa10_ta10_fm10_tm10*125*a,17627,0,792,3,18422,0.043,125,3022@TOP@human_GAPDH_TAA_len41_fa10_ta10_fm10_tm10,a
3022@TOP@human_GAPDH_TAA_len41_fa10_ta10_fm10_tm10*126*g,2,0,18448,1,18451,1.0,126,3022@TOP@human_GAPDH_TAA_len41_fa10_ta10_fm10_tm10,g
3022@TOP@human_GAPDH_TAA_len41_fa10_ta10_fm10_tm10*127*a,18559,2,16,0,18577,0.001,127,3022@TOP@human_GAPDH_TAA_len41_fa10_ta10_fm10_tm10,a
3022@TOP@human_GAPDH_TAA_len41_fa10_ta10_fm10_tm10*128*c,0,18703,3,1,18707,0.0,128,3022@TOP@human_GAPDH_TAA_len41_fa10_ta10_fm10_tm10,c
3022@TOP@human_GAPDH_TAA_len41_fa10_ta10_fm10_tm10*129*c,1,18565,0,0,18566,0.0,129,3022@TOP@human_GAPDH_TAA_len41_fa10_ta10_fm10_tm10,c
3022@TOP@human_GAPDH_TAA_len41_fa10_ta10_fm10_tm10*130*c,0,18671,0,2,18673,0.0,130,3022@TOP@human_GAPDH_TAA_len41_fa10_ta10_fm10_tm10,c
3022@TOP@human_GAPDH_TAA_len41_fa10_ta10_fm10_tm10*131*c,1,18689,3,2,18695,0.0,131,3022@TOP@human_GAPDH_TAA_len41_fa10_ta10_fm10_tm10,c
3022@TOP@human_GAPDH_TAA_len41_fa10_ta10_fm10_tm10*132*t,2,1,0,18463,18466,0.0,132,3022@TOP@human_GAPDH_TAA_len41_fa10_ta10_fm10_tm10,t
3022@TOP@human_GAPDH_TAA_len41_fa10_ta10_fm10_tm10*133*g,1,0,18397,0,18398,1.0,133,3022@TOP@human_GAPDH_TAA_len41_fa10_ta10_fm10_tm10,g
3022@TOP@human_GAPDH_TAA_len41_fa10_ta10_fm10_tm10*134*g,0,8,18512,0,18520,1.0,134,3022@TOP@human_GAPDH_TAA_len41_fa10_ta10_fm10_tm10,g
3023@TOP@human_GAPDH_TAA_len41_fa10_ta10_fm10_tm10*114*t,1,1,0,4017,4019,0.0,114,3023@TOP@human_GAPDH_TAA_len41_fa10_ta10_fm10_tm10,t
3023@TOP@human_GAPDH_TAA_len41_fa10_ta10_fm10_tm10*115*c,0,4033,0,0,4033,0.0,115,3023@TOP@human_GAPDH_TAA_len41_fa10_ta10_fm10_tm10,c
3023@TOP@human_GAPDH_TAA_len41_fa10_ta10_fm10_tm10*116*c,0,3999,0,0,3999,0.0,116,3023@TOP@human_GAPDH_TAA_len41_fa10_ta10_fm10_tm10,c
3023@TOP@human_GAPDH_TAA_len41_fa10_ta10_fm10_tm10*117*a,4008,0,8,0,4016,0.002,117,3023@TOP@human_GAPDH_TAA_len41_fa10_ta10_fm10_tm10,a
3023@TOP@human_GAPDH_TAA_len41_fa10_ta10_fm10_tm10*118*a,3427,0,563,0,3990,0.141,118,3023@TOP@human_GAPDH_TAA_len41_fa10_ta10_fm10_tm10,a
3023@TOP@human_GAPDH_TAA_len41_fa10_ta10_fm10_tm10*119*g,0,0,3966,0,3966,1.0,119,3023@TOP@human_GAPDH_TAA_len41_fa10_ta10_fm10_tm10,g
3023@TOP@human_GAPDH_TAA_len41_fa10_ta10_fm10_tm10*120*g,0,0,3954,0,3954,1.0,120,3023@TOP@human_GAPDH_TAA_len41_fa10_ta10_fm10_tm10,g
3023@TOP@human_GAPDH_TAA_len41_fa10_ta10_fm10_tm10*121*a,3993,0,7,0,4000,0.002,121,3023@TOP@human_GAPDH_TAA_len41_fa10_ta10_fm10_tm10,a
3023@TOP@human_GAPDH_TAA_len41_fa10_ta10_fm10_tm10*122*g,1,0,4006,0,4007,1.0,122,3023@TOP@human_GAPDH_TAA_len41_fa10_ta10_fm10_tm10,g
3023@TOP@human_GAPDH_TAA_len41_fa10_ta10_fm10_tm10*123*t,0,1,0,3966,3967,0.0,123,3023@TOP@human_GAPDH_TAA_len41_fa10_ta10_fm10_tm10,t
3023@TOP@human_GAPDH_TAA_len41_fa10_ta10_fm10_tm10*124*a,2989,0,964,1,3954,0.244,124,3023@TOP@human_GAPDH_TAA_len41_fa10_ta10_fm10_tm10,a
3023@TOP@human_GAPDH_TAA_len41_fa10_ta10_fm10_tm10*125*a,3666,1,293,0,3960,0.074,125,3023@TOP@human_GAPDH_TAA_len41_fa10_ta10_fm10_tm10,a
3023@TOP@human_GAPDH_TAA_len41_fa10_ta10_fm10_tm10*126*g,0,0,3967,2,3969,0.999,126,3023@TOP@human_GAPDH_TAA_len41_fa10_ta10_fm10_tm10,g
3023@TOP@human_GAPDH_TAA_len41_fa10_ta10_fm10_tm10*127*a,3988,0,4,0,3992,0.001,127,3023@TOP@human_GAPDH_TAA_len41_fa10_ta10_fm10_tm10,a
3023@TOP@human_GAPDH_TAA_len41_fa10_ta10_fm10_tm10*128*c,0,4017,0,0,4017,0.0,128,3023@TOP@human_GAPDH_TAA_len41_fa10_ta10_fm10_tm10,c
3023@TOP@human_GAPDH_TAA_len41_fa10_ta10_fm10_tm10*129*c,0,3989,0,0,3989,0.0,129,3023@TOP@human_GAPDH_TAA_len41_fa10_ta10_fm10_tm10,c
3023@TOP@human_GAPDH_TAA_len41_fa10_ta10_fm10_tm10*130*c,0,4017,0,0,4017,0.0,130,3023@TOP@human_GAPDH_TAA_len41_fa10_ta10_fm10_tm10,c
3023@TOP@human_GAPDH_TAA_len41_fa10_ta10_fm10_tm10*131*c,1,4020,0,0,4021,0.0,131,3023@TOP@human_GAPDH_TAA_len41_fa10_ta10_fm10_tm10,c
3023@TOP@human_GAPDH_TAA_len41_fa10_ta10_fm10_tm10*132*t,2,1,0,3955,3958,0.0,132,3023@TOP@human_GAPDH_TAA_len41_fa10_ta10_fm10_tm10,t
3023@TOP@human_GAPDH_TAA_len41_fa10_ta10_fm10_tm10*133*g,0,0,3958,0,3958,1.0,133,3023@TOP@human_GAPDH_TAA_len41_fa10_ta10_fm10_tm10,g
3023@TOP@human_GAPDH_TAA_len41_fa10_ta10_fm10_tm10*134*g,0,3,3975,1,3979,0.999,134,3023@TOP@human_GAPDH_TAA_len41_fa10_ta10_fm10_tm10,g
3024@TOP@human_GAPDH_TAA_len41_fa10_ta10_fm10_tm10*114*t,2,4,0,7394,7400,0.0,114,3024@TOP@human_GAPDH_TAA_len41_fa10_ta10_fm10_tm10,t
3024@TOP@human_GAPDH_TAA_len41_fa10_ta10_fm10_tm10*115*c,0,7435,0,1,7436,0.0,115,3024@TOP@human_GAPDH_TAA_len41_fa10_ta10_fm10_tm10,c
3024@TOP@human_GAPDH_TAA_len41_fa10_ta10_fm10_tm10*116*c,0,7409,0,0,7409,0.0,116,3024@TOP@human_GAPDH_TAA_len41_fa10_ta10_fm10_tm10,c
3024@TOP@human_GAPDH_TAA_len41_fa10_ta10_fm10_tm10*117*a,7365,0,24,0,7389,0.003,117,3024@TOP@human_GAPDH_TAA_len41_fa10_ta10_fm10_tm10,a
3024@TOP@human_GAPDH_TAA_len41_fa10_ta10_fm10_tm10*118*a,6778,0,584,0,7362,0.079,118,3024@TOP@human_GAPDH_TAA_len41_fa10_ta10_fm10_tm10,a
3024@TOP@human_GAPDH_TAA_len41_fa10_ta10_fm10_tm10*119*g,0,0,7340,3,7343,1.0,119,3024@TOP@human_GAPDH_TAA_len41_fa10_ta10_fm10_tm10,g
3024@TOP@human_GAPDH_TAA_len41_fa10_ta10_fm10_tm10*120*g,0,0,7321,0,7321,1.0,120,3024@TOP@human_GAPDH_TAA_len41_fa10_ta10_fm10_tm10,g
3024@TOP@human_GAPDH_TAA_len41_fa10_ta10_fm10_tm10*121*a,7378,1,15,0,7394,0.002,121,3024@TOP@human_GAPDH_TAA_len41_fa10_ta10_fm10_tm10,a
3024@TOP@human_GAPDH_TAA_len41_fa10_ta10_fm10_tm10*122*g,0,0,7410,0,7410,1.0,122,3024@TOP@human_GAPDH_TAA_len41_fa10_ta10_fm10_tm10,g
3024@TOP@human_GAPDH_TAA_len41_fa10_ta10_fm10_tm10*123*t,0,0,2,7312,7314,0.0,123,3024@TOP@human_GAPDH_TAA_len41_fa10_ta10_fm10_tm10,t
3024@TOP@human_GAPDH_TAA_len41_fa10_ta10_fm10_tm10*124*a,4804,0,2502,0,7306,0.342,124,3024@TOP@human_GAPDH_TAA_len41_fa10_ta10_fm10_tm10,a
3024@TOP@human_GAPDH_TAA_len41_fa10_ta10_fm10_tm10*125*a,6378,0,931,3,7312,0.127,125,3024@TOP@human_GAPDH_TAA_len41_fa10_ta10_fm10_tm10,a
3024@TOP@human_GAPDH_TAA_len41_fa10_ta10_fm10_tm10*126*g,0,0,7313,0,7313,1.0,126,3024@TOP@human_GAPDH_TAA_len41_fa10_ta10_fm10_tm10,g
3024@TOP@human_GAPDH_TAA_len41_fa10_ta10_fm10_tm10*127*a,7359,3,10,0,7372,0.001,127,3024@TOP@human_GAPDH_TAA_len41_fa10_ta10_fm10_tm10,a
3024@TOP@human_GAPDH_TAA_len41_fa10_ta10_fm10_tm10*128*c,0,7421,0,0,7421,0.0,128,3024@TOP@human_GAPDH_TAA_len41_fa10_ta10_fm10_tm10,c
3024@TOP@human_GAPDH_TAA_len41_fa10_ta10_fm10_tm10*129*c,0,7363,0,2,7365,0.0,129,3024@TOP@human_GAPDH_TAA_len41_fa10_ta10_fm10_tm10,c
3024@TOP@human_GAPDH_TAA_len41_fa10_ta10_fm10_tm10*130*c,0,7400,0,3,7403,0.0,130,3024@TOP@human_GAPDH_TAA_len41_fa10_ta10_fm10_tm10,c
3024@TOP@human_GAPDH_TAA_len41_fa10_ta10_fm10_tm10*131*c,0,7416,0,0,7416,0.0,131,3024@TOP@human_GAPDH_TAA_len41_fa10_ta10_fm10_tm10,c
3024@TOP@human_GAPDH_TAA_len41_fa10_ta10_fm10_tm10*132*t,2,1,0,7322,7325,0.0,132,3024@TOP@human_GAPDH_TAA_len41_fa10_ta10_fm10_tm10,t
3024@TOP@human_GAPDH_TAA_len41_fa10_ta10_fm10_tm10*133*g,1,0,7301,0,7302,1.0,133,3024@TOP@human_GAPDH_TAA_len41_fa10_ta10_fm10_tm10,g
3024@TOP@human_GAPDH_TAA_len41_fa10_ta10_fm10_tm10*134*g,2,3,7345,0,7350,0.999,134,3024@TOP@human_GAPDH_TAA_len41_fa10_ta10_fm10_tm10,g
3025@TOP@human_GAPDH_TAA_len41_fa10_ta10_fm10_tm10*114*t,0,4,0,4353,4357,0.0,114,3025@TOP@human_GAPDH_TAA_len41_fa10_ta10_fm10_tm10,t
3025@TOP@human_GAPDH_TAA_len41_fa10_ta10_fm10_tm10*115*c,0,4384,0,0,4384,0.0,115,3025@TOP@human_GAPDH_TAA_len41_fa10_ta10_fm10_tm10,c
3025@TOP@human_GAPDH_TAA_len41_fa10_ta10_fm10_tm10*116*c,0,4365,0,0,4365,0.0,116,3025@TOP@human_GAPDH_TAA_len41_fa10_ta10_fm10_tm10,c
3025@TOP@human_GAPDH_TAA_len41_fa10_ta10_fm10_tm10*117*a,4164,0,196,0,4360,0.045,117,3025@TOP@human_GAPDH_TAA_len41_fa10_ta10_fm10_tm10,a
3025@TOP@human_GAPDH_TAA_len41_fa10_ta10_fm10_tm10*118*a,3111,0,1224,0,4335,0.282,118,3025@TOP@human_GAPDH_TAA_len41_fa10_ta10_fm10_tm10,a
3025@TOP@human_GAPDH_TAA_len41_fa10_ta10_fm10_tm10*119*g,0,0,4329,0,4329,1.0,119,3025@TOP@human_GAPDH_TAA_len41_fa10_ta10_fm10_tm10,g
3025@TOP@human_GAPDH_TAA_len41_fa10_ta10_fm10_tm10*120*g,0,0,4327,1,4328,1.0,120,3025@TOP@human_GAPDH_TAA_len41_fa10_ta10_fm10_tm10,g
3025@TOP@human_GAPDH_TAA_len41_fa10_ta10_fm10_tm10*121*a,4349,0,1,2,4352,0.0,121,3025@TOP@human_GAPDH_TAA_len41_fa10_ta10_fm10_tm10,a
3025@TOP@human_GAPDH_TAA_len41_fa10_ta10_fm10_tm10*122*g,0,0,4369,0,4369,1.0,122,3025@TOP@human_GAPDH_TAA_len41_fa10_ta10_fm10_tm10,g
3025@TOP@human_GAPDH_TAA_len41_fa10_ta10_fm10_tm10*123*t,1,0,0,4316,4317,0.0,123,3025@TOP@human_GAPDH_TAA_len41_fa10_ta10_fm10_tm10,t
3025@TOP@human_GAPDH_TAA_len41_fa10_ta10_fm10_tm10*124*a,3630,1,654,0,4285,0.153,124,3025@TOP@human_GAPDH_TAA_len41_fa10_ta10_fm10_tm10,a
3025@TOP@human_GAPDH_TAA_len41_fa10_ta10_fm10_tm10*125*a,4141,0,139,1,4281,0.032,125,3025@TOP@human_GAPDH_TAA_len41_fa10_ta10_fm10_tm10,a
3025@TOP@human_GAPDH_TAA_len41_fa10_ta10_fm10_tm10*126*g,0,0,4311,0,4311,1.0,126,3025@TOP@human_GAPDH_TAA_len41_fa10_ta10_fm10_tm10,g
3025@TOP@human_GAPDH_TAA_len41_fa10_ta10_fm10_tm10*127*a,4343,0,10,1,4354,0.002,127,3025@TOP@human_GAPDH_TAA_len41_fa10_ta10_fm10_tm10,a
3025@TOP@human_GAPDH_TAA_len41_fa10_ta10_fm10_tm10*128*c,0,4374,0,0,4374,0.0,128,3025@TOP@human_GAPDH_TAA_len41_fa10_ta10_fm10_tm10,c
3025@TOP@human_GAPDH_TAA_len41_fa10_ta10_fm10_tm10*129*c,1,4328,0,1,4330,0.0,129,3025@TOP@human_GAPDH_TAA_len41_fa10_ta10_fm10_tm10,c
3025@TOP@human_GAPDH_TAA_len41_fa10_ta10_fm10_tm10*130*c,0,4359,3,0,4362,0.001,130,3025@TOP@human_GAPDH_TAA_len41_fa10_ta10_fm10_tm10,c
3025@TOP@human_GAPDH_TAA_len41_fa10_ta10_fm10_tm10*131*c,0,4366,0,0,4366,0.0,131,3025@TOP@human_GAPDH_TAA_len41_fa10_ta10_fm10_tm10,c
3025@TOP@human_GAPDH_TAA_len41_fa10_ta10_fm10_tm10*132*t,1,3,0,4297,4301,0.0,132,3025@TOP@human_GAPDH_TAA_len41_fa10_ta10_fm10_tm10,t
3025@TOP@human_GAPDH_TAA_len41_fa10_ta10_fm10_tm10*133*g,1,0,4299,1,4301,1.0,133,3025@TOP@human_GAPDH_TAA_len41_fa10_ta10_fm10_tm10,g
3025@TOP@human_GAPDH_TAA_len41_fa10_ta10_fm10_tm10*134*g,0,1,4321,0,4322,1.0,134,3025@TOP@human_GAPDH_TAA_len41_fa10_ta10_fm10_tm10,g
3026@TOP@human_GAPDH_TAA_len41_fa10_ta10_fm10_tm10*114*t,0,1,0,3257,3258,0.0,114,3026@TOP@human_GAPDH_TAA_len41_fa10_ta10_fm10_tm10,t
3026@TOP@human_GAPDH_TAA_len41_fa10_ta10_fm10_tm10*115*c,0,3272,0,1,3273,0.0,115,3026@TOP@human_GAPDH_TAA_len41_fa10_ta10_fm10_tm10,c
3026@TOP@human_GAPDH_TAA_len41_fa10_ta10_fm10_tm10*116*c,0,3255,0,0,3255,0.0,116,3026@TOP@human_GAPDH_TAA_len41_fa10_ta10_fm10_tm10,c
3026@TOP@human_GAPDH_TAA_len41_fa10_ta10_fm10_tm10*117*a,3036,0,215,0,3251,0.066,117,3026@TOP@human_GAPDH_TAA_len41_fa10_ta10_fm10_tm10,a
3026@TOP@human_GAPDH_TAA_len41_fa10_ta10_fm10_tm10*118*a,2392,0,849,0,3241,0.262,118,3026@TOP@human_GAPDH_TAA_len41_fa10_ta10_fm10_tm10,a
3026@TOP@human_GAPDH_TAA_len41_fa10_ta10_fm10_tm10*119*g,0,0,3231,0,3231,1.0,119,3026@TOP@human_GAPDH_TAA_len41_fa10_ta10_fm10_tm10,g
3026@TOP@human_GAPDH_TAA_len41_fa10_ta10_fm10_tm10*120*g,0,0,3234,0,3234,1.0,120,3026@TOP@human_GAPDH_TAA_len41_fa10_ta10_fm10_tm10,g
3026@TOP@human_GAPDH_TAA_len41_fa10_ta10_fm10_tm10*121*a,3243,0,0,0,3243,0.0,121,3026@TOP@human_GAPDH_TAA_len41_fa10_ta10_fm10_tm10,a
3026@TOP@human_GAPDH_TAA_len41_fa10_ta10_fm10_tm10*122*g,0,0,3259,0,3259,1.0,122,3026@TOP@human_GAPDH_TAA_len41_fa10_ta10_fm10_tm10,g
3026@TOP@human_GAPDH_TAA_len41_fa10_ta10_fm10_tm10*123*t,0,0,0,3202,3202,0.0,123,3026@TOP@human_GAPDH_TAA_len41_fa10_ta10_fm10_tm10,t
3026@TOP@human_GAPDH_TAA_len41_fa10_ta10_fm10_tm10*124*a,3063,0,136,0,3199,0.043,124,3026@TOP@human_GAPDH_TAA_len41_fa10_ta10_fm10_tm10,a
3026@TOP@human_GAPDH_TAA_len41_fa10_ta10_fm10_tm10*125*a,3136,1,57,0,3194,0.018,125,3026@TOP@human_GAPDH_TAA_len41_fa10_ta10_fm10_tm10,a
3026@TOP@human_GAPDH_TAA_len41_fa10_ta10_fm10_tm10*126*g,0,0,3208,0,3208,1.0,126,3026@TOP@human_GAPDH_TAA_len41_fa10_ta10_fm10_tm10,g
3026@TOP@human_GAPDH_TAA_len41_fa10_ta10_fm10_tm10*127*a,3255,0,0,0,3255,0.0,127,3026@TOP@human_GAPDH_TAA_len41_fa10_ta10_fm10_tm10,a
3026@TOP@human_GAPDH_TAA_len41_fa10_ta10_fm10_tm10*128*c,0,3266,0,0,3266,0.0,128,3026@TOP@human_GAPDH_TAA_len41_fa10_ta10_fm10_tm10,c
3026@TOP@human_GAPDH_TAA_len41_fa10_ta10_fm10_tm10*129*c,0,3232,0,0,3232,0.0,129,3026@TOP@human_GAPDH_TAA_len41_fa10_ta10_fm10_tm10,c
3026@TOP@human_GAPDH_TAA_len41_fa10_ta10_fm10_tm10*130*c,0,3260,0,3,3263,0.0,130,3026@TOP@human_GAPDH_TAA_len41_fa10_ta10_fm10_tm10,c
3026@TOP@human_GAPDH_TAA_len41_fa10_ta10_fm10_tm10*131*c,1,3262,0,1,3264,0.0,131,3026@TOP@human_GAPDH_TAA_len41_fa10_ta10_fm10_tm10,c
3026@TOP@human_GAPDH_TAA_len41_fa10_ta10_fm10_tm10*132*t,0,4,0,3207,3211,0.0,132,3026@TOP@human_GAPDH_TAA_len41_fa10_ta10_fm10_tm10,t
3026@TOP@human_GAPDH_TAA_len41_fa10_ta10_fm10_tm10*133*g,0,0,3216,0,3216,1.0,133,3026@TOP@human_GAPDH_TAA_len41_fa10_ta10_fm10_tm10,g
3026@TOP@human_GAPDH_TAA_len41_fa10_ta10_fm10_tm10*134*g,3,0,3230,0,3233,0.999,134,3026@TOP@human_GAPDH_TAA_len41_fa10_ta10_fm10_tm10,g
3027@TOP@human_GAPDH_TAA_len41_fa10_ta10_fm10_tm10*114*t,2,9,0,24703,24714,0.0,114,3027@TOP@human_GAPDH_TAA_len41_fa10_ta10_fm10_tm10,t
3027@TOP@human_GAPDH_TAA_len41_fa10_ta10_fm10_tm10*115*c,1,24859,0,1,24861,0.0,115,3027@TOP@human_GAPDH_TAA_len41_fa10_ta10_fm10_tm10,c
3027@TOP@human_GAPDH_TAA_len41_fa10_ta10_fm10_tm10*116*c,1,24770,0,1,24772,0.0,116,3027@TOP@human_GAPDH_TAA_len41_fa10_ta10_fm10_tm10,c
3027@TOP@human_GAPDH_TAA_len41_fa10_ta10_fm10_tm10*117*a,24731,0,45,1,24777,0.002,117,3027@TOP@human_GAPDH_TAA_len41_fa10_ta10_fm10_tm10,a
3027@TOP@human_GAPDH_TAA_len41_fa10_ta10_fm10_tm10*118*a,23698,0,940,0,24638,0.038,118,3027@TOP@human_GAPDH_TAA_len41_fa10_ta10_fm10_tm10,a
3027@TOP@human_GAPDH_TAA_len41_fa10_ta10_fm10_tm10*119*g,1,0,24581,0,24582,1.0,119,3027@TOP@human_GAPDH_TAA_len41_fa10_ta10_fm10_tm10,g
3027@TOP@human_GAPDH_TAA_len41_fa10_ta10_fm10_tm10*120*g,1,0,24512,1,24514,1.0,120,3027@TOP@human_GAPDH_TAA_len41_fa10_ta10_fm10_tm10,g
3027@TOP@human_GAPDH_TAA_len41_fa10_ta10_fm10_tm10*121*a,24699,0,6,0,24705,0.0,121,3027@TOP@human_GAPDH_TAA_len41_fa10_ta10_fm10_tm10,a
3027@TOP@human_GAPDH_TAA_len41_fa10_ta10_fm10_tm10*122*g,1,0,24763,0,24764,1.0,122,3027@TOP@human_GAPDH_TAA_len41_fa10_ta10_fm10_tm10,g
3027@TOP@human_GAPDH_TAA_len41_fa10_ta10_fm10_tm10*123*t,0,0,13,24440,24453,0.001,123,3027@TOP@human_GAPDH_TAA_len41_fa10_ta10_fm10_tm10,t
3027@TOP@human_GAPDH_TAA_len41_fa10_ta10_fm10_tm10*124*a,21962,1,2393,1,24357,0.098,124,3027@TOP@human_GAPDH_TAA_len41_fa10_ta10_fm10_tm10,a
3027@TOP@human_GAPDH_TAA_len41_fa10_ta10_fm10_tm10*125*a,23577,0,750,3,24330,0.031,125,3027@TOP@human_GAPDH_TAA_len41_fa10_ta10_fm10_tm10,a
3027@TOP@human_GAPDH_TAA_len41_fa10_ta10_fm10_tm10*126*g,2,0,24451,1,24454,1.0,126,3027@TOP@human_GAPDH_TAA_len41_fa10_ta10_fm10_tm10,g
3027@TOP@human_GAPDH_TAA_len41_fa10_ta10_fm10_tm10*127*a,24642,1,21,2,24666,0.001,127,3027@TOP@human_GAPDH_TAA_len41_fa10_ta10_fm10_tm10,a
3027@TOP@human_GAPDH_TAA_len41_fa10_ta10_fm10_tm10*128*c,1,24793,2,0,24796,0.0,128,3027@TOP@human_GAPDH_TAA_len41_fa10_ta10_fm10_tm10,c
3027@TOP@human_GAPDH_TAA_len41_fa10_ta10_fm10_tm10*129*c,3,24658,0,1,24662,0.0,129,3027@TOP@human_GAPDH_TAA_len41_fa10_ta10_fm10_tm10,c
3027@TOP@human_GAPDH_TAA_len41_fa10_ta10_fm10_tm10*130*c,2,24766,0,2,24770,0.0,130,3027@TOP@human_GAPDH_TAA_len41_fa10_ta10_fm10_tm10,c
3027@TOP@human_GAPDH_TAA_len41_fa10_ta10_fm10_tm10*131*c,2,24819,0,0,24821,0.0,131,3027@TOP@human_GAPDH_TAA_len41_fa10_ta10_fm10_tm10,c
3027@TOP@human_GAPDH_TAA_len41_fa10_ta10_fm10_tm10*132*t,3,4,5,24493,24505,0.0,132,3027@TOP@human_GAPDH_TAA_len41_fa10_ta10_fm10_tm10,t
3027@TOP@human_GAPDH_TAA_len41_fa10_ta10_fm10_tm10*133*g,6,2,24446,0,24454,1.0,133,3027@TOP@human_GAPDH_TAA_len41_fa10_ta10_fm10_tm10,g
3027@TOP@human_GAPDH_TAA_len41_fa10_ta10_fm10_tm10*134*g,2,8,24575,0,24585,1.0,134,3027@TOP@human_GAPDH_TAA_len41_fa10_ta10_fm10_tm10,g
3028@TOP@human_GAPDH_TAA_len41_fa10_ta10_fm10_tm10*114*t,1,11,1,27674,27687,0.0,114,3028@TOP@human_GAPDH_TAA_len41_fa10_ta10_fm10_tm10,t
3028@TOP@human_GAPDH_TAA_len41_fa10_ta10_fm10_tm10*115*c,0,27836,0,0,27836,0.0,115,3028@TOP@human_GAPDH_TAA_len41_fa10_ta10_fm10_tm10,c
3028@TOP@human_GAPDH_TAA_len41_fa10_ta10_fm10_tm10*116*c,0,27719,0,5,27724,0.0,116,3028@TOP@human_GAPDH_TAA_len41_fa10_ta10_fm10_tm10,c
3028@TOP@human_GAPDH_TAA_len41_fa10_ta10_fm10_tm10*117*a,27670,0,35,0,27705,0.001,117,3028@TOP@human_GAPDH_TAA_len41_fa10_ta10_fm10_tm10,a
3028@TOP@human_GAPDH_TAA_len41_fa10_ta10_fm10_tm10*118*a,26854,1,684,0,27539,0.025,118,3028@TOP@human_GAPDH_TAA_len41_fa10_ta10_fm10_tm10,a
3028@TOP@human_GAPDH_TAA_len41_fa10_ta10_fm10_tm10*119*g,2,1,27534,2,27539,1.0,119,3028@TOP@human_GAPDH_TAA_len41_fa10_ta10_fm10_tm10,g
3028@TOP@human_GAPDH_TAA_len41_fa10_ta10_fm10_tm10*120*g,1,1,27375,3,27380,1.0,120,3028@TOP@human_GAPDH_TAA_len41_fa10_ta10_fm10_tm10,g
3028@TOP@human_GAPDH_TAA_len41_fa10_ta10_fm10_tm10*121*a,27679,0,12,0,27691,0.0,121,3028@TOP@human_GAPDH_TAA_len41_fa10_ta10_fm10_tm10,a
3028@TOP@human_GAPDH_TAA_len41_fa10_ta10_fm10_tm10*122*g,1,0,27718,0,27719,1.0,122,3028@TOP@human_GAPDH_TAA_len41_fa10_ta10_fm10_tm10,g
3028@TOP@human_GAPDH_TAA_len41_fa10_ta10_fm10_tm10*123*t,2,1,4,27394,27401,0.0,123,3028@TOP@human_GAPDH_TAA_len41_fa10_ta10_fm10_tm10,t
3028@TOP@human_GAPDH_TAA_len41_fa10_ta10_fm10_tm10*124*a,22108,0,5202,1,27311,0.19,124,3028@TOP@human_GAPDH_TAA_len41_fa10_ta10_fm10_tm10,a
3028@TOP@human_GAPDH_TAA_len41_fa10_ta10_fm10_tm10*125*a,26766,3,502,6,27277,0.018,125,3028@TOP@human_GAPDH_TAA_len41_fa10_ta10_fm10_tm10,a
3028@TOP@human_GAPDH_TAA_len41_fa10_ta10_fm10_tm10*126*g,0,0,27391,0,27391,1.0,126,3028@TOP@human_GAPDH_TAA_len41_fa10_ta10_fm10_tm10,g
3028@TOP@human_GAPDH_TAA_len41_fa10_ta10_fm10_tm10*127*a,27635,2,15,0,27652,0.001,127,3028@TOP@human_GAPDH_TAA_len41_fa10_ta10_fm10_tm10,a
3028@TOP@human_GAPDH_TAA_len41_fa10_ta10_fm10_tm10*128*c,0,27777,1,0,27778,0.0,128,3028@TOP@human_GAPDH_TAA_len41_fa10_ta10_fm10_tm10,c
3028@TOP@human_GAPDH_TAA_len41_fa10_ta10_fm10_tm10*129*c,2,27592,0,0,27594,0.0,129,3028@TOP@human_GAPDH_TAA_len41_fa10_ta10_fm10_tm10,c
3028@TOP@human_GAPDH_TAA_len41_fa10_ta10_fm10_tm10*130*c,2,27733,0,3,27738,0.0,130,3028@TOP@human_GAPDH_TAA_len41_fa10_ta10_fm10_tm10,c
3028@TOP@human_GAPDH_TAA_len41_fa10_ta10_fm10_tm10*131*c,5,27782,0,2,27789,0.0,131,3028@TOP@human_GAPDH_TAA_len41_fa10_ta10_fm10_tm10,c
3028@TOP@human_GAPDH_TAA_len41_fa10_ta10_fm10_tm10*132*t,3,3,1,27448,27455,0.0,132,3028@TOP@human_GAPDH_TAA_len41_fa10_ta10_fm10_tm10,t
3028@TOP@human_GAPDH_TAA_len41_fa10_ta10_fm10_tm10*133*g,1,0,27355,1,27357,1.0,133,3028@TOP@human_GAPDH_TAA_len41_fa10_ta10_fm10_tm10,g
3028@TOP@human_GAPDH_TAA_len41_fa10_ta10_fm10_tm10*134*g,0,4,27442,1,27447,1.0,134,3028@TOP@human_GAPDH_TAA_len41_fa10_ta10_fm10_tm10,g
3029@TOP@human_GAPDH_TAA_len41_fa10_ta10_fm10_tm10*114*t,4,2,0,19555,19561,0.0,114,3029@TOP@human_GAPDH_TAA_len41_fa10_ta10_fm10_tm10,t
3029@TOP@human_GAPDH_TAA_len41_fa10_ta10_fm10_tm10*115*c,0,19667,0,2,19669,0.0,115,3029@TOP@human_GAPDH_TAA_len41_fa10_ta10_fm10_tm10,c
3029@TOP@human_GAPDH_TAA_len41_fa10_ta10_fm10_tm10*116*c,0,19586,0,0,19586,0.0,116,3029@TOP@human_GAPDH_TAA_len41_fa10_ta10_fm10_tm10,c
3029@TOP@human_GAPDH_TAA_len41_fa10_ta10_fm10_tm10*117*a,19482,0,56,0,19538,0.003,117,3029@TOP@human_GAPDH_TAA_len41_fa10_ta10_fm10_tm10,a
3029@TOP@human_GAPDH_TAA_len41_fa10_ta10_fm10_tm10*118*a,18372,0,1029,1,19402,0.053,118,3029@TOP@human_GAPDH_TAA_len41_fa10_ta10_fm10_tm10,a
3029@TOP@human_GAPDH_TAA_len41_fa10_ta10_fm10_tm10*119*g,0,0,19428,2,19430,1.0,119,3029@TOP@human_GAPDH_TAA_len41_fa10_ta10_fm10_tm10,g
3029@TOP@human_GAPDH_TAA_len41_fa10_ta10_fm10_tm10*120*g,1,1,19343,2,19347,1.0,120,3029@TOP@human_GAPDH_TAA_len41_fa10_ta10_fm10_tm10,g
3029@TOP@human_GAPDH_TAA_len41_fa10_ta10_fm10_tm10*121*a,19530,0,12,0,19542,0.001,121,3029@TOP@human_GAPDH_TAA_len41_fa10_ta10_fm10_tm10,a
3029@TOP@human_GAPDH_TAA_len41_fa10_ta10_fm10_tm10*122*g,4,0,19583,0,19587,1.0,122,3029@TOP@human_GAPDH_TAA_len41_fa10_ta10_fm10_tm10,g
3029@TOP@human_GAPDH_TAA_len41_fa10_ta10_fm10_tm10*123*t,2,1,1,19324,19328,0.0,123,3029@TOP@human_GAPDH_TAA_len41_fa10_ta10_fm10_tm10,t
3029@TOP@human_GAPDH_TAA_len41_fa10_ta10_fm10_tm10*124*a,16452,0,2774,0,19226,0.144,124,3029@TOP@human_GAPDH_TAA_len41_fa10_ta10_fm10_tm10,a
3029@TOP@human_GAPDH_TAA_len41_fa10_ta10_fm10_tm10*125*a,18287,3,948,2,19240,0.049,125,3029@TOP@human_GAPDH_TAA_len41_fa10_ta10_fm10_tm10,a
3029@TOP@human_GAPDH_TAA_len41_fa10_ta10_fm10_tm10*126*g,0,0,19318,1,19319,1.0,126,3029@TOP@human_GAPDH_TAA_len41_fa10_ta10_fm10_tm10,g
3029@TOP@human_GAPDH_TAA_len41_fa10_ta10_fm10_tm10*127*a,19460,0,28,0,19488,0.001,127,3029@TOP@human_GAPDH_TAA_len41_fa10_ta10_fm10_tm10,a
3029@TOP@human_GAPDH_TAA_len41_fa10_ta10_fm10_tm10*128*c,0,19605,1,0,19606,0.0,128,3029@TOP@human_GAPDH_TAA_len41_fa10_ta10_fm10_tm10,c
3029@TOP@human_GAPDH_TAA_len41_fa10_ta10_fm10_tm10*129*c,0,19479,0,1,19480,0.0,129,3029@TOP@human_GAPDH_TAA_len41_fa10_ta10_fm10_tm10,c
3029@TOP@human_GAPDH_TAA_len41_fa10_ta10_fm10_tm10*130*c,0,19574,0,1,19575,0.0,130,3029@TOP@human_GAPDH_TAA_len41_fa10_ta10_fm10_tm10,c
3029@TOP@human_GAPDH_TAA_len41_fa10_ta10_fm10_tm10*131*c,1,19621,1,6,19629,0.0,131,3029@TOP@human_GAPDH_TAA_len41_fa10_ta10_fm10_tm10,c
3029@TOP@human_GAPDH_TAA_len41_fa10_ta10_fm10_tm10*132*t,1,6,2,19330,19339,0.0,132,3029@TOP@human_GAPDH_TAA_len41_fa10_ta10_fm10_tm10,t
3029@TOP@human_GAPDH_TAA_len41_fa10_ta10_fm10_tm10*133*g,2,0,19299,3,19304,1.0,133,3029@TOP@human_GAPDH_TAA_len41_fa10_ta10_fm10_tm10,g
3029@TOP@human_GAPDH_TAA_len41_fa10_ta10_fm10_tm10*134*g,0,5,19384,1,19390,1.0,134,3029@TOP@human_GAPDH_TAA_len41_fa10_ta10_fm10_tm10,g
3030@TOP@human_GAPDH_TAA_len41_fa10_ta10_fm10_tm10*114*t,0,0,0,4115,4115,0.0,114,3030@TOP@human_GAPDH_TAA_len41_fa10_ta10_fm10_tm10,t
3030@TOP@human_GAPDH_TAA_len41_fa10_ta10_fm10_tm10*115*c,0,4126,0,3,4129,0.0,115,3030@TOP@human_GAPDH_TAA_len41_fa10_ta10_fm10_tm10,c
3030@TOP@human_GAPDH_TAA_len41_fa10_ta10_fm10_tm10*116*c,1,4108,0,0,4109,0.0,116,3030@TOP@human_GAPDH_TAA_len41_fa10_ta10_fm10_tm10,c
3030@TOP@human_GAPDH_TAA_len41_fa10_ta10_fm10_tm10*117*a,4054,0,52,0,4106,0.013,117,3030@TOP@human_GAPDH_TAA_len41_fa10_ta10_fm10_tm10,a
3030@TOP@human_GAPDH_TAA_len41_fa10_ta10_fm10_tm10*118*a,2746,0,1329,0,4075,0.326,118,3030@TOP@human_GAPDH_TAA_len41_fa10_ta10_fm10_tm10,a
3030@TOP@human_GAPDH_TAA_len41_fa10_ta10_fm10_tm10*119*g,0,0,4079,0,4079,1.0,119,3030@TOP@human_GAPDH_TAA_len41_fa10_ta10_fm10_tm10,g
3030@TOP@human_GAPDH_TAA_len41_fa10_ta10_fm10_tm10*120*g,0,0,4063,0,4063,1.0,120,3030@TOP@human_GAPDH_TAA_len41_fa10_ta10_fm10_tm10,g
3030@TOP@human_GAPDH_TAA_len41_fa10_ta10_fm10_tm10*121*a,4067,0,15,0,4082,0.004,121,3030@TOP@human_GAPDH_TAA_len41_fa10_ta10_fm10_tm10,a
3030@TOP@human_GAPDH_TAA_len41_fa10_ta10_fm10_tm10*122*g,0,0,4114,0,4114,1.0,122,3030@TOP@human_GAPDH_TAA_len41_fa10_ta10_fm10_tm10,g
3030@TOP@human_GAPDH_TAA_len41_fa10_ta10_fm10_tm10*123*t,0,2,1,4040,4043,0.0,123,3030@TOP@human_GAPDH_TAA_len41_fa10_ta10_fm10_tm10,t
3030@TOP@human_GAPDH_TAA_len41_fa10_ta10_fm10_tm10*124*a,3808,0,217,0,4025,0.054,124,3030@TOP@human_GAPDH_TAA_len41_fa10_ta10_fm10_tm10,a
3030@TOP@human_GAPDH_TAA_len41_fa10_ta10_fm10_tm10*125*a,3734,1,293,0,4028,0.073,125,3030@TOP@human_GAPDH_TAA_len41_fa10_ta10_fm10_tm10,a
3030@TOP@human_GAPDH_TAA_len41_fa10_ta10_fm10_tm10*126*g,0,0,4042,0,4042,1.0,126,3030@TOP@human_GAPDH_TAA_len41_fa10_ta10_fm10_tm10,g
3030@TOP@human_GAPDH_TAA_len41_fa10_ta10_fm10_tm10*127*a,4085,0,10,1,4096,0.002,127,3030@TOP@human_GAPDH_TAA_len41_fa10_ta10_fm10_tm10,a
3030@TOP@human_GAPDH_TAA_len41_fa10_ta10_fm10_tm10*128*c,0,4112,0,0,4112,0.0,128,3030@TOP@human_GAPDH_TAA_len41_fa10_ta10_fm10_tm10,c
3030@TOP@human_GAPDH_TAA_len41_fa10_ta10_fm10_tm10*129*c,0,4087,0,0,4087,0.0,129,3030@TOP@human_GAPDH_TAA_len41_fa10_ta10_fm10_tm10,c
3030@TOP@human_GAPDH_TAA_len41_fa10_ta10_fm10_tm10*130*c,0,4117,0,0,4117,0.0,130,3030@TOP@human_GAPDH_TAA_len41_fa10_ta10_fm10_tm10,c
3030@TOP@human_GAPDH_TAA_len41_fa10_ta10_fm10_tm10*131*c,0,4118,0,0,4118,0.0,131,3030@TOP@human_GAPDH_TAA_len41_fa10_ta10_fm10_tm10,c
3030@TOP@human_GAPDH_TAA_len41_fa10_ta10_fm10_tm10*132*t,1,0,0,4054,4055,0.0,132,3030@TOP@human_GAPDH_TAA_len41_fa10_ta10_fm10_tm10,t
3030@TOP@human_GAPDH_TAA_len41_fa10_ta10_fm10_tm10*133*g,1,0,4055,0,4056,1.0,133,3030@TOP@human_GAPDH_TAA_len41_fa10_ta10_fm10_tm10,g
3030@TOP@human_GAPDH_TAA_len41_fa10_ta10_fm10_tm10*134*g,0,5,4066,0,4071,0.999,134,3030@TOP@human_GAPDH_TAA_len41_fa10_ta10_fm10_tm10,g
3031@TOP@human_GAPDH_TAA_len41_fa10_ta10_fm10_tm10*114*t,2,2,0,10180,10184,0.0,114,3031@TOP@human_GAPDH_TAA_len41_fa10_ta10_fm10_tm10,t
3031@TOP@human_GAPDH_TAA_len41_fa10_ta10_fm10_tm10*115*c,0,10241,0,1,10242,0.0,115,3031@TOP@human_GAPDH_TAA_len41_fa10_ta10_fm10_tm10,c
3031@TOP@human_GAPDH_TAA_len41_fa10_ta10_fm10_tm10*116*c,1,10205,0,1,10207,0.0,116,3031@TOP@human_GAPDH_TAA_len41_fa10_ta10_fm10_tm10,c
3031@TOP@human_GAPDH_TAA_len41_fa10_ta10_fm10_tm10*117*a,10144,0,51,0,10195,0.005,117,3031@TOP@human_GAPDH_TAA_len41_fa10_ta10_fm10_tm10,a
3031@TOP@human_GAPDH_TAA_len41_fa10_ta10_fm10_tm10*118*a,9370,1,776,3,10150,0.076,118,3031@TOP@human_GAPDH_TAA_len41_fa10_ta10_fm10_tm10,a
3031@TOP@human_GAPDH_TAA_len41_fa10_ta10_fm10_tm10*119*g,0,0,10116,0,10116,1.0,119,3031@TOP@human_GAPDH_TAA_len41_fa10_ta10_fm10_tm10,g
3031@TOP@human_GAPDH_TAA_len41_fa10_ta10_fm10_tm10*120*g,0,0,10086,1,10087,1.0,120,3031@TOP@human_GAPDH_TAA_len41_fa10_ta10_fm10_tm10,g
3031@TOP@human_GAPDH_TAA_len41_fa10_ta10_fm10_tm10*121*a,10044,0,143,0,10187,0.014,121,3031@TOP@human_GAPDH_TAA_len41_fa10_ta10_fm10_tm10,a
3031@TOP@human_GAPDH_TAA_len41_fa10_ta10_fm10_tm10*122*g,0,0,10203,0,10203,1.0,122,3031@TOP@human_GAPDH_TAA_len41_fa10_ta10_fm10_tm10,g
3031@TOP@human_GAPDH_TAA_len41_fa10_ta10_fm10_tm10*123*t,1,1,0,10055,10057,0.0,123,3031@TOP@human_GAPDH_TAA_len41_fa10_ta10_fm10_tm10,t
3031@TOP@human_GAPDH_TAA_len41_fa10_ta10_fm10_tm10*124*a,8049,0,2002,0,10051,0.199,124,3031@TOP@human_GAPDH_TAA_len41_fa10_ta10_fm10_tm10,a
3031@TOP@human_GAPDH_TAA_len41_fa10_ta10_fm10_tm10*125*a,8831,0,1210,1,10042,0.12,125,3031@TOP@human_GAPDH_TAA_len41_fa10_ta10_fm10_tm10,a
3031@TOP@human_GAPDH_TAA_len41_fa10_ta10_fm10_tm10*126*g,0,0,10078,0,10078,1.0,126,3031@TOP@human_GAPDH_TAA_len41_fa10_ta10_fm10_tm10,g
3031@TOP@human_GAPDH_TAA_len41_fa10_ta10_fm10_tm10*127*a,10150,0,20,0,10170,0.002,127,3031@TOP@human_GAPDH_TAA_len41_fa10_ta10_fm10_tm10,a
3031@TOP@human_GAPDH_TAA_len41_fa10_ta10_fm10_tm10*128*c,0,10222,0,0,10222,0.0,128,3031@TOP@human_GAPDH_TAA_len41_fa10_ta10_fm10_tm10,c
3031@TOP@human_GAPDH_TAA_len41_fa10_ta10_fm10_tm10*129*c,0,10173,0,0,10173,0.0,129,3031@TOP@human_GAPDH_TAA_len41_fa10_ta10_fm10_tm10,c
3031@TOP@human_GAPDH_TAA_len41_fa10_ta10_fm10_tm10*130*c,0,10199,0,0,10199,0.0,130,3031@TOP@human_GAPDH_TAA_len41_fa10_ta10_fm10_tm10,c
3031@TOP@human_GAPDH_TAA_len41_fa10_ta10_fm10_tm10*131*c,0,10228,0,0,10228,0.0,131,3031@TOP@human_GAPDH_TAA_len41_fa10_ta10_fm10_tm10,c
3031@TOP@human_GAPDH_TAA_len41_fa10_ta10_fm10_tm10*132*t,3,1,0,10081,10085,0.0,132,3031@TOP@human_GAPDH_TAA_len41_fa10_ta10_fm10_tm10,t
3031@TOP@human_GAPDH_TAA_len41_fa10_ta10_fm10_tm10*133*g,0,0,10061,0,10061,1.0,133,3031@TOP@human_GAPDH_TAA_len41_fa10_ta10_fm10_tm10,g
3031@TOP@human_GAPDH_TAA_len41_fa10_ta10_fm10_tm10*134*g,1,8,10108,0,10117,0.999,134,3031@TOP@human_GAPDH_TAA_len41_fa10_ta10_fm10_tm10,g
3032@TOP@human_GAPDH_TAA_len41_fa10_ta10_fm10_tm10*114*t,0,0,0,2154,2154,0.0,114,3032@TOP@human_GAPDH_TAA_len41_fa10_ta10_fm10_tm10,t
3032@TOP@human_GAPDH_TAA_len41_fa10_ta10_fm10_tm10*115*c,0,2173,0,0,2173,0.0,115,3032@TOP@human_GAPDH_TAA_len41_fa10_ta10_fm10_tm10,c
3032@TOP@human_GAPDH_TAA_len41_fa10_ta10_fm10_tm10*116*c,0,2166,0,0,2166,0.0,116,3032@TOP@human_GAPDH_TAA_len41_fa10_ta10_fm10_tm10,c
3032@TOP@human_GAPDH_TAA_len41_fa10_ta10_fm10_tm10*117*a,2133,0,32,0,2165,0.015,117,3032@TOP@human_GAPDH_TAA_len41_fa10_ta10_fm10_tm10,a
3032@TOP@human_GAPDH_TAA_len41_fa10_ta10_fm10_tm10*118*a,1419,0,730,0,2149,0.34,118,3032@TOP@human_GAPDH_TAA_len41_fa10_ta10_fm10_tm10,a
3032@TOP@human_GAPDH_TAA_len41_fa10_ta10_fm10_tm10*119*g,0,0,2145,0,2145,1.0,119,3032@TOP@human_GAPDH_TAA_len41_fa10_ta10_fm10_tm10,g
3032@TOP@human_GAPDH_TAA_len41_fa10_ta10_fm10_tm10*120*g,0,0,2150,1,2151,1.0,120,3032@TOP@human_GAPDH_TAA_len41_fa10_ta10_fm10_tm10,g
3032@TOP@human_GAPDH_TAA_len41_fa10_ta10_fm10_tm10*121*a,2151,0,4,0,2155,0.002,121,3032@TOP@human_GAPDH_TAA_len41_fa10_ta10_fm10_tm10,a
3032@TOP@human_GAPDH_TAA_len41_fa10_ta10_fm10_tm10*122*g,1,0,2163,0,2164,1.0,122,3032@TOP@human_GAPDH_TAA_len41_fa10_ta10_fm10_tm10,g
3032@TOP@human_GAPDH_TAA_len41_fa10_ta10_fm10_tm10*123*t,0,0,0,2135,2135,0.0,123,3032@TOP@human_GAPDH_TAA_len41_fa10_ta10_fm10_tm10,t
3032@TOP@human_GAPDH_TAA_len41_fa10_ta10_fm10_tm10*124*a,1629,0,513,0,2142,0.239,124,3032@TOP@human_GAPDH_TAA_len41_fa10_ta10_fm10_tm10,a
3032@TOP@human_GAPDH_TAA_len41_fa10_ta10_fm10_tm10*125*a,1776,0,340,0,2116,0.161,125,3032@TOP@human_GAPDH_TAA_len41_fa10_ta10_fm10_tm10,a
3032@TOP@human_GAPDH_TAA_len41_fa10_ta10_fm10_tm10*126*g,0,0,2139,0,2139,1.0,126,3032@TOP@human_GAPDH_TAA_len41_fa10_ta10_fm10_tm10,g
3032@TOP@human_GAPDH_TAA_len41_fa10_ta10_fm10_tm10*127*a,2155,0,5,0,2160,0.002,127,3032@TOP@human_GAPDH_TAA_len41_fa10_ta10_fm10_tm10,a
3032@TOP@human_GAPDH_TAA_len41_fa10_ta10_fm10_tm10*128*c,0,2167,0,0,2167,0.0,128,3032@TOP@human_GAPDH_TAA_len41_fa10_ta10_fm10_tm10,c
3032@TOP@human_GAPDH_TAA_len41_fa10_ta10_fm10_tm10*129*c,0,2148,0,0,2148,0.0,129,3032@TOP@human_GAPDH_TAA_len41_fa10_ta10_fm10_tm10,c
3032@TOP@human_GAPDH_TAA_len41_fa10_ta10_fm10_tm10*130*c,0,2158,0,0,2158,0.0,130,3032@TOP@human_GAPDH_TAA_len41_fa10_ta10_fm10_tm10,c
3032@TOP@human_GAPDH_TAA_len41_fa10_ta10_fm10_tm10*131*c,1,2164,0,0,2165,0.0,131,3032@TOP@human_GAPDH_TAA_len41_fa10_ta10_fm10_tm10,c
3032@TOP@human_GAPDH_TAA_len41_fa10_ta10_fm10_tm10*132*t,0,2,0,2120,2122,0.0,132,3032@TOP@human_GAPDH_TAA_len41_fa10_ta10_fm10_tm10,t
3032@TOP@human_GAPDH_TAA_len41_fa10_ta10_fm10_tm10*133*g,0,0,2127,0,2127,1.0,133,3032@TOP@human_GAPDH_TAA_len41_fa10_ta10_fm10_tm10,g
3032@TOP@human_GAPDH_TAA_len41_fa10_ta10_fm10_tm10*134*g,0,2,2142,0,2144,0.999,134,3032@TOP@human_GAPDH_TAA_len41_fa10_ta10_fm10_tm10,g
3033@TOP@human_GAPDH_TAA_len41_fa10_ta10_fm10_tm10*114*t,1,1,0,4322,4324,0.0,114,3033@TOP@human_GAPDH_TAA_len41_fa10_ta10_fm10_tm10,t
3033@TOP@human_GAPDH_TAA_len41_fa10_ta10_fm10_tm10*115*c,0,4343,0,1,4344,0.0,115,3033@TOP@human_GAPDH_TAA_len41_fa10_ta10_fm10_tm10,c
3033@TOP@human_GAPDH_TAA_len41_fa10_ta10_fm10_tm10*116*c,0,4327,0,0,4327,0.0,116,3033@TOP@human_GAPDH_TAA_len41_fa10_ta10_fm10_tm10,c
3033@TOP@human_GAPDH_TAA_len41_fa10_ta10_fm10_tm10*117*a,4309,0,15,0,4324,0.003,117,3033@TOP@human_GAPDH_TAA_len41_fa10_ta10_fm10_tm10,a
3033@TOP@human_GAPDH_TAA_len41_fa10_ta10_fm10_tm10*118*a,4028,0,268,0,4296,0.062,118,3033@TOP@human_GAPDH_TAA_len41_fa10_ta10_fm10_tm10,a
3033@TOP@human_GAPDH_TAA_len41_fa10_ta10_fm10_tm10*119*g,0,0,4293,0,4293,1.0,119,3033@TOP@human_GAPDH_TAA_len41_fa10_ta10_fm10_tm10,g
3033@TOP@human_GAPDH_TAA_len41_fa10_ta10_fm10_tm10*120*g,1,0,4279,0,4280,1.0,120,3033@TOP@human_GAPDH_TAA_len41_fa10_ta10_fm10_tm10,g
3033@TOP@human_GAPDH_TAA_len41_fa10_ta10_fm10_tm10*121*a,4305,0,3,0,4308,0.001,121,3033@TOP@human_GAPDH_TAA_len41_fa10_ta10_fm10_tm10,a
3033@TOP@human_GAPDH_TAA_len41_fa10_ta10_fm10_tm10*122*g,0,0,4331,0,4331,1.0,122,3033@TOP@human_GAPDH_TAA_len41_fa10_ta10_fm10_tm10,g
3033@TOP@human_GAPDH_TAA_len41_fa10_ta10_fm10_tm10*123*t,0,0,0,4259,4259,0.0,123,3033@TOP@human_GAPDH_TAA_len41_fa10_ta10_fm10_tm10,t
3033@TOP@human_GAPDH_TAA_len41_fa10_ta10_fm10_tm10*124*a,4009,0,240,0,4249,0.056,124,3033@TOP@human_GAPDH_TAA_len41_fa10_ta10_fm10_tm10,a
3033@TOP@human_GAPDH_TAA_len41_fa10_ta10_fm10_tm10*125*a,4140,0,104,0,4244,0.025,125,3033@TOP@human_GAPDH_TAA_len41_fa10_ta10_fm10_tm10,a
3033@TOP@human_GAPDH_TAA_len41_fa10_ta10_fm10_tm10*126*g,3,0,4271,2,4276,0.999,126,3033@TOP@human_GAPDH_TAA_len41_fa10_ta10_fm10_tm10,g
3033@TOP@human_GAPDH_TAA_len41_fa10_ta10_fm10_tm10*127*a,4303,0,1,0,4304,0.0,127,3033@TOP@human_GAPDH_TAA_len41_fa10_ta10_fm10_tm10,a
3033@TOP@human_GAPDH_TAA_len41_fa10_ta10_fm10_tm10*128*c,1,4334,0,0,4335,0.0,128,3033@TOP@human_GAPDH_TAA_len41_fa10_ta10_fm10_tm10,c
3033@TOP@human_GAPDH_TAA_len41_fa10_ta10_fm10_tm10*129*c,0,4298,0,0,4298,0.0,129,3033@TOP@human_GAPDH_TAA_len41_fa10_ta10_fm10_tm10,c
3033@TOP@human_GAPDH_TAA_len41_fa10_ta10_fm10_tm10*130*c,0,4327,0,0,4327,0.0,130,3033@TOP@human_GAPDH_TAA_len41_fa10_ta10_fm10_tm10,c
3033@TOP@human_GAPDH_TAA_len41_fa10_ta10_fm10_tm10*131*c,2,4342,0,0,4344,0.0,131,3033@TOP@human_GAPDH_TAA_len41_fa10_ta10_fm10_tm10,c
3033@TOP@human_GAPDH_TAA_len41_fa10_ta10_fm10_tm10*132*t,0,2,0,4280,4282,0.0,132,3033@TOP@human_GAPDH_TAA_len41_fa10_ta10_fm10_tm10,t
3033@TOP@human_GAPDH_TAA_len41_fa10_ta10_fm10_tm10*133*g,0,0,4266,0,4266,1.0,133,3033@TOP@human_GAPDH_TAA_len41_fa10_ta10_fm10_tm10,g
3033@TOP@human_GAPDH_TAA_len41_fa10_ta10_fm10_tm10*134*g,0,1,4287,0,4288,1.0,134,3033@TOP@human_GAPDH_TAA_len41_fa10_ta10_fm10_tm10,g
3034@TOP@human_GAPDH_TAA_len41_fa10_ta10_fm10_tm10*114*t,0,0,0,1553,1553,0.0,114,3034@TOP@human_GAPDH_TAA_len41_fa10_ta10_fm10_tm10,t
3034@TOP@human_GAPDH_TAA_len41_fa10_ta10_fm10_tm10*115*c,0,1563,0,2,1565,0.0,115,3034@TOP@human_GAPDH_TAA_len41_fa10_ta10_fm10_tm10,c
3034@TOP@human_GAPDH_TAA_len41_fa10_ta10_fm10_tm10*116*c,0,1559,0,0,1559,0.0,116,3034@TOP@human_GAPDH_TAA_len41_fa10_ta10_fm10_tm10,c
3034@TOP@human_GAPDH_TAA_len41_fa10_ta10_fm10_tm10*117*a,1555,0,2,0,1557,0.001,117,3034@TOP@human_GAPDH_TAA_len41_fa10_ta10_fm10_tm10,a
3034@TOP@human_GAPDH_TAA_len41_fa10_ta10_fm10_tm10*118*a,1530,0,18,0,1548,0.012,118,3034@TOP@human_GAPDH_TAA_len41_fa10_ta10_fm10_tm10,a
3034@TOP@human_GAPDH_TAA_len41_fa10_ta10_fm10_tm10*119*g,0,0,1539,0,1539,1.0,119,3034@TOP@human_GAPDH_TAA_len41_fa10_ta10_fm10_tm10,g
3034@TOP@human_GAPDH_TAA_len41_fa10_ta10_fm10_tm10*120*g,0,0,1535,0,1535,1.0,120,3034@TOP@human_GAPDH_TAA_len41_fa10_ta10_fm10_tm10,g
3034@TOP@human_GAPDH_TAA_len41_fa10_ta10_fm10_tm10*121*a,1555,0,0,0,1555,0.0,121,3034@TOP@human_GAPDH_TAA_len41_fa10_ta10_fm10_tm10,a
3034@TOP@human_GAPDH_TAA_len41_fa10_ta10_fm10_tm10*122*g,0,0,1556,0,1556,1.0,122,3034@TOP@human_GAPDH_TAA_len41_fa10_ta10_fm10_tm10,g
3034@TOP@human_GAPDH_TAA_len41_fa10_ta10_fm10_tm10*123*t,0,0,0,1535,1535,0.0,123,3034@TOP@human_GAPDH_TAA_len41_fa10_ta10_fm10_tm10,t
3034@TOP@human_GAPDH_TAA_len41_fa10_ta10_fm10_tm10*124*a,1392,0,137,0,1529,0.09,124,3034@TOP@human_GAPDH_TAA_len41_fa10_ta10_fm10_tm10,a
3034@TOP@human_GAPDH_TAA_len41_fa10_ta10_fm10_tm10*125*a,1486,0,45,0,1531,0.029,125,3034@TOP@human_GAPDH_TAA_len41_fa10_ta10_fm10_tm10,a
3034@TOP@human_GAPDH_TAA_len41_fa10_ta10_fm10_tm10*126*g,0,0,1538,0,1538,1.0,126,3034@TOP@human_GAPDH_TAA_len41_fa10_ta10_fm10_tm10,g
3034@TOP@human_GAPDH_TAA_len41_fa10_ta10_fm10_tm10*127*a,1551,0,0,0,1551,0.0,127,3034@TOP@human_GAPDH_TAA_len41_fa10_ta10_fm10_tm10,a
3034@TOP@human_GAPDH_TAA_len41_fa10_ta10_fm10_tm10*128*c,0,1564,0,0,1564,0.0,128,3034@TOP@human_GAPDH_TAA_len41_fa10_ta10_fm10_tm10,c
3034@TOP@human_GAPDH_TAA_len41_fa10_ta10_fm10_tm10*129*c,0,1545,0,0,1545,0.0,129,3034@TOP@human_GAPDH_TAA_len41_fa10_ta10_fm10_tm10,c
3034@TOP@human_GAPDH_TAA_len41_fa10_ta10_fm10_tm10*130*c,0,1557,0,0,1557,0.0,130,3034@TOP@human_GAPDH_TAA_len41_fa10_ta10_fm10_tm10,c
3034@TOP@human_GAPDH_TAA_len41_fa10_ta10_fm10_tm10*131*c,0,1558,0,0,1558,0.0,131,3034@TOP@human_GAPDH_TAA_len41_fa10_ta10_fm10_tm10,c
3034@TOP@human_GAPDH_TAA_len41_fa10_ta10_fm10_tm10*132*t,0,0,0,1538,1538,0.0,132,3034@TOP@human_GAPDH_TAA_len41_fa10_ta10_fm10_tm10,t
3034@TOP@human_GAPDH_TAA_len41_fa10_ta10_fm10_tm10*133*g,0,0,1535,0,1535,1.0,133,3034@TOP@human_GAPDH_TAA_len41_fa10_ta10_fm10_tm10,g
3034@TOP@human_GAPDH_TAA_len41_fa10_ta10_fm10_tm10*134*g,0,2,1533,0,1535,0.999,134,3034@TOP@human_GAPDH_TAA_len41_fa10_ta10_fm10_tm10,g
3035@TOP@human_GAPDH_TAA_len41_fa10_ta10_fm10_tm10*114*t,2,9,0,39496,39507,0.0,114,3035@TOP@human_GAPDH_TAA_len41_fa10_ta10_fm10_tm10,t
3035@TOP@human_GAPDH_TAA_len41_fa10_ta10_fm10_tm10*115*c,2,39728,0,2,39732,0.0,115,3035@TOP@human_GAPDH_TAA_len41_fa10_ta10_fm10_tm10,c
3035@TOP@human_GAPDH_TAA_len41_fa10_ta10_fm10_tm10*116*c,2,39589,0,1,39592,0.0,116,3035@TOP@human_GAPDH_TAA_len41_fa10_ta10_fm10_tm10,c
3035@TOP@human_GAPDH_TAA_len41_fa10_ta10_fm10_tm10*117*a,37861,0,1696,0,39557,0.043,117,3035@TOP@human_GAPDH_TAA_len41_fa10_ta10_fm10_tm10,a
3035@TOP@human_GAPDH_TAA_len41_fa10_ta10_fm10_tm10*118*a,38383,0,986,1,39370,0.025,118,3035@TOP@human_GAPDH_TAA_len41_fa10_ta10_fm10_tm10,a
3035@TOP@human_GAPDH_TAA_len41_fa10_ta10_fm10_tm10*119*g,1,0,39289,1,39291,1.0,119,3035@TOP@human_GAPDH_TAA_len41_fa10_ta10_fm10_tm10,g
3035@TOP@human_GAPDH_TAA_len41_fa10_ta10_fm10_tm10*120*g,4,0,39126,1,39131,1.0,120,3035@TOP@human_GAPDH_TAA_len41_fa10_ta10_fm10_tm10,g
3035@TOP@human_GAPDH_TAA_len41_fa10_ta10_fm10_tm10*121*a,39504,0,41,0,39545,0.001,121,3035@TOP@human_GAPDH_TAA_len41_fa10_ta10_fm10_tm10,a
3035@TOP@human_GAPDH_TAA_len41_fa10_ta10_fm10_tm10*122*g,6,0,39558,2,39566,1.0,122,3035@TOP@human_GAPDH_TAA_len41_fa10_ta10_fm10_tm10,g
3035@TOP@human_GAPDH_TAA_len41_fa10_ta10_fm10_tm10*123*t,4,5,1,39085,39095,0.0,123,3035@TOP@human_GAPDH_TAA_len41_fa10_ta10_fm10_tm10,t
3035@TOP@human_GAPDH_TAA_len41_fa10_ta10_fm10_tm10*124*a,37631,1,1347,1,38980,0.035,124,3035@TOP@human_GAPDH_TAA_len41_fa10_ta10_fm10_tm10,a
3035@TOP@human_GAPDH_TAA_len41_fa10_ta10_fm10_tm10*125*a,38230,0,638,8,38876,0.016,125,3035@TOP@human_GAPDH_TAA_len41_fa10_ta10_fm10_tm10,a
3035@TOP@human_GAPDH_TAA_len41_fa10_ta10_fm10_tm10*126*g,1,0,39058,2,39061,1.0,126,3035@TOP@human_GAPDH_TAA_len41_fa10_ta10_fm10_tm10,g
3035@TOP@human_GAPDH_TAA_len41_fa10_ta10_fm10_tm10*127*a,39358,4,41,0,39403,0.001,127,3035@TOP@human_GAPDH_TAA_len41_fa10_ta10_fm10_tm10,a
3035@TOP@human_GAPDH_TAA_len41_fa10_ta10_fm10_tm10*128*c,2,39617,5,4,39628,0.0,128,3035@TOP@human_GAPDH_TAA_len41_fa10_ta10_fm10_tm10,c
3035@TOP@human_GAPDH_TAA_len41_fa10_ta10_fm10_tm10*129*c,1,39371,0,0,39372,0.0,129,3035@TOP@human_GAPDH_TAA_len41_fa10_ta10_fm10_tm10,c
3035@TOP@human_GAPDH_TAA_len41_fa10_ta10_fm10_tm10*130*c,9,39533,1,3,39546,0.0,130,3035@TOP@human_GAPDH_TAA_len41_fa10_ta10_fm10_tm10,c
3035@TOP@human_GAPDH_TAA_len41_fa10_ta10_fm10_tm10*131*c,1,39665,0,4,39670,0.0,131,3035@TOP@human_GAPDH_TAA_len41_fa10_ta10_fm10_tm10,c
3035@TOP@human_GAPDH_TAA_len41_fa10_ta10_fm10_tm10*132*t,3,7,0,39126,39136,0.0,132,3035@TOP@human_GAPDH_TAA_len41_fa10_ta10_fm10_tm10,t
3035@TOP@human_GAPDH_TAA_len41_fa10_ta10_fm10_tm10*133*g,6,1,39066,1,39074,1.0,133,3035@TOP@human_GAPDH_TAA_len41_fa10_ta10_fm10_tm10,g
3035@TOP@human_GAPDH_TAA_len41_fa10_ta10_fm10_tm10*134*g,1,3,39264,3,39271,1.0,134,3035@TOP@human_GAPDH_TAA_len41_fa10_ta10_fm10_tm10,g
3036@TOP@human_GAPDH_TAA_len41_fa10_ta10_fm10_tm10*114*t,0,1,0,4352,4353,0.0,114,3036@TOP@human_GAPDH_TAA_len41_fa10_ta10_fm10_tm10,t
3036@TOP@human_GAPDH_TAA_len41_fa10_ta10_fm10_tm10*115*c,0,4374,0,0,4374,0.0,115,3036@TOP@human_GAPDH_TAA_len41_fa10_ta10_fm10_tm10,c
3036@TOP@human_GAPDH_TAA_len41_fa10_ta10_fm10_tm10*116*c,0,4356,0,0,4356,0.0,116,3036@TOP@human_GAPDH_TAA_len41_fa10_ta10_fm10_tm10,c
3036@TOP@human_GAPDH_TAA_len41_fa10_ta10_fm10_tm10*117*a,4072,0,271,0,4343,0.062,117,3036@TOP@human_GAPDH_TAA_len41_fa10_ta10_fm10_tm10,a
3036@TOP@human_GAPDH_TAA_len41_fa10_ta10_fm10_tm10*118*a,2404,0,1917,0,4321,0.444,118,3036@TOP@human_GAPDH_TAA_len41_fa10_ta10_fm10_tm10,a
3036@TOP@human_GAPDH_TAA_len41_fa10_ta10_fm10_tm10*119*g,2,0,4319,1,4322,0.999,119,3036@TOP@human_GAPDH_TAA_len41_fa10_ta10_fm10_tm10,g
3036@TOP@human_GAPDH_TAA_len41_fa10_ta10_fm10_tm10*120*g,0,0,4324,0,4324,1.0,120,3036@TOP@human_GAPDH_TAA_len41_fa10_ta10_fm10_tm10,g
3036@TOP@human_GAPDH_TAA_len41_fa10_ta10_fm10_tm10*121*a,4317,0,9,0,4326,0.002,121,3036@TOP@human_GAPDH_TAA_len41_fa10_ta10_fm10_tm10,a
3036@TOP@human_GAPDH_TAA_len41_fa10_ta10_fm10_tm10*122*g,2,0,4356,0,4358,1.0,122,3036@TOP@human_GAPDH_TAA_len41_fa10_ta10_fm10_tm10,g
3036@TOP@human_GAPDH_TAA_len41_fa10_ta10_fm10_tm10*123*t,0,5,1,4296,4302,0.0,123,3036@TOP@human_GAPDH_TAA_len41_fa10_ta10_fm10_tm10,t
3036@TOP@human_GAPDH_TAA_len41_fa10_ta10_fm10_tm10*124*a,2210,0,2105,0,4315,0.488,124,3036@TOP@human_GAPDH_TAA_len41_fa10_ta10_fm10_tm10,a
3036@TOP@human_GAPDH_TAA_len41_fa10_ta10_fm10_tm10*125*a,3161,1,1129,2,4293,0.263,125,3036@TOP@human_GAPDH_TAA_len41_fa10_ta10_fm10_tm10,a
3036@TOP@human_GAPDH_TAA_len41_fa10_ta10_fm10_tm10*126*g,1,0,4315,0,4316,1.0,126,3036@TOP@human_GAPDH_TAA_len41_fa10_ta10_fm10_tm10,g
3036@TOP@human_GAPDH_TAA_len41_fa10_ta10_fm10_tm10*127*a,4337,0,11,0,4348,0.003,127,3036@TOP@human_GAPDH_TAA_len41_fa10_ta10_fm10_tm10,a
3036@TOP@human_GAPDH_TAA_len41_fa10_ta10_fm10_tm10*128*c,1,4361,0,1,4363,0.0,128,3036@TOP@human_GAPDH_TAA_len41_fa10_ta10_fm10_tm10,c
3036@TOP@human_GAPDH_TAA_len41_fa10_ta10_fm10_tm10*129*c,0,4344,0,0,4344,0.0,129,3036@TOP@human_GAPDH_TAA_len41_fa10_ta10_fm10_tm10,c
3036@TOP@human_GAPDH_TAA_len41_fa10_ta10_fm10_tm10*130*c,0,4360,0,0,4360,0.0,130,3036@TOP@human_GAPDH_TAA_len41_fa10_ta10_fm10_tm10,c
3036@TOP@human_GAPDH_TAA_len41_fa10_ta10_fm10_tm10*131*c,0,4371,0,0,4371,0.0,131,3036@TOP@human_GAPDH_TAA_len41_fa10_ta10_fm10_tm10,c
3036@TOP@human_GAPDH_TAA_len41_fa10_ta10_fm10_tm10*132*t,0,2,0,4299,4301,0.0,132,3036@TOP@human_GAPDH_TAA_len41_fa10_ta10_fm10_tm10,t
3036@TOP@human_GAPDH_TAA_len41_fa10_ta10_fm10_tm10*133*g,0,0,4295,2,4297,1.0,133,3036@TOP@human_GAPDH_TAA_len41_fa10_ta10_fm10_tm10,g
3036@TOP@human_GAPDH_TAA_len41_fa10_ta10_fm10_tm10*134*g,2,0,4318,0,4320,1.0,134,3036@TOP@human_GAPDH_TAA_len41_fa10_ta10_fm10_tm10,g
3037@TOP@human_GAPDH_TAA_len41_fa10_ta10_fm10_tm10*114*t,3,2,0,20291,20296,0.0,114,3037@TOP@human_GAPDH_TAA_len41_fa10_ta10_fm10_tm10,t
3037@TOP@human_GAPDH_TAA_len41_fa10_ta10_fm10_tm10*115*c,1,20388,0,0,20389,0.0,115,3037@TOP@human_GAPDH_TAA_len41_fa10_ta10_fm10_tm10,c
3037@TOP@human_GAPDH_TAA_len41_fa10_ta10_fm10_tm10*116*c,2,20296,0,2,20300,0.0,116,3037@TOP@human_GAPDH_TAA_len41_fa10_ta10_fm10_tm10,c
3037@TOP@human_GAPDH_TAA_len41_fa10_ta10_fm10_tm10*117*a,20114,0,168,0,20282,0.008,117,3037@TOP@human_GAPDH_TAA_len41_fa10_ta10_fm10_tm10,a
3037@TOP@human_GAPDH_TAA_len41_fa10_ta10_fm10_tm10*118*a,17867,1,2318,1,20187,0.115,118,3037@TOP@human_GAPDH_TAA_len41_fa10_ta10_fm10_tm10,a
3037@TOP@human_GAPDH_TAA_len41_fa10_ta10_fm10_tm10*119*g,1,0,20129,2,20132,1.0,119,3037@TOP@human_GAPDH_TAA_len41_fa10_ta10_fm10_tm10,g
3037@TOP@human_GAPDH_TAA_len41_fa10_ta10_fm10_tm10*120*g,2,0,20075,2,20079,1.0,120,3037@TOP@human_GAPDH_TAA_len41_fa10_ta10_fm10_tm10,g
3037@TOP@human_GAPDH_TAA_len41_fa10_ta10_fm10_tm10*121*a,20241,0,12,0,20253,0.001,121,3037@TOP@human_GAPDH_TAA_len41_fa10_ta10_fm10_tm10,a
3037@TOP@human_GAPDH_TAA_len41_fa10_ta10_fm10_tm10*122*g,5,0,20286,0,20291,1.0,122,3037@TOP@human_GAPDH_TAA_len41_fa10_ta10_fm10_tm10,g
3037@TOP@human_GAPDH_TAA_len41_fa10_ta10_fm10_tm10*123*t,2,1,2,20045,20050,0.0,123,3037@TOP@human_GAPDH_TAA_len41_fa10_ta10_fm10_tm10,t
3037@TOP@human_GAPDH_TAA_len41_fa10_ta10_fm10_tm10*124*a,16674,0,3329,0,20003,0.166,124,3037@TOP@human_GAPDH_TAA_len41_fa10_ta10_fm10_tm10,a
3037@TOP@human_GAPDH_TAA_len41_fa10_ta10_fm10_tm10*125*a,18523,5,1456,1,19985,0.073,125,3037@TOP@human_GAPDH_TAA_len41_fa10_ta10_fm10_tm10,a
3037@TOP@human_GAPDH_TAA_len41_fa10_ta10_fm10_tm10*126*g,0,0,20056,1,20057,1.0,126,3037@TOP@human_GAPDH_TAA_len41_fa10_ta10_fm10_tm10,g
3037@TOP@human_GAPDH_TAA_len41_fa10_ta10_fm10_tm10*127*a,20222,1,14,0,20237,0.001,127,3037@TOP@human_GAPDH_TAA_len41_fa10_ta10_fm10_tm10,a
3037@TOP@human_GAPDH_TAA_len41_fa10_ta10_fm10_tm10*128*c,1,20344,5,0,20350,0.0,128,3037@TOP@human_GAPDH_TAA_len41_fa10_ta10_fm10_tm10,c
3037@TOP@human_GAPDH_TAA_len41_fa10_ta10_fm10_tm10*129*c,1,20197,0,0,20198,0.0,129,3037@TOP@human_GAPDH_TAA_len41_fa10_ta10_fm10_tm10,c
3037@TOP@human_GAPDH_TAA_len41_fa10_ta10_fm10_tm10*130*c,0,20297,0,4,20301,0.0,130,3037@TOP@human_GAPDH_TAA_len41_fa10_ta10_fm10_tm10,c
3037@TOP@human_GAPDH_TAA_len41_fa10_ta10_fm10_tm10*131*c,6,20350,0,1,20357,0.0,131,3037@TOP@human_GAPDH_TAA_len41_fa10_ta10_fm10_tm10,c
3037@TOP@human_GAPDH_TAA_len41_fa10_ta10_fm10_tm10*132*t,6,9,3,20098,20116,0.0,132,3037@TOP@human_GAPDH_TAA_len41_fa10_ta10_fm10_tm10,t
3037@TOP@human_GAPDH_TAA_len41_fa10_ta10_fm10_tm10*133*g,1,1,20034,3,20039,1.0,133,3037@TOP@human_GAPDH_TAA_len41_fa10_ta10_fm10_tm10,g
3037@TOP@human_GAPDH_TAA_len41_fa10_ta10_fm10_tm10*134*g,1,6,20145,0,20152,1.0,134,3037@TOP@human_GAPDH_TAA_len41_fa10_ta10_fm10_tm10,g
3038@TOP@human_GAPDH_TAA_len41_fa10_ta10_fm10_tm10*114*t,0,0,0,3974,3974,0.0,114,3038@TOP@human_GAPDH_TAA_len41_fa10_ta10_fm10_tm10,t
3038@TOP@human_GAPDH_TAA_len41_fa10_ta10_fm10_tm10*115*c,0,3996,0,0,3996,0.0,115,3038@TOP@human_GAPDH_TAA_len41_fa10_ta10_fm10_tm10,c
3038@TOP@human_GAPDH_TAA_len41_fa10_ta10_fm10_tm10*116*c,0,3984,0,0,3984,0.0,116,3038@TOP@human_GAPDH_TAA_len41_fa10_ta10_fm10_tm10,c
3038@TOP@human_GAPDH_TAA_len41_fa10_ta10_fm10_tm10*117*a,3768,0,204,0,3972,0.051,117,3038@TOP@human_GAPDH_TAA_len41_fa10_ta10_fm10_tm10,a
3038@TOP@human_GAPDH_TAA_len41_fa10_ta10_fm10_tm10*118*a,2784,0,1167,1,3952,0.295,118,3038@TOP@human_GAPDH_TAA_len41_fa10_ta10_fm10_tm10,a
3038@TOP@human_GAPDH_TAA_len41_fa10_ta10_fm10_tm10*119*g,0,0,3940,0,3940,1.0,119,3038@TOP@human_GAPDH_TAA_len41_fa10_ta10_fm10_tm10,g
3038@TOP@human_GAPDH_TAA_len41_fa10_ta10_fm10_tm10*120*g,0,0,3936,0,3936,1.0,120,3038@TOP@human_GAPDH_TAA_len41_fa10_ta10_fm10_tm10,g
3038@TOP@human_GAPDH_TAA_len41_fa10_ta10_fm10_tm10*121*a,3956,0,3,0,3959,0.001,121,3038@TOP@human_GAPDH_TAA_len41_fa10_ta10_fm10_tm10,a
3038@TOP@human_GAPDH_TAA_len41_fa10_ta10_fm10_tm10*122*g,0,0,3979,0,3979,1.0,122,3038@TOP@human_GAPDH_TAA_len41_fa10_ta10_fm10_tm10,g
3038@TOP@human_GAPDH_TAA_len41_fa10_ta10_fm10_tm10*123*t,0,4,0,3923,3927,0.0,123,3038@TOP@human_GAPDH_TAA_len41_fa10_ta10_fm10_tm10,t
3038@TOP@human_GAPDH_TAA_len41_fa10_ta10_fm10_tm10*124*a,2875,0,1050,0,3925,0.268,124,3038@TOP@human_GAPDH_TAA_len41_fa10_ta10_fm10_tm10,a
3038@TOP@human_GAPDH_TAA_len41_fa10_ta10_fm10_tm10*125*a,3289,1,594,0,3884,0.153,125,3038@TOP@human_GAPDH_TAA_len41_fa10_ta10_fm10_tm10,a
3038@TOP@human_GAPDH_TAA_len41_fa10_ta10_fm10_tm10*126*g,0,0,3938,1,3939,1.0,126,3038@TOP@human_GAPDH_TAA_len41_fa10_ta10_fm10_tm10,g
3038@TOP@human_GAPDH_TAA_len41_fa10_ta10_fm10_tm10*127*a,3946,0,11,0,3957,0.003,127,3038@TOP@human_GAPDH_TAA_len41_fa10_ta10_fm10_tm10,a
3038@TOP@human_GAPDH_TAA_len41_fa10_ta10_fm10_tm10*128*c,1,3988,1,0,3990,0.0,128,3038@TOP@human_GAPDH_TAA_len41_fa10_ta10_fm10_tm10,c
3038@TOP@human_GAPDH_TAA_len41_fa10_ta10_fm10_tm10*129*c,0,3963,0,0,3963,0.0,129,3038@TOP@human_GAPDH_TAA_len41_fa10_ta10_fm10_tm10,c
3038@TOP@human_GAPDH_TAA_len41_fa10_ta10_fm10_tm10*130*c,0,3981,0,0,3981,0.0,130,3038@TOP@human_GAPDH_TAA_len41_fa10_ta10_fm10_tm10,c
3038@TOP@human_GAPDH_TAA_len41_fa10_ta10_fm10_tm10*131*c,0,3991,0,0,3991,0.0,131,3038@TOP@human_GAPDH_TAA_len41_fa10_ta10_fm10_tm10,c
3038@TOP@human_GAPDH_TAA_len41_fa10_ta10_fm10_tm10*132*t,1,0,0,3934,3935,0.0,132,3038@TOP@human_GAPDH_TAA_len41_fa10_ta10_fm10_tm10,t
3038@TOP@human_GAPDH_TAA_len41_fa10_ta10_fm10_tm10*133*g,0,0,3917,1,3918,1.0,133,3038@TOP@human_GAPDH_TAA_len41_fa10_ta10_fm10_tm10,g
3038@TOP@human_GAPDH_TAA_len41_fa10_ta10_fm10_tm10*134*g,0,3,3943,0,3946,0.999,134,3038@TOP@human_GAPDH_TAA_len41_fa10_ta10_fm10_tm10,g
3039@TOP@human_GAPDH_TAA_len41_fa10_ta10_fm10_tm10*114*t,0,0,0,10736,10736,0.0,114,3039@TOP@human_GAPDH_TAA_len41_fa10_ta10_fm10_tm10,t
3039@TOP@human_GAPDH_TAA_len41_fa10_ta10_fm10_tm10*115*c,0,10778,0,1,10779,0.0,115,3039@TOP@human_GAPDH_TAA_len41_fa10_ta10_fm10_tm10,c
3039@TOP@human_GAPDH_TAA_len41_fa10_ta10_fm10_tm10*116*c,0,10746,0,1,10747,0.0,116,3039@TOP@human_GAPDH_TAA_len41_fa10_ta10_fm10_tm10,c
3039@TOP@human_GAPDH_TAA_len41_fa10_ta10_fm10_tm10*117*a,10175,0,542,2,10719,0.051,117,3039@TOP@human_GAPDH_TAA_len41_fa10_ta10_fm10_tm10,a
3039@TOP@human_GAPDH_TAA_len41_fa10_ta10_fm10_tm10*118*a,8456,1,2220,1,10678,0.208,118,3039@TOP@human_GAPDH_TAA_len41_fa10_ta10_fm10_tm10,a
3039@TOP@human_GAPDH_TAA_len41_fa10_ta10_fm10_tm10*119*g,0,5,10659,6,10670,0.999,119,3039@TOP@human_GAPDH_TAA_len41_fa10_ta10_fm10_tm10,g
3039@TOP@human_GAPDH_TAA_len41_fa10_ta10_fm10_tm10*120*g,0,0,10651,0,10651,1.0,120,3039@TOP@human_GAPDH_TAA_len41_fa10_ta10_fm10_tm10,g
3039@TOP@human_GAPDH_TAA_len41_fa10_ta10_fm10_tm10*121*a,10686,0,25,0,10711,0.002,121,3039@TOP@human_GAPDH_TAA_len41_fa10_ta10_fm10_tm10,a
3039@TOP@human_GAPDH_TAA_len41_fa10_ta10_fm10_tm10*122*g,0,0,10736,2,10738,1.0,122,3039@TOP@human_GAPDH_TAA_len41_fa10_ta10_fm10_tm10,g
3039@TOP@human_GAPDH_TAA_len41_fa10_ta10_fm10_tm10*123*t,1,1,0,10622,10624,0.0,123,3039@TOP@human_GAPDH_TAA_len41_fa10_ta10_fm10_tm10,t
3039@TOP@human_GAPDH_TAA_len41_fa10_ta10_fm10_tm10*124*a,7417,0,3182,0,10599,0.3,124,3039@TOP@human_GAPDH_TAA_len41_fa10_ta10_fm10_tm10,a
3039@TOP@human_GAPDH_TAA_len41_fa10_ta10_fm10_tm10*125*a,9427,0,1131,1,10559,0.107,125,3039@TOP@human_GAPDH_TAA_len41_fa10_ta10_fm10_tm10,a
3039@TOP@human_GAPDH_TAA_len41_fa10_ta10_fm10_tm10*126*g,2,0,10640,1,10643,1.0,126,3039@TOP@human_GAPDH_TAA_len41_fa10_ta10_fm10_tm10,g
3039@TOP@human_GAPDH_TAA_len41_fa10_ta10_fm10_tm10*127*a,10712,0,5,2,10719,0.0,127,3039@TOP@human_GAPDH_TAA_len41_fa10_ta10_fm10_tm10,a
3039@TOP@human_GAPDH_TAA_len41_fa10_ta10_fm10_tm10*128*c,0,10758,1,0,10759,0.0,128,3039@TOP@human_GAPDH_TAA_len41_fa10_ta10_fm10_tm10,c
3039@TOP@human_GAPDH_TAA_len41_fa10_ta10_fm10_tm10*129*c,1,10683,0,1,10685,0.0,129,3039@TOP@human_GAPDH_TAA_len41_fa10_ta10_fm10_tm10,c
3039@TOP@human_GAPDH_TAA_len41_fa10_ta10_fm10_tm10*130*c,1,10749,0,2,10752,0.0,130,3039@TOP@human_GAPDH_TAA_len41_fa10_ta10_fm10_tm10,c
3039@TOP@human_GAPDH_TAA_len41_fa10_ta10_fm10_tm10*131*c,3,10765,0,1,10769,0.0,131,3039@TOP@human_GAPDH_TAA_len41_fa10_ta10_fm10_tm10,c
3039@TOP@human_GAPDH_TAA_len41_fa10_ta10_fm10_tm10*132*t,2,1,6,10621,10630,0.001,132,3039@TOP@human_GAPDH_TAA_len41_fa10_ta10_fm10_tm10,t
3039@TOP@human_GAPDH_TAA_len41_fa10_ta10_fm10_tm10*133*g,0,0,10604,0,10604,1.0,133,3039@TOP@human_GAPDH_TAA_len41_fa10_ta10_fm10_tm10,g
3039@TOP@human_GAPDH_TAA_len41_fa10_ta10_fm10_tm10*134*g,0,4,10644,1,10649,1.0,134,3039@TOP@human_GAPDH_TAA_len41_fa10_ta10_fm10_tm10,g
3040@TOP@human_GAPDH_TAA_len41_fa10_ta10_fm10_tm10*114*t,0,0,0,3200,3200,0.0,114,3040@TOP@human_GAPDH_TAA_len41_fa10_ta10_fm10_tm10,t
3040@TOP@human_GAPDH_TAA_len41_fa10_ta10_fm10_tm10*115*c,0,3214,0,0,3214,0.0,115,3040@TOP@human_GAPDH_TAA_len41_fa10_ta10_fm10_tm10,c
3040@TOP@human_GAPDH_TAA_len41_fa10_ta10_fm10_tm10*116*c,1,3196,0,0,3197,0.0,116,3040@TOP@human_GAPDH_TAA_len41_fa10_ta10_fm10_tm10,c
3040@TOP@human_GAPDH_TAA_len41_fa10_ta10_fm10_tm10*117*a,3160,0,33,0,3193,0.01,117,3040@TOP@human_GAPDH_TAA_len41_fa10_ta10_fm10_tm10,a
3040@TOP@human_GAPDH_TAA_len41_fa10_ta10_fm10_tm10*118*a,2782,0,398,0,3180,0.125,118,3040@TOP@human_GAPDH_TAA_len41_fa10_ta10_fm10_tm10,a
3040@TOP@human_GAPDH_TAA_len41_fa10_ta10_fm10_tm10*119*g,0,0,3177,0,3177,1.0,119,3040@TOP@human_GAPDH_TAA_len41_fa10_ta10_fm10_tm10,g
3040@TOP@human_GAPDH_TAA_len41_fa10_ta10_fm10_tm10*120*g,0,0,3167,0,3167,1.0,120,3040@TOP@human_GAPDH_TAA_len41_fa10_ta10_fm10_tm10,g
3040@TOP@human_GAPDH_TAA_len41_fa10_ta10_fm10_tm10*121*a,3184,0,7,0,3191,0.002,121,3040@TOP@human_GAPDH_TAA_len41_fa10_ta10_fm10_tm10,a
3040@TOP@human_GAPDH_TAA_len41_fa10_ta10_fm10_tm10*122*g,0,0,3209,0,3209,1.0,122,3040@TOP@human_GAPDH_TAA_len41_fa10_ta10_fm10_tm10,g
3040@TOP@human_GAPDH_TAA_len41_fa10_ta10_fm10_tm10*123*t,0,0,2,3162,3164,0.001,123,3040@TOP@human_GAPDH_TAA_len41_fa10_ta10_fm10_tm10,t
3040@TOP@human_GAPDH_TAA_len41_fa10_ta10_fm10_tm10*124*a,2758,0,402,0,3160,0.127,124,3040@TOP@human_GAPDH_TAA_len41_fa10_ta10_fm10_tm10,a
3040@TOP@human_GAPDH_TAA_len41_fa10_ta10_fm10_tm10*125*a,2953,1,177,0,3131,0.057,125,3040@TOP@human_GAPDH_TAA_len41_fa10_ta10_fm10_tm10,a
3040@TOP@human_GAPDH_TAA_len41_fa10_ta10_fm10_tm10*126*g,0,0,3179,0,3179,1.0,126,3040@TOP@human_GAPDH_TAA_len41_fa10_ta10_fm10_tm10,g
3040@TOP@human_GAPDH_TAA_len41_fa10_ta10_fm10_tm10*127*a,3182,0,4,0,3186,0.001,127,3040@TOP@human_GAPDH_TAA_len41_fa10_ta10_fm10_tm10,a
3040@TOP@human_GAPDH_TAA_len41_fa10_ta10_fm10_tm10*128*c,0,3207,0,0,3207,0.0,128,3040@TOP@human_GAPDH_TAA_len41_fa10_ta10_fm10_tm10,c
3040@TOP@human_GAPDH_TAA_len41_fa10_ta10_fm10_tm10*129*c,0,3188,0,0,3188,0.0,129,3040@TOP@human_GAPDH_TAA_len41_fa10_ta10_fm10_tm10,c
3040@TOP@human_GAPDH_TAA_len41_fa10_ta10_fm10_tm10*130*c,0,3204,0,0,3204,0.0,130,3040@TOP@human_GAPDH_TAA_len41_fa10_ta10_fm10_tm10,c
3040@TOP@human_GAPDH_TAA_len41_fa10_ta10_fm10_tm10*131*c,0,3205,0,0,3205,0.0,131,3040@TOP@human_GAPDH_TAA_len41_fa10_ta10_fm10_tm10,c
3040@TOP@human_GAPDH_TAA_len41_fa10_ta10_fm10_tm10*132*t,0,1,1,3159,3161,0.0,132,3040@TOP@human_GAPDH_TAA_len41_fa10_ta10_fm10_tm10,t
3040@TOP@human_GAPDH_TAA_len41_fa10_ta10_fm10_tm10*133*g,1,0,3144,0,3145,1.0,133,3040@TOP@human_GAPDH_TAA_len41_fa10_ta10_fm10_tm10,g
3040@TOP@human_GAPDH_TAA_len41_fa10_ta10_fm10_tm10*134*g,0,3,3167,0,3170,0.999,134,3040@TOP@human_GAPDH_TAA_len41_fa10_ta10_fm10_tm10,g
3041@TOP@human_GAPDH_TAA_len41_fa10_ta10_fm10_tm10*114*t,1,4,0,23190,23195,0.0,114,3041@TOP@human_GAPDH_TAA_len41_fa10_ta10_fm10_tm10,t
3041@TOP@human_GAPDH_TAA_len41_fa10_ta10_fm10_tm10*115*c,1,23344,1,3,23349,0.0,115,3041@TOP@human_GAPDH_TAA_len41_fa10_ta10_fm10_tm10,c
3041@TOP@human_GAPDH_TAA_len41_fa10_ta10_fm10_tm10*116*c,1,23253,0,0,23254,0.0,116,3041@TOP@human_GAPDH_TAA_len41_fa10_ta10_fm10_tm10,c
3041@TOP@human_GAPDH_TAA_len41_fa10_ta10_fm10_tm10*117*a,23083,0,145,0,23228,0.006,117,3041@TOP@human_GAPDH_TAA_len41_fa10_ta10_fm10_tm10,a
3041@TOP@human_GAPDH_TAA_len41_fa10_ta10_fm10_tm10*118*a,19744,1,3330,1,23076,0.144,118,3041@TOP@human_GAPDH_TAA_len41_fa10_ta10_fm10_tm10,a
3041@TOP@human_GAPDH_TAA_len41_fa10_ta10_fm10_tm10*119*g,1,1,23034,0,23036,1.0,119,3041@TOP@human_GAPDH_TAA_len41_fa10_ta10_fm10_tm10,g
3041@TOP@human_GAPDH_TAA_len41_fa10_ta10_fm10_tm10*120*g,1,3,22952,0,22956,1.0,120,3041@TOP@human_GAPDH_TAA_len41_fa10_ta10_fm10_tm10,g
3041@TOP@human_GAPDH_TAA_len41_fa10_ta10_fm10_tm10*121*a,23154,1,3,0,23158,0.0,121,3041@TOP@human_GAPDH_TAA_len41_fa10_ta10_fm10_tm10,a
3041@TOP@human_GAPDH_TAA_len41_fa10_ta10_fm10_tm10*122*g,2,0,23246,1,23249,1.0,122,3041@TOP@human_GAPDH_TAA_len41_fa10_ta10_fm10_tm10,g
3041@TOP@human_GAPDH_TAA_len41_fa10_ta10_fm10_tm10*123*t,3,10,1,22863,22877,0.0,123,3041@TOP@human_GAPDH_TAA_len41_fa10_ta10_fm10_tm10,t
3041@TOP@human_GAPDH_TAA_len41_fa10_ta10_fm10_tm10*124*a,22115,2,653,2,22772,0.029,124,3041@TOP@human_GAPDH_TAA_len41_fa10_ta10_fm10_tm10,a
3041@TOP@human_GAPDH_TAA_len41_fa10_ta10_fm10_tm10*125*a,21395,1,1345,3,22744,0.059,125,3041@TOP@human_GAPDH_TAA_len41_fa10_ta10_fm10_tm10,a
3041@TOP@human_GAPDH_TAA_len41_fa10_ta10_fm10_tm10*126*g,0,1,22906,2,22909,1.0,126,3041@TOP@human_GAPDH_TAA_len41_fa10_ta10_fm10_tm10,g
3041@TOP@human_GAPDH_TAA_len41_fa10_ta10_fm10_tm10*127*a,23051,3,40,2,23096,0.002,127,3041@TOP@human_GAPDH_TAA_len41_fa10_ta10_fm10_tm10,a
3041@TOP@human_GAPDH_TAA_len41_fa10_ta10_fm10_tm10*128*c,0,23279,4,2,23285,0.0,128,3041@TOP@human_GAPDH_TAA_len41_fa10_ta10_fm10_tm10,c
3041@TOP@human_GAPDH_TAA_len41_fa10_ta10_fm10_tm10*129*c,0,23114,0,1,23115,0.0,129,3041@TOP@human_GAPDH_TAA_len41_fa10_ta10_fm10_tm10,c
3041@TOP@human_GAPDH_TAA_len41_fa10_ta10_fm10_tm10*130*c,1,23247,0,0,23248,0.0,130,3041@TOP@human_GAPDH_TAA_len41_fa10_ta10_fm10_tm10,c
3041@TOP@human_GAPDH_TAA_len41_fa10_ta10_fm10_tm10*131*c,1,23290,0,3,23294,0.0,131,3041@TOP@human_GAPDH_TAA_len41_fa10_ta10_fm10_tm10,c
3041@TOP@human_GAPDH_TAA_len41_fa10_ta10_fm10_tm10*132*t,5,3,5,22975,22988,0.0,132,3041@TOP@human_GAPDH_TAA_len41_fa10_ta10_fm10_tm10,t
3041@TOP@human_GAPDH_TAA_len41_fa10_ta10_fm10_tm10*133*g,0,0,22926,0,22926,1.0,133,3041@TOP@human_GAPDH_TAA_len41_fa10_ta10_fm10_tm10,g
3041@TOP@human_GAPDH_TAA_len41_fa10_ta10_fm10_tm10*134*g,3,7,23028,1,23039,1.0,134,3041@TOP@human_GAPDH_TAA_len41_fa10_ta10_fm10_tm10,g
3042@TOP@human_GAPDH_TAA_len41_fa10_ta10_fm10_tm10*114*t,4,5,0,44221,44230,0.0,114,3042@TOP@human_GAPDH_TAA_len41_fa10_ta10_fm10_tm10,t
3042@TOP@human_GAPDH_TAA_len41_fa10_ta10_fm10_tm10*115*c,1,44449,1,7,44458,0.0,115,3042@TOP@human_GAPDH_TAA_len41_fa10_ta10_fm10_tm10,c
3042@TOP@human_GAPDH_TAA_len41_fa10_ta10_fm10_tm10*116*c,0,44276,0,0,44276,0.0,116,3042@TOP@human_GAPDH_TAA_len41_fa10_ta10_fm10_tm10,c
3042@TOP@human_GAPDH_TAA_len41_fa10_ta10_fm10_tm10*117*a,44113,0,151,0,44264,0.003,117,3042@TOP@human_GAPDH_TAA_len41_fa10_ta10_fm10_tm10,a
3042@TOP@human_GAPDH_TAA_len41_fa10_ta10_fm10_tm10*118*a,40877,1,3070,0,43948,0.07,118,3042@TOP@human_GAPDH_TAA_len41_fa10_ta10_fm10_tm10,a
3042@TOP@human_GAPDH_TAA_len41_fa10_ta10_fm10_tm10*119*g,0,0,43897,0,43897,1.0,119,3042@TOP@human_GAPDH_TAA_len41_fa10_ta10_fm10_tm10,g
3042@TOP@human_GAPDH_TAA_len41_fa10_ta10_fm10_tm10*120*g,4,2,43757,0,43763,1.0,120,3042@TOP@human_GAPDH_TAA_len41_fa10_ta10_fm10_tm10,g
3042@TOP@human_GAPDH_TAA_len41_fa10_ta10_fm10_tm10*121*a,44197,1,6,0,44204,0.0,121,3042@TOP@human_GAPDH_TAA_len41_fa10_ta10_fm10_tm10,a
3042@TOP@human_GAPDH_TAA_len41_fa10_ta10_fm10_tm10*122*g,1,0,44278,0,44279,1.0,122,3042@TOP@human_GAPDH_TAA_len41_fa10_ta10_fm10_tm10,g
3042@TOP@human_GAPDH_TAA_len41_fa10_ta10_fm10_tm10*123*t,4,3,6,43662,43675,0.0,123,3042@TOP@human_GAPDH_TAA_len41_fa10_ta10_fm10_tm10,t
3042@TOP@human_GAPDH_TAA_len41_fa10_ta10_fm10_tm10*124*a,42054,1,1454,0,43509,0.033,124,3042@TOP@human_GAPDH_TAA_len41_fa10_ta10_fm10_tm10,a
3042@TOP@human_GAPDH_TAA_len41_fa10_ta10_fm10_tm10*125*a,41785,1,1622,8,43416,0.037,125,3042@TOP@human_GAPDH_TAA_len41_fa10_ta10_fm10_tm10,a
3042@TOP@human_GAPDH_TAA_len41_fa10_ta10_fm10_tm10*126*g,3,0,43643,1,43647,1.0,126,3042@TOP@human_GAPDH_TAA_len41_fa10_ta10_fm10_tm10,g
3042@TOP@human_GAPDH_TAA_len41_fa10_ta10_fm10_tm10*127*a,44010,3,92,1,44106,0.002,127,3042@TOP@human_GAPDH_TAA_len41_fa10_ta10_fm10_tm10,a
3042@TOP@human_GAPDH_TAA_len41_fa10_ta10_fm10_tm10*128*c,0,44348,6,4,44358,0.0,128,3042@TOP@human_GAPDH_TAA_len41_fa10_ta10_fm10_tm10,c
3042@TOP@human_GAPDH_TAA_len41_fa10_ta10_fm10_tm10*129*c,2,44045,0,1,44048,0.0,129,3042@TOP@human_GAPDH_TAA_len41_fa10_ta10_fm10_tm10,c
3042@TOP@human_GAPDH_TAA_len41_fa10_ta10_fm10_tm10*130*c,4,44243,0,2,44249,0.0,130,3042@TOP@human_GAPDH_TAA_len41_fa10_ta10_fm10_tm10,c
3042@TOP@human_GAPDH_TAA_len41_fa10_ta10_fm10_tm10*131*c,3,44364,0,1,44368,0.0,131,3042@TOP@human_GAPDH_TAA_len41_fa10_ta10_fm10_tm10,c
3042@TOP@human_GAPDH_TAA_len41_fa10_ta10_fm10_tm10*132*t,5,14,7,43725,43751,0.0,132,3042@TOP@human_GAPDH_TAA_len41_fa10_ta10_fm10_tm10,t
3042@TOP@human_GAPDH_TAA_len41_fa10_ta10_fm10_tm10*133*g,5,0,43679,3,43687,1.0,133,3042@TOP@human_GAPDH_TAA_len41_fa10_ta10_fm10_tm10,g
3042@TOP@human_GAPDH_TAA_len41_fa10_ta10_fm10_tm10*134*g,5,4,43854,1,43864,1.0,134,3042@TOP@human_GAPDH_TAA_len41_fa10_ta10_fm10_tm10,g
3043@TOP@human_GAPDH_TAA_len41_fa10_ta10_fm10_tm10*114*t,0,1,0,8340,8341,0.0,114,3043@TOP@human_GAPDH_TAA_len41_fa10_ta10_fm10_tm10,t
3043@TOP@human_GAPDH_TAA_len41_fa10_ta10_fm10_tm10*115*c,0,8396,0,0,8396,0.0,115,3043@TOP@human_GAPDH_TAA_len41_fa10_ta10_fm10_tm10,c
3043@TOP@human_GAPDH_TAA_len41_fa10_ta10_fm10_tm10*116*c,0,8363,0,0,8363,0.0,116,3043@TOP@human_GAPDH_TAA_len41_fa10_ta10_fm10_tm10,c
3043@TOP@human_GAPDH_TAA_len41_fa10_ta10_fm10_tm10*117*a,8027,1,306,2,8336,0.037,117,3043@TOP@human_GAPDH_TAA_len41_fa10_ta10_fm10_tm10,a
3043@TOP@human_GAPDH_TAA_len41_fa10_ta10_fm10_tm10*118*a,3407,1,4900,0,8308,0.59,118,3043@TOP@human_GAPDH_TAA_len41_fa10_ta10_fm10_tm10,a
3043@TOP@human_GAPDH_TAA_len41_fa10_ta10_fm10_tm10*119*g,1,0,8302,0,8303,1.0,119,3043@TOP@human_GAPDH_TAA_len41_fa10_ta10_fm10_tm10,g
3043@TOP@human_GAPDH_TAA_len41_fa10_ta10_fm10_tm10*120*g,0,1,8301,0,8302,1.0,120,3043@TOP@human_GAPDH_TAA_len41_fa10_ta10_fm10_tm10,g
3043@TOP@human_GAPDH_TAA_len41_fa10_ta10_fm10_tm10*121*a,8260,0,26,1,8287,0.003,121,3043@TOP@human_GAPDH_TAA_len41_fa10_ta10_fm10_tm10,a
3043@TOP@human_GAPDH_TAA_len41_fa10_ta10_fm10_tm10*122*g,3,0,8368,0,8371,1.0,122,3043@TOP@human_GAPDH_TAA_len41_fa10_ta10_fm10_tm10,g
3043@TOP@human_GAPDH_TAA_len41_fa10_ta10_fm10_tm10*123*t,1,8,2,8261,8272,0.0,123,3043@TOP@human_GAPDH_TAA_len41_fa10_ta10_fm10_tm10,t
3043@TOP@human_GAPDH_TAA_len41_fa10_ta10_fm10_tm10*124*a,4600,0,3646,0,8246,0.442,124,3043@TOP@human_GAPDH_TAA_len41_fa10_ta10_fm10_tm10,a
3043@TOP@human_GAPDH_TAA_len41_fa10_ta10_fm10_tm10*125*a,4995,0,3274,0,8269,0.396,125,3043@TOP@human_GAPDH_TAA_len41_fa10_ta10_fm10_tm10,a
3043@TOP@human_GAPDH_TAA_len41_fa10_ta10_fm10_tm10*126*g,0,0,8276,0,8276,1.0,126,3043@TOP@human_GAPDH_TAA_len41_fa10_ta10_fm10_tm10,g
3043@TOP@human_GAPDH_TAA_len41_fa10_ta10_fm10_tm10*127*a,8323,0,21,0,8344,0.003,127,3043@TOP@human_GAPDH_TAA_len41_fa10_ta10_fm10_tm10,a
3043@TOP@human_GAPDH_TAA_len41_fa10_ta10_fm10_tm10*128*c,0,8378,0,0,8378,0.0,128,3043@TOP@human_GAPDH_TAA_len41_fa10_ta10_fm10_tm10,c
3043@TOP@human_GAPDH_TAA_len41_fa10_ta10_fm10_tm10*129*c,0,8349,0,0,8349,0.0,129,3043@TOP@human_GAPDH_TAA_len41_fa10_ta10_fm10_tm10,c
3043@TOP@human_GAPDH_TAA_len41_fa10_ta10_fm10_tm10*130*c,0,8378,0,0,8378,0.0,130,3043@TOP@human_GAPDH_TAA_len41_fa10_ta10_fm10_tm10,c
3043@TOP@human_GAPDH_TAA_len41_fa10_ta10_fm10_tm10*131*c,1,8379,0,0,8380,0.0,131,3043@TOP@human_GAPDH_TAA_len41_fa10_ta10_fm10_tm10,c
3043@TOP@human_GAPDH_TAA_len41_fa10_ta10_fm10_tm10*132*t,1,2,1,8276,8280,0.0,132,3043@TOP@human_GAPDH_TAA_len41_fa10_ta10_fm10_tm10,t
3043@TOP@human_GAPDH_TAA_len41_fa10_ta10_fm10_tm10*133*g,0,1,8288,0,8289,1.0,133,3043@TOP@human_GAPDH_TAA_len41_fa10_ta10_fm10_tm10,g
3043@TOP@human_GAPDH_TAA_len41_fa10_ta10_fm10_tm10*134*g,0,3,8296,0,8299,1.0,134,3043@TOP@human_GAPDH_TAA_len41_fa10_ta10_fm10_tm10,g
3044@TOP@human_GAPDH_TAA_len41_fa10_ta10_fm10_tm10*114*t,3,11,0,31750,31764,0.0,114,3044@TOP@human_GAPDH_TAA_len41_fa10_ta10_fm10_tm10,t
3044@TOP@human_GAPDH_TAA_len41_fa10_ta10_fm10_tm10*115*c,1,31923,0,0,31924,0.0,115,3044@TOP@human_GAPDH_TAA_len41_fa10_ta10_fm10_tm10,c
3044@TOP@human_GAPDH_TAA_len41_fa10_ta10_fm10_tm10*116*c,1,31823,0,1,31825,0.0,116,3044@TOP@human_GAPDH_TAA_len41_fa10_ta10_fm10_tm10,c
3044@TOP@human_GAPDH_TAA_len41_fa10_ta10_fm10_tm10*117*a,31366,0,413,2,31781,0.013,117,3044@TOP@human_GAPDH_TAA_len41_fa10_ta10_fm10_tm10,a
3044@TOP@human_GAPDH_TAA_len41_fa10_ta10_fm10_tm10*118*a,24851,1,6766,6,31624,0.214,118,3044@TOP@human_GAPDH_TAA_len41_fa10_ta10_fm10_tm10,a
3044@TOP@human_GAPDH_TAA_len41_fa10_ta10_fm10_tm10*119*g,1,0,31552,0,31553,1.0,119,3044@TOP@human_GAPDH_TAA_len41_fa10_ta10_fm10_tm10,g
3044@TOP@human_GAPDH_TAA_len41_fa10_ta10_fm10_tm10*120*g,0,0,31506,2,31508,1.0,120,3044@TOP@human_GAPDH_TAA_len41_fa10_ta10_fm10_tm10,g
3044@TOP@human_GAPDH_TAA_len41_fa10_ta10_fm10_tm10*121*a,31653,0,22,1,31676,0.001,121,3044@TOP@human_GAPDH_TAA_len41_fa10_ta10_fm10_tm10,a
3044@TOP@human_GAPDH_TAA_len41_fa10_ta10_fm10_tm10*122*g,1,0,31830,0,31831,1.0,122,3044@TOP@human_GAPDH_TAA_len41_fa10_ta10_fm10_tm10,g
3044@TOP@human_GAPDH_TAA_len41_fa10_ta10_fm10_tm10*123*t,3,1,8,31381,31393,0.0,123,3044@TOP@human_GAPDH_TAA_len41_fa10_ta10_fm10_tm10,t
3044@TOP@human_GAPDH_TAA_len41_fa10_ta10_fm10_tm10*124*a,23411,2,7930,2,31345,0.253,124,3044@TOP@human_GAPDH_TAA_len41_fa10_ta10_fm10_tm10,a
3044@TOP@human_GAPDH_TAA_len41_fa10_ta10_fm10_tm10*125*a,27760,0,3551,1,31312,0.113,125,3044@TOP@human_GAPDH_TAA_len41_fa10_ta10_fm10_tm10,a
3044@TOP@human_GAPDH_TAA_len41_fa10_ta10_fm10_tm10*126*g,0,0,31469,0,31469,1.0,126,3044@TOP@human_GAPDH_TAA_len41_fa10_ta10_fm10_tm10,g
3044@TOP@human_GAPDH_TAA_len41_fa10_ta10_fm10_tm10*127*a,31675,2,35,0,31712,0.001,127,3044@TOP@human_GAPDH_TAA_len41_fa10_ta10_fm10_tm10,a
3044@TOP@human_GAPDH_TAA_len41_fa10_ta10_fm10_tm10*128*c,0,31861,2,0,31863,0.0,128,3044@TOP@human_GAPDH_TAA_len41_fa10_ta10_fm10_tm10,c
3044@TOP@human_GAPDH_TAA_len41_fa10_ta10_fm10_tm10*129*c,0,31653,0,2,31655,0.0,129,3044@TOP@human_GAPDH_TAA_len41_fa10_ta10_fm10_tm10,c
3044@TOP@human_GAPDH_TAA_len41_fa10_ta10_fm10_tm10*130*c,0,31810,0,2,31812,0.0,130,3044@TOP@human_GAPDH_TAA_len41_fa10_ta10_fm10_tm10,c
3044@TOP@human_GAPDH_TAA_len41_fa10_ta10_fm10_tm10*131*c,0,31882,1,1,31884,0.0,131,3044@TOP@human_GAPDH_TAA_len41_fa10_ta10_fm10_tm10,c
3044@TOP@human_GAPDH_TAA_len41_fa10_ta10_fm10_tm10*132*t,2,8,1,31440,31451,0.0,132,3044@TOP@human_GAPDH_TAA_len41_fa10_ta10_fm10_tm10,t
3044@TOP@human_GAPDH_TAA_len41_fa10_ta10_fm10_tm10*133*g,3,1,31343,0,31347,1.0,133,3044@TOP@human_GAPDH_TAA_len41_fa10_ta10_fm10_tm10,g
3044@TOP@human_GAPDH_TAA_len41_fa10_ta10_fm10_tm10*134*g,3,5,31573,1,31582,1.0,134,3044@TOP@human_GAPDH_TAA_len41_fa10_ta10_fm10_tm10,g
3045@TOP@human_GAPDH_TAA_len41_fa10_ta10_fm10_tm10*114*t,2,11,0,34219,34232,0.0,114,3045@TOP@human_GAPDH_TAA_len41_fa10_ta10_fm10_tm10,t
3045@TOP@human_GAPDH_TAA_len41_fa10_ta10_fm10_tm10*115*c,0,34423,0,1,34424,0.0,115,3045@TOP@human_GAPDH_TAA_len41_fa10_ta10_fm10_tm10,c
3045@TOP@human_GAPDH_TAA_len41_fa10_ta10_fm10_tm10*116*c,2,34299,0,3,34304,0.0,116,3045@TOP@human_GAPDH_TAA_len41_fa10_ta10_fm10_tm10,c
3045@TOP@human_GAPDH_TAA_len41_fa10_ta10_fm10_tm10*117*a,34209,1,49,0,34259,0.001,117,3045@TOP@human_GAPDH_TAA_len41_fa10_ta10_fm10_tm10,a
3045@TOP@human_GAPDH_TAA_len41_fa10_ta10_fm10_tm10*118*a,33533,0,539,0,34072,0.016,118,3045@TOP@human_GAPDH_TAA_len41_fa10_ta10_fm10_tm10,a
3045@TOP@human_GAPDH_TAA_len41_fa10_ta10_fm10_tm10*119*g,1,1,34012,0,34014,1.0,119,3045@TOP@human_GAPDH_TAA_len41_fa10_ta10_fm10_tm10,g
3045@TOP@human_GAPDH_TAA_len41_fa10_ta10_fm10_tm10*120*g,2,2,33893,1,33898,1.0,120,3045@TOP@human_GAPDH_TAA_len41_fa10_ta10_fm10_tm10,g
3045@TOP@human_GAPDH_TAA_len41_fa10_ta10_fm10_tm10*121*a,34236,0,21,0,34257,0.001,121,3045@TOP@human_GAPDH_TAA_len41_fa10_ta10_fm10_tm10,a
3045@TOP@human_GAPDH_TAA_len41_fa10_ta10_fm10_tm10*122*g,1,0,34296,0,34297,1.0,122,3045@TOP@human_GAPDH_TAA_len41_fa10_ta10_fm10_tm10,g
3045@TOP@human_GAPDH_TAA_len41_fa10_ta10_fm10_tm10*123*t,3,9,4,33888,33904,0.0,123,3045@TOP@human_GAPDH_TAA_len41_fa10_ta10_fm10_tm10,t
3045@TOP@human_GAPDH_TAA_len41_fa10_ta10_fm10_tm10*124*a,28858,0,5014,0,33872,0.148,124,3045@TOP@human_GAPDH_TAA_len41_fa10_ta10_fm10_tm10,a
3045@TOP@human_GAPDH_TAA_len41_fa10_ta10_fm10_tm10*125*a,32634,3,940,4,33581,0.028,125,3045@TOP@human_GAPDH_TAA_len41_fa10_ta10_fm10_tm10,a
3045@TOP@human_GAPDH_TAA_len41_fa10_ta10_fm10_tm10*126*g,0,0,33845,2,33847,1.0,126,3045@TOP@human_GAPDH_TAA_len41_fa10_ta10_fm10_tm10,g
3045@TOP@human_GAPDH_TAA_len41_fa10_ta10_fm10_tm10*127*a,34111,1,26,1,34139,0.001,127,3045@TOP@human_GAPDH_TAA_len41_fa10_ta10_fm10_tm10,a
3045@TOP@human_GAPDH_TAA_len41_fa10_ta10_fm10_tm10*128*c,3,34357,1,1,34362,0.0,128,3045@TOP@human_GAPDH_TAA_len41_fa10_ta10_fm10_tm10,c
3045@TOP@human_GAPDH_TAA_len41_fa10_ta10_fm10_tm10*129*c,2,34022,0,1,34025,0.0,129,3045@TOP@human_GAPDH_TAA_len41_fa10_ta10_fm10_tm10,c
3045@TOP@human_GAPDH_TAA_len41_fa10_ta10_fm10_tm10*130*c,1,34312,0,0,34313,0.0,130,3045@TOP@human_GAPDH_TAA_len41_fa10_ta10_fm10_tm10,c
3045@TOP@human_GAPDH_TAA_len41_fa10_ta10_fm10_tm10*131*c,6,34347,0,7,34360,0.0,131,3045@TOP@human_GAPDH_TAA_len41_fa10_ta10_fm10_tm10,c
3045@TOP@human_GAPDH_TAA_len41_fa10_ta10_fm10_tm10*132*t,4,4,1,33940,33949,0.0,132,3045@TOP@human_GAPDH_TAA_len41_fa10_ta10_fm10_tm10,t
3045@TOP@human_GAPDH_TAA_len41_fa10_ta10_fm10_tm10*133*g,0,1,33751,2,33754,1.0,133,3045@TOP@human_GAPDH_TAA_len41_fa10_ta10_fm10_tm10,g
3045@TOP@human_GAPDH_TAA_len41_fa10_ta10_fm10_tm10*134*g,4,3,33973,0,33980,1.0,134,3045@TOP@human_GAPDH_TAA_len41_fa10_ta10_fm10_tm10,g
3046@TOP@human_GAPDH_TAA_len41_fa10_ta10_fm10_tm10*114*t,0,0,2,3833,3835,0.001,114,3046@TOP@human_GAPDH_TAA_len41_fa10_ta10_fm10_tm10,t
3046@TOP@human_GAPDH_TAA_len41_fa10_ta10_fm10_tm10*115*c,0,3867,0,1,3868,0.0,115,3046@TOP@human_GAPDH_TAA_len41_fa10_ta10_fm10_tm10,c
3046@TOP@human_GAPDH_TAA_len41_fa10_ta10_fm10_tm10*116*c,1,3846,0,0,3847,0.0,116,3046@TOP@human_GAPDH_TAA_len41_fa10_ta10_fm10_tm10,c
3046@TOP@human_GAPDH_TAA_len41_fa10_ta10_fm10_tm10*117*a,3585,0,252,0,3837,0.066,117,3046@TOP@human_GAPDH_TAA_len41_fa10_ta10_fm10_tm10,a
3046@TOP@human_GAPDH_TAA_len41_fa10_ta10_fm10_tm10*118*a,1410,0,2402,0,3812,0.63,118,3046@TOP@human_GAPDH_TAA_len41_fa10_ta10_fm10_tm10,a
3046@TOP@human_GAPDH_TAA_len41_fa10_ta10_fm10_tm10*119*g,0,0,3812,0,3812,1.0,119,3046@TOP@human_GAPDH_TAA_len41_fa10_ta10_fm10_tm10,g
3046@TOP@human_GAPDH_TAA_len41_fa10_ta10_fm10_tm10*120*g,0,0,3826,0,3826,1.0,120,3046@TOP@human_GAPDH_TAA_len41_fa10_ta10_fm10_tm10,g
3046@TOP@human_GAPDH_TAA_len41_fa10_ta10_fm10_tm10*121*a,3806,0,5,0,3811,0.001,121,3046@TOP@human_GAPDH_TAA_len41_fa10_ta10_fm10_tm10,a
3046@TOP@human_GAPDH_TAA_len41_fa10_ta10_fm10_tm10*122*g,0,1,3857,0,3858,1.0,122,3046@TOP@human_GAPDH_TAA_len41_fa10_ta10_fm10_tm10,g
3046@TOP@human_GAPDH_TAA_len41_fa10_ta10_fm10_tm10*123*t,0,4,0,3792,3796,0.0,123,3046@TOP@human_GAPDH_TAA_len41_fa10_ta10_fm10_tm10,t
3046@TOP@human_GAPDH_TAA_len41_fa10_ta10_fm10_tm10*124*a,2504,0,1277,0,3781,0.338,124,3046@TOP@human_GAPDH_TAA_len41_fa10_ta10_fm10_tm10,a
3046@TOP@human_GAPDH_TAA_len41_fa10_ta10_fm10_tm10*125*a,1916,0,1863,0,3779,0.493,125,3046@TOP@human_GAPDH_TAA_len41_fa10_ta10_fm10_tm10,a
3046@TOP@human_GAPDH_TAA_len41_fa10_ta10_fm10_tm10*126*g,0,0,3813,0,3813,1.0,126,3046@TOP@human_GAPDH_TAA_len41_fa10_ta10_fm10_tm10,g
3046@TOP@human_GAPDH_TAA_len41_fa10_ta10_fm10_tm10*127*a,3829,0,13,0,3842,0.003,127,3046@TOP@human_GAPDH_TAA_len41_fa10_ta10_fm10_tm10,a
3046@TOP@human_GAPDH_TAA_len41_fa10_ta10_fm10_tm10*128*c,0,3858,0,0,3858,0.0,128,3046@TOP@human_GAPDH_TAA_len41_fa10_ta10_fm10_tm10,c
3046@TOP@human_GAPDH_TAA_len41_fa10_ta10_fm10_tm10*129*c,0,3840,0,0,3840,0.0,129,3046@TOP@human_GAPDH_TAA_len41_fa10_ta10_fm10_tm10,c
3046@TOP@human_GAPDH_TAA_len41_fa10_ta10_fm10_tm10*130*c,0,3853,0,0,3853,0.0,130,3046@TOP@human_GAPDH_TAA_len41_fa10_ta10_fm10_tm10,c
3046@TOP@human_GAPDH_TAA_len41_fa10_ta10_fm10_tm10*131*c,0,3858,0,1,3859,0.0,131,3046@TOP@human_GAPDH_TAA_len41_fa10_ta10_fm10_tm10,c
3046@TOP@human_GAPDH_TAA_len41_fa10_ta10_fm10_tm10*132*t,0,3,0,3807,3810,0.0,132,3046@TOP@human_GAPDH_TAA_len41_fa10_ta10_fm10_tm10,t
3046@TOP@human_GAPDH_TAA_len41_fa10_ta10_fm10_tm10*133*g,1,0,3793,0,3794,1.0,133,3046@TOP@human_GAPDH_TAA_len41_fa10_ta10_fm10_tm10,g
3046@TOP@human_GAPDH_TAA_len41_fa10_ta10_fm10_tm10*134*g,1,1,3821,0,3823,0.999,134,3046@TOP@human_GAPDH_TAA_len41_fa10_ta10_fm10_tm10,g
3047@TOP@human_GAPDH_TAA_len41_fa10_ta10_fm10_tm10*114*t,1,3,0,8831,8835,0.0,114,3047@TOP@human_GAPDH_TAA_len41_fa10_ta10_fm10_tm10,t
3047@TOP@human_GAPDH_TAA_len41_fa10_ta10_fm10_tm10*115*c,0,8888,0,0,8888,0.0,115,3047@TOP@human_GAPDH_TAA_len41_fa10_ta10_fm10_tm10,c
3047@TOP@human_GAPDH_TAA_len41_fa10_ta10_fm10_tm10*116*c,0,8852,0,0,8852,0.0,116,3047@TOP@human_GAPDH_TAA_len41_fa10_ta10_fm10_tm10,c
3047@TOP@human_GAPDH_TAA_len41_fa10_ta10_fm10_tm10*117*a,8568,0,273,1,8842,0.031,117,3047@TOP@human_GAPDH_TAA_len41_fa10_ta10_fm10_tm10,a
3047@TOP@human_GAPDH_TAA_len41_fa10_ta10_fm10_tm10*118*a,5746,0,3043,0,8789,0.346,118,3047@TOP@human_GAPDH_TAA_len41_fa10_ta10_fm10_tm10,a
3047@TOP@human_GAPDH_TAA_len41_fa10_ta10_fm10_tm10*119*g,0,0,8786,1,8787,1.0,119,3047@TOP@human_GAPDH_TAA_len41_fa10_ta10_fm10_tm10,g
3047@TOP@human_GAPDH_TAA_len41_fa10_ta10_fm10_tm10*120*g,1,0,8785,0,8786,1.0,120,3047@TOP@human_GAPDH_TAA_len41_fa10_ta10_fm10_tm10,g
3047@TOP@human_GAPDH_TAA_len41_fa10_ta10_fm10_tm10*121*a,8796,1,4,0,8801,0.0,121,3047@TOP@human_GAPDH_TAA_len41_fa10_ta10_fm10_tm10,a
3047@TOP@human_GAPDH_TAA_len41_fa10_ta10_fm10_tm10*122*g,1,0,8857,0,8858,1.0,122,3047@TOP@human_GAPDH_TAA_len41_fa10_ta10_fm10_tm10,g
3047@TOP@human_GAPDH_TAA_len41_fa10_ta10_fm10_tm10*123*t,1,0,0,8738,8739,0.0,123,3047@TOP@human_GAPDH_TAA_len41_fa10_ta10_fm10_tm10,t
3047@TOP@human_GAPDH_TAA_len41_fa10_ta10_fm10_tm10*124*a,6347,0,2374,2,8723,0.272,124,3047@TOP@human_GAPDH_TAA_len41_fa10_ta10_fm10_tm10,a
3047@TOP@human_GAPDH_TAA_len41_fa10_ta10_fm10_tm10*125*a,7372,0,1329,1,8702,0.153,125,3047@TOP@human_GAPDH_TAA_len41_fa10_ta10_fm10_tm10,a
3047@TOP@human_GAPDH_TAA_len41_fa10_ta10_fm10_tm10*126*g,0,0,8760,1,8761,1.0,126,3047@TOP@human_GAPDH_TAA_len41_fa10_ta10_fm10_tm10,g
3047@TOP@human_GAPDH_TAA_len41_fa10_ta10_fm10_tm10*127*a,8810,1,4,0,8815,0.0,127,3047@TOP@human_GAPDH_TAA_len41_fa10_ta10_fm10_tm10,a
3047@TOP@human_GAPDH_TAA_len41_fa10_ta10_fm10_tm10*128*c,1,8860,0,2,8863,0.0,128,3047@TOP@human_GAPDH_TAA_len41_fa10_ta10_fm10_tm10,c
3047@TOP@human_GAPDH_TAA_len41_fa10_ta10_fm10_tm10*129*c,0,8817,0,0,8817,0.0,129,3047@TOP@human_GAPDH_TAA_len41_fa10_ta10_fm10_tm10,c
3047@TOP@human_GAPDH_TAA_len41_fa10_ta10_fm10_tm10*130*c,1,8858,0,0,8859,0.0,130,3047@TOP@human_GAPDH_TAA_len41_fa10_ta10_fm10_tm10,c
3047@TOP@human_GAPDH_TAA_len41_fa10_ta10_fm10_tm10*131*c,0,8881,0,2,8883,0.0,131,3047@TOP@human_GAPDH_TAA_len41_fa10_ta10_fm10_tm10,c
3047@TOP@human_GAPDH_TAA_len41_fa10_ta10_fm10_tm10*132*t,1,3,1,8754,8759,0.0,132,3047@TOP@human_GAPDH_TAA_len41_fa10_ta10_fm10_tm10,t
3047@TOP@human_GAPDH_TAA_len41_fa10_ta10_fm10_tm10*133*g,1,0,8747,0,8748,1.0,133,3047@TOP@human_GAPDH_TAA_len41_fa10_ta10_fm10_tm10,g
3047@TOP@human_GAPDH_TAA_len41_fa10_ta10_fm10_tm10*134*g,1,1,8775,2,8779,1.0,134,3047@TOP@human_GAPDH_TAA_len41_fa10_ta10_fm10_tm10,g
3048@TOP@human_GAPDH_TAA_len41_fa10_ta10_fm10_tm10*114*t,0,1,0,1174,1175,0.0,114,3048@TOP@human_GAPDH_TAA_len41_fa10_ta10_fm10_tm10,t
3048@TOP@human_GAPDH_TAA_len41_fa10_ta10_fm10_tm10*115*c,0,1182,0,2,1184,0.0,115,3048@TOP@human_GAPDH_TAA_len41_fa10_ta10_fm10_tm10,c
3048@TOP@human_GAPDH_TAA_len41_fa10_ta10_fm10_tm10*116*c,0,1177,0,0,1177,0.0,116,3048@TOP@human_GAPDH_TAA_len41_fa10_ta10_fm10_tm10,c
3048@TOP@human_GAPDH_TAA_len41_fa10_ta10_fm10_tm10*117*a,1164,0,14,0,1178,0.012,117,3048@TOP@human_GAPDH_TAA_len41_fa10_ta10_fm10_tm10,a
3048@TOP@human_GAPDH_TAA_len41_fa10_ta10_fm10_tm10*118*a,1007,0,165,0,1172,0.141,118,3048@TOP@human_GAPDH_TAA_len41_fa10_ta10_fm10_tm10,a
3048@TOP@human_GAPDH_TAA_len41_fa10_ta10_fm10_tm10*119*g,0,0,1164,0,1164,1.0,119,3048@TOP@human_GAPDH_TAA_len41_fa10_ta10_fm10_tm10,g
3048@TOP@human_GAPDH_TAA_len41_fa10_ta10_fm10_tm10*120*g,1,0,1159,0,1160,0.999,120,3048@TOP@human_GAPDH_TAA_len41_fa10_ta10_fm10_tm10,g
3048@TOP@human_GAPDH_TAA_len41_fa10_ta10_fm10_tm10*121*a,1176,0,0,0,1176,0.0,121,3048@TOP@human_GAPDH_TAA_len41_fa10_ta10_fm10_tm10,a
3048@TOP@human_GAPDH_TAA_len41_fa10_ta10_fm10_tm10*122*g,0,0,1175,0,1175,1.0,122,3048@TOP@human_GAPDH_TAA_len41_fa10_ta10_fm10_tm10,g
3048@TOP@human_GAPDH_TAA_len41_fa10_ta10_fm10_tm10*123*t,0,1,0,1158,1159,0.0,123,3048@TOP@human_GAPDH_TAA_len41_fa10_ta10_fm10_tm10,t
3048@TOP@human_GAPDH_TAA_len41_fa10_ta10_fm10_tm10*124*a,1031,0,136,0,1167,0.117,124,3048@TOP@human_GAPDH_TAA_len41_fa10_ta10_fm10_tm10,a
3048@TOP@human_GAPDH_TAA_len41_fa10_ta10_fm10_tm10*125*a,1040,1,120,0,1161,0.103,125,3048@TOP@human_GAPDH_TAA_len41_fa10_ta10_fm10_tm10,a
3048@TOP@human_GAPDH_TAA_len41_fa10_ta10_fm10_tm10*126*g,0,0,1164,1,1165,0.999,126,3048@TOP@human_GAPDH_TAA_len41_fa10_ta10_fm10_tm10,g
3048@TOP@human_GAPDH_TAA_len41_fa10_ta10_fm10_tm10*127*a,1176,0,0,0,1176,0.0,127,3048@TOP@human_GAPDH_TAA_len41_fa10_ta10_fm10_tm10,a
3048@TOP@human_GAPDH_TAA_len41_fa10_ta10_fm10_tm10*128*c,0,1181,0,0,1181,0.0,128,3048@TOP@human_GAPDH_TAA_len41_fa10_ta10_fm10_tm10,c
3048@TOP@human_GAPDH_TAA_len41_fa10_ta10_fm10_tm10*129*c,0,1168,0,0,1168,0.0,129,3048@TOP@human_GAPDH_TAA_len41_fa10_ta10_fm10_tm10,c
3048@TOP@human_GAPDH_TAA_len41_fa10_ta10_fm10_tm10*130*c,0,1183,0,0,1183,0.0,130,3048@TOP@human_GAPDH_TAA_len41_fa10_ta10_fm10_tm10,c
3048@TOP@human_GAPDH_TAA_len41_fa10_ta10_fm10_tm10*131*c,0,1181,0,0,1181,0.0,131,3048@TOP@human_GAPDH_TAA_len41_fa10_ta10_fm10_tm10,c
3048@TOP@human_GAPDH_TAA_len41_fa10_ta10_fm10_tm10*132*t,0,0,0,1167,1167,0.0,132,3048@TOP@human_GAPDH_TAA_len41_fa10_ta10_fm10_tm10,t
3048@TOP@human_GAPDH_TAA_len41_fa10_ta10_fm10_tm10*133*g,0,0,1159,0,1159,1.0,133,3048@TOP@human_GAPDH_TAA_len41_fa10_ta10_fm10_tm10,g
3048@TOP@human_GAPDH_TAA_len41_fa10_ta10_fm10_tm10*134*g,0,0,1168,0,1168,1.0,134,3048@TOP@human_GAPDH_TAA_len41_fa10_ta10_fm10_tm10,g
3049@TOP@human_GAPDH_TAA_len41_fa10_ta10_fm10_tm10*114*t,0,0,0,991,991,0.0,114,3049@TOP@human_GAPDH_TAA_len41_fa10_ta10_fm10_tm10,t
3049@TOP@human_GAPDH_TAA_len41_fa10_ta10_fm10_tm10*115*c,0,998,0,0,998,0.0,115,3049@TOP@human_GAPDH_TAA_len41_fa10_ta10_fm10_tm10,c
3049@TOP@human_GAPDH_TAA_len41_fa10_ta10_fm10_tm10*116*c,1,984,0,0,985,0.0,116,3049@TOP@human_GAPDH_TAA_len41_fa10_ta10_fm10_tm10,c
3049@TOP@human_GAPDH_TAA_len41_fa10_ta10_fm10_tm10*117*a,976,0,18,0,994,0.018,117,3049@TOP@human_GAPDH_TAA_len41_fa10_ta10_fm10_tm10,a
3049@TOP@human_GAPDH_TAA_len41_fa10_ta10_fm10_tm10*118*a,740,0,241,0,981,0.246,118,3049@TOP@human_GAPDH_TAA_len41_fa10_ta10_fm10_tm10,a
3049@TOP@human_GAPDH_TAA_len41_fa10_ta10_fm10_tm10*119*g,0,0,982,1,983,0.999,119,3049@TOP@human_GAPDH_TAA_len41_fa10_ta10_fm10_tm10,g
3049@TOP@human_GAPDH_TAA_len41_fa10_ta10_fm10_tm10*120*g,0,0,970,0,970,1.0,120,3049@TOP@human_GAPDH_TAA_len41_fa10_ta10_fm10_tm10,g
3049@TOP@human_GAPDH_TAA_len41_fa10_ta10_fm10_tm10*121*a,988,0,2,0,990,0.002,121,3049@TOP@human_GAPDH_TAA_len41_fa10_ta10_fm10_tm10,a
3049@TOP@human_GAPDH_TAA_len41_fa10_ta10_fm10_tm10*122*g,0,0,987,0,987,1.0,122,3049@TOP@human_GAPDH_TAA_len41_fa10_ta10_fm10_tm10,g
3049@TOP@human_GAPDH_TAA_len41_fa10_ta10_fm10_tm10*123*t,0,0,0,975,975,0.0,123,3049@TOP@human_GAPDH_TAA_len41_fa10_ta10_fm10_tm10,t
3049@TOP@human_GAPDH_TAA_len41_fa10_ta10_fm10_tm10*124*a,771,0,203,0,974,0.208,124,3049@TOP@human_GAPDH_TAA_len41_fa10_ta10_fm10_tm10,a
3049@TOP@human_GAPDH_TAA_len41_fa10_ta10_fm10_tm10*125*a,859,0,112,0,971,0.115,125,3049@TOP@human_GAPDH_TAA_len41_fa10_ta10_fm10_tm10,a
3049@TOP@human_GAPDH_TAA_len41_fa10_ta10_fm10_tm10*126*g,0,0,977,0,977,1.0,126,3049@TOP@human_GAPDH_TAA_len41_fa10_ta10_fm10_tm10,g
3049@TOP@human_GAPDH_TAA_len41_fa10_ta10_fm10_tm10*127*a,988,0,1,0,989,0.001,127,3049@TOP@human_GAPDH_TAA_len41_fa10_ta10_fm10_tm10,a
3049@TOP@human_GAPDH_TAA_len41_fa10_ta10_fm10_tm10*128*c,0,995,0,0,995,0.0,128,3049@TOP@human_GAPDH_TAA_len41_fa10_ta10_fm10_tm10,c
3049@TOP@human_GAPDH_TAA_len41_fa10_ta10_fm10_tm10*129*c,0,978,0,0,978,0.0,129,3049@TOP@human_GAPDH_TAA_len41_fa10_ta10_fm10_tm10,c
3049@TOP@human_GAPDH_TAA_len41_fa10_ta10_fm10_tm10*130*c,0,985,0,0,985,0.0,130,3049@TOP@human_GAPDH_TAA_len41_fa10_ta10_fm10_tm10,c
3049@TOP@human_GAPDH_TAA_len41_fa10_ta10_fm10_tm10*131*c,0,995,0,0,995,0.0,131,3049@TOP@human_GAPDH_TAA_len41_fa10_ta10_fm10_tm10,c
3049@TOP@human_GAPDH_TAA_len41_fa10_ta10_fm10_tm10*132*t,0,1,0,975,976,0.0,132,3049@TOP@human_GAPDH_TAA_len41_fa10_ta10_fm10_tm10,t
3049@TOP@human_GAPDH_TAA_len41_fa10_ta10_fm10_tm10*133*g,0,0,969,0,969,1.0,133,3049@TOP@human_GAPDH_TAA_len41_fa10_ta10_fm10_tm10,g
3049@TOP@human_GAPDH_TAA_len41_fa10_ta10_fm10_tm10*134*g,0,0,972,0,972,1.0,134,3049@TOP@human_GAPDH_TAA_len41_fa10_ta10_fm10_tm10,g
3050@TOP@human_GAPDH_TAA_len41_fa10_ta10_fm10_tm10*114*t,1,5,0,42543,42549,0.0,114,3050@TOP@human_GAPDH_TAA_len41_fa10_ta10_fm10_tm10,t
3050@TOP@human_GAPDH_TAA_len41_fa10_ta10_fm10_tm10*115*c,1,42758,0,0,42759,0.0,115,3050@TOP@human_GAPDH_TAA_len41_fa10_ta10_fm10_tm10,c
3050@TOP@human_GAPDH_TAA_len41_fa10_ta10_fm10_tm10*116*c,0,42620,0,8,42628,0.0,116,3050@TOP@human_GAPDH_TAA_len41_fa10_ta10_fm10_tm10,c
3050@TOP@human_GAPDH_TAA_len41_fa10_ta10_fm10_tm10*117*a,41841,1,714,1,42557,0.017,117,3050@TOP@human_GAPDH_TAA_len41_fa10_ta10_fm10_tm10,a
3050@TOP@human_GAPDH_TAA_len41_fa10_ta10_fm10_tm10*118*a,39161,1,3147,6,42315,0.074,118,3050@TOP@human_GAPDH_TAA_len41_fa10_ta10_fm10_tm10,a
3050@TOP@human_GAPDH_TAA_len41_fa10_ta10_fm10_tm10*119*g,1,0,42285,3,42289,1.0,119,3050@TOP@human_GAPDH_TAA_len41_fa10_ta10_fm10_tm10,g
3050@TOP@human_GAPDH_TAA_len41_fa10_ta10_fm10_tm10*120*g,2,0,42188,4,42194,1.0,120,3050@TOP@human_GAPDH_TAA_len41_fa10_ta10_fm10_tm10,g
3050@TOP@human_GAPDH_TAA_len41_fa10_ta10_fm10_tm10*121*a,42496,0,6,0,42502,0.0,121,3050@TOP@human_GAPDH_TAA_len41_fa10_ta10_fm10_tm10,a
3050@TOP@human_GAPDH_TAA_len41_fa10_ta10_fm10_tm10*122*g,8,0,42587,1,42596,1.0,122,3050@TOP@human_GAPDH_TAA_len41_fa10_ta10_fm10_tm10,g
3050@TOP@human_GAPDH_TAA_len41_fa10_ta10_fm10_tm10*123*t,2,7,12,42023,42044,0.0,123,3050@TOP@human_GAPDH_TAA_len41_fa10_ta10_fm10_tm10,t
3050@TOP@human_GAPDH_TAA_len41_fa10_ta10_fm10_tm10*124*a,34244,0,7649,0,41893,0.183,124,3050@TOP@human_GAPDH_TAA_len41_fa10_ta10_fm10_tm10,a
3050@TOP@human_GAPDH_TAA_len41_fa10_ta10_fm10_tm10*125*a,40533,2,1322,1,41858,0.032,125,3050@TOP@human_GAPDH_TAA_len41_fa10_ta10_fm10_tm10,a
3050@TOP@human_GAPDH_TAA_len41_fa10_ta10_fm10_tm10*126*g,5,1,42068,3,42077,1.0,126,3050@TOP@human_GAPDH_TAA_len41_fa10_ta10_fm10_tm10,g
3050@TOP@human_GAPDH_TAA_len41_fa10_ta10_fm10_tm10*127*a,42413,1,30,3,42447,0.001,127,3050@TOP@human_GAPDH_TAA_len41_fa10_ta10_fm10_tm10,a
3050@TOP@human_GAPDH_TAA_len41_fa10_ta10_fm10_tm10*128*c,3,42669,0,1,42673,0.0,128,3050@TOP@human_GAPDH_TAA_len41_fa10_ta10_fm10_tm10,c
3050@TOP@human_GAPDH_TAA_len41_fa10_ta10_fm10_tm10*129*c,5,42363,0,2,42370,0.0,129,3050@TOP@human_GAPDH_TAA_len41_fa10_ta10_fm10_tm10,c
3050@TOP@human_GAPDH_TAA_len41_fa10_ta10_fm10_tm10*130*c,5,42609,0,2,42616,0.0,130,3050@TOP@human_GAPDH_TAA_len41_fa10_ta10_fm10_tm10,c
3050@TOP@human_GAPDH_TAA_len41_fa10_ta10_fm10_tm10*131*c,4,42689,0,0,42693,0.0,131,3050@TOP@human_GAPDH_TAA_len41_fa10_ta10_fm10_tm10,c
3050@TOP@human_GAPDH_TAA_len41_fa10_ta10_fm10_tm10*132*t,5,4,2,42127,42138,0.0,132,3050@TOP@human_GAPDH_TAA_len41_fa10_ta10_fm10_tm10,t
3050@TOP@human_GAPDH_TAA_len41_fa10_ta10_fm10_tm10*133*g,10,0,42065,1,42076,1.0,133,3050@TOP@human_GAPDH_TAA_len41_fa10_ta10_fm10_tm10,g
3050@TOP@human_GAPDH_TAA_len41_fa10_ta10_fm10_tm10*134*g,4,7,42214,1,42226,1.0,134,3050@TOP@human_GAPDH_TAA_len41_fa10_ta10_fm10_tm10,g
3051@TOP@human_GAPDH_TAA_len41_fa10_ta10_fm10_tm10*114*t,3,3,0,13493,13499,0.0,114,3051@TOP@human_GAPDH_TAA_len41_fa10_ta10_fm10_tm10,t
3051@TOP@human_GAPDH_TAA_len41_fa10_ta10_fm10_tm10*115*c,0,13561,0,0,13561,0.0,115,3051@TOP@human_GAPDH_TAA_len41_fa10_ta10_fm10_tm10,c
3051@TOP@human_GAPDH_TAA_len41_fa10_ta10_fm10_tm10*116*c,1,13498,0,5,13504,0.0,116,3051@TOP@human_GAPDH_TAA_len41_fa10_ta10_fm10_tm10,c
3051@TOP@human_GAPDH_TAA_len41_fa10_ta10_fm10_tm10*117*a,13230,0,259,0,13489,0.019,117,3051@TOP@human_GAPDH_TAA_len41_fa10_ta10_fm10_tm10,a
3051@TOP@human_GAPDH_TAA_len41_fa10_ta10_fm10_tm10*118*a,10691,0,2740,0,13431,0.204,118,3051@TOP@human_GAPDH_TAA_len41_fa10_ta10_fm10_tm10,a
3051@TOP@human_GAPDH_TAA_len41_fa10_ta10_fm10_tm10*119*g,0,0,13396,0,13396,1.0,119,3051@TOP@human_GAPDH_TAA_len41_fa10_ta10_fm10_tm10,g
3051@TOP@human_GAPDH_TAA_len41_fa10_ta10_fm10_tm10*120*g,0,0,13373,0,13373,1.0,120,3051@TOP@human_GAPDH_TAA_len41_fa10_ta10_fm10_tm10,g
3051@TOP@human_GAPDH_TAA_len41_fa10_ta10_fm10_tm10*121*a,13452,0,13,2,13467,0.001,121,3051@TOP@human_GAPDH_TAA_len41_fa10_ta10_fm10_tm10,a
3051@TOP@human_GAPDH_TAA_len41_fa10_ta10_fm10_tm10*122*g,1,0,13515,0,13516,1.0,122,3051@TOP@human_GAPDH_TAA_len41_fa10_ta10_fm10_tm10,g
3051@TOP@human_GAPDH_TAA_len41_fa10_ta10_fm10_tm10*123*t,2,3,3,13352,13360,0.0,123,3051@TOP@human_GAPDH_TAA_len41_fa10_ta10_fm10_tm10,t
3051@TOP@human_GAPDH_TAA_len41_fa10_ta10_fm10_tm10*124*a,10971,0,2326,0,13297,0.175,124,3051@TOP@human_GAPDH_TAA_len41_fa10_ta10_fm10_tm10,a
3051@TOP@human_GAPDH_TAA_len41_fa10_ta10_fm10_tm10*125*a,12306,1,999,0,13306,0.075,125,3051@TOP@human_GAPDH_TAA_len41_fa10_ta10_fm10_tm10,a
3051@TOP@human_GAPDH_TAA_len41_fa10_ta10_fm10_tm10*126*g,5,0,13325,0,13330,1.0,126,3051@TOP@human_GAPDH_TAA_len41_fa10_ta10_fm10_tm10,g
3051@TOP@human_GAPDH_TAA_len41_fa10_ta10_fm10_tm10*127*a,13422,1,32,1,13456,0.002,127,3051@TOP@human_GAPDH_TAA_len41_fa10_ta10_fm10_tm10,a
3051@TOP@human_GAPDH_TAA_len41_fa10_ta10_fm10_tm10*128*c,0,13519,2,0,13521,0.0,128,3051@TOP@human_GAPDH_TAA_len41_fa10_ta10_fm10_tm10,c
3051@TOP@human_GAPDH_TAA_len41_fa10_ta10_fm10_tm10*129*c,0,13444,0,0,13444,0.0,129,3051@TOP@human_GAPDH_TAA_len41_fa10_ta10_fm10_tm10,c
3051@TOP@human_GAPDH_TAA_len41_fa10_ta10_fm10_tm10*130*c,0,13519,0,0,13519,0.0,130,3051@TOP@human_GAPDH_TAA_len41_fa10_ta10_fm10_tm10,c
3051@TOP@human_GAPDH_TAA_len41_fa10_ta10_fm10_tm10*131*c,0,13553,0,1,13554,0.0,131,3051@TOP@human_GAPDH_TAA_len41_fa10_ta10_fm10_tm10,c
3051@TOP@human_GAPDH_TAA_len41_fa10_ta10_fm10_tm10*132*t,1,0,1,13342,13344,0.0,132,3051@TOP@human_GAPDH_TAA_len41_fa10_ta10_fm10_tm10,t
3051@TOP@human_GAPDH_TAA_len41_fa10_ta10_fm10_tm10*133*g,0,0,13347,0,13347,1.0,133,3051@TOP@human_GAPDH_TAA_len41_fa10_ta10_fm10_tm10,g
3051@TOP@human_GAPDH_TAA_len41_fa10_ta10_fm10_tm10*134*g,1,7,13412,1,13421,0.999,134,3051@TOP@human_GAPDH_TAA_len41_fa10_ta10_fm10_tm10,g
3052@TOP@human_GAPDH_TAA_len41_fa10_ta10_fm10_tm10*114*t,0,1,0,1983,1984,0.0,114,3052@TOP@human_GAPDH_TAA_len41_fa10_ta10_fm10_tm10,t
3052@TOP@human_GAPDH_TAA_len41_fa10_ta10_fm10_tm10*115*c,0,1993,0,0,1993,0.0,115,3052@TOP@human_GAPDH_TAA_len41_fa10_ta10_fm10_tm10,c
3052@TOP@human_GAPDH_TAA_len41_fa10_ta10_fm10_tm10*116*c,0,1989,0,0,1989,0.0,116,3052@TOP@human_GAPDH_TAA_len41_fa10_ta10_fm10_tm10,c
3052@TOP@human_GAPDH_TAA_len41_fa10_ta10_fm10_tm10*117*a,1948,0,41,0,1989,0.021,117,3052@TOP@human_GAPDH_TAA_len41_fa10_ta10_fm10_tm10,a
3052@TOP@human_GAPDH_TAA_len41_fa10_ta10_fm10_tm10*118*a,1518,0,462,0,1980,0.233,118,3052@TOP@human_GAPDH_TAA_len41_fa10_ta10_fm10_tm10,a
3052@TOP@human_GAPDH_TAA_len41_fa10_ta10_fm10_tm10*119*g,0,0,1967,1,1968,0.999,119,3052@TOP@human_GAPDH_TAA_len41_fa10_ta10_fm10_tm10,g
3052@TOP@human_GAPDH_TAA_len41_fa10_ta10_fm10_tm10*120*g,0,0,1962,0,1962,1.0,120,3052@TOP@human_GAPDH_TAA_len41_fa10_ta10_fm10_tm10,g
3052@TOP@human_GAPDH_TAA_len41_fa10_ta10_fm10_tm10*121*a,1981,0,0,0,1981,0.0,121,3052@TOP@human_GAPDH_TAA_len41_fa10_ta10_fm10_tm10,a
3052@TOP@human_GAPDH_TAA_len41_fa10_ta10_fm10_tm10*122*g,0,0,1983,0,1983,1.0,122,3052@TOP@human_GAPDH_TAA_len41_fa10_ta10_fm10_tm10,g
3052@TOP@human_GAPDH_TAA_len41_fa10_ta10_fm10_tm10*123*t,0,1,0,1963,1964,0.0,123,3052@TOP@human_GAPDH_TAA_len41_fa10_ta10_fm10_tm10,t
3052@TOP@human_GAPDH_TAA_len41_fa10_ta10_fm10_tm10*124*a,1550,0,406,0,1956,0.208,124,3052@TOP@human_GAPDH_TAA_len41_fa10_ta10_fm10_tm10,a
3052@TOP@human_GAPDH_TAA_len41_fa10_ta10_fm10_tm10*125*a,1825,0,132,0,1957,0.067,125,3052@TOP@human_GAPDH_TAA_len41_fa10_ta10_fm10_tm10,a
3052@TOP@human_GAPDH_TAA_len41_fa10_ta10_fm10_tm10*126*g,0,0,1955,0,1955,1.0,126,3052@TOP@human_GAPDH_TAA_len41_fa10_ta10_fm10_tm10,g
3052@TOP@human_GAPDH_TAA_len41_fa10_ta10_fm10_tm10*127*a,1971,0,5,0,1976,0.003,127,3052@TOP@human_GAPDH_TAA_len41_fa10_ta10_fm10_tm10,a
3052@TOP@human_GAPDH_TAA_len41_fa10_ta10_fm10_tm10*128*c,0,1989,0,0,1989,0.0,128,3052@TOP@human_GAPDH_TAA_len41_fa10_ta10_fm10_tm10,c
3052@TOP@human_GAPDH_TAA_len41_fa10_ta10_fm10_tm10*129*c,1,1977,0,0,1978,0.0,129,3052@TOP@human_GAPDH_TAA_len41_fa10_ta10_fm10_tm10,c
3052@TOP@human_GAPDH_TAA_len41_fa10_ta10_fm10_tm10*130*c,0,1986,0,0,1986,0.0,130,3052@TOP@human_GAPDH_TAA_len41_fa10_ta10_fm10_tm10,c
3052@TOP@human_GAPDH_TAA_len41_fa10_ta10_fm10_tm10*131*c,0,1987,0,0,1987,0.0,131,3052@TOP@human_GAPDH_TAA_len41_fa10_ta10_fm10_tm10,c
3052@TOP@human_GAPDH_TAA_len41_fa10_ta10_fm10_tm10*132*t,0,0,0,1967,1967,0.0,132,3052@TOP@human_GAPDH_TAA_len41_fa10_ta10_fm10_tm10,t
3052@TOP@human_GAPDH_TAA_len41_fa10_ta10_fm10_tm10*133*g,0,0,1949,1,1950,0.999,133,3052@TOP@human_GAPDH_TAA_len41_fa10_ta10_fm10_tm10,g
3052@TOP@human_GAPDH_TAA_len41_fa10_ta10_fm10_tm10*134*g,0,0,1976,0,1976,1.0,134,3052@TOP@human_GAPDH_TAA_len41_fa10_ta10_fm10_tm10,g
3053@TOP@human_GAPDH_TAA_len41_fa10_ta10_fm10_tm10*114*t,2,0,0,9844,9846,0.0,114,3053@TOP@human_GAPDH_TAA_len41_fa10_ta10_fm10_tm10,t
3053@TOP@human_GAPDH_TAA_len41_fa10_ta10_fm10_tm10*115*c,0,9897,0,0,9897,0.0,115,3053@TOP@human_GAPDH_TAA_len41_fa10_ta10_fm10_tm10,c
3053@TOP@human_GAPDH_TAA_len41_fa10_ta10_fm10_tm10*116*c,0,9849,0,1,9850,0.0,116,3053@TOP@human_GAPDH_TAA_len41_fa10_ta10_fm10_tm10,c
3053@TOP@human_GAPDH_TAA_len41_fa10_ta10_fm10_tm10*117*a,9670,0,183,0,9853,0.019,117,3053@TOP@human_GAPDH_TAA_len41_fa10_ta10_fm10_tm10,a
3053@TOP@human_GAPDH_TAA_len41_fa10_ta10_fm10_tm10*118*a,8403,0,1400,2,9805,0.143,118,3053@TOP@human_GAPDH_TAA_len41_fa10_ta10_fm10_tm10,a
3053@TOP@human_GAPDH_TAA_len41_fa10_ta10_fm10_tm10*119*g,0,0,9772,0,9772,1.0,119,3053@TOP@human_GAPDH_TAA_len41_fa10_ta10_fm10_tm10,g
3053@TOP@human_GAPDH_TAA_len41_fa10_ta10_fm10_tm10*120*g,0,0,9751,1,9752,1.0,120,3053@TOP@human_GAPDH_TAA_len41_fa10_ta10_fm10_tm10,g
3053@TOP@human_GAPDH_TAA_len41_fa10_ta10_fm10_tm10*121*a,9807,0,10,0,9817,0.001,121,3053@TOP@human_GAPDH_TAA_len41_fa10_ta10_fm10_tm10,a
3053@TOP@human_GAPDH_TAA_len41_fa10_ta10_fm10_tm10*122*g,1,2,9857,0,9860,1.0,122,3053@TOP@human_GAPDH_TAA_len41_fa10_ta10_fm10_tm10,g
3053@TOP@human_GAPDH_TAA_len41_fa10_ta10_fm10_tm10*123*t,1,0,0,9739,9740,0.0,123,3053@TOP@human_GAPDH_TAA_len41_fa10_ta10_fm10_tm10,t
3053@TOP@human_GAPDH_TAA_len41_fa10_ta10_fm10_tm10*124*a,7882,0,1809,0,9691,0.187,124,3053@TOP@human_GAPDH_TAA_len41_fa10_ta10_fm10_tm10,a
3053@TOP@human_GAPDH_TAA_len41_fa10_ta10_fm10_tm10*125*a,8950,0,726,1,9677,0.075,125,3053@TOP@human_GAPDH_TAA_len41_fa10_ta10_fm10_tm10,a
3053@TOP@human_GAPDH_TAA_len41_fa10_ta10_fm10_tm10*126*g,0,0,9768,0,9768,1.0,126,3053@TOP@human_GAPDH_TAA_len41_fa10_ta10_fm10_tm10,g
3053@TOP@human_GAPDH_TAA_len41_fa10_ta10_fm10_tm10*127*a,9795,0,26,4,9825,0.003,127,3053@TOP@human_GAPDH_TAA_len41_fa10_ta10_fm10_tm10,a
3053@TOP@human_GAPDH_TAA_len41_fa10_ta10_fm10_tm10*128*c,0,9879,0,0,9879,0.0,128,3053@TOP@human_GAPDH_TAA_len41_fa10_ta10_fm10_tm10,c
3053@TOP@human_GAPDH_TAA_len41_fa10_ta10_fm10_tm10*129*c,1,9805,1,1,9808,0.0,129,3053@TOP@human_GAPDH_TAA_len41_fa10_ta10_fm10_tm10,c
3053@TOP@human_GAPDH_TAA_len41_fa10_ta10_fm10_tm10*130*c,0,9864,1,2,9867,0.0,130,3053@TOP@human_GAPDH_TAA_len41_fa10_ta10_fm10_tm10,c
3053@TOP@human_GAPDH_TAA_len41_fa10_ta10_fm10_tm10*131*c,0,9883,0,3,9886,0.0,131,3053@TOP@human_GAPDH_TAA_len41_fa10_ta10_fm10_tm10,c
3053@TOP@human_GAPDH_TAA_len41_fa10_ta10_fm10_tm10*132*t,0,1,3,9722,9726,0.0,132,3053@TOP@human_GAPDH_TAA_len41_fa10_ta10_fm10_tm10,t
3053@TOP@human_GAPDH_TAA_len41_fa10_ta10_fm10_tm10*133*g,1,0,9731,0,9732,1.0,133,3053@TOP@human_GAPDH_TAA_len41_fa10_ta10_fm10_tm10,g
3053@TOP@human_GAPDH_TAA_len41_fa10_ta10_fm10_tm10*134*g,0,0,9786,0,9786,1.0,134,3053@TOP@human_GAPDH_TAA_len41_fa10_ta10_fm10_tm10,g
3054@TOP@human_GAPDH_TAA_len41_fa10_ta10_fm10_tm10*114*t,1,14,1,35862,35878,0.0,114,3054@TOP@human_GAPDH_TAA_len41_fa10_ta10_fm10_tm10,t
3054@TOP@human_GAPDH_TAA_len41_fa10_ta10_fm10_tm10*115*c,1,36048,0,2,36051,0.0,115,3054@TOP@human_GAPDH_TAA_len41_fa10_ta10_fm10_tm10,c
3054@TOP@human_GAPDH_TAA_len41_fa10_ta10_fm10_tm10*116*c,3,35891,0,0,35894,0.0,116,3054@TOP@human_GAPDH_TAA_len41_fa10_ta10_fm10_tm10,c
3054@TOP@human_GAPDH_TAA_len41_fa10_ta10_fm10_tm10*117*a,35865,0,64,0,35929,0.002,117,3054@TOP@human_GAPDH_TAA_len41_fa10_ta10_fm10_tm10,a
3054@TOP@human_GAPDH_TAA_len41_fa10_ta10_fm10_tm10*118*a,35211,1,514,1,35727,0.014,118,3054@TOP@human_GAPDH_TAA_len41_fa10_ta10_fm10_tm10,a
3054@TOP@human_GAPDH_TAA_len41_fa10_ta10_fm10_tm10*119*g,0,0,35634,0,35634,1.0,119,3054@TOP@human_GAPDH_TAA_len41_fa10_ta10_fm10_tm10,g
3054@TOP@human_GAPDH_TAA_len41_fa10_ta10_fm10_tm10*120*g,2,0,35528,1,35531,1.0,120,3054@TOP@human_GAPDH_TAA_len41_fa10_ta10_fm10_tm10,g
3054@TOP@human_GAPDH_TAA_len41_fa10_ta10_fm10_tm10*121*a,35811,0,60,0,35871,0.002,121,3054@TOP@human_GAPDH_TAA_len41_fa10_ta10_fm10_tm10,a
3054@TOP@human_GAPDH_TAA_len41_fa10_ta10_fm10_tm10*122*g,1,0,35927,3,35931,1.0,122,3054@TOP@human_GAPDH_TAA_len41_fa10_ta10_fm10_tm10,g
3054@TOP@human_GAPDH_TAA_len41_fa10_ta10_fm10_tm10*123*t,3,5,7,35422,35437,0.0,123,3054@TOP@human_GAPDH_TAA_len41_fa10_ta10_fm10_tm10,t
3054@TOP@human_GAPDH_TAA_len41_fa10_ta10_fm10_tm10*124*a,34036,0,1314,0,35350,0.037,124,3054@TOP@human_GAPDH_TAA_len41_fa10_ta10_fm10_tm10,a
3054@TOP@human_GAPDH_TAA_len41_fa10_ta10_fm10_tm10*125*a,34438,1,819,6,35264,0.023,125,3054@TOP@human_GAPDH_TAA_len41_fa10_ta10_fm10_tm10,a
3054@TOP@human_GAPDH_TAA_len41_fa10_ta10_fm10_tm10*126*g,2,0,35430,1,35433,1.0,126,3054@TOP@human_GAPDH_TAA_len41_fa10_ta10_fm10_tm10,g
3054@TOP@human_GAPDH_TAA_len41_fa10_ta10_fm10_tm10*127*a,35771,0,25,0,35796,0.001,127,3054@TOP@human_GAPDH_TAA_len41_fa10_ta10_fm10_tm10,a
3054@TOP@human_GAPDH_TAA_len41_fa10_ta10_fm10_tm10*128*c,0,35961,5,5,35971,0.0,128,3054@TOP@human_GAPDH_TAA_len41_fa10_ta10_fm10_tm10,c
3054@TOP@human_GAPDH_TAA_len41_fa10_ta10_fm10_tm10*129*c,7,35718,0,3,35728,0.0,129,3054@TOP@human_GAPDH_TAA_len41_fa10_ta10_fm10_tm10,c
3054@TOP@human_GAPDH_TAA_len41_fa10_ta10_fm10_tm10*130*c,1,35899,0,2,35902,0.0,130,3054@TOP@human_GAPDH_TAA_len41_fa10_ta10_fm10_tm10,c
3054@TOP@human_GAPDH_TAA_len41_fa10_ta10_fm10_tm10*131*c,0,35997,0,7,36004,0.0,131,3054@TOP@human_GAPDH_TAA_len41_fa10_ta10_fm10_tm10,c
3054@TOP@human_GAPDH_TAA_len41_fa10_ta10_fm10_tm10*132*t,5,3,7,35499,35514,0.0,132,3054@TOP@human_GAPDH_TAA_len41_fa10_ta10_fm10_tm10,t
3054@TOP@human_GAPDH_TAA_len41_fa10_ta10_fm10_tm10*133*g,1,1,35364,1,35367,1.0,133,3054@TOP@human_GAPDH_TAA_len41_fa10_ta10_fm10_tm10,g
3054@TOP@human_GAPDH_TAA_len41_fa10_ta10_fm10_tm10*134*g,3,16,35606,0,35625,0.999,134,3054@TOP@human_GAPDH_TAA_len41_fa10_ta10_fm10_tm10,g
3055@TOP@human_GAPDH_TAA_len41_fa10_ta10_fm10_tm10*114*t,3,4,1,38783,38791,0.0,114,3055@TOP@human_GAPDH_TAA_len41_fa10_ta10_fm10_tm10,t
3055@TOP@human_GAPDH_TAA_len41_fa10_ta10_fm10_tm10*115*c,2,39013,0,2,39017,0.0,115,3055@TOP@human_GAPDH_TAA_len41_fa10_ta10_fm10_tm10,c
3055@TOP@human_GAPDH_TAA_len41_fa10_ta10_fm10_tm10*116*c,0,38862,0,3,38865,0.0,116,3055@TOP@human_GAPDH_TAA_len41_fa10_ta10_fm10_tm10,c
3055@TOP@human_GAPDH_TAA_len41_fa10_ta10_fm10_tm10*117*a,38632,0,224,2,38858,0.006,117,3055@TOP@human_GAPDH_TAA_len41_fa10_ta10_fm10_tm10,a
3055@TOP@human_GAPDH_TAA_len41_fa10_ta10_fm10_tm10*118*a,36015,1,2650,6,38672,0.069,118,3055@TOP@human_GAPDH_TAA_len41_fa10_ta10_fm10_tm10,a
3055@TOP@human_GAPDH_TAA_len41_fa10_ta10_fm10_tm10*119*g,1,0,38566,3,38570,1.0,119,3055@TOP@human_GAPDH_TAA_len41_fa10_ta10_fm10_tm10,g
3055@TOP@human_GAPDH_TAA_len41_fa10_ta10_fm10_tm10*120*g,4,0,38362,1,38367,1.0,120,3055@TOP@human_GAPDH_TAA_len41_fa10_ta10_fm10_tm10,g
3055@TOP@human_GAPDH_TAA_len41_fa10_ta10_fm10_tm10*121*a,38773,0,15,0,38788,0.0,121,3055@TOP@human_GAPDH_TAA_len41_fa10_ta10_fm10_tm10,a
3055@TOP@human_GAPDH_TAA_len41_fa10_ta10_fm10_tm10*122*g,4,0,38871,0,38875,1.0,122,3055@TOP@human_GAPDH_TAA_len41_fa10_ta10_fm10_tm10,g
3055@TOP@human_GAPDH_TAA_len41_fa10_ta10_fm10_tm10*123*t,4,2,4,38327,38337,0.0,123,3055@TOP@human_GAPDH_TAA_len41_fa10_ta10_fm10_tm10,t
3055@TOP@human_GAPDH_TAA_len41_fa10_ta10_fm10_tm10*124*a,35999,2,2296,1,38298,0.06,124,3055@TOP@human_GAPDH_TAA_len41_fa10_ta10_fm10_tm10,a
3055@TOP@human_GAPDH_TAA_len41_fa10_ta10_fm10_tm10*125*a,37450,0,768,1,38219,0.02,125,3055@TOP@human_GAPDH_TAA_len41_fa10_ta10_fm10_tm10,a
3055@TOP@human_GAPDH_TAA_len41_fa10_ta10_fm10_tm10*126*g,2,0,38354,2,38358,1.0,126,3055@TOP@human_GAPDH_TAA_len41_fa10_ta10_fm10_tm10,g
3055@TOP@human_GAPDH_TAA_len41_fa10_ta10_fm10_tm10*127*a,38704,0,35,3,38742,0.001,127,3055@TOP@human_GAPDH_TAA_len41_fa10_ta10_fm10_tm10,a
3055@TOP@human_GAPDH_TAA_len41_fa10_ta10_fm10_tm10*128*c,0,38923,1,0,38924,0.0,128,3055@TOP@human_GAPDH_TAA_len41_fa10_ta10_fm10_tm10,c
3055@TOP@human_GAPDH_TAA_len41_fa10_ta10_fm10_tm10*129*c,3,38619,0,2,38624,0.0,129,3055@TOP@human_GAPDH_TAA_len41_fa10_ta10_fm10_tm10,c
3055@TOP@human_GAPDH_TAA_len41_fa10_ta10_fm10_tm10*130*c,1,38859,0,5,38865,0.0,130,3055@TOP@human_GAPDH_TAA_len41_fa10_ta10_fm10_tm10,c
3055@TOP@human_GAPDH_TAA_len41_fa10_ta10_fm10_tm10*131*c,1,38927,0,5,38933,0.0,131,3055@TOP@human_GAPDH_TAA_len41_fa10_ta10_fm10_tm10,c
3055@TOP@human_GAPDH_TAA_len41_fa10_ta10_fm10_tm10*132*t,4,8,2,38384,38398,0.0,132,3055@TOP@human_GAPDH_TAA_len41_fa10_ta10_fm10_tm10,t
3055@TOP@human_GAPDH_TAA_len41_fa10_ta10_fm10_tm10*133*g,7,0,38304,0,38311,1.0,133,3055@TOP@human_GAPDH_TAA_len41_fa10_ta10_fm10_tm10,g
3055@TOP@human_GAPDH_TAA_len41_fa10_ta10_fm10_tm10*134*g,0,5,38552,2,38559,1.0,134,3055@TOP@human_GAPDH_TAA_len41_fa10_ta10_fm10_tm10,g
3056@TOP@human_GAPDH_TAA_len41_fa10_ta10_fm10_tm10*114*t,3,17,0,43605,43625,0.0,114,3056@TOP@human_GAPDH_TAA_len41_fa10_ta10_fm10_tm10,t
3056@TOP@human_GAPDH_TAA_len41_fa10_ta10_fm10_tm10*115*c,2,43853,0,2,43857,0.0,115,3056@TOP@human_GAPDH_TAA_len41_fa10_ta10_fm10_tm10,c
3056@TOP@human_GAPDH_TAA_len41_fa10_ta10_fm10_tm10*116*c,1,43689,1,0,43691,0.0,116,3056@TOP@human_GAPDH_TAA_len41_fa10_ta10_fm10_tm10,c
3056@TOP@human_GAPDH_TAA_len41_fa10_ta10_fm10_tm10*117*a,43343,0,317,1,43661,0.007,117,3056@TOP@human_GAPDH_TAA_len41_fa10_ta10_fm10_tm10,a
3056@TOP@human_GAPDH_TAA_len41_fa10_ta10_fm10_tm10*118*a,39940,1,3476,0,43417,0.08,118,3056@TOP@human_GAPDH_TAA_len41_fa10_ta10_fm10_tm10,a
3056@TOP@human_GAPDH_TAA_len41_fa10_ta10_fm10_tm10*119*g,1,1,43320,3,43325,1.0,119,3056@TOP@human_GAPDH_TAA_len41_fa10_ta10_fm10_tm10,g
3056@TOP@human_GAPDH_TAA_len41_fa10_ta10_fm10_tm10*120*g,3,1,43222,1,43227,1.0,120,3056@TOP@human_GAPDH_TAA_len41_fa10_ta10_fm10_tm10,g
3056@TOP@human_GAPDH_TAA_len41_fa10_ta10_fm10_tm10*121*a,43599,0,6,0,43605,0.0,121,3056@TOP@human_GAPDH_TAA_len41_fa10_ta10_fm10_tm10,a
3056@TOP@human_GAPDH_TAA_len41_fa10_ta10_fm10_tm10*122*g,4,0,43691,0,43695,1.0,122,3056@TOP@human_GAPDH_TAA_len41_fa10_ta10_fm10_tm10,g
3056@TOP@human_GAPDH_TAA_len41_fa10_ta10_fm10_tm10*123*t,5,5,6,43111,43127,0.0,123,3056@TOP@human_GAPDH_TAA_len41_fa10_ta10_fm10_tm10,t
3056@TOP@human_GAPDH_TAA_len41_fa10_ta10_fm10_tm10*124*a,40669,1,2308,0,42978,0.054,124,3056@TOP@human_GAPDH_TAA_len41_fa10_ta10_fm10_tm10,a
3056@TOP@human_GAPDH_TAA_len41_fa10_ta10_fm10_tm10*125*a,40116,2,2776,2,42896,0.065,125,3056@TOP@human_GAPDH_TAA_len41_fa10_ta10_fm10_tm10,a
3056@TOP@human_GAPDH_TAA_len41_fa10_ta10_fm10_tm10*126*g,4,0,43118,3,43125,1.0,126,3056@TOP@human_GAPDH_TAA_len41_fa10_ta10_fm10_tm10,g
3056@TOP@human_GAPDH_TAA_len41_fa10_ta10_fm10_tm10*127*a,43488,1,33,0,43522,0.001,127,3056@TOP@human_GAPDH_TAA_len41_fa10_ta10_fm10_tm10,a
3056@TOP@human_GAPDH_TAA_len41_fa10_ta10_fm10_tm10*128*c,0,43749,3,2,43754,0.0,128,3056@TOP@human_GAPDH_TAA_len41_fa10_ta10_fm10_tm10,c
3056@TOP@human_GAPDH_TAA_len41_fa10_ta10_fm10_tm10*129*c,1,43470,0,4,43475,0.0,129,3056@TOP@human_GAPDH_TAA_len41_fa10_ta10_fm10_tm10,c
3056@TOP@human_GAPDH_TAA_len41_fa10_ta10_fm10_tm10*130*c,2,43694,0,5,43701,0.0,130,3056@TOP@human_GAPDH_TAA_len41_fa10_ta10_fm10_tm10,c
3056@TOP@human_GAPDH_TAA_len41_fa10_ta10_fm10_tm10*131*c,0,43778,0,3,43781,0.0,131,3056@TOP@human_GAPDH_TAA_len41_fa10_ta10_fm10_tm10,c
3056@TOP@human_GAPDH_TAA_len41_fa10_ta10_fm10_tm10*132*t,5,24,4,43139,43172,0.0,132,3056@TOP@human_GAPDH_TAA_len41_fa10_ta10_fm10_tm10,t
3056@TOP@human_GAPDH_TAA_len41_fa10_ta10_fm10_tm10*133*g,1,2,43074,0,43077,1.0,133,3056@TOP@human_GAPDH_TAA_len41_fa10_ta10_fm10_tm10,g
3056@TOP@human_GAPDH_TAA_len41_fa10_ta10_fm10_tm10*134*g,4,5,43303,3,43315,1.0,134,3056@TOP@human_GAPDH_TAA_len41_fa10_ta10_fm10_tm10,g
3057@TOP@human_GAPDH_TAA_len41_fa10_ta10_fm10_tm10*114*t,0,0,0,1605,1605,0.0,114,3057@TOP@human_GAPDH_TAA_len41_fa10_ta10_fm10_tm10,t
3057@TOP@human_GAPDH_TAA_len41_fa10_ta10_fm10_tm10*115*c,0,1616,0,0,1616,0.0,115,3057@TOP@human_GAPDH_TAA_len41_fa10_ta10_fm10_tm10,c
3057@TOP@human_GAPDH_TAA_len41_fa10_ta10_fm10_tm10*116*c,0,1610,0,0,1610,0.0,116,3057@TOP@human_GAPDH_TAA_len41_fa10_ta10_fm10_tm10,c
3057@TOP@human_GAPDH_TAA_len41_fa10_ta10_fm10_tm10*117*a,1585,0,21,0,1606,0.013,117,3057@TOP@human_GAPDH_TAA_len41_fa10_ta10_fm10_tm10,a
3057@TOP@human_GAPDH_TAA_len41_fa10_ta10_fm10_tm10*118*a,1444,0,157,1,1602,0.098,118,3057@TOP@human_GAPDH_TAA_len41_fa10_ta10_fm10_tm10,a
3057@TOP@human_GAPDH_TAA_len41_fa10_ta10_fm10_tm10*119*g,0,0,1596,0,1596,1.0,119,3057@TOP@human_GAPDH_TAA_len41_fa10_ta10_fm10_tm10,g
3057@TOP@human_GAPDH_TAA_len41_fa10_ta10_fm10_tm10*120*g,0,0,1590,0,1590,1.0,120,3057@TOP@human_GAPDH_TAA_len41_fa10_ta10_fm10_tm10,g
3057@TOP@human_GAPDH_TAA_len41_fa10_ta10_fm10_tm10*121*a,1605,0,1,0,1606,0.001,121,3057@TOP@human_GAPDH_TAA_len41_fa10_ta10_fm10_tm10,a
3057@TOP@human_GAPDH_TAA_len41_fa10_ta10_fm10_tm10*122*g,0,0,1612,0,1612,1.0,122,3057@TOP@human_GAPDH_TAA_len41_fa10_ta10_fm10_tm10,g
3057@TOP@human_GAPDH_TAA_len41_fa10_ta10_fm10_tm10*123*t,0,2,0,1586,1588,0.0,123,3057@TOP@human_GAPDH_TAA_len41_fa10_ta10_fm10_tm10,t
3057@TOP@human_GAPDH_TAA_len41_fa10_ta10_fm10_tm10*124*a,1417,0,168,0,1585,0.106,124,3057@TOP@human_GAPDH_TAA_len41_fa10_ta10_fm10_tm10,a
3057@TOP@human_GAPDH_TAA_len41_fa10_ta10_fm10_tm10*125*a,1520,0,62,0,1582,0.039,125,3057@TOP@human_GAPDH_TAA_len41_fa10_ta10_fm10_tm10,a
3057@TOP@human_GAPDH_TAA_len41_fa10_ta10_fm10_tm10*126*g,0,0,1582,0,1582,1.0,126,3057@TOP@human_GAPDH_TAA_len41_fa10_ta10_fm10_tm10,g
3057@TOP@human_GAPDH_TAA_len41_fa10_ta10_fm10_tm10*127*a,1597,0,5,0,1602,0.003,127,3057@TOP@human_GAPDH_TAA_len41_fa10_ta10_fm10_tm10,a
3057@TOP@human_GAPDH_TAA_len41_fa10_ta10_fm10_tm10*128*c,0,1612,0,0,1612,0.0,128,3057@TOP@human_GAPDH_TAA_len41_fa10_ta10_fm10_tm10,c
3057@TOP@human_GAPDH_TAA_len41_fa10_ta10_fm10_tm10*129*c,0,1606,0,0,1606,0.0,129,3057@TOP@human_GAPDH_TAA_len41_fa10_ta10_fm10_tm10,c
3057@TOP@human_GAPDH_TAA_len41_fa10_ta10_fm10_tm10*130*c,1,1609,0,0,1610,0.0,130,3057@TOP@human_GAPDH_TAA_len41_fa10_ta10_fm10_tm10,c
3057@TOP@human_GAPDH_TAA_len41_fa10_ta10_fm10_tm10*131*c,0,1614,0,0,1614,0.0,131,3057@TOP@human_GAPDH_TAA_len41_fa10_ta10_fm10_tm10,c
3057@TOP@human_GAPDH_TAA_len41_fa10_ta10_fm10_tm10*132*t,1,0,0,1592,1593,0.0,132,3057@TOP@human_GAPDH_TAA_len41_fa10_ta10_fm10_tm10,t
3057@TOP@human_GAPDH_TAA_len41_fa10_ta10_fm10_tm10*133*g,2,0,1596,2,1600,0.998,133,3057@TOP@human_GAPDH_TAA_len41_fa10_ta10_fm10_tm10,g
3057@TOP@human_GAPDH_TAA_len41_fa10_ta10_fm10_tm10*134*g,0,2,1592,0,1594,0.999,134,3057@TOP@human_GAPDH_TAA_len41_fa10_ta10_fm10_tm10,g
3058@TOP@human_GAPDH_TAA_len41_fa10_ta10_fm10_tm10*114*t,0,0,0,1563,1563,0.0,114,3058@TOP@human_GAPDH_TAA_len41_fa10_ta10_fm10_tm10,t
3058@TOP@human_GAPDH_TAA_len41_fa10_ta10_fm10_tm10*115*c,0,1574,0,0,1574,0.0,115,3058@TOP@human_GAPDH_TAA_len41_fa10_ta10_fm10_tm10,c
3058@TOP@human_GAPDH_TAA_len41_fa10_ta10_fm10_tm10*116*c,0,1566,0,0,1566,0.0,116,3058@TOP@human_GAPDH_TAA_len41_fa10_ta10_fm10_tm10,c
3058@TOP@human_GAPDH_TAA_len41_fa10_ta10_fm10_tm10*117*a,1498,0,60,0,1558,0.039,117,3058@TOP@human_GAPDH_TAA_len41_fa10_ta10_fm10_tm10,a
3058@TOP@human_GAPDH_TAA_len41_fa10_ta10_fm10_tm10*118*a,1202,0,331,0,1533,0.216,118,3058@TOP@human_GAPDH_TAA_len41_fa10_ta10_fm10_tm10,a
3058@TOP@human_GAPDH_TAA_len41_fa10_ta10_fm10_tm10*119*g,0,0,1549,0,1549,1.0,119,3058@TOP@human_GAPDH_TAA_len41_fa10_ta10_fm10_tm10,g
3058@TOP@human_GAPDH_TAA_len41_fa10_ta10_fm10_tm10*120*g,0,1,1552,0,1553,0.999,120,3058@TOP@human_GAPDH_TAA_len41_fa10_ta10_fm10_tm10,g
3058@TOP@human_GAPDH_TAA_len41_fa10_ta10_fm10_tm10*121*a,1552,0,1,0,1553,0.001,121,3058@TOP@human_GAPDH_TAA_len41_fa10_ta10_fm10_tm10,a
3058@TOP@human_GAPDH_TAA_len41_fa10_ta10_fm10_tm10*122*g,0,0,1567,0,1567,1.0,122,3058@TOP@human_GAPDH_TAA_len41_fa10_ta10_fm10_tm10,g
3058@TOP@human_GAPDH_TAA_len41_fa10_ta10_fm10_tm10*123*t,0,0,0,1533,1533,0.0,123,3058@TOP@human_GAPDH_TAA_len41_fa10_ta10_fm10_tm10,t
3058@TOP@human_GAPDH_TAA_len41_fa10_ta10_fm10_tm10*124*a,1387,0,119,0,1506,0.079,124,3058@TOP@human_GAPDH_TAA_len41_fa10_ta10_fm10_tm10,a
3058@TOP@human_GAPDH_TAA_len41_fa10_ta10_fm10_tm10*125*a,1419,0,93,0,1512,0.062,125,3058@TOP@human_GAPDH_TAA_len41_fa10_ta10_fm10_tm10,a
3058@TOP@human_GAPDH_TAA_len41_fa10_ta10_fm10_tm10*126*g,0,0,1538,0,1538,1.0,126,3058@TOP@human_GAPDH_TAA_len41_fa10_ta10_fm10_tm10,g
3058@TOP@human_GAPDH_TAA_len41_fa10_ta10_fm10_tm10*127*a,1541,0,8,0,1549,0.005,127,3058@TOP@human_GAPDH_TAA_len41_fa10_ta10_fm10_tm10,a
3058@TOP@human_GAPDH_TAA_len41_fa10_ta10_fm10_tm10*128*c,0,1570,0,0,1570,0.0,128,3058@TOP@human_GAPDH_TAA_len41_fa10_ta10_fm10_tm10,c
3058@TOP@human_GAPDH_TAA_len41_fa10_ta10_fm10_tm10*129*c,0,1557,0,0,1557,0.0,129,3058@TOP@human_GAPDH_TAA_len41_fa10_ta10_fm10_tm10,c
3058@TOP@human_GAPDH_TAA_len41_fa10_ta10_fm10_tm10*130*c,0,1569,0,0,1569,0.0,130,3058@TOP@human_GAPDH_TAA_len41_fa10_ta10_fm10_tm10,c
3058@TOP@human_GAPDH_TAA_len41_fa10_ta10_fm10_tm10*131*c,0,1570,0,1,1571,0.0,131,3058@TOP@human_GAPDH_TAA_len41_fa10_ta10_fm10_tm10,c
3058@TOP@human_GAPDH_TAA_len41_fa10_ta10_fm10_tm10*132*t,0,2,0,1544,1546,0.0,132,3058@TOP@human_GAPDH_TAA_len41_fa10_ta10_fm10_tm10,t
3058@TOP@human_GAPDH_TAA_len41_fa10_ta10_fm10_tm10*133*g,0,0,1553,0,1553,1.0,133,3058@TOP@human_GAPDH_TAA_len41_fa10_ta10_fm10_tm10,g
3058@TOP@human_GAPDH_TAA_len41_fa10_ta10_fm10_tm10*134*g,0,2,1551,0,1553,0.999,134,3058@TOP@human_GAPDH_TAA_len41_fa10_ta10_fm10_tm10,g
3059@TOP@human_GAPDH_TAA_len41_fa10_ta10_fm10_tm10*114*t,0,0,0,1567,1567,0.0,114,3059@TOP@human_GAPDH_TAA_len41_fa10_ta10_fm10_tm10,t
3059@TOP@human_GAPDH_TAA_len41_fa10_ta10_fm10_tm10*115*c,0,1582,0,0,1582,0.0,115,3059@TOP@human_GAPDH_TAA_len41_fa10_ta10_fm10_tm10,c
3059@TOP@human_GAPDH_TAA_len41_fa10_ta10_fm10_tm10*116*c,1,1571,1,0,1573,0.001,116,3059@TOP@human_GAPDH_TAA_len41_fa10_ta10_fm10_tm10,c
3059@TOP@human_GAPDH_TAA_len41_fa10_ta10_fm10_tm10*117*a,1568,0,13,0,1581,0.008,117,3059@TOP@human_GAPDH_TAA_len41_fa10_ta10_fm10_tm10,a
3059@TOP@human_GAPDH_TAA_len41_fa10_ta10_fm10_tm10*118*a,1432,0,133,0,1565,0.085,118,3059@TOP@human_GAPDH_TAA_len41_fa10_ta10_fm10_tm10,a
3059@TOP@human_GAPDH_TAA_len41_fa10_ta10_fm10_tm10*119*g,0,0,1560,0,1560,1.0,119,3059@TOP@human_GAPDH_TAA_len41_fa10_ta10_fm10_tm10,g
3059@TOP@human_GAPDH_TAA_len41_fa10_ta10_fm10_tm10*120*g,0,0,1551,0,1551,1.0,120,3059@TOP@human_GAPDH_TAA_len41_fa10_ta10_fm10_tm10,g
3059@TOP@human_GAPDH_TAA_len41_fa10_ta10_fm10_tm10*121*a,1565,0,6,0,1571,0.004,121,3059@TOP@human_GAPDH_TAA_len41_fa10_ta10_fm10_tm10,a
3059@TOP@human_GAPDH_TAA_len41_fa10_ta10_fm10_tm10*122*g,0,0,1573,0,1573,1.0,122,3059@TOP@human_GAPDH_TAA_len41_fa10_ta10_fm10_tm10,g
3059@TOP@human_GAPDH_TAA_len41_fa10_ta10_fm10_tm10*123*t,0,0,0,1555,1555,0.0,123,3059@TOP@human_GAPDH_TAA_len41_fa10_ta10_fm10_tm10,t
3059@TOP@human_GAPDH_TAA_len41_fa10_ta10_fm10_tm10*124*a,1327,0,233,0,1560,0.149,124,3059@TOP@human_GAPDH_TAA_len41_fa10_ta10_fm10_tm10,a
3059@TOP@human_GAPDH_TAA_len41_fa10_ta10_fm10_tm10*125*a,1402,0,139,0,1541,0.09,125,3059@TOP@human_GAPDH_TAA_len41_fa10_ta10_fm10_tm10,a
3059@TOP@human_GAPDH_TAA_len41_fa10_ta10_fm10_tm10*126*g,0,0,1551,0,1551,1.0,126,3059@TOP@human_GAPDH_TAA_len41_fa10_ta10_fm10_tm10,g
3059@TOP@human_GAPDH_TAA_len41_fa10_ta10_fm10_tm10*127*a,1568,0,0,0,1568,0.0,127,3059@TOP@human_GAPDH_TAA_len41_fa10_ta10_fm10_tm10,a
3059@TOP@human_GAPDH_TAA_len41_fa10_ta10_fm10_tm10*128*c,0,1575,0,0,1575,0.0,128,3059@TOP@human_GAPDH_TAA_len41_fa10_ta10_fm10_tm10,c
3059@TOP@human_GAPDH_TAA_len41_fa10_ta10_fm10_tm10*129*c,0,1560,0,0,1560,0.0,129,3059@TOP@human_GAPDH_TAA_len41_fa10_ta10_fm10_tm10,c
3059@TOP@human_GAPDH_TAA_len41_fa10_ta10_fm10_tm10*130*c,1,1576,0,0,1577,0.0,130,3059@TOP@human_GAPDH_TAA_len41_fa10_ta10_fm10_tm10,c
3059@TOP@human_GAPDH_TAA_len41_fa10_ta10_fm10_tm10*131*c,1,1578,0,0,1579,0.0,131,3059@TOP@human_GAPDH_TAA_len41_fa10_ta10_fm10_tm10,c
3059@TOP@human_GAPDH_TAA_len41_fa10_ta10_fm10_tm10*132*t,0,0,2,1542,1544,0.001,132,3059@TOP@human_GAPDH_TAA_len41_fa10_ta10_fm10_tm10,t
3059@TOP@human_GAPDH_TAA_len41_fa10_ta10_fm10_tm10*133*g,1,0,1550,0,1551,0.999,133,3059@TOP@human_GAPDH_TAA_len41_fa10_ta10_fm10_tm10,g
3059@TOP@human_GAPDH_TAA_len41_fa10_ta10_fm10_tm10*134*g,0,1,1563,0,1564,0.999,134,3059@TOP@human_GAPDH_TAA_len41_fa10_ta10_fm10_tm10,g
3060@TOP@human_GAPDH_TAA_len41_fa10_ta10_fm10_tm10*114*t,1,6,0,13154,13161,0.0,114,3060@TOP@human_GAPDH_TAA_len41_fa10_ta10_fm10_tm10,t
3060@TOP@human_GAPDH_TAA_len41_fa10_ta10_fm10_tm10*115*c,0,13227,0,3,13230,0.0,115,3060@TOP@human_GAPDH_TAA_len41_fa10_ta10_fm10_tm10,c
3060@TOP@human_GAPDH_TAA_len41_fa10_ta10_fm10_tm10*116*c,0,13176,0,0,13176,0.0,116,3060@TOP@human_GAPDH_TAA_len41_fa10_ta10_fm10_tm10,c
3060@TOP@human_GAPDH_TAA_len41_fa10_ta10_fm10_tm10*117*a,12879,0,290,0,13169,0.022,117,3060@TOP@human_GAPDH_TAA_len41_fa10_ta10_fm10_tm10,a
3060@TOP@human_GAPDH_TAA_len41_fa10_ta10_fm10_tm10*118*a,10186,0,2920,0,13106,0.223,118,3060@TOP@human_GAPDH_TAA_len41_fa10_ta10_fm10_tm10,a
3060@TOP@human_GAPDH_TAA_len41_fa10_ta10_fm10_tm10*119*g,1,0,13065,0,13066,1.0,119,3060@TOP@human_GAPDH_TAA_len41_fa10_ta10_fm10_tm10,g
3060@TOP@human_GAPDH_TAA_len41_fa10_ta10_fm10_tm10*120*g,1,0,13050,0,13051,1.0,120,3060@TOP@human_GAPDH_TAA_len41_fa10_ta10_fm10_tm10,g
3060@TOP@human_GAPDH_TAA_len41_fa10_ta10_fm10_tm10*121*a,13111,0,6,0,13117,0.0,121,3060@TOP@human_GAPDH_TAA_len41_fa10_ta10_fm10_tm10,a
3060@TOP@human_GAPDH_TAA_len41_fa10_ta10_fm10_tm10*122*g,0,0,13175,0,13175,1.0,122,3060@TOP@human_GAPDH_TAA_len41_fa10_ta10_fm10_tm10,g
3060@TOP@human_GAPDH_TAA_len41_fa10_ta10_fm10_tm10*123*t,1,4,2,13010,13017,0.0,123,3060@TOP@human_GAPDH_TAA_len41_fa10_ta10_fm10_tm10,t
3060@TOP@human_GAPDH_TAA_len41_fa10_ta10_fm10_tm10*124*a,11307,1,1669,0,12977,0.129,124,3060@TOP@human_GAPDH_TAA_len41_fa10_ta10_fm10_tm10,a
3060@TOP@human_GAPDH_TAA_len41_fa10_ta10_fm10_tm10*125*a,12143,1,819,1,12964,0.063,125,3060@TOP@human_GAPDH_TAA_len41_fa10_ta10_fm10_tm10,a
3060@TOP@human_GAPDH_TAA_len41_fa10_ta10_fm10_tm10*126*g,0,1,13019,0,13020,1.0,126,3060@TOP@human_GAPDH_TAA_len41_fa10_ta10_fm10_tm10,g
3060@TOP@human_GAPDH_TAA_len41_fa10_ta10_fm10_tm10*127*a,13114,1,13,0,13128,0.001,127,3060@TOP@human_GAPDH_TAA_len41_fa10_ta10_fm10_tm10,a
3060@TOP@human_GAPDH_TAA_len41_fa10_ta10_fm10_tm10*128*c,0,13200,1,0,13201,0.0,128,3060@TOP@human_GAPDH_TAA_len41_fa10_ta10_fm10_tm10,c
3060@TOP@human_GAPDH_TAA_len41_fa10_ta10_fm10_tm10*129*c,0,13113,0,0,13113,0.0,129,3060@TOP@human_GAPDH_TAA_len41_fa10_ta10_fm10_tm10,c
3060@TOP@human_GAPDH_TAA_len41_fa10_ta10_fm10_tm10*130*c,0,13186,0,0,13186,0.0,130,3060@TOP@human_GAPDH_TAA_len41_fa10_ta10_fm10_tm10,c
3060@TOP@human_GAPDH_TAA_len41_fa10_ta10_fm10_tm10*131*c,0,13209,0,0,13209,0.0,131,3060@TOP@human_GAPDH_TAA_len41_fa10_ta10_fm10_tm10,c
3060@TOP@human_GAPDH_TAA_len41_fa10_ta10_fm10_tm10*132*t,1,2,1,13049,13053,0.0,132,3060@TOP@human_GAPDH_TAA_len41_fa10_ta10_fm10_tm10,t
3060@TOP@human_GAPDH_TAA_len41_fa10_ta10_fm10_tm10*133*g,1,1,13013,0,13015,1.0,133,3060@TOP@human_GAPDH_TAA_len41_fa10_ta10_fm10_tm10,g
3060@TOP@human_GAPDH_TAA_len41_fa10_ta10_fm10_tm10*134*g,0,13,13069,2,13084,0.999,134,3060@TOP@human_GAPDH_TAA_len41_fa10_ta10_fm10_tm10,g
3061@TOP@human_GAPDH_TAA_len41_fa10_ta10_fm10_tm10*114*t,5,20,1,45290,45316,0.0,114,3061@TOP@human_GAPDH_TAA_len41_fa10_ta10_fm10_tm10,t
3061@TOP@human_GAPDH_TAA_len41_fa10_ta10_fm10_tm10*115*c,2,45551,0,0,45553,0.0,115,3061@TOP@human_GAPDH_TAA_len41_fa10_ta10_fm10_tm10,c
3061@TOP@human_GAPDH_TAA_len41_fa10_ta10_fm10_tm10*116*c,2,45371,0,1,45374,0.0,116,3061@TOP@human_GAPDH_TAA_len41_fa10_ta10_fm10_tm10,c
3061@TOP@human_GAPDH_TAA_len41_fa10_ta10_fm10_tm10*117*a,45268,1,72,0,45341,0.002,117,3061@TOP@human_GAPDH_TAA_len41_fa10_ta10_fm10_tm10,a
3061@TOP@human_GAPDH_TAA_len41_fa10_ta10_fm10_tm10*118*a,44338,1,785,3,45127,0.017,118,3061@TOP@human_GAPDH_TAA_len41_fa10_ta10_fm10_tm10,a
3061@TOP@human_GAPDH_TAA_len41_fa10_ta10_fm10_tm10*119*g,0,0,44998,3,45001,1.0,119,3061@TOP@human_GAPDH_TAA_len41_fa10_ta10_fm10_tm10,g
3061@TOP@human_GAPDH_TAA_len41_fa10_ta10_fm10_tm10*120*g,4,1,44837,1,44843,1.0,120,3061@TOP@human_GAPDH_TAA_len41_fa10_ta10_fm10_tm10,g
3061@TOP@human_GAPDH_TAA_len41_fa10_ta10_fm10_tm10*121*a,45305,0,11,2,45318,0.0,121,3061@TOP@human_GAPDH_TAA_len41_fa10_ta10_fm10_tm10,a
3061@TOP@human_GAPDH_TAA_len41_fa10_ta10_fm10_tm10*122*g,1,1,45381,0,45383,1.0,122,3061@TOP@human_GAPDH_TAA_len41_fa10_ta10_fm10_tm10,g
3061@TOP@human_GAPDH_TAA_len41_fa10_ta10_fm10_tm10*123*t,2,5,10,44766,44783,0.0,123,3061@TOP@human_GAPDH_TAA_len41_fa10_ta10_fm10_tm10,t
3061@TOP@human_GAPDH_TAA_len41_fa10_ta10_fm10_tm10*124*a,43408,2,1194,0,44604,0.027,124,3061@TOP@human_GAPDH_TAA_len41_fa10_ta10_fm10_tm10,a
3061@TOP@human_GAPDH_TAA_len41_fa10_ta10_fm10_tm10*125*a,43901,3,658,7,44569,0.015,125,3061@TOP@human_GAPDH_TAA_len41_fa10_ta10_fm10_tm10,a
3061@TOP@human_GAPDH_TAA_len41_fa10_ta10_fm10_tm10*126*g,0,0,44743,4,44747,1.0,126,3061@TOP@human_GAPDH_TAA_len41_fa10_ta10_fm10_tm10,g
3061@TOP@human_GAPDH_TAA_len41_fa10_ta10_fm10_tm10*127*a,45176,0,27,0,45203,0.001,127,3061@TOP@human_GAPDH_TAA_len41_fa10_ta10_fm10_tm10,a
3061@TOP@human_GAPDH_TAA_len41_fa10_ta10_fm10_tm10*128*c,2,45460,4,1,45467,0.0,128,3061@TOP@human_GAPDH_TAA_len41_fa10_ta10_fm10_tm10,c
3061@TOP@human_GAPDH_TAA_len41_fa10_ta10_fm10_tm10*129*c,7,45090,0,2,45099,0.0,129,3061@TOP@human_GAPDH_TAA_len41_fa10_ta10_fm10_tm10,c
3061@TOP@human_GAPDH_TAA_len41_fa10_ta10_fm10_tm10*130*c,2,45391,0,6,45399,0.0,130,3061@TOP@human_GAPDH_TAA_len41_fa10_ta10_fm10_tm10,c
3061@TOP@human_GAPDH_TAA_len41_fa10_ta10_fm10_tm10*131*c,3,45463,0,2,45468,0.0,131,3061@TOP@human_GAPDH_TAA_len41_fa10_ta10_fm10_tm10,c
3061@TOP@human_GAPDH_TAA_len41_fa10_ta10_fm10_tm10*132*t,2,13,9,44849,44873,0.0,132,3061@TOP@human_GAPDH_TAA_len41_fa10_ta10_fm10_tm10,t
3061@TOP@human_GAPDH_TAA_len41_fa10_ta10_fm10_tm10*133*g,6,1,44764,2,44773,1.0,133,3061@TOP@human_GAPDH_TAA_len41_fa10_ta10_fm10_tm10,g
3061@TOP@human_GAPDH_TAA_len41_fa10_ta10_fm10_tm10*134*g,1,4,44996,0,45001,1.0,134,3061@TOP@human_GAPDH_TAA_len41_fa10_ta10_fm10_tm10,g
3062@TOP@human_GAPDH_TAA_len41_fa10_ta10_fm10_tm10*114*t,3,11,0,34298,34312,0.0,114,3062@TOP@human_GAPDH_TAA_len41_fa10_ta10_fm10_tm10,t
3062@TOP@human_GAPDH_TAA_len41_fa10_ta10_fm10_tm10*115*c,1,34479,0,0,34480,0.0,115,3062@TOP@human_GAPDH_TAA_len41_fa10_ta10_fm10_tm10,c
3062@TOP@human_GAPDH_TAA_len41_fa10_ta10_fm10_tm10*116*c,0,34368,0,2,34370,0.0,116,3062@TOP@human_GAPDH_TAA_len41_fa10_ta10_fm10_tm10,c
3062@TOP@human_GAPDH_TAA_len41_fa10_ta10_fm10_tm10*117*a,34283,0,51,0,34334,0.001,117,3062@TOP@human_GAPDH_TAA_len41_fa10_ta10_fm10_tm10,a
3062@TOP@human_GAPDH_TAA_len41_fa10_ta10_fm10_tm10*118*a,33371,2,753,3,34129,0.022,118,3062@TOP@human_GAPDH_TAA_len41_fa10_ta10_fm10_tm10,a
3062@TOP@human_GAPDH_TAA_len41_fa10_ta10_fm10_tm10*119*g,2,0,34069,0,34071,1.0,119,3062@TOP@human_GAPDH_TAA_len41_fa10_ta10_fm10_tm10,g
3062@TOP@human_GAPDH_TAA_len41_fa10_ta10_fm10_tm10*120*g,2,0,33936,1,33939,1.0,120,3062@TOP@human_GAPDH_TAA_len41_fa10_ta10_fm10_tm10,g
3062@TOP@human_GAPDH_TAA_len41_fa10_ta10_fm10_tm10*121*a,34301,0,12,1,34314,0.0,121,3062@TOP@human_GAPDH_TAA_len41_fa10_ta10_fm10_tm10,a
3062@TOP@human_GAPDH_TAA_len41_fa10_ta10_fm10_tm10*122*g,6,1,34327,3,34337,1.0,122,3062@TOP@human_GAPDH_TAA_len41_fa10_ta10_fm10_tm10,g
3062@TOP@human_GAPDH_TAA_len41_fa10_ta10_fm10_tm10*123*t,3,3,0,33883,33889,0.0,123,3062@TOP@human_GAPDH_TAA_len41_fa10_ta10_fm10_tm10,t
3062@TOP@human_GAPDH_TAA_len41_fa10_ta10_fm10_tm10*124*a,32990,1,809,0,33800,0.024,124,3062@TOP@human_GAPDH_TAA_len41_fa10_ta10_fm10_tm10,a
3062@TOP@human_GAPDH_TAA_len41_fa10_ta10_fm10_tm10*125*a,33334,4,404,2,33744,0.012,125,3062@TOP@human_GAPDH_TAA_len41_fa10_ta10_fm10_tm10,a
3062@TOP@human_GAPDH_TAA_len41_fa10_ta10_fm10_tm10*126*g,1,1,33804,4,33810,1.0,126,3062@TOP@human_GAPDH_TAA_len41_fa10_ta10_fm10_tm10,g
3062@TOP@human_GAPDH_TAA_len41_fa10_ta10_fm10_tm10*127*a,34215,1,14,2,34232,0.0,127,3062@TOP@human_GAPDH_TAA_len41_fa10_ta10_fm10_tm10,a
3062@TOP@human_GAPDH_TAA_len41_fa10_ta10_fm10_tm10*128*c,3,34409,2,3,34417,0.0,128,3062@TOP@human_GAPDH_TAA_len41_fa10_ta10_fm10_tm10,c
3062@TOP@human_GAPDH_TAA_len41_fa10_ta10_fm10_tm10*129*c,0,34156,0,9,34165,0.0,129,3062@TOP@human_GAPDH_TAA_len41_fa10_ta10_fm10_tm10,c
3062@TOP@human_GAPDH_TAA_len41_fa10_ta10_fm10_tm10*130*c,2,34341,0,4,34347,0.0,130,3062@TOP@human_GAPDH_TAA_len41_fa10_ta10_fm10_tm10,c
3062@TOP@human_GAPDH_TAA_len41_fa10_ta10_fm10_tm10*131*c,1,34425,0,3,34429,0.0,131,3062@TOP@human_GAPDH_TAA_len41_fa10_ta10_fm10_tm10,c
3062@TOP@human_GAPDH_TAA_len41_fa10_ta10_fm10_tm10*132*t,6,18,6,33916,33946,0.0,132,3062@TOP@human_GAPDH_TAA_len41_fa10_ta10_fm10_tm10,t
3062@TOP@human_GAPDH_TAA_len41_fa10_ta10_fm10_tm10*133*g,2,0,33880,1,33883,1.0,133,3062@TOP@human_GAPDH_TAA_len41_fa10_ta10_fm10_tm10,g
3062@TOP@human_GAPDH_TAA_len41_fa10_ta10_fm10_tm10*134*g,3,2,34038,0,34043,1.0,134,3062@TOP@human_GAPDH_TAA_len41_fa10_ta10_fm10_tm10,g
3063@TOP@human_GAPDH_TAA_len41_fa10_ta10_fm10_tm10*114*t,1,0,0,1205,1206,0.0,114,3063@TOP@human_GAPDH_TAA_len41_fa10_ta10_fm10_tm10,t
3063@TOP@human_GAPDH_TAA_len41_fa10_ta10_fm10_tm10*115*c,1,1213,0,0,1214,0.0,115,3063@TOP@human_GAPDH_TAA_len41_fa10_ta10_fm10_tm10,c
3063@TOP@human_GAPDH_TAA_len41_fa10_ta10_fm10_tm10*116*c,0,1214,0,0,1214,0.0,116,3063@TOP@human_GAPDH_TAA_len41_fa10_ta10_fm10_tm10,c
3063@TOP@human_GAPDH_TAA_len41_fa10_ta10_fm10_tm10*117*a,1211,0,4,0,1215,0.003,117,3063@TOP@human_GAPDH_TAA_len41_fa10_ta10_fm10_tm10,a
3063@TOP@human_GAPDH_TAA_len41_fa10_ta10_fm10_tm10*118*a,1101,0,107,0,1208,0.089,118,3063@TOP@human_GAPDH_TAA_len41_fa10_ta10_fm10_tm10,a
3063@TOP@human_GAPDH_TAA_len41_fa10_ta10_fm10_tm10*119*g,0,0,1195,0,1195,1.0,119,3063@TOP@human_GAPDH_TAA_len41_fa10_ta10_fm10_tm10,g
3063@TOP@human_GAPDH_TAA_len41_fa10_ta10_fm10_tm10*120*g,0,0,1196,0,1196,1.0,120,3063@TOP@human_GAPDH_TAA_len41_fa10_ta10_fm10_tm10,g
3063@TOP@human_GAPDH_TAA_len41_fa10_ta10_fm10_tm10*121*a,1202,0,4,0,1206,0.003,121,3063@TOP@human_GAPDH_TAA_len41_fa10_ta10_fm10_tm10,a
3063@TOP@human_GAPDH_TAA_len41_fa10_ta10_fm10_tm10*122*g,0,0,1206,1,1207,0.999,122,3063@TOP@human_GAPDH_TAA_len41_fa10_ta10_fm10_tm10,g
3063@TOP@human_GAPDH_TAA_len41_fa10_ta10_fm10_tm10*123*t,0,2,3,1190,1195,0.003,123,3063@TOP@human_GAPDH_TAA_len41_fa10_ta10_fm10_tm10,t
3063@TOP@human_GAPDH_TAA_len41_fa10_ta10_fm10_tm10*124*a,1044,1,143,0,1188,0.12,124,3063@TOP@human_GAPDH_TAA_len41_fa10_ta10_fm10_tm10,a
3063@TOP@human_GAPDH_TAA_len41_fa10_ta10_fm10_tm10*125*a,1109,0,87,1,1197,0.073,125,3063@TOP@human_GAPDH_TAA_len41_fa10_ta10_fm10_tm10,a
3063@TOP@human_GAPDH_TAA_len41_fa10_ta10_fm10_tm10*126*g,1,0,1189,0,1190,0.999,126,3063@TOP@human_GAPDH_TAA_len41_fa10_ta10_fm10_tm10,g
3063@TOP@human_GAPDH_TAA_len41_fa10_ta10_fm10_tm10*127*a,1206,1,3,0,1210,0.002,127,3063@TOP@human_GAPDH_TAA_len41_fa10_ta10_fm10_tm10,a
3063@TOP@human_GAPDH_TAA_len41_fa10_ta10_fm10_tm10*128*c,0,1208,0,3,1211,0.0,128,3063@TOP@human_GAPDH_TAA_len41_fa10_ta10_fm10_tm10,c
3063@TOP@human_GAPDH_TAA_len41_fa10_ta10_fm10_tm10*129*c,0,1208,0,0,1208,0.0,129,3063@TOP@human_GAPDH_TAA_len41_fa10_ta10_fm10_tm10,c
3063@TOP@human_GAPDH_TAA_len41_fa10_ta10_fm10_tm10*130*c,0,1211,0,0,1211,0.0,130,3063@TOP@human_GAPDH_TAA_len41_fa10_ta10_fm10_tm10,c
3063@TOP@human_GAPDH_TAA_len41_fa10_ta10_fm10_tm10*131*c,0,1215,0,0,1215,0.0,131,3063@TOP@human_GAPDH_TAA_len41_fa10_ta10_fm10_tm10,c
3063@TOP@human_GAPDH_TAA_len41_fa10_ta10_fm10_tm10*132*t,0,0,0,1197,1197,0.0,132,3063@TOP@human_GAPDH_TAA_len41_fa10_ta10_fm10_tm10,t
3063@TOP@human_GAPDH_TAA_len41_fa10_ta10_fm10_tm10*133*g,0,0,1189,0,1189,1.0,133,3063@TOP@human_GAPDH_TAA_len41_fa10_ta10_fm10_tm10,g
3063@TOP@human_GAPDH_TAA_len41_fa10_ta10_fm10_tm10*134*g,0,1,1194,0,1195,0.999,134,3063@TOP@human_GAPDH_TAA_len41_fa10_ta10_fm10_tm10,g
3064@TOP@human_GAPDH_TAA_len41_fa10_ta10_fm10_tm10*114*t,0,0,0,9281,9281,0.0,114,3064@TOP@human_GAPDH_TAA_len41_fa10_ta10_fm10_tm10,t
3064@TOP@human_GAPDH_TAA_len41_fa10_ta10_fm10_tm10*115*c,1,9322,0,0,9323,0.0,115,3064@TOP@human_GAPDH_TAA_len41_fa10_ta10_fm10_tm10,c
3064@TOP@human_GAPDH_TAA_len41_fa10_ta10_fm10_tm10*116*c,0,9293,0,1,9294,0.0,116,3064@TOP@human_GAPDH_TAA_len41_fa10_ta10_fm10_tm10,c
3064@TOP@human_GAPDH_TAA_len41_fa10_ta10_fm10_tm10*117*a,9265,0,18,0,9283,0.002,117,3064@TOP@human_GAPDH_TAA_len41_fa10_ta10_fm10_tm10,a
3064@TOP@human_GAPDH_TAA_len41_fa10_ta10_fm10_tm10*118*a,8731,0,507,0,9238,0.055,118,3064@TOP@human_GAPDH_TAA_len41_fa10_ta10_fm10_tm10,a
3064@TOP@human_GAPDH_TAA_len41_fa10_ta10_fm10_tm10*119*g,2,0,9213,2,9217,1.0,119,3064@TOP@human_GAPDH_TAA_len41_fa10_ta10_fm10_tm10,g
3064@TOP@human_GAPDH_TAA_len41_fa10_ta10_fm10_tm10*120*g,1,0,9186,0,9187,1.0,120,3064@TOP@human_GAPDH_TAA_len41_fa10_ta10_fm10_tm10,g
3064@TOP@human_GAPDH_TAA_len41_fa10_ta10_fm10_tm10*121*a,9244,0,33,0,9277,0.004,121,3064@TOP@human_GAPDH_TAA_len41_fa10_ta10_fm10_tm10,a
3064@TOP@human_GAPDH_TAA_len41_fa10_ta10_fm10_tm10*122*g,1,1,9282,0,9284,1.0,122,3064@TOP@human_GAPDH_TAA_len41_fa10_ta10_fm10_tm10,g
3064@TOP@human_GAPDH_TAA_len41_fa10_ta10_fm10_tm10*123*t,1,0,4,9159,9164,0.0,123,3064@TOP@human_GAPDH_TAA_len41_fa10_ta10_fm10_tm10,t
3064@TOP@human_GAPDH_TAA_len41_fa10_ta10_fm10_tm10*124*a,8317,0,841,0,9158,0.092,124,3064@TOP@human_GAPDH_TAA_len41_fa10_ta10_fm10_tm10,a
3064@TOP@human_GAPDH_TAA_len41_fa10_ta10_fm10_tm10*125*a,8698,0,403,0,9101,0.044,125,3064@TOP@human_GAPDH_TAA_len41_fa10_ta10_fm10_tm10,a
3064@TOP@human_GAPDH_TAA_len41_fa10_ta10_fm10_tm10*126*g,0,0,9154,1,9155,1.0,126,3064@TOP@human_GAPDH_TAA_len41_fa10_ta10_fm10_tm10,g
3064@TOP@human_GAPDH_TAA_len41_fa10_ta10_fm10_tm10*127*a,9223,0,12,0,9235,0.001,127,3064@TOP@human_GAPDH_TAA_len41_fa10_ta10_fm10_tm10,a
3064@TOP@human_GAPDH_TAA_len41_fa10_ta10_fm10_tm10*128*c,0,9286,3,0,9289,0.0,128,3064@TOP@human_GAPDH_TAA_len41_fa10_ta10_fm10_tm10,c
3064@TOP@human_GAPDH_TAA_len41_fa10_ta10_fm10_tm10*129*c,0,9214,0,1,9215,0.0,129,3064@TOP@human_GAPDH_TAA_len41_fa10_ta10_fm10_tm10,c
3064@TOP@human_GAPDH_TAA_len41_fa10_ta10_fm10_tm10*130*c,1,9285,0,2,9288,0.0,130,3064@TOP@human_GAPDH_TAA_len41_fa10_ta10_fm10_tm10,c
3064@TOP@human_GAPDH_TAA_len41_fa10_ta10_fm10_tm10*131*c,0,9307,0,0,9307,0.0,131,3064@TOP@human_GAPDH_TAA_len41_fa10_ta10_fm10_tm10,c
3064@TOP@human_GAPDH_TAA_len41_fa10_ta10_fm10_tm10*132*t,2,2,0,9203,9207,0.0,132,3064@TOP@human_GAPDH_TAA_len41_fa10_ta10_fm10_tm10,t
3064@TOP@human_GAPDH_TAA_len41_fa10_ta10_fm10_tm10*133*g,0,0,9153,0,9153,1.0,133,3064@TOP@human_GAPDH_TAA_len41_fa10_ta10_fm10_tm10,g
3064@TOP@human_GAPDH_TAA_len41_fa10_ta10_fm10_tm10*134*g,1,7,9186,2,9196,0.999,134,3064@TOP@human_GAPDH_TAA_len41_fa10_ta10_fm10_tm10,g
3065@TOP@human_GAPDH_TAA_len41_fa10_ta10_fm10_tm10*114*t,2,3,0,1389,1394,0.0,114,3065@TOP@human_GAPDH_TAA_len41_fa10_ta10_fm10_tm10,t
3065@TOP@human_GAPDH_TAA_len41_fa10_ta10_fm10_tm10*115*c,0,1401,0,0,1401,0.0,115,3065@TOP@human_GAPDH_TAA_len41_fa10_ta10_fm10_tm10,c
3065@TOP@human_GAPDH_TAA_len41_fa10_ta10_fm10_tm10*116*c,0,1392,1,0,1393,0.001,116,3065@TOP@human_GAPDH_TAA_len41_fa10_ta10_fm10_tm10,c
3065@TOP@human_GAPDH_TAA_len41_fa10_ta10_fm10_tm10*117*a,1383,0,7,0,1390,0.005,117,3065@TOP@human_GAPDH_TAA_len41_fa10_ta10_fm10_tm10,a
3065@TOP@human_GAPDH_TAA_len41_fa10_ta10_fm10_tm10*118*a,1222,0,159,0,1381,0.115,118,3065@TOP@human_GAPDH_TAA_len41_fa10_ta10_fm10_tm10,a
3065@TOP@human_GAPDH_TAA_len41_fa10_ta10_fm10_tm10*119*g,0,0,1371,0,1371,1.0,119,3065@TOP@human_GAPDH_TAA_len41_fa10_ta10_fm10_tm10,g
3065@TOP@human_GAPDH_TAA_len41_fa10_ta10_fm10_tm10*120*g,0,0,1361,0,1361,1.0,120,3065@TOP@human_GAPDH_TAA_len41_fa10_ta10_fm10_tm10,g
3065@TOP@human_GAPDH_TAA_len41_fa10_ta10_fm10_tm10*121*a,1386,0,3,0,1389,0.002,121,3065@TOP@human_GAPDH_TAA_len41_fa10_ta10_fm10_tm10,a
3065@TOP@human_GAPDH_TAA_len41_fa10_ta10_fm10_tm10*122*g,0,0,1388,0,1388,1.0,122,3065@TOP@human_GAPDH_TAA_len41_fa10_ta10_fm10_tm10,g
3065@TOP@human_GAPDH_TAA_len41_fa10_ta10_fm10_tm10*123*t,0,0,0,1359,1359,0.0,123,3065@TOP@human_GAPDH_TAA_len41_fa10_ta10_fm10_tm10,t
3065@TOP@human_GAPDH_TAA_len41_fa10_ta10_fm10_tm10*124*a,1135,0,235,0,1370,0.172,124,3065@TOP@human_GAPDH_TAA_len41_fa10_ta10_fm10_tm10,a
3065@TOP@human_GAPDH_TAA_len41_fa10_ta10_fm10_tm10*125*a,1197,0,153,0,1350,0.113,125,3065@TOP@human_GAPDH_TAA_len41_fa10_ta10_fm10_tm10,a
3065@TOP@human_GAPDH_TAA_len41_fa10_ta10_fm10_tm10*126*g,0,0,1370,0,1370,1.0,126,3065@TOP@human_GAPDH_TAA_len41_fa10_ta10_fm10_tm10,g
3065@TOP@human_GAPDH_TAA_len41_fa10_ta10_fm10_tm10*127*a,1387,0,1,0,1388,0.001,127,3065@TOP@human_GAPDH_TAA_len41_fa10_ta10_fm10_tm10,a
3065@TOP@human_GAPDH_TAA_len41_fa10_ta10_fm10_tm10*128*c,0,1392,0,0,1392,0.0,128,3065@TOP@human_GAPDH_TAA_len41_fa10_ta10_fm10_tm10,c
3065@TOP@human_GAPDH_TAA_len41_fa10_ta10_fm10_tm10*129*c,0,1380,0,0,1380,0.0,129,3065@TOP@human_GAPDH_TAA_len41_fa10_ta10_fm10_tm10,c
3065@TOP@human_GAPDH_TAA_len41_fa10_ta10_fm10_tm10*130*c,0,1385,0,0,1385,0.0,130,3065@TOP@human_GAPDH_TAA_len41_fa10_ta10_fm10_tm10,c
3065@TOP@human_GAPDH_TAA_len41_fa10_ta10_fm10_tm10*131*c,52,1343,0,0,1395,0.0,131,3065@TOP@human_GAPDH_TAA_len41_fa10_ta10_fm10_tm10,c
3065@TOP@human_GAPDH_TAA_len41_fa10_ta10_fm10_tm10*132*t,0,0,0,1375,1375,0.0,132,3065@TOP@human_GAPDH_TAA_len41_fa10_ta10_fm10_tm10,t
3065@TOP@human_GAPDH_TAA_len41_fa10_ta10_fm10_tm10*133*g,0,0,1371,0,1371,1.0,133,3065@TOP@human_GAPDH_TAA_len41_fa10_ta10_fm10_tm10,g
3065@TOP@human_GAPDH_TAA_len41_fa10_ta10_fm10_tm10*134*g,0,0,1372,0,1372,1.0,134,3065@TOP@human_GAPDH_TAA_len41_fa10_ta10_fm10_tm10,g
3066@TOP@human_GAPDH_TAA_len41_fa10_ta10_fm10_tm10*114*t,0,3,0,4065,4068,0.0,114,3066@TOP@human_GAPDH_TAA_len41_fa10_ta10_fm10_tm10,t
3066@TOP@human_GAPDH_TAA_len41_fa10_ta10_fm10_tm10*115*c,0,4098,0,0,4098,0.0,115,3066@TOP@human_GAPDH_TAA_len41_fa10_ta10_fm10_tm10,c
3066@TOP@human_GAPDH_TAA_len41_fa10_ta10_fm10_tm10*116*c,0,4079,0,1,4080,0.0,116,3066@TOP@human_GAPDH_TAA_len41_fa10_ta10_fm10_tm10,c
3066@TOP@human_GAPDH_TAA_len41_fa10_ta10_fm10_tm10*117*a,4066,0,15,0,4081,0.004,117,3066@TOP@human_GAPDH_TAA_len41_fa10_ta10_fm10_tm10,a
3066@TOP@human_GAPDH_TAA_len41_fa10_ta10_fm10_tm10*118*a,3632,0,428,0,4060,0.105,118,3066@TOP@human_GAPDH_TAA_len41_fa10_ta10_fm10_tm10,a
3066@TOP@human_GAPDH_TAA_len41_fa10_ta10_fm10_tm10*119*g,1,0,4046,0,4047,1.0,119,3066@TOP@human_GAPDH_TAA_len41_fa10_ta10_fm10_tm10,g
3066@TOP@human_GAPDH_TAA_len41_fa10_ta10_fm10_tm10*120*g,0,0,4033,0,4033,1.0,120,3066@TOP@human_GAPDH_TAA_len41_fa10_ta10_fm10_tm10,g
3066@TOP@human_GAPDH_TAA_len41_fa10_ta10_fm10_tm10*121*a,4064,0,10,0,4074,0.002,121,3066@TOP@human_GAPDH_TAA_len41_fa10_ta10_fm10_tm10,a
3066@TOP@human_GAPDH_TAA_len41_fa10_ta10_fm10_tm10*122*g,2,0,4078,0,4080,1.0,122,3066@TOP@human_GAPDH_TAA_len41_fa10_ta10_fm10_tm10,g
3066@TOP@human_GAPDH_TAA_len41_fa10_ta10_fm10_tm10*123*t,0,0,1,4032,4033,0.0,123,3066@TOP@human_GAPDH_TAA_len41_fa10_ta10_fm10_tm10,t
3066@TOP@human_GAPDH_TAA_len41_fa10_ta10_fm10_tm10*124*a,3125,0,885,0,4010,0.221,124,3066@TOP@human_GAPDH_TAA_len41_fa10_ta10_fm10_tm10,a
3066@TOP@human_GAPDH_TAA_len41_fa10_ta10_fm10_tm10*125*a,3774,0,237,2,4013,0.059,125,3066@TOP@human_GAPDH_TAA_len41_fa10_ta10_fm10_tm10,a
3066@TOP@human_GAPDH_TAA_len41_fa10_ta10_fm10_tm10*126*g,0,0,4032,1,4033,1.0,126,3066@TOP@human_GAPDH_TAA_len41_fa10_ta10_fm10_tm10,g
3066@TOP@human_GAPDH_TAA_len41_fa10_ta10_fm10_tm10*127*a,4062,0,4,0,4066,0.001,127,3066@TOP@human_GAPDH_TAA_len41_fa10_ta10_fm10_tm10,a
3066@TOP@human_GAPDH_TAA_len41_fa10_ta10_fm10_tm10*128*c,0,4086,0,1,4087,0.0,128,3066@TOP@human_GAPDH_TAA_len41_fa10_ta10_fm10_tm10,c
3066@TOP@human_GAPDH_TAA_len41_fa10_ta10_fm10_tm10*129*c,0,4066,0,1,4067,0.0,129,3066@TOP@human_GAPDH_TAA_len41_fa10_ta10_fm10_tm10,c
3066@TOP@human_GAPDH_TAA_len41_fa10_ta10_fm10_tm10*130*c,0,4077,0,0,4077,0.0,130,3066@TOP@human_GAPDH_TAA_len41_fa10_ta10_fm10_tm10,c
3066@TOP@human_GAPDH_TAA_len41_fa10_ta10_fm10_tm10*131*c,1,4090,0,1,4092,0.0,131,3066@TOP@human_GAPDH_TAA_len41_fa10_ta10_fm10_tm10,c
3066@TOP@human_GAPDH_TAA_len41_fa10_ta10_fm10_tm10*132*t,0,0,0,4033,4033,0.0,132,3066@TOP@human_GAPDH_TAA_len41_fa10_ta10_fm10_tm10,t
3066@TOP@human_GAPDH_TAA_len41_fa10_ta10_fm10_tm10*133*g,0,0,4029,0,4029,1.0,133,3066@TOP@human_GAPDH_TAA_len41_fa10_ta10_fm10_tm10,g
3066@TOP@human_GAPDH_TAA_len41_fa10_ta10_fm10_tm10*134*g,0,0,4035,0,4035,1.0,134,3066@TOP@human_GAPDH_TAA_len41_fa10_ta10_fm10_tm10,g
3067@TOP@human_GAPDH_TAA_len41_fa10_ta10_fm10_tm10*114*t,0,0,0,2137,2137,0.0,114,3067@TOP@human_GAPDH_TAA_len41_fa10_ta10_fm10_tm10,t
3067@TOP@human_GAPDH_TAA_len41_fa10_ta10_fm10_tm10*115*c,0,2154,0,0,2154,0.0,115,3067@TOP@human_GAPDH_TAA_len41_fa10_ta10_fm10_tm10,c
3067@TOP@human_GAPDH_TAA_len41_fa10_ta10_fm10_tm10*116*c,0,2145,0,0,2145,0.0,116,3067@TOP@human_GAPDH_TAA_len41_fa10_ta10_fm10_tm10,c
3067@TOP@human_GAPDH_TAA_len41_fa10_ta10_fm10_tm10*117*a,2128,0,16,0,2144,0.007,117,3067@TOP@human_GAPDH_TAA_len41_fa10_ta10_fm10_tm10,a
3067@TOP@human_GAPDH_TAA_len41_fa10_ta10_fm10_tm10*118*a,1893,0,236,0,2129,0.111,118,3067@TOP@human_GAPDH_TAA_len41_fa10_ta10_fm10_tm10,a
3067@TOP@human_GAPDH_TAA_len41_fa10_ta10_fm10_tm10*119*g,0,0,2125,0,2125,1.0,119,3067@TOP@human_GAPDH_TAA_len41_fa10_ta10_fm10_tm10,g
3067@TOP@human_GAPDH_TAA_len41_fa10_ta10_fm10_tm10*120*g,0,0,2115,0,2115,1.0,120,3067@TOP@human_GAPDH_TAA_len41_fa10_ta10_fm10_tm10,g
3067@TOP@human_GAPDH_TAA_len41_fa10_ta10_fm10_tm10*121*a,2142,0,0,0,2142,0.0,121,3067@TOP@human_GAPDH_TAA_len41_fa10_ta10_fm10_tm10,a
3067@TOP@human_GAPDH_TAA_len41_fa10_ta10_fm10_tm10*122*g,0,0,2144,0,2144,1.0,122,3067@TOP@human_GAPDH_TAA_len41_fa10_ta10_fm10_tm10,g
3067@TOP@human_GAPDH_TAA_len41_fa10_ta10_fm10_tm10*123*t,0,0,2,2112,2114,0.001,123,3067@TOP@human_GAPDH_TAA_len41_fa10_ta10_fm10_tm10,t
3067@TOP@human_GAPDH_TAA_len41_fa10_ta10_fm10_tm10*124*a,1791,0,312,0,2103,0.148,124,3067@TOP@human_GAPDH_TAA_len41_fa10_ta10_fm10_tm10,a
3067@TOP@human_GAPDH_TAA_len41_fa10_ta10_fm10_tm10*125*a,1949,0,153,0,2102,0.073,125,3067@TOP@human_GAPDH_TAA_len41_fa10_ta10_fm10_tm10,a
3067@TOP@human_GAPDH_TAA_len41_fa10_ta10_fm10_tm10*126*g,0,0,2111,0,2111,1.0,126,3067@TOP@human_GAPDH_TAA_len41_fa10_ta10_fm10_tm10,g
3067@TOP@human_GAPDH_TAA_len41_fa10_ta10_fm10_tm10*127*a,2130,0,8,0,2138,0.004,127,3067@TOP@human_GAPDH_TAA_len41_fa10_ta10_fm10_tm10,a
3067@TOP@human_GAPDH_TAA_len41_fa10_ta10_fm10_tm10*128*c,0,2150,0,0,2150,0.0,128,3067@TOP@human_GAPDH_TAA_len41_fa10_ta10_fm10_tm10,c
3067@TOP@human_GAPDH_TAA_len41_fa10_ta10_fm10_tm10*129*c,0,2132,0,0,2132,0.0,129,3067@TOP@human_GAPDH_TAA_len41_fa10_ta10_fm10_tm10,c
3067@TOP@human_GAPDH_TAA_len41_fa10_ta10_fm10_tm10*130*c,1,2144,1,0,2146,0.0,130,3067@TOP@human_GAPDH_TAA_len41_fa10_ta10_fm10_tm10,c
3067@TOP@human_GAPDH_TAA_len41_fa10_ta10_fm10_tm10*131*c,0,2151,0,1,2152,0.0,131,3067@TOP@human_GAPDH_TAA_len41_fa10_ta10_fm10_tm10,c
3067@TOP@human_GAPDH_TAA_len41_fa10_ta10_fm10_tm10*132*t,0,0,0,2128,2128,0.0,132,3067@TOP@human_GAPDH_TAA_len41_fa10_ta10_fm10_tm10,t
3067@TOP@human_GAPDH_TAA_len41_fa10_ta10_fm10_tm10*133*g,0,0,2118,1,2119,1.0,133,3067@TOP@human_GAPDH_TAA_len41_fa10_ta10_fm10_tm10,g
3067@TOP@human_GAPDH_TAA_len41_fa10_ta10_fm10_tm10*134*g,0,1,2120,0,2121,1.0,134,3067@TOP@human_GAPDH_TAA_len41_fa10_ta10_fm10_tm10,g
3068@TOP@human_GAPDH_TAA_len41_fa10_ta10_fm10_tm10*114*t,2,3,0,17697,17702,0.0,114,3068@TOP@human_GAPDH_TAA_len41_fa10_ta10_fm10_tm10,t
3068@TOP@human_GAPDH_TAA_len41_fa10_ta10_fm10_tm10*115*c,0,17785,0,1,17786,0.0,115,3068@TOP@human_GAPDH_TAA_len41_fa10_ta10_fm10_tm10,c
3068@TOP@human_GAPDH_TAA_len41_fa10_ta10_fm10_tm10*116*c,0,17699,0,0,17699,0.0,116,3068@TOP@human_GAPDH_TAA_len41_fa10_ta10_fm10_tm10,c
3068@TOP@human_GAPDH_TAA_len41_fa10_ta10_fm10_tm10*117*a,17652,0,29,0,17681,0.002,117,3068@TOP@human_GAPDH_TAA_len41_fa10_ta10_fm10_tm10,a
3068@TOP@human_GAPDH_TAA_len41_fa10_ta10_fm10_tm10*118*a,17357,0,229,0,17586,0.013,118,3068@TOP@human_GAPDH_TAA_len41_fa10_ta10_fm10_tm10,a
3068@TOP@human_GAPDH_TAA_len41_fa10_ta10_fm10_tm10*119*g,0,0,17586,1,17587,1.0,119,3068@TOP@human_GAPDH_TAA_len41_fa10_ta10_fm10_tm10,g
3068@TOP@human_GAPDH_TAA_len41_fa10_ta10_fm10_tm10*120*g,0,0,17474,2,17476,1.0,120,3068@TOP@human_GAPDH_TAA_len41_fa10_ta10_fm10_tm10,g
3068@TOP@human_GAPDH_TAA_len41_fa10_ta10_fm10_tm10*121*a,17673,0,6,0,17679,0.0,121,3068@TOP@human_GAPDH_TAA_len41_fa10_ta10_fm10_tm10,a
3068@TOP@human_GAPDH_TAA_len41_fa10_ta10_fm10_tm10*122*g,0,1,17698,0,17699,1.0,122,3068@TOP@human_GAPDH_TAA_len41_fa10_ta10_fm10_tm10,g
3068@TOP@human_GAPDH_TAA_len41_fa10_ta10_fm10_tm10*123*t,3,3,0,17443,17449,0.0,123,3068@TOP@human_GAPDH_TAA_len41_fa10_ta10_fm10_tm10,t
3068@TOP@human_GAPDH_TAA_len41_fa10_ta10_fm10_tm10*124*a,16933,1,465,4,17403,0.027,124,3068@TOP@human_GAPDH_TAA_len41_fa10_ta10_fm10_tm10,a
3068@TOP@human_GAPDH_TAA_len41_fa10_ta10_fm10_tm10*125*a,17076,3,298,8,17385,0.017,125,3068@TOP@human_GAPDH_TAA_len41_fa10_ta10_fm10_tm10,a
3068@TOP@human_GAPDH_TAA_len41_fa10_ta10_fm10_tm10*126*g,0,2,17453,2,17457,1.0,126,3068@TOP@human_GAPDH_TAA_len41_fa10_ta10_fm10_tm10,g
3068@TOP@human_GAPDH_TAA_len41_fa10_ta10_fm10_tm10*127*a,17609,0,10,0,17619,0.001,127,3068@TOP@human_GAPDH_TAA_len41_fa10_ta10_fm10_tm10,a
3068@TOP@human_GAPDH_TAA_len41_fa10_ta10_fm10_tm10*128*c,0,17733,0,2,17735,0.0,128,3068@TOP@human_GAPDH_TAA_len41_fa10_ta10_fm10_tm10,c
3068@TOP@human_GAPDH_TAA_len41_fa10_ta10_fm10_tm10*129*c,0,17604,0,1,17605,0.0,129,3068@TOP@human_GAPDH_TAA_len41_fa10_ta10_fm10_tm10,c
3068@TOP@human_GAPDH_TAA_len41_fa10_ta10_fm10_tm10*130*c,2,17704,0,1,17707,0.0,130,3068@TOP@human_GAPDH_TAA_len41_fa10_ta10_fm10_tm10,c
3068@TOP@human_GAPDH_TAA_len41_fa10_ta10_fm10_tm10*131*c,2,17747,0,0,17749,0.0,131,3068@TOP@human_GAPDH_TAA_len41_fa10_ta10_fm10_tm10,c
3068@TOP@human_GAPDH_TAA_len41_fa10_ta10_fm10_tm10*132*t,0,4,2,17517,17523,0.0,132,3068@TOP@human_GAPDH_TAA_len41_fa10_ta10_fm10_tm10,t
3068@TOP@human_GAPDH_TAA_len41_fa10_ta10_fm10_tm10*133*g,1,1,17492,0,17494,1.0,133,3068@TOP@human_GAPDH_TAA_len41_fa10_ta10_fm10_tm10,g
3068@TOP@human_GAPDH_TAA_len41_fa10_ta10_fm10_tm10*134*g,1,1,17557,1,17560,1.0,134,3068@TOP@human_GAPDH_TAA_len41_fa10_ta10_fm10_tm10,g
3069@TOP@human_GAPDH_TAA_len41_fa10_ta10_fm10_tm10*114*t,1,3,0,10313,10317,0.0,114,3069@TOP@human_GAPDH_TAA_len41_fa10_ta10_fm10_tm10,t
3069@TOP@human_GAPDH_TAA_len41_fa10_ta10_fm10_tm10*115*c,1,10377,0,3,10381,0.0,115,3069@TOP@human_GAPDH_TAA_len41_fa10_ta10_fm10_tm10,c
3069@TOP@human_GAPDH_TAA_len41_fa10_ta10_fm10_tm10*116*c,0,10332,0,0,10332,0.0,116,3069@TOP@human_GAPDH_TAA_len41_fa10_ta10_fm10_tm10,c
3069@TOP@human_GAPDH_TAA_len41_fa10_ta10_fm10_tm10*117*a,10293,0,35,0,10328,0.003,117,3069@TOP@human_GAPDH_TAA_len41_fa10_ta10_fm10_tm10,a
3069@TOP@human_GAPDH_TAA_len41_fa10_ta10_fm10_tm10*118*a,9443,0,837,0,10280,0.081,118,3069@TOP@human_GAPDH_TAA_len41_fa10_ta10_fm10_tm10,a
3069@TOP@human_GAPDH_TAA_len41_fa10_ta10_fm10_tm10*119*g,0,0,10264,0,10264,1.0,119,3069@TOP@human_GAPDH_TAA_len41_fa10_ta10_fm10_tm10,g
3069@TOP@human_GAPDH_TAA_len41_fa10_ta10_fm10_tm10*120*g,0,0,10224,0,10224,1.0,120,3069@TOP@human_GAPDH_TAA_len41_fa10_ta10_fm10_tm10,g
3069@TOP@human_GAPDH_TAA_len41_fa10_ta10_fm10_tm10*121*a,10302,0,17,0,10319,0.002,121,3069@TOP@human_GAPDH_TAA_len41_fa10_ta10_fm10_tm10,a
3069@TOP@human_GAPDH_TAA_len41_fa10_ta10_fm10_tm10*122*g,1,0,10330,0,10331,1.0,122,3069@TOP@human_GAPDH_TAA_len41_fa10_ta10_fm10_tm10,g
3069@TOP@human_GAPDH_TAA_len41_fa10_ta10_fm10_tm10*123*t,0,1,4,10187,10192,0.0,123,3069@TOP@human_GAPDH_TAA_len41_fa10_ta10_fm10_tm10,t
3069@TOP@human_GAPDH_TAA_len41_fa10_ta10_fm10_tm10*124*a,9807,1,368,1,10177,0.036,124,3069@TOP@human_GAPDH_TAA_len41_fa10_ta10_fm10_tm10,a
3069@TOP@human_GAPDH_TAA_len41_fa10_ta10_fm10_tm10*125*a,9923,0,221,0,10144,0.022,125,3069@TOP@human_GAPDH_TAA_len41_fa10_ta10_fm10_tm10,a
3069@TOP@human_GAPDH_TAA_len41_fa10_ta10_fm10_tm10*126*g,1,0,10186,3,10190,1.0,126,3069@TOP@human_GAPDH_TAA_len41_fa10_ta10_fm10_tm10,g
3069@TOP@human_GAPDH_TAA_len41_fa10_ta10_fm10_tm10*127*a,10297,1,10,0,10308,0.001,127,3069@TOP@human_GAPDH_TAA_len41_fa10_ta10_fm10_tm10,a
3069@TOP@human_GAPDH_TAA_len41_fa10_ta10_fm10_tm10*128*c,1,10347,1,1,10350,0.0,128,3069@TOP@human_GAPDH_TAA_len41_fa10_ta10_fm10_tm10,c
3069@TOP@human_GAPDH_TAA_len41_fa10_ta10_fm10_tm10*129*c,0,10283,0,0,10283,0.0,129,3069@TOP@human_GAPDH_TAA_len41_fa10_ta10_fm10_tm10,c
3069@TOP@human_GAPDH_TAA_len41_fa10_ta10_fm10_tm10*130*c,0,10337,0,2,10339,0.0,130,3069@TOP@human_GAPDH_TAA_len41_fa10_ta10_fm10_tm10,c
3069@TOP@human_GAPDH_TAA_len41_fa10_ta10_fm10_tm10*131*c,1,10366,0,0,10367,0.0,131,3069@TOP@human_GAPDH_TAA_len41_fa10_ta10_fm10_tm10,c
3069@TOP@human_GAPDH_TAA_len41_fa10_ta10_fm10_tm10*132*t,2,2,3,10210,10217,0.0,132,3069@TOP@human_GAPDH_TAA_len41_fa10_ta10_fm10_tm10,t
3069@TOP@human_GAPDH_TAA_len41_fa10_ta10_fm10_tm10*133*g,1,0,10187,4,10192,1.0,133,3069@TOP@human_GAPDH_TAA_len41_fa10_ta10_fm10_tm10,g
3069@TOP@human_GAPDH_TAA_len41_fa10_ta10_fm10_tm10*134*g,0,0,10246,1,10247,1.0,134,3069@TOP@human_GAPDH_TAA_len41_fa10_ta10_fm10_tm10,g
3070@TOP@human_GAPDH_TAA_len41_fa10_ta10_fm10_tm10*114*t,0,0,2,571,573,0.003,114,3070@TOP@human_GAPDH_TAA_len41_fa10_ta10_fm10_tm10,t
3070@TOP@human_GAPDH_TAA_len41_fa10_ta10_fm10_tm10*115*c,0,578,0,0,578,0.0,115,3070@TOP@human_GAPDH_TAA_len41_fa10_ta10_fm10_tm10,c
3070@TOP@human_GAPDH_TAA_len41_fa10_ta10_fm10_tm10*116*c,0,577,0,0,577,0.0,116,3070@TOP@human_GAPDH_TAA_len41_fa10_ta10_fm10_tm10,c
3070@TOP@human_GAPDH_TAA_len41_fa10_ta10_fm10_tm10*117*a,538,0,37,0,575,0.064,117,3070@TOP@human_GAPDH_TAA_len41_fa10_ta10_fm10_tm10,a
3070@TOP@human_GAPDH_TAA_len41_fa10_ta10_fm10_tm10*118*a,431,0,142,0,573,0.248,118,3070@TOP@human_GAPDH_TAA_len41_fa10_ta10_fm10_tm10,a
3070@TOP@human_GAPDH_TAA_len41_fa10_ta10_fm10_tm10*119*g,0,0,572,0,572,1.0,119,3070@TOP@human_GAPDH_TAA_len41_fa10_ta10_fm10_tm10,g
3070@TOP@human_GAPDH_TAA_len41_fa10_ta10_fm10_tm10*120*g,0,0,572,0,572,1.0,120,3070@TOP@human_GAPDH_TAA_len41_fa10_ta10_fm10_tm10,g
3070@TOP@human_GAPDH_TAA_len41_fa10_ta10_fm10_tm10*121*a,576,0,0,0,576,0.0,121,3070@TOP@human_GAPDH_TAA_len41_fa10_ta10_fm10_tm10,a
3070@TOP@human_GAPDH_TAA_len41_fa10_ta10_fm10_tm10*122*g,0,0,576,0,576,1.0,122,3070@TOP@human_GAPDH_TAA_len41_fa10_ta10_fm10_tm10,g
3070@TOP@human_GAPDH_TAA_len41_fa10_ta10_fm10_tm10*123*t,0,4,0,562,566,0.0,123,3070@TOP@human_GAPDH_TAA_len41_fa10_ta10_fm10_tm10,t
3070@TOP@human_GAPDH_TAA_len41_fa10_ta10_fm10_tm10*124*a,477,0,83,0,560,0.148,124,3070@TOP@human_GAPDH_TAA_len41_fa10_ta10_fm10_tm10,a
3070@TOP@human_GAPDH_TAA_len41_fa10_ta10_fm10_tm10*125*a,499,0,68,0,567,0.12,125,3070@TOP@human_GAPDH_TAA_len41_fa10_ta10_fm10_tm10,a
3070@TOP@human_GAPDH_TAA_len41_fa10_ta10_fm10_tm10*126*g,0,0,578,0,578,1.0,126,3070@TOP@human_GAPDH_TAA_len41_fa10_ta10_fm10_tm10,g
3070@TOP@human_GAPDH_TAA_len41_fa10_ta10_fm10_tm10*127*a,572,0,0,0,572,0.0,127,3070@TOP@human_GAPDH_TAA_len41_fa10_ta10_fm10_tm10,a
3070@TOP@human_GAPDH_TAA_len41_fa10_ta10_fm10_tm10*128*c,0,577,2,0,579,0.003,128,3070@TOP@human_GAPDH_TAA_len41_fa10_ta10_fm10_tm10,c
3070@TOP@human_GAPDH_TAA_len41_fa10_ta10_fm10_tm10*129*c,0,576,0,0,576,0.0,129,3070@TOP@human_GAPDH_TAA_len41_fa10_ta10_fm10_tm10,c
3070@TOP@human_GAPDH_TAA_len41_fa10_ta10_fm10_tm10*130*c,0,575,0,0,575,0.0,130,3070@TOP@human_GAPDH_TAA_len41_fa10_ta10_fm10_tm10,c
3070@TOP@human_GAPDH_TAA_len41_fa10_ta10_fm10_tm10*131*c,0,579,0,0,579,0.0,131,3070@TOP@human_GAPDH_TAA_len41_fa10_ta10_fm10_tm10,c
3070@TOP@human_GAPDH_TAA_len41_fa10_ta10_fm10_tm10*132*t,0,0,0,567,567,0.0,132,3070@TOP@human_GAPDH_TAA_len41_fa10_ta10_fm10_tm10,t
3070@TOP@human_GAPDH_TAA_len41_fa10_ta10_fm10_tm10*133*g,0,0,568,0,568,1.0,133,3070@TOP@human_GAPDH_TAA_len41_fa10_ta10_fm10_tm10,g
3070@TOP@human_GAPDH_TAA_len41_fa10_ta10_fm10_tm10*134*g,0,0,572,0,572,1.0,134,3070@TOP@human_GAPDH_TAA_len41_fa10_ta10_fm10_tm10,g
3071@TOP@human_GAPDH_TAA_len41_fa10_ta10_fm10_tm10*114*t,2,0,0,1063,1065,0.0,114,3071@TOP@human_GAPDH_TAA_len41_fa10_ta10_fm10_tm10,t
3071@TOP@human_GAPDH_TAA_len41_fa10_ta10_fm10_tm10*115*c,1,1078,0,0,1079,0.0,115,3071@TOP@human_GAPDH_TAA_len41_fa10_ta10_fm10_tm10,c
3071@TOP@human_GAPDH_TAA_len41_fa10_ta10_fm10_tm10*116*c,0,1073,0,0,1073,0.0,116,3071@TOP@human_GAPDH_TAA_len41_fa10_ta10_fm10_tm10,c
3071@TOP@human_GAPDH_TAA_len41_fa10_ta10_fm10_tm10*117*a,1007,0,64,0,1071,0.06,117,3071@TOP@human_GAPDH_TAA_len41_fa10_ta10_fm10_tm10,a
3071@TOP@human_GAPDH_TAA_len41_fa10_ta10_fm10_tm10*118*a,864,0,193,0,1057,0.183,118,3071@TOP@human_GAPDH_TAA_len41_fa10_ta10_fm10_tm10,a
3071@TOP@human_GAPDH_TAA_len41_fa10_ta10_fm10_tm10*119*g,0,0,1060,0,1060,1.0,119,3071@TOP@human_GAPDH_TAA_len41_fa10_ta10_fm10_tm10,g
3071@TOP@human_GAPDH_TAA_len41_fa10_ta10_fm10_tm10*120*g,0,0,1055,0,1055,1.0,120,3071@TOP@human_GAPDH_TAA_len41_fa10_ta10_fm10_tm10,g
3071@TOP@human_GAPDH_TAA_len41_fa10_ta10_fm10_tm10*121*a,1069,0,0,0,1069,0.0,121,3071@TOP@human_GAPDH_TAA_len41_fa10_ta10_fm10_tm10,a
3071@TOP@human_GAPDH_TAA_len41_fa10_ta10_fm10_tm10*122*g,0,0,1072,0,1072,1.0,122,3071@TOP@human_GAPDH_TAA_len41_fa10_ta10_fm10_tm10,g
3071@TOP@human_GAPDH_TAA_len41_fa10_ta10_fm10_tm10*123*t,0,0,0,1062,1062,0.0,123,3071@TOP@human_GAPDH_TAA_len41_fa10_ta10_fm10_tm10,t
3071@TOP@human_GAPDH_TAA_len41_fa10_ta10_fm10_tm10*124*a,770,0,283,0,1053,0.269,124,3071@TOP@human_GAPDH_TAA_len41_fa10_ta10_fm10_tm10,a
3071@TOP@human_GAPDH_TAA_len41_fa10_ta10_fm10_tm10*125*a,981,0,68,0,1049,0.065,125,3071@TOP@human_GAPDH_TAA_len41_fa10_ta10_fm10_tm10,a
3071@TOP@human_GAPDH_TAA_len41_fa10_ta10_fm10_tm10*126*g,0,0,1054,0,1054,1.0,126,3071@TOP@human_GAPDH_TAA_len41_fa10_ta10_fm10_tm10,g
3071@TOP@human_GAPDH_TAA_len41_fa10_ta10_fm10_tm10*127*a,1070,0,0,0,1070,0.0,127,3071@TOP@human_GAPDH_TAA_len41_fa10_ta10_fm10_tm10,a
3071@TOP@human_GAPDH_TAA_len41_fa10_ta10_fm10_tm10*128*c,0,1074,0,0,1074,0.0,128,3071@TOP@human_GAPDH_TAA_len41_fa10_ta10_fm10_tm10,c
3071@TOP@human_GAPDH_TAA_len41_fa10_ta10_fm10_tm10*129*c,0,1063,0,0,1063,0.0,129,3071@TOP@human_GAPDH_TAA_len41_fa10_ta10_fm10_tm10,c
3071@TOP@human_GAPDH_TAA_len41_fa10_ta10_fm10_tm10*130*c,0,1072,0,0,1072,0.0,130,3071@TOP@human_GAPDH_TAA_len41_fa10_ta10_fm10_tm10,c
3071@TOP@human_GAPDH_TAA_len41_fa10_ta10_fm10_tm10*131*c,0,1077,0,0,1077,0.0,131,3071@TOP@human_GAPDH_TAA_len41_fa10_ta10_fm10_tm10,c
3071@TOP@human_GAPDH_TAA_len41_fa10_ta10_fm10_tm10*132*t,0,1,0,1062,1063,0.0,132,3071@TOP@human_GAPDH_TAA_len41_fa10_ta10_fm10_tm10,t
3071@TOP@human_GAPDH_TAA_len41_fa10_ta10_fm10_tm10*133*g,0,0,1059,0,1059,1.0,133,3071@TOP@human_GAPDH_TAA_len41_fa10_ta10_fm10_tm10,g
3071@TOP@human_GAPDH_TAA_len41_fa10_ta10_fm10_tm10*134*g,0,0,1061,0,1061,1.0,134,3071@TOP@human_GAPDH_TAA_len41_fa10_ta10_fm10_tm10,g
3072@TOP@human_GAPDH_TAA_len41_fa10_ta10_fm10_tm10*114*t,0,6,0,18010,18016,0.0,114,3072@TOP@human_GAPDH_TAA_len41_fa10_ta10_fm10_tm10,t
3072@TOP@human_GAPDH_TAA_len41_fa10_ta10_fm10_tm10*115*c,0,18122,0,2,18124,0.0,115,3072@TOP@human_GAPDH_TAA_len41_fa10_ta10_fm10_tm10,c
3072@TOP@human_GAPDH_TAA_len41_fa10_ta10_fm10_tm10*116*c,0,18043,0,0,18043,0.0,116,3072@TOP@human_GAPDH_TAA_len41_fa10_ta10_fm10_tm10,c
3072@TOP@human_GAPDH_TAA_len41_fa10_ta10_fm10_tm10*117*a,17968,0,78,0,18046,0.004,117,3072@TOP@human_GAPDH_TAA_len41_fa10_ta10_fm10_tm10,a
3072@TOP@human_GAPDH_TAA_len41_fa10_ta10_fm10_tm10*118*a,17535,0,406,0,17941,0.023,118,3072@TOP@human_GAPDH_TAA_len41_fa10_ta10_fm10_tm10,a
3072@TOP@human_GAPDH_TAA_len41_fa10_ta10_fm10_tm10*119*g,0,0,17940,1,17941,1.0,119,3072@TOP@human_GAPDH_TAA_len41_fa10_ta10_fm10_tm10,g
3072@TOP@human_GAPDH_TAA_len41_fa10_ta10_fm10_tm10*120*g,0,0,17834,0,17834,1.0,120,3072@TOP@human_GAPDH_TAA_len41_fa10_ta10_fm10_tm10,g
3072@TOP@human_GAPDH_TAA_len41_fa10_ta10_fm10_tm10*121*a,18020,0,11,0,18031,0.001,121,3072@TOP@human_GAPDH_TAA_len41_fa10_ta10_fm10_tm10,a
3072@TOP@human_GAPDH_TAA_len41_fa10_ta10_fm10_tm10*122*g,0,0,18052,0,18052,1.0,122,3072@TOP@human_GAPDH_TAA_len41_fa10_ta10_fm10_tm10,g
3072@TOP@human_GAPDH_TAA_len41_fa10_ta10_fm10_tm10*123*t,1,5,3,17827,17836,0.0,123,3072@TOP@human_GAPDH_TAA_len41_fa10_ta10_fm10_tm10,t
3072@TOP@human_GAPDH_TAA_len41_fa10_ta10_fm10_tm10*124*a,13017,0,4783,3,17803,0.269,124,3072@TOP@human_GAPDH_TAA_len41_fa10_ta10_fm10_tm10,a
3072@TOP@human_GAPDH_TAA_len41_fa10_ta10_fm10_tm10*125*a,15617,2,2150,1,17770,0.121,125,3072@TOP@human_GAPDH_TAA_len41_fa10_ta10_fm10_tm10,a
3072@TOP@human_GAPDH_TAA_len41_fa10_ta10_fm10_tm10*126*g,0,0,17871,1,17872,1.0,126,3072@TOP@human_GAPDH_TAA_len41_fa10_ta10_fm10_tm10,g
3072@TOP@human_GAPDH_TAA_len41_fa10_ta10_fm10_tm10*127*a,18001,2,13,0,18016,0.001,127,3072@TOP@human_GAPDH_TAA_len41_fa10_ta10_fm10_tm10,a
3072@TOP@human_GAPDH_TAA_len41_fa10_ta10_fm10_tm10*128*c,1,18077,1,2,18081,0.0,128,3072@TOP@human_GAPDH_TAA_len41_fa10_ta10_fm10_tm10,c
3072@TOP@human_GAPDH_TAA_len41_fa10_ta10_fm10_tm10*129*c,3,17959,0,2,17964,0.0,129,3072@TOP@human_GAPDH_TAA_len41_fa10_ta10_fm10_tm10,c
3072@TOP@human_GAPDH_TAA_len41_fa10_ta10_fm10_tm10*130*c,2,18063,0,1,18066,0.0,130,3072@TOP@human_GAPDH_TAA_len41_fa10_ta10_fm10_tm10,c
3072@TOP@human_GAPDH_TAA_len41_fa10_ta10_fm10_tm10*131*c,0,18101,0,0,18101,0.0,131,3072@TOP@human_GAPDH_TAA_len41_fa10_ta10_fm10_tm10,c
3072@TOP@human_GAPDH_TAA_len41_fa10_ta10_fm10_tm10*132*t,2,0,4,17856,17862,0.0,132,3072@TOP@human_GAPDH_TAA_len41_fa10_ta10_fm10_tm10,t
3072@TOP@human_GAPDH_TAA_len41_fa10_ta10_fm10_tm10*133*g,0,0,17819,0,17819,1.0,133,3072@TOP@human_GAPDH_TAA_len41_fa10_ta10_fm10_tm10,g
3072@TOP@human_GAPDH_TAA_len41_fa10_ta10_fm10_tm10*134*g,0,7,17908,0,17915,1.0,134,3072@TOP@human_GAPDH_TAA_len41_fa10_ta10_fm10_tm10,g
3073@TOP@human_GAPDH_TAA_len41_fa10_ta10_fm10_tm10*114*t,2,9,0,30868,30879,0.0,114,3073@TOP@human_GAPDH_TAA_len41_fa10_ta10_fm10_tm10,t
3073@TOP@human_GAPDH_TAA_len41_fa10_ta10_fm10_tm10*115*c,1,31044,0,1,31046,0.0,115,3073@TOP@human_GAPDH_TAA_len41_fa10_ta10_fm10_tm10,c
3073@TOP@human_GAPDH_TAA_len41_fa10_ta10_fm10_tm10*116*c,1,30911,0,1,30913,0.0,116,3073@TOP@human_GAPDH_TAA_len41_fa10_ta10_fm10_tm10,c
3073@TOP@human_GAPDH_TAA_len41_fa10_ta10_fm10_tm10*117*a,30835,0,70,1,30906,0.002,117,3073@TOP@human_GAPDH_TAA_len41_fa10_ta10_fm10_tm10,a
3073@TOP@human_GAPDH_TAA_len41_fa10_ta10_fm10_tm10*118*a,30236,0,490,0,30726,0.016,118,3073@TOP@human_GAPDH_TAA_len41_fa10_ta10_fm10_tm10,a
3073@TOP@human_GAPDH_TAA_len41_fa10_ta10_fm10_tm10*119*g,0,3,30670,1,30674,1.0,119,3073@TOP@human_GAPDH_TAA_len41_fa10_ta10_fm10_tm10,g
3073@TOP@human_GAPDH_TAA_len41_fa10_ta10_fm10_tm10*120*g,0,0,30543,1,30544,1.0,120,3073@TOP@human_GAPDH_TAA_len41_fa10_ta10_fm10_tm10,g
3073@TOP@human_GAPDH_TAA_len41_fa10_ta10_fm10_tm10*121*a,30849,0,14,0,30863,0.0,121,3073@TOP@human_GAPDH_TAA_len41_fa10_ta10_fm10_tm10,a
3073@TOP@human_GAPDH_TAA_len41_fa10_ta10_fm10_tm10*122*g,0,0,30918,1,30919,1.0,122,3073@TOP@human_GAPDH_TAA_len41_fa10_ta10_fm10_tm10,g
3073@TOP@human_GAPDH_TAA_len41_fa10_ta10_fm10_tm10*123*t,3,7,4,30556,30570,0.0,123,3073@TOP@human_GAPDH_TAA_len41_fa10_ta10_fm10_tm10,t
3073@TOP@human_GAPDH_TAA_len41_fa10_ta10_fm10_tm10*124*a,19112,1,11388,0,30501,0.373,124,3073@TOP@human_GAPDH_TAA_len41_fa10_ta10_fm10_tm10,a
3073@TOP@human_GAPDH_TAA_len41_fa10_ta10_fm10_tm10*125*a,28185,3,2321,2,30511,0.076,125,3073@TOP@human_GAPDH_TAA_len41_fa10_ta10_fm10_tm10,a
3073@TOP@human_GAPDH_TAA_len41_fa10_ta10_fm10_tm10*126*g,1,0,30614,3,30618,1.0,126,3073@TOP@human_GAPDH_TAA_len41_fa10_ta10_fm10_tm10,g
3073@TOP@human_GAPDH_TAA_len41_fa10_ta10_fm10_tm10*127*a,30823,0,11,0,30834,0.0,127,3073@TOP@human_GAPDH_TAA_len41_fa10_ta10_fm10_tm10,a
3073@TOP@human_GAPDH_TAA_len41_fa10_ta10_fm10_tm10*128*c,2,30954,1,4,30961,0.0,128,3073@TOP@human_GAPDH_TAA_len41_fa10_ta10_fm10_tm10,c
3073@TOP@human_GAPDH_TAA_len41_fa10_ta10_fm10_tm10*129*c,0,30823,0,0,30823,0.0,129,3073@TOP@human_GAPDH_TAA_len41_fa10_ta10_fm10_tm10,c
3073@TOP@human_GAPDH_TAA_len41_fa10_ta10_fm10_tm10*130*c,4,30919,0,5,30928,0.0,130,3073@TOP@human_GAPDH_TAA_len41_fa10_ta10_fm10_tm10,c
3073@TOP@human_GAPDH_TAA_len41_fa10_ta10_fm10_tm10*131*c,1,30982,1,3,30987,0.0,131,3073@TOP@human_GAPDH_TAA_len41_fa10_ta10_fm10_tm10,c
3073@TOP@human_GAPDH_TAA_len41_fa10_ta10_fm10_tm10*132*t,5,5,2,30545,30557,0.0,132,3073@TOP@human_GAPDH_TAA_len41_fa10_ta10_fm10_tm10,t
3073@TOP@human_GAPDH_TAA_len41_fa10_ta10_fm10_tm10*133*g,1,2,30479,0,30482,1.0,133,3073@TOP@human_GAPDH_TAA_len41_fa10_ta10_fm10_tm10,g
3073@TOP@human_GAPDH_TAA_len41_fa10_ta10_fm10_tm10*134*g,1,4,30657,1,30663,1.0,134,3073@TOP@human_GAPDH_TAA_len41_fa10_ta10_fm10_tm10,g
3074@TOP@human_GAPDH_TAA_len41_fa10_ta10_fm10_tm10*114*t,2,10,0,46355,46367,0.0,114,3074@TOP@human_GAPDH_TAA_len41_fa10_ta10_fm10_tm10,t
3074@TOP@human_GAPDH_TAA_len41_fa10_ta10_fm10_tm10*115*c,1,46624,0,3,46628,0.0,115,3074@TOP@human_GAPDH_TAA_len41_fa10_ta10_fm10_tm10,c
3074@TOP@human_GAPDH_TAA_len41_fa10_ta10_fm10_tm10*116*c,2,46436,0,2,46440,0.0,116,3074@TOP@human_GAPDH_TAA_len41_fa10_ta10_fm10_tm10,c
3074@TOP@human_GAPDH_TAA_len41_fa10_ta10_fm10_tm10*117*a,46259,1,144,1,46405,0.003,117,3074@TOP@human_GAPDH_TAA_len41_fa10_ta10_fm10_tm10,a
3074@TOP@human_GAPDH_TAA_len41_fa10_ta10_fm10_tm10*118*a,44655,0,1497,2,46154,0.032,118,3074@TOP@human_GAPDH_TAA_len41_fa10_ta10_fm10_tm10,a
3074@TOP@human_GAPDH_TAA_len41_fa10_ta10_fm10_tm10*119*g,5,0,46100,1,46106,1.0,119,3074@TOP@human_GAPDH_TAA_len41_fa10_ta10_fm10_tm10,g
3074@TOP@human_GAPDH_TAA_len41_fa10_ta10_fm10_tm10*120*g,2,0,45953,0,45955,1.0,120,3074@TOP@human_GAPDH_TAA_len41_fa10_ta10_fm10_tm10,g
3074@TOP@human_GAPDH_TAA_len41_fa10_ta10_fm10_tm10*121*a,46259,0,138,0,46397,0.003,121,3074@TOP@human_GAPDH_TAA_len41_fa10_ta10_fm10_tm10,a
3074@TOP@human_GAPDH_TAA_len41_fa10_ta10_fm10_tm10*122*g,0,1,46428,3,46432,1.0,122,3074@TOP@human_GAPDH_TAA_len41_fa10_ta10_fm10_tm10,g
3074@TOP@human_GAPDH_TAA_len41_fa10_ta10_fm10_tm10*123*t,4,6,4,45863,45877,0.0,123,3074@TOP@human_GAPDH_TAA_len41_fa10_ta10_fm10_tm10,t
3074@TOP@human_GAPDH_TAA_len41_fa10_ta10_fm10_tm10*124*a,29679,3,16199,1,45882,0.353,124,3074@TOP@human_GAPDH_TAA_len41_fa10_ta10_fm10_tm10,a
3074@TOP@human_GAPDH_TAA_len41_fa10_ta10_fm10_tm10*125*a,41691,1,4086,6,45784,0.089,125,3074@TOP@human_GAPDH_TAA_len41_fa10_ta10_fm10_tm10,a
3074@TOP@human_GAPDH_TAA_len41_fa10_ta10_fm10_tm10*126*g,0,0,45948,1,45949,1.0,126,3074@TOP@human_GAPDH_TAA_len41_fa10_ta10_fm10_tm10,g
3074@TOP@human_GAPDH_TAA_len41_fa10_ta10_fm10_tm10*127*a,46293,3,39,2,46337,0.001,127,3074@TOP@human_GAPDH_TAA_len41_fa10_ta10_fm10_tm10,a
3074@TOP@human_GAPDH_TAA_len41_fa10_ta10_fm10_tm10*128*c,2,46519,4,5,46530,0.0,128,3074@TOP@human_GAPDH_TAA_len41_fa10_ta10_fm10_tm10,c
3074@TOP@human_GAPDH_TAA_len41_fa10_ta10_fm10_tm10*129*c,3,46265,0,2,46270,0.0,129,3074@TOP@human_GAPDH_TAA_len41_fa10_ta10_fm10_tm10,c
3074@TOP@human_GAPDH_TAA_len41_fa10_ta10_fm10_tm10*130*c,1,46442,2,7,46452,0.0,130,3074@TOP@human_GAPDH_TAA_len41_fa10_ta10_fm10_tm10,c
3074@TOP@human_GAPDH_TAA_len41_fa10_ta10_fm10_tm10*131*c,2,46561,0,3,46566,0.0,131,3074@TOP@human_GAPDH_TAA_len41_fa10_ta10_fm10_tm10,c
3074@TOP@human_GAPDH_TAA_len41_fa10_ta10_fm10_tm10*132*t,2,7,7,45899,45915,0.0,132,3074@TOP@human_GAPDH_TAA_len41_fa10_ta10_fm10_tm10,t
3074@TOP@human_GAPDH_TAA_len41_fa10_ta10_fm10_tm10*133*g,6,2,45846,1,45855,1.0,133,3074@TOP@human_GAPDH_TAA_len41_fa10_ta10_fm10_tm10,g
3074@TOP@human_GAPDH_TAA_len41_fa10_ta10_fm10_tm10*134*g,5,6,46071,3,46085,1.0,134,3074@TOP@human_GAPDH_TAA_len41_fa10_ta10_fm10_tm10,g
3075@TOP@human_GAPDH_TAA_len41_fa10_ta10_fm10_tm10*114*t,4,9,0,45995,46008,0.0,114,3075@TOP@human_GAPDH_TAA_len41_fa10_ta10_fm10_tm10,t
3075@TOP@human_GAPDH_TAA_len41_fa10_ta10_fm10_tm10*115*c,2,46249,0,1,46252,0.0,115,3075@TOP@human_GAPDH_TAA_len41_fa10_ta10_fm10_tm10,c
3075@TOP@human_GAPDH_TAA_len41_fa10_ta10_fm10_tm10*116*c,0,46089,0,2,46091,0.0,116,3075@TOP@human_GAPDH_TAA_len41_fa10_ta10_fm10_tm10,c
3075@TOP@human_GAPDH_TAA_len41_fa10_ta10_fm10_tm10*117*a,45936,0,131,0,46067,0.003,117,3075@TOP@human_GAPDH_TAA_len41_fa10_ta10_fm10_tm10,a
3075@TOP@human_GAPDH_TAA_len41_fa10_ta10_fm10_tm10*118*a,44655,1,1164,0,45820,0.025,118,3075@TOP@human_GAPDH_TAA_len41_fa10_ta10_fm10_tm10,a
3075@TOP@human_GAPDH_TAA_len41_fa10_ta10_fm10_tm10*119*g,2,0,45713,1,45716,1.0,119,3075@TOP@human_GAPDH_TAA_len41_fa10_ta10_fm10_tm10,g
3075@TOP@human_GAPDH_TAA_len41_fa10_ta10_fm10_tm10*120*g,5,1,45576,4,45586,1.0,120,3075@TOP@human_GAPDH_TAA_len41_fa10_ta10_fm10_tm10,g
3075@TOP@human_GAPDH_TAA_len41_fa10_ta10_fm10_tm10*121*a,45951,0,72,0,46023,0.002,121,3075@TOP@human_GAPDH_TAA_len41_fa10_ta10_fm10_tm10,a
3075@TOP@human_GAPDH_TAA_len41_fa10_ta10_fm10_tm10*122*g,1,0,46070,0,46071,1.0,122,3075@TOP@human_GAPDH_TAA_len41_fa10_ta10_fm10_tm10,g
3075@TOP@human_GAPDH_TAA_len41_fa10_ta10_fm10_tm10*123*t,5,2,5,45535,45547,0.0,123,3075@TOP@human_GAPDH_TAA_len41_fa10_ta10_fm10_tm10,t
3075@TOP@human_GAPDH_TAA_len41_fa10_ta10_fm10_tm10*124*a,36628,1,8794,7,45430,0.194,124,3075@TOP@human_GAPDH_TAA_len41_fa10_ta10_fm10_tm10,a
3075@TOP@human_GAPDH_TAA_len41_fa10_ta10_fm10_tm10*125*a,40621,1,4680,0,45302,0.103,125,3075@TOP@human_GAPDH_TAA_len41_fa10_ta10_fm10_tm10,a
3075@TOP@human_GAPDH_TAA_len41_fa10_ta10_fm10_tm10*126*g,0,1,45526,5,45532,1.0,126,3075@TOP@human_GAPDH_TAA_len41_fa10_ta10_fm10_tm10,g
3075@TOP@human_GAPDH_TAA_len41_fa10_ta10_fm10_tm10*127*a,45901,2,20,0,45923,0.0,127,3075@TOP@human_GAPDH_TAA_len41_fa10_ta10_fm10_tm10,a
3075@TOP@human_GAPDH_TAA_len41_fa10_ta10_fm10_tm10*128*c,1,46105,5,2,46113,0.0,128,3075@TOP@human_GAPDH_TAA_len41_fa10_ta10_fm10_tm10,c
3075@TOP@human_GAPDH_TAA_len41_fa10_ta10_fm10_tm10*129*c,2,45778,1,1,45782,0.0,129,3075@TOP@human_GAPDH_TAA_len41_fa10_ta10_fm10_tm10,c
3075@TOP@human_GAPDH_TAA_len41_fa10_ta10_fm10_tm10*130*c,6,46050,1,1,46058,0.0,130,3075@TOP@human_GAPDH_TAA_len41_fa10_ta10_fm10_tm10,c
3075@TOP@human_GAPDH_TAA_len41_fa10_ta10_fm10_tm10*131*c,3,46148,0,6,46157,0.0,131,3075@TOP@human_GAPDH_TAA_len41_fa10_ta10_fm10_tm10,c
3075@TOP@human_GAPDH_TAA_len41_fa10_ta10_fm10_tm10*132*t,1,17,3,45528,45549,0.0,132,3075@TOP@human_GAPDH_TAA_len41_fa10_ta10_fm10_tm10,t
3075@TOP@human_GAPDH_TAA_len41_fa10_ta10_fm10_tm10*133*g,3,2,45490,0,45495,1.0,133,3075@TOP@human_GAPDH_TAA_len41_fa10_ta10_fm10_tm10,g
3075@TOP@human_GAPDH_TAA_len41_fa10_ta10_fm10_tm10*134*g,2,13,45673,3,45691,1.0,134,3075@TOP@human_GAPDH_TAA_len41_fa10_ta10_fm10_tm10,g
3076@TOP@human_GAPDH_TAA_len41_fa10_ta10_fm10_tm10*114*t,0,0,0,2920,2920,0.0,114,3076@TOP@human_GAPDH_TAA_len41_fa10_ta10_fm10_tm10,t
3076@TOP@human_GAPDH_TAA_len41_fa10_ta10_fm10_tm10*115*c,0,2930,0,0,2930,0.0,115,3076@TOP@human_GAPDH_TAA_len41_fa10_ta10_fm10_tm10,c
3076@TOP@human_GAPDH_TAA_len41_fa10_ta10_fm10_tm10*116*c,0,2925,0,0,2925,0.0,116,3076@TOP@human_GAPDH_TAA_len41_fa10_ta10_fm10_tm10,c
3076@TOP@human_GAPDH_TAA_len41_fa10_ta10_fm10_tm10*117*a,2789,0,132,0,2921,0.045,117,3076@TOP@human_GAPDH_TAA_len41_fa10_ta10_fm10_tm10,a
3076@TOP@human_GAPDH_TAA_len41_fa10_ta10_fm10_tm10*118*a,2161,0,741,0,2902,0.255,118,3076@TOP@human_GAPDH_TAA_len41_fa10_ta10_fm10_tm10,a
3076@TOP@human_GAPDH_TAA_len41_fa10_ta10_fm10_tm10*119*g,0,0,2896,0,2896,1.0,119,3076@TOP@human_GAPDH_TAA_len41_fa10_ta10_fm10_tm10,g
3076@TOP@human_GAPDH_TAA_len41_fa10_ta10_fm10_tm10*120*g,2,0,2900,0,2902,0.999,120,3076@TOP@human_GAPDH_TAA_len41_fa10_ta10_fm10_tm10,g
3076@TOP@human_GAPDH_TAA_len41_fa10_ta10_fm10_tm10*121*a,2890,0,13,0,2903,0.004,121,3076@TOP@human_GAPDH_TAA_len41_fa10_ta10_fm10_tm10,a
3076@TOP@human_GAPDH_TAA_len41_fa10_ta10_fm10_tm10*122*g,0,0,2916,0,2916,1.0,122,3076@TOP@human_GAPDH_TAA_len41_fa10_ta10_fm10_tm10,g
3076@TOP@human_GAPDH_TAA_len41_fa10_ta10_fm10_tm10*123*t,1,0,1,2880,2882,0.0,123,3076@TOP@human_GAPDH_TAA_len41_fa10_ta10_fm10_tm10,t
3076@TOP@human_GAPDH_TAA_len41_fa10_ta10_fm10_tm10*124*a,2287,0,586,0,2873,0.204,124,3076@TOP@human_GAPDH_TAA_len41_fa10_ta10_fm10_tm10,a
3076@TOP@human_GAPDH_TAA_len41_fa10_ta10_fm10_tm10*125*a,2578,0,295,0,2873,0.103,125,3076@TOP@human_GAPDH_TAA_len41_fa10_ta10_fm10_tm10,a
3076@TOP@human_GAPDH_TAA_len41_fa10_ta10_fm10_tm10*126*g,0,0,2880,0,2880,1.0,126,3076@TOP@human_GAPDH_TAA_len41_fa10_ta10_fm10_tm10,g
3076@TOP@human_GAPDH_TAA_len41_fa10_ta10_fm10_tm10*127*a,2898,0,4,0,2902,0.001,127,3076@TOP@human_GAPDH_TAA_len41_fa10_ta10_fm10_tm10,a
3076@TOP@human_GAPDH_TAA_len41_fa10_ta10_fm10_tm10*128*c,0,2929,0,0,2929,0.0,128,3076@TOP@human_GAPDH_TAA_len41_fa10_ta10_fm10_tm10,c
3076@TOP@human_GAPDH_TAA_len41_fa10_ta10_fm10_tm10*129*c,0,2906,0,0,2906,0.0,129,3076@TOP@human_GAPDH_TAA_len41_fa10_ta10_fm10_tm10,c
3076@TOP@human_GAPDH_TAA_len41_fa10_ta10_fm10_tm10*130*c,1,2921,0,0,2922,0.0,130,3076@TOP@human_GAPDH_TAA_len41_fa10_ta10_fm10_tm10,c
3076@TOP@human_GAPDH_TAA_len41_fa10_ta10_fm10_tm10*131*c,0,2924,0,0,2924,0.0,131,3076@TOP@human_GAPDH_TAA_len41_fa10_ta10_fm10_tm10,c
3076@TOP@human_GAPDH_TAA_len41_fa10_ta10_fm10_tm10*132*t,0,0,0,2881,2881,0.0,132,3076@TOP@human_GAPDH_TAA_len41_fa10_ta10_fm10_tm10,t
3076@TOP@human_GAPDH_TAA_len41_fa10_ta10_fm10_tm10*133*g,0,0,2878,0,2878,1.0,133,3076@TOP@human_GAPDH_TAA_len41_fa10_ta10_fm10_tm10,g
3076@TOP@human_GAPDH_TAA_len41_fa10_ta10_fm10_tm10*134*g,0,2,2894,0,2896,0.999,134,3076@TOP@human_GAPDH_TAA_len41_fa10_ta10_fm10_tm10,g
3077@TOP@human_GAPDH_TAA_len41_fa10_ta10_fm10_tm10*114*t,1,10,1,27426,27438,0.0,114,3077@TOP@human_GAPDH_TAA_len41_fa10_ta10_fm10_tm10,t
3077@TOP@human_GAPDH_TAA_len41_fa10_ta10_fm10_tm10*115*c,0,27592,0,0,27592,0.0,115,3077@TOP@human_GAPDH_TAA_len41_fa10_ta10_fm10_tm10,c
3077@TOP@human_GAPDH_TAA_len41_fa10_ta10_fm10_tm10*116*c,0,27501,0,4,27505,0.0,116,3077@TOP@human_GAPDH_TAA_len41_fa10_ta10_fm10_tm10,c
3077@TOP@human_GAPDH_TAA_len41_fa10_ta10_fm10_tm10*117*a,26979,0,470,1,27450,0.017,117,3077@TOP@human_GAPDH_TAA_len41_fa10_ta10_fm10_tm10,a
3077@TOP@human_GAPDH_TAA_len41_fa10_ta10_fm10_tm10*118*a,24398,0,2922,0,27320,0.107,118,3077@TOP@human_GAPDH_TAA_len41_fa10_ta10_fm10_tm10,a
3077@TOP@human_GAPDH_TAA_len41_fa10_ta10_fm10_tm10*119*g,1,0,27270,2,27273,1.0,119,3077@TOP@human_GAPDH_TAA_len41_fa10_ta10_fm10_tm10,g
3077@TOP@human_GAPDH_TAA_len41_fa10_ta10_fm10_tm10*120*g,3,1,27202,0,27206,1.0,120,3077@TOP@human_GAPDH_TAA_len41_fa10_ta10_fm10_tm10,g
3077@TOP@human_GAPDH_TAA_len41_fa10_ta10_fm10_tm10*121*a,27400,0,15,1,27416,0.001,121,3077@TOP@human_GAPDH_TAA_len41_fa10_ta10_fm10_tm10,a
3077@TOP@human_GAPDH_TAA_len41_fa10_ta10_fm10_tm10*122*g,4,0,27509,1,27514,1.0,122,3077@TOP@human_GAPDH_TAA_len41_fa10_ta10_fm10_tm10,g
3077@TOP@human_GAPDH_TAA_len41_fa10_ta10_fm10_tm10*123*t,1,3,2,27121,27127,0.0,123,3077@TOP@human_GAPDH_TAA_len41_fa10_ta10_fm10_tm10,t
3077@TOP@human_GAPDH_TAA_len41_fa10_ta10_fm10_tm10*124*a,22379,2,4729,0,27110,0.174,124,3077@TOP@human_GAPDH_TAA_len41_fa10_ta10_fm10_tm10,a
3077@TOP@human_GAPDH_TAA_len41_fa10_ta10_fm10_tm10*125*a,25217,0,1822,2,27041,0.067,125,3077@TOP@human_GAPDH_TAA_len41_fa10_ta10_fm10_tm10,a
3077@TOP@human_GAPDH_TAA_len41_fa10_ta10_fm10_tm10*126*g,1,2,27166,0,27169,1.0,126,3077@TOP@human_GAPDH_TAA_len41_fa10_ta10_fm10_tm10,g
3077@TOP@human_GAPDH_TAA_len41_fa10_ta10_fm10_tm10*127*a,27351,0,27,1,27379,0.001,127,3077@TOP@human_GAPDH_TAA_len41_fa10_ta10_fm10_tm10,a
3077@TOP@human_GAPDH_TAA_len41_fa10_ta10_fm10_tm10*128*c,2,27516,3,0,27521,0.0,128,3077@TOP@human_GAPDH_TAA_len41_fa10_ta10_fm10_tm10,c
3077@TOP@human_GAPDH_TAA_len41_fa10_ta10_fm10_tm10*129*c,1,27346,1,1,27349,0.0,129,3077@TOP@human_GAPDH_TAA_len41_fa10_ta10_fm10_tm10,c
3077@TOP@human_GAPDH_TAA_len41_fa10_ta10_fm10_tm10*130*c,3,27476,0,0,27479,0.0,130,3077@TOP@human_GAPDH_TAA_len41_fa10_ta10_fm10_tm10,c
3077@TOP@human_GAPDH_TAA_len41_fa10_ta10_fm10_tm10*131*c,4,27550,1,1,27556,0.0,131,3077@TOP@human_GAPDH_TAA_len41_fa10_ta10_fm10_tm10,c
3077@TOP@human_GAPDH_TAA_len41_fa10_ta10_fm10_tm10*132*t,0,4,6,27179,27189,0.0,132,3077@TOP@human_GAPDH_TAA_len41_fa10_ta10_fm10_tm10,t
3077@TOP@human_GAPDH_TAA_len41_fa10_ta10_fm10_tm10*133*g,2,0,27098,3,27103,1.0,133,3077@TOP@human_GAPDH_TAA_len41_fa10_ta10_fm10_tm10,g
3077@TOP@human_GAPDH_TAA_len41_fa10_ta10_fm10_tm10*134*g,4,4,27287,0,27295,1.0,134,3077@TOP@human_GAPDH_TAA_len41_fa10_ta10_fm10_tm10,g
3078@TOP@human_GAPDH_TAA_len41_fa10_ta10_fm10_tm10*114*t,0,6,3,15351,15360,0.0,114,3078@TOP@human_GAPDH_TAA_len41_fa10_ta10_fm10_tm10,t
3078@TOP@human_GAPDH_TAA_len41_fa10_ta10_fm10_tm10*115*c,0,15454,0,1,15455,0.0,115,3078@TOP@human_GAPDH_TAA_len41_fa10_ta10_fm10_tm10,c
3078@TOP@human_GAPDH_TAA_len41_fa10_ta10_fm10_tm10*116*c,0,15382,0,1,15383,0.0,116,3078@TOP@human_GAPDH_TAA_len41_fa10_ta10_fm10_tm10,c
3078@TOP@human_GAPDH_TAA_len41_fa10_ta10_fm10_tm10*117*a,15157,3,213,0,15373,0.014,117,3078@TOP@human_GAPDH_TAA_len41_fa10_ta10_fm10_tm10,a
3078@TOP@human_GAPDH_TAA_len41_fa10_ta10_fm10_tm10*118*a,13837,0,1492,0,15329,0.097,118,3078@TOP@human_GAPDH_TAA_len41_fa10_ta10_fm10_tm10,a
3078@TOP@human_GAPDH_TAA_len41_fa10_ta10_fm10_tm10*119*g,0,0,15283,0,15283,1.0,119,3078@TOP@human_GAPDH_TAA_len41_fa10_ta10_fm10_tm10,g
3078@TOP@human_GAPDH_TAA_len41_fa10_ta10_fm10_tm10*120*g,0,0,15227,0,15227,1.0,120,3078@TOP@human_GAPDH_TAA_len41_fa10_ta10_fm10_tm10,g
3078@TOP@human_GAPDH_TAA_len41_fa10_ta10_fm10_tm10*121*a,15331,0,22,0,15353,0.001,121,3078@TOP@human_GAPDH_TAA_len41_fa10_ta10_fm10_tm10,a
3078@TOP@human_GAPDH_TAA_len41_fa10_ta10_fm10_tm10*122*g,0,1,15397,0,15398,1.0,122,3078@TOP@human_GAPDH_TAA_len41_fa10_ta10_fm10_tm10,g
3078@TOP@human_GAPDH_TAA_len41_fa10_ta10_fm10_tm10*123*t,2,4,3,15187,15196,0.0,123,3078@TOP@human_GAPDH_TAA_len41_fa10_ta10_fm10_tm10,t
3078@TOP@human_GAPDH_TAA_len41_fa10_ta10_fm10_tm10*124*a,12976,0,2138,0,15114,0.141,124,3078@TOP@human_GAPDH_TAA_len41_fa10_ta10_fm10_tm10,a
3078@TOP@human_GAPDH_TAA_len41_fa10_ta10_fm10_tm10*125*a,14164,1,955,0,15120,0.063,125,3078@TOP@human_GAPDH_TAA_len41_fa10_ta10_fm10_tm10,a
3078@TOP@human_GAPDH_TAA_len41_fa10_ta10_fm10_tm10*126*g,5,0,15221,0,15226,1.0,126,3078@TOP@human_GAPDH_TAA_len41_fa10_ta10_fm10_tm10,g
3078@TOP@human_GAPDH_TAA_len41_fa10_ta10_fm10_tm10*127*a,15326,0,14,0,15340,0.001,127,3078@TOP@human_GAPDH_TAA_len41_fa10_ta10_fm10_tm10,a
3078@TOP@human_GAPDH_TAA_len41_fa10_ta10_fm10_tm10*128*c,2,15402,3,2,15409,0.0,128,3078@TOP@human_GAPDH_TAA_len41_fa10_ta10_fm10_tm10,c
3078@TOP@human_GAPDH_TAA_len41_fa10_ta10_fm10_tm10*129*c,0,15317,0,0,15317,0.0,129,3078@TOP@human_GAPDH_TAA_len41_fa10_ta10_fm10_tm10,c
3078@TOP@human_GAPDH_TAA_len41_fa10_ta10_fm10_tm10*130*c,0,15385,0,4,15389,0.0,130,3078@TOP@human_GAPDH_TAA_len41_fa10_ta10_fm10_tm10,c
3078@TOP@human_GAPDH_TAA_len41_fa10_ta10_fm10_tm10*131*c,5,15417,0,0,15422,0.0,131,3078@TOP@human_GAPDH_TAA_len41_fa10_ta10_fm10_tm10,c
3078@TOP@human_GAPDH_TAA_len41_fa10_ta10_fm10_tm10*132*t,0,5,4,15228,15237,0.0,132,3078@TOP@human_GAPDH_TAA_len41_fa10_ta10_fm10_tm10,t
3078@TOP@human_GAPDH_TAA_len41_fa10_ta10_fm10_tm10*133*g,1,0,15204,0,15205,1.0,133,3078@TOP@human_GAPDH_TAA_len41_fa10_ta10_fm10_tm10,g
3078@TOP@human_GAPDH_TAA_len41_fa10_ta10_fm10_tm10*134*g,0,3,15255,1,15259,1.0,134,3078@TOP@human_GAPDH_TAA_len41_fa10_ta10_fm10_tm10,g
3079@TOP@human_GAPDH_TAA_len41_fa10_ta10_fm10_tm10*114*t,0,4,0,4011,4015,0.0,114,3079@TOP@human_GAPDH_TAA_len41_fa10_ta10_fm10_tm10,t
3079@TOP@human_GAPDH_TAA_len41_fa10_ta10_fm10_tm10*115*c,0,4033,0,0,4033,0.0,115,3079@TOP@human_GAPDH_TAA_len41_fa10_ta10_fm10_tm10,c
3079@TOP@human_GAPDH_TAA_len41_fa10_ta10_fm10_tm10*116*c,0,4016,0,1,4017,0.0,116,3079@TOP@human_GAPDH_TAA_len41_fa10_ta10_fm10_tm10,c
3079@TOP@human_GAPDH_TAA_len41_fa10_ta10_fm10_tm10*117*a,3956,0,57,0,4013,0.014,117,3079@TOP@human_GAPDH_TAA_len41_fa10_ta10_fm10_tm10,a
3079@TOP@human_GAPDH_TAA_len41_fa10_ta10_fm10_tm10*118*a,3379,0,622,0,4001,0.155,118,3079@TOP@human_GAPDH_TAA_len41_fa10_ta10_fm10_tm10,a
3079@TOP@human_GAPDH_TAA_len41_fa10_ta10_fm10_tm10*119*g,0,0,3987,0,3987,1.0,119,3079@TOP@human_GAPDH_TAA_len41_fa10_ta10_fm10_tm10,g
3079@TOP@human_GAPDH_TAA_len41_fa10_ta10_fm10_tm10*120*g,1,1,3967,0,3969,0.999,120,3079@TOP@human_GAPDH_TAA_len41_fa10_ta10_fm10_tm10,g
3079@TOP@human_GAPDH_TAA_len41_fa10_ta10_fm10_tm10*121*a,4005,0,3,0,4008,0.001,121,3079@TOP@human_GAPDH_TAA_len41_fa10_ta10_fm10_tm10,a
3079@TOP@human_GAPDH_TAA_len41_fa10_ta10_fm10_tm10*122*g,2,0,4016,0,4018,1.0,122,3079@TOP@human_GAPDH_TAA_len41_fa10_ta10_fm10_tm10,g
3079@TOP@human_GAPDH_TAA_len41_fa10_ta10_fm10_tm10*123*t,1,0,2,3959,3962,0.001,123,3079@TOP@human_GAPDH_TAA_len41_fa10_ta10_fm10_tm10,t
3079@TOP@human_GAPDH_TAA_len41_fa10_ta10_fm10_tm10*124*a,3608,0,350,0,3958,0.088,124,3079@TOP@human_GAPDH_TAA_len41_fa10_ta10_fm10_tm10,a
3079@TOP@human_GAPDH_TAA_len41_fa10_ta10_fm10_tm10*125*a,3793,0,127,0,3920,0.032,125,3079@TOP@human_GAPDH_TAA_len41_fa10_ta10_fm10_tm10,a
3079@TOP@human_GAPDH_TAA_len41_fa10_ta10_fm10_tm10*126*g,7,0,3958,0,3965,0.998,126,3079@TOP@human_GAPDH_TAA_len41_fa10_ta10_fm10_tm10,g
3079@TOP@human_GAPDH_TAA_len41_fa10_ta10_fm10_tm10*127*a,3995,0,1,1,3997,0.0,127,3079@TOP@human_GAPDH_TAA_len41_fa10_ta10_fm10_tm10,a
3079@TOP@human_GAPDH_TAA_len41_fa10_ta10_fm10_tm10*128*c,0,4015,1,0,4016,0.0,128,3079@TOP@human_GAPDH_TAA_len41_fa10_ta10_fm10_tm10,c
3079@TOP@human_GAPDH_TAA_len41_fa10_ta10_fm10_tm10*129*c,0,3997,0,0,3997,0.0,129,3079@TOP@human_GAPDH_TAA_len41_fa10_ta10_fm10_tm10,c
3079@TOP@human_GAPDH_TAA_len41_fa10_ta10_fm10_tm10*130*c,0,4006,0,0,4006,0.0,130,3079@TOP@human_GAPDH_TAA_len41_fa10_ta10_fm10_tm10,c
3079@TOP@human_GAPDH_TAA_len41_fa10_ta10_fm10_tm10*131*c,1,4022,0,1,4024,0.0,131,3079@TOP@human_GAPDH_TAA_len41_fa10_ta10_fm10_tm10,c
3079@TOP@human_GAPDH_TAA_len41_fa10_ta10_fm10_tm10*132*t,0,0,0,3974,3974,0.0,132,3079@TOP@human_GAPDH_TAA_len41_fa10_ta10_fm10_tm10,t
3079@TOP@human_GAPDH_TAA_len41_fa10_ta10_fm10_tm10*133*g,0,0,3954,0,3954,1.0,133,3079@TOP@human_GAPDH_TAA_len41_fa10_ta10_fm10_tm10,g
3079@TOP@human_GAPDH_TAA_len41_fa10_ta10_fm10_tm10*134*g,0,9,3971,0,3980,0.998,134,3079@TOP@human_GAPDH_TAA_len41_fa10_ta10_fm10_tm10,g
3080@TOP@human_GAPDH_TAA_len41_fa20_ta0_fm14_tm6*114*t,1,8,0,19857,19866,0.0,114,3080@TOP@human_GAPDH_TAA_len41_fa20_ta0_fm14_tm6,t
3080@TOP@human_GAPDH_TAA_len41_fa20_ta0_fm14_tm6*115*c,0,19996,0,0,19996,0.0,115,3080@TOP@human_GAPDH_TAA_len41_fa20_ta0_fm14_tm6,c
3080@TOP@human_GAPDH_TAA_len41_fa20_ta0_fm14_tm6*116*c,0,19925,0,0,19925,0.0,116,3080@TOP@human_GAPDH_TAA_len41_fa20_ta0_fm14_tm6,c
3080@TOP@human_GAPDH_TAA_len41_fa20_ta0_fm14_tm6*117*a,19888,0,28,0,19916,0.001,117,3080@TOP@human_GAPDH_TAA_len41_fa20_ta0_fm14_tm6,a
3080@TOP@human_GAPDH_TAA_len41_fa20_ta0_fm14_tm6*118*a,19555,1,228,3,19787,0.012,118,3080@TOP@human_GAPDH_TAA_len41_fa20_ta0_fm14_tm6,a
3080@TOP@human_GAPDH_TAA_len41_fa20_ta0_fm14_tm6*119*g,4,1,19750,5,19760,0.999,119,3080@TOP@human_GAPDH_TAA_len41_fa20_ta0_fm14_tm6,g
3080@TOP@human_GAPDH_TAA_len41_fa20_ta0_fm14_tm6*120*g,1,1,19649,1,19652,1.0,120,3080@TOP@human_GAPDH_TAA_len41_fa20_ta0_fm14_tm6,g
3080@TOP@human_GAPDH_TAA_len41_fa20_ta0_fm14_tm6*121*a,19893,0,4,0,19897,0.0,121,3080@TOP@human_GAPDH_TAA_len41_fa20_ta0_fm14_tm6,a
3080@TOP@human_GAPDH_TAA_len41_fa20_ta0_fm14_tm6*122*g,0,1,19914,1,19916,1.0,122,3080@TOP@human_GAPDH_TAA_len41_fa20_ta0_fm14_tm6,g
3080@TOP@human_GAPDH_TAA_len41_fa20_ta0_fm14_tm6*123*t,3,2,2,19635,19642,0.0,123,3080@TOP@human_GAPDH_TAA_len41_fa20_ta0_fm14_tm6,t
3080@TOP@human_GAPDH_TAA_len41_fa20_ta0_fm14_tm6*124*a,18244,0,1355,0,19599,0.069,124,3080@TOP@human_GAPDH_TAA_len41_fa20_ta0_fm14_tm6,a
3080@TOP@human_GAPDH_TAA_len41_fa20_ta0_fm14_tm6*125*a,19224,0,357,0,19581,0.018,125,3080@TOP@human_GAPDH_TAA_len41_fa20_ta0_fm14_tm6,a
3080@TOP@human_GAPDH_TAA_len41_fa20_ta0_fm14_tm6*126*g,1,0,19652,0,19653,1.0,126,3080@TOP@human_GAPDH_TAA_len41_fa20_ta0_fm14_tm6,g
3080@TOP@human_GAPDH_TAA_len41_fa20_ta0_fm14_tm6*127*a,19828,1,16,0,19845,0.001,127,3080@TOP@human_GAPDH_TAA_len41_fa20_ta0_fm14_tm6,a
3080@TOP@human_GAPDH_TAA_len41_fa20_ta0_fm14_tm6*128*c,2,19958,1,0,19961,0.0,128,3080@TOP@human_GAPDH_TAA_len41_fa20_ta0_fm14_tm6,c
3080@TOP@human_GAPDH_TAA_len41_fa20_ta0_fm14_tm6*129*c,1,19806,0,0,19807,0.0,129,3080@TOP@human_GAPDH_TAA_len41_fa20_ta0_fm14_tm6,c
3080@TOP@human_GAPDH_TAA_len41_fa20_ta0_fm14_tm6*130*c,1,19916,0,1,19918,0.0,130,3080@TOP@human_GAPDH_TAA_len41_fa20_ta0_fm14_tm6,c
3080@TOP@human_GAPDH_TAA_len41_fa20_ta0_fm14_tm6*131*c,2,19972,0,2,19976,0.0,131,3080@TOP@human_GAPDH_TAA_len41_fa20_ta0_fm14_tm6,c
3080@TOP@human_GAPDH_TAA_len41_fa20_ta0_fm14_tm6*132*t,6,4,0,19666,19676,0.0,132,3080@TOP@human_GAPDH_TAA_len41_fa20_ta0_fm14_tm6,t
3080@TOP@human_GAPDH_TAA_len41_fa20_ta0_fm14_tm6*133*g,2,1,19650,0,19653,1.0,133,3080@TOP@human_GAPDH_TAA_len41_fa20_ta0_fm14_tm6,g
3080@TOP@human_GAPDH_TAA_len41_fa20_ta0_fm14_tm6*134*g,1,2,19749,1,19753,1.0,134,3080@TOP@human_GAPDH_TAA_len41_fa20_ta0_fm14_tm6,g
3081@TOP@human_GAPDH_TAA_len41_fa20_ta0_fm14_tm6*114*t,0,0,0,1364,1364,0.0,114,3081@TOP@human_GAPDH_TAA_len41_fa20_ta0_fm14_tm6,t
3081@TOP@human_GAPDH_TAA_len41_fa20_ta0_fm14_tm6*115*c,0,1370,0,0,1370,0.0,115,3081@TOP@human_GAPDH_TAA_len41_fa20_ta0_fm14_tm6,c
3081@TOP@human_GAPDH_TAA_len41_fa20_ta0_fm14_tm6*116*c,0,1369,0,0,1369,0.0,116,3081@TOP@human_GAPDH_TAA_len41_fa20_ta0_fm14_tm6,c
3081@TOP@human_GAPDH_TAA_len41_fa20_ta0_fm14_tm6*117*a,1364,0,0,0,1364,0.0,117,3081@TOP@human_GAPDH_TAA_len41_fa20_ta0_fm14_tm6,a
3081@TOP@human_GAPDH_TAA_len41_fa20_ta0_fm14_tm6*118*a,1325,0,28,0,1353,0.021,118,3081@TOP@human_GAPDH_TAA_len41_fa20_ta0_fm14_tm6,a
3081@TOP@human_GAPDH_TAA_len41_fa20_ta0_fm14_tm6*119*g,0,0,1360,0,1360,1.0,119,3081@TOP@human_GAPDH_TAA_len41_fa20_ta0_fm14_tm6,g
3081@TOP@human_GAPDH_TAA_len41_fa20_ta0_fm14_tm6*120*g,0,0,1346,0,1346,1.0,120,3081@TOP@human_GAPDH_TAA_len41_fa20_ta0_fm14_tm6,g
3081@TOP@human_GAPDH_TAA_len41_fa20_ta0_fm14_tm6*121*a,1357,0,0,0,1357,0.0,121,3081@TOP@human_GAPDH_TAA_len41_fa20_ta0_fm14_tm6,a
3081@TOP@human_GAPDH_TAA_len41_fa20_ta0_fm14_tm6*122*g,0,0,1365,0,1365,1.0,122,3081@TOP@human_GAPDH_TAA_len41_fa20_ta0_fm14_tm6,g
3081@TOP@human_GAPDH_TAA_len41_fa20_ta0_fm14_tm6*123*t,1,0,0,1342,1343,0.0,123,3081@TOP@human_GAPDH_TAA_len41_fa20_ta0_fm14_tm6,t
3081@TOP@human_GAPDH_TAA_len41_fa20_ta0_fm14_tm6*124*a,1265,0,76,0,1341,0.057,124,3081@TOP@human_GAPDH_TAA_len41_fa20_ta0_fm14_tm6,a
3081@TOP@human_GAPDH_TAA_len41_fa20_ta0_fm14_tm6*125*a,1307,0,31,0,1338,0.023,125,3081@TOP@human_GAPDH_TAA_len41_fa20_ta0_fm14_tm6,a
3081@TOP@human_GAPDH_TAA_len41_fa20_ta0_fm14_tm6*126*g,0,0,1350,0,1350,1.0,126,3081@TOP@human_GAPDH_TAA_len41_fa20_ta0_fm14_tm6,g
3081@TOP@human_GAPDH_TAA_len41_fa20_ta0_fm14_tm6*127*a,1357,0,1,0,1358,0.001,127,3081@TOP@human_GAPDH_TAA_len41_fa20_ta0_fm14_tm6,a
3081@TOP@human_GAPDH_TAA_len41_fa20_ta0_fm14_tm6*128*c,0,1361,2,0,1363,0.001,128,3081@TOP@human_GAPDH_TAA_len41_fa20_ta0_fm14_tm6,c
3081@TOP@human_GAPDH_TAA_len41_fa20_ta0_fm14_tm6*129*c,0,1354,0,0,1354,0.0,129,3081@TOP@human_GAPDH_TAA_len41_fa20_ta0_fm14_tm6,c
3081@TOP@human_GAPDH_TAA_len41_fa20_ta0_fm14_tm6*130*c,0,1365,0,0,1365,0.0,130,3081@TOP@human_GAPDH_TAA_len41_fa20_ta0_fm14_tm6,c
3081@TOP@human_GAPDH_TAA_len41_fa20_ta0_fm14_tm6*131*c,1,1364,0,0,1365,0.0,131,3081@TOP@human_GAPDH_TAA_len41_fa20_ta0_fm14_tm6,c
3081@TOP@human_GAPDH_TAA_len41_fa20_ta0_fm14_tm6*132*t,1,0,0,1349,1350,0.0,132,3081@TOP@human_GAPDH_TAA_len41_fa20_ta0_fm14_tm6,t
3081@TOP@human_GAPDH_TAA_len41_fa20_ta0_fm14_tm6*133*g,0,0,1333,0,1333,1.0,133,3081@TOP@human_GAPDH_TAA_len41_fa20_ta0_fm14_tm6,g
3081@TOP@human_GAPDH_TAA_len41_fa20_ta0_fm14_tm6*134*g,0,1,1355,0,1356,0.999,134,3081@TOP@human_GAPDH_TAA_len41_fa20_ta0_fm14_tm6,g
3082@TOP@human_GAPDH_TAA_len41_fa20_ta0_fm14_tm6*114*t,0,0,0,1399,1399,0.0,114,3082@TOP@human_GAPDH_TAA_len41_fa20_ta0_fm14_tm6,t
3082@TOP@human_GAPDH_TAA_len41_fa20_ta0_fm14_tm6*115*c,0,1406,0,0,1406,0.0,115,3082@TOP@human_GAPDH_TAA_len41_fa20_ta0_fm14_tm6,c
3082@TOP@human_GAPDH_TAA_len41_fa20_ta0_fm14_tm6*116*c,0,1395,0,1,1396,0.0,116,3082@TOP@human_GAPDH_TAA_len41_fa20_ta0_fm14_tm6,c
3082@TOP@human_GAPDH_TAA_len41_fa20_ta0_fm14_tm6*117*a,1394,0,4,0,1398,0.003,117,3082@TOP@human_GAPDH_TAA_len41_fa20_ta0_fm14_tm6,a
3082@TOP@human_GAPDH_TAA_len41_fa20_ta0_fm14_tm6*118*a,1348,0,41,0,1389,0.03,118,3082@TOP@human_GAPDH_TAA_len41_fa20_ta0_fm14_tm6,a
3082@TOP@human_GAPDH_TAA_len41_fa20_ta0_fm14_tm6*119*g,0,0,1395,0,1395,1.0,119,3082@TOP@human_GAPDH_TAA_len41_fa20_ta0_fm14_tm6,g
3082@TOP@human_GAPDH_TAA_len41_fa20_ta0_fm14_tm6*120*g,0,0,1390,1,1391,0.999,120,3082@TOP@human_GAPDH_TAA_len41_fa20_ta0_fm14_tm6,g
3082@TOP@human_GAPDH_TAA_len41_fa20_ta0_fm14_tm6*121*a,1396,0,0,0,1396,0.0,121,3082@TOP@human_GAPDH_TAA_len41_fa20_ta0_fm14_tm6,a
3082@TOP@human_GAPDH_TAA_len41_fa20_ta0_fm14_tm6*122*g,0,0,1400,0,1400,1.0,122,3082@TOP@human_GAPDH_TAA_len41_fa20_ta0_fm14_tm6,g
3082@TOP@human_GAPDH_TAA_len41_fa20_ta0_fm14_tm6*123*t,0,0,0,1383,1383,0.0,123,3082@TOP@human_GAPDH_TAA_len41_fa20_ta0_fm14_tm6,t
3082@TOP@human_GAPDH_TAA_len41_fa20_ta0_fm14_tm6*124*a,1325,0,51,0,1376,0.037,124,3082@TOP@human_GAPDH_TAA_len41_fa20_ta0_fm14_tm6,a
3082@TOP@human_GAPDH_TAA_len41_fa20_ta0_fm14_tm6*125*a,1352,2,27,0,1381,0.02,125,3082@TOP@human_GAPDH_TAA_len41_fa20_ta0_fm14_tm6,a
3082@TOP@human_GAPDH_TAA_len41_fa20_ta0_fm14_tm6*126*g,0,0,1377,0,1377,1.0,126,3082@TOP@human_GAPDH_TAA_len41_fa20_ta0_fm14_tm6,g
3082@TOP@human_GAPDH_TAA_len41_fa20_ta0_fm14_tm6*127*a,1393,0,1,0,1394,0.001,127,3082@TOP@human_GAPDH_TAA_len41_fa20_ta0_fm14_tm6,a
3082@TOP@human_GAPDH_TAA_len41_fa20_ta0_fm14_tm6*128*c,0,1403,0,0,1403,0.0,128,3082@TOP@human_GAPDH_TAA_len41_fa20_ta0_fm14_tm6,c
3082@TOP@human_GAPDH_TAA_len41_fa20_ta0_fm14_tm6*129*c,0,1392,0,0,1392,0.0,129,3082@TOP@human_GAPDH_TAA_len41_fa20_ta0_fm14_tm6,c
3082@TOP@human_GAPDH_TAA_len41_fa20_ta0_fm14_tm6*130*c,0,1402,0,0,1402,0.0,130,3082@TOP@human_GAPDH_TAA_len41_fa20_ta0_fm14_tm6,c
3082@TOP@human_GAPDH_TAA_len41_fa20_ta0_fm14_tm6*131*c,0,1403,0,0,1403,0.0,131,3082@TOP@human_GAPDH_TAA_len41_fa20_ta0_fm14_tm6,c
3082@TOP@human_GAPDH_TAA_len41_fa20_ta0_fm14_tm6*132*t,0,0,0,1387,1387,0.0,132,3082@TOP@human_GAPDH_TAA_len41_fa20_ta0_fm14_tm6,t
3082@TOP@human_GAPDH_TAA_len41_fa20_ta0_fm14_tm6*133*g,0,0,1385,0,1385,1.0,133,3082@TOP@human_GAPDH_TAA_len41_fa20_ta0_fm14_tm6,g
3082@TOP@human_GAPDH_TAA_len41_fa20_ta0_fm14_tm6*134*g,0,1,1390,0,1391,0.999,134,3082@TOP@human_GAPDH_TAA_len41_fa20_ta0_fm14_tm6,g
3083@TOP@human_GAPDH_TAA_len41_fa20_ta0_fm14_tm6*114*t,0,0,0,962,962,0.0,114,3083@TOP@human_GAPDH_TAA_len41_fa20_ta0_fm14_tm6,t
3083@TOP@human_GAPDH_TAA_len41_fa20_ta0_fm14_tm6*115*c,0,969,0,0,969,0.0,115,3083@TOP@human_GAPDH_TAA_len41_fa20_ta0_fm14_tm6,c
3083@TOP@human_GAPDH_TAA_len41_fa20_ta0_fm14_tm6*116*c,0,961,0,0,961,0.0,116,3083@TOP@human_GAPDH_TAA_len41_fa20_ta0_fm14_tm6,c
3083@TOP@human_GAPDH_TAA_len41_fa20_ta0_fm14_tm6*117*a,962,0,1,0,963,0.001,117,3083@TOP@human_GAPDH_TAA_len41_fa20_ta0_fm14_tm6,a
3083@TOP@human_GAPDH_TAA_len41_fa20_ta0_fm14_tm6*118*a,936,0,22,0,958,0.023,118,3083@TOP@human_GAPDH_TAA_len41_fa20_ta0_fm14_tm6,a
3083@TOP@human_GAPDH_TAA_len41_fa20_ta0_fm14_tm6*119*g,0,0,944,0,944,1.0,119,3083@TOP@human_GAPDH_TAA_len41_fa20_ta0_fm14_tm6,g
3083@TOP@human_GAPDH_TAA_len41_fa20_ta0_fm14_tm6*120*g,0,0,946,0,946,1.0,120,3083@TOP@human_GAPDH_TAA_len41_fa20_ta0_fm14_tm6,g
3083@TOP@human_GAPDH_TAA_len41_fa20_ta0_fm14_tm6*121*a,963,0,1,0,964,0.001,121,3083@TOP@human_GAPDH_TAA_len41_fa20_ta0_fm14_tm6,a
3083@TOP@human_GAPDH_TAA_len41_fa20_ta0_fm14_tm6*122*g,0,0,964,0,964,1.0,122,3083@TOP@human_GAPDH_TAA_len41_fa20_ta0_fm14_tm6,g
3083@TOP@human_GAPDH_TAA_len41_fa20_ta0_fm14_tm6*123*t,0,0,0,953,953,0.0,123,3083@TOP@human_GAPDH_TAA_len41_fa20_ta0_fm14_tm6,t
3083@TOP@human_GAPDH_TAA_len41_fa20_ta0_fm14_tm6*124*a,898,0,43,0,941,0.046,124,3083@TOP@human_GAPDH_TAA_len41_fa20_ta0_fm14_tm6,a
3083@TOP@human_GAPDH_TAA_len41_fa20_ta0_fm14_tm6*125*a,926,0,20,0,946,0.021,125,3083@TOP@human_GAPDH_TAA_len41_fa20_ta0_fm14_tm6,a
3083@TOP@human_GAPDH_TAA_len41_fa20_ta0_fm14_tm6*126*g,0,0,949,0,949,1.0,126,3083@TOP@human_GAPDH_TAA_len41_fa20_ta0_fm14_tm6,g
3083@TOP@human_GAPDH_TAA_len41_fa20_ta0_fm14_tm6*127*a,956,0,0,0,956,0.0,127,3083@TOP@human_GAPDH_TAA_len41_fa20_ta0_fm14_tm6,a
3083@TOP@human_GAPDH_TAA_len41_fa20_ta0_fm14_tm6*128*c,0,962,1,0,963,0.001,128,3083@TOP@human_GAPDH_TAA_len41_fa20_ta0_fm14_tm6,c
3083@TOP@human_GAPDH_TAA_len41_fa20_ta0_fm14_tm6*129*c,0,960,0,0,960,0.0,129,3083@TOP@human_GAPDH_TAA_len41_fa20_ta0_fm14_tm6,c
3083@TOP@human_GAPDH_TAA_len41_fa20_ta0_fm14_tm6*130*c,0,961,0,0,961,0.0,130,3083@TOP@human_GAPDH_TAA_len41_fa20_ta0_fm14_tm6,c
3083@TOP@human_GAPDH_TAA_len41_fa20_ta0_fm14_tm6*131*c,0,968,0,0,968,0.0,131,3083@TOP@human_GAPDH_TAA_len41_fa20_ta0_fm14_tm6,c
3083@TOP@human_GAPDH_TAA_len41_fa20_ta0_fm14_tm6*132*t,0,0,0,952,952,0.0,132,3083@TOP@human_GAPDH_TAA_len41_fa20_ta0_fm14_tm6,t
3083@TOP@human_GAPDH_TAA_len41_fa20_ta0_fm14_tm6*133*g,1,0,947,0,948,0.999,133,3083@TOP@human_GAPDH_TAA_len41_fa20_ta0_fm14_tm6,g
3083@TOP@human_GAPDH_TAA_len41_fa20_ta0_fm14_tm6*134*g,0,1,945,0,946,0.999,134,3083@TOP@human_GAPDH_TAA_len41_fa20_ta0_fm14_tm6,g
3084@TOP@human_GAPDH_TAA_len41_fa20_ta0_fm14_tm6*114*t,0,0,0,795,795,0.0,114,3084@TOP@human_GAPDH_TAA_len41_fa20_ta0_fm14_tm6,t
3084@TOP@human_GAPDH_TAA_len41_fa20_ta0_fm14_tm6*115*c,0,799,0,0,799,0.0,115,3084@TOP@human_GAPDH_TAA_len41_fa20_ta0_fm14_tm6,c
3084@TOP@human_GAPDH_TAA_len41_fa20_ta0_fm14_tm6*116*c,0,799,0,0,799,0.0,116,3084@TOP@human_GAPDH_TAA_len41_fa20_ta0_fm14_tm6,c
3084@TOP@human_GAPDH_TAA_len41_fa20_ta0_fm14_tm6*117*a,792,0,4,0,796,0.005,117,3084@TOP@human_GAPDH_TAA_len41_fa20_ta0_fm14_tm6,a
3084@TOP@human_GAPDH_TAA_len41_fa20_ta0_fm14_tm6*118*a,779,0,14,0,793,0.018,118,3084@TOP@human_GAPDH_TAA_len41_fa20_ta0_fm14_tm6,a
3084@TOP@human_GAPDH_TAA_len41_fa20_ta0_fm14_tm6*119*g,0,0,793,0,793,1.0,119,3084@TOP@human_GAPDH_TAA_len41_fa20_ta0_fm14_tm6,g
3084@TOP@human_GAPDH_TAA_len41_fa20_ta0_fm14_tm6*120*g,1,0,788,0,789,0.999,120,3084@TOP@human_GAPDH_TAA_len41_fa20_ta0_fm14_tm6,g
3084@TOP@human_GAPDH_TAA_len41_fa20_ta0_fm14_tm6*121*a,797,0,0,0,797,0.0,121,3084@TOP@human_GAPDH_TAA_len41_fa20_ta0_fm14_tm6,a
3084@TOP@human_GAPDH_TAA_len41_fa20_ta0_fm14_tm6*122*g,0,0,797,0,797,1.0,122,3084@TOP@human_GAPDH_TAA_len41_fa20_ta0_fm14_tm6,g
3084@TOP@human_GAPDH_TAA_len41_fa20_ta0_fm14_tm6*123*t,0,0,0,779,779,0.0,123,3084@TOP@human_GAPDH_TAA_len41_fa20_ta0_fm14_tm6,t
3084@TOP@human_GAPDH_TAA_len41_fa20_ta0_fm14_tm6*124*a,726,0,49,0,775,0.063,124,3084@TOP@human_GAPDH_TAA_len41_fa20_ta0_fm14_tm6,a
3084@TOP@human_GAPDH_TAA_len41_fa20_ta0_fm14_tm6*125*a,757,0,30,0,787,0.038,125,3084@TOP@human_GAPDH_TAA_len41_fa20_ta0_fm14_tm6,a
3084@TOP@human_GAPDH_TAA_len41_fa20_ta0_fm14_tm6*126*g,0,0,786,0,786,1.0,126,3084@TOP@human_GAPDH_TAA_len41_fa20_ta0_fm14_tm6,g
3084@TOP@human_GAPDH_TAA_len41_fa20_ta0_fm14_tm6*127*a,791,0,1,0,792,0.001,127,3084@TOP@human_GAPDH_TAA_len41_fa20_ta0_fm14_tm6,a
3084@TOP@human_GAPDH_TAA_len41_fa20_ta0_fm14_tm6*128*c,0,797,0,0,797,0.0,128,3084@TOP@human_GAPDH_TAA_len41_fa20_ta0_fm14_tm6,c
3084@TOP@human_GAPDH_TAA_len41_fa20_ta0_fm14_tm6*129*c,0,793,0,0,793,0.0,129,3084@TOP@human_GAPDH_TAA_len41_fa20_ta0_fm14_tm6,c
3084@TOP@human_GAPDH_TAA_len41_fa20_ta0_fm14_tm6*130*c,0,795,0,0,795,0.0,130,3084@TOP@human_GAPDH_TAA_len41_fa20_ta0_fm14_tm6,c
3084@TOP@human_GAPDH_TAA_len41_fa20_ta0_fm14_tm6*131*c,0,796,0,3,799,0.0,131,3084@TOP@human_GAPDH_TAA_len41_fa20_ta0_fm14_tm6,c
3084@TOP@human_GAPDH_TAA_len41_fa20_ta0_fm14_tm6*132*t,0,0,0,792,792,0.0,132,3084@TOP@human_GAPDH_TAA_len41_fa20_ta0_fm14_tm6,t
3084@TOP@human_GAPDH_TAA_len41_fa20_ta0_fm14_tm6*133*g,0,0,781,0,781,1.0,133,3084@TOP@human_GAPDH_TAA_len41_fa20_ta0_fm14_tm6,g
3084@TOP@human_GAPDH_TAA_len41_fa20_ta0_fm14_tm6*134*g,0,0,791,0,791,1.0,134,3084@TOP@human_GAPDH_TAA_len41_fa20_ta0_fm14_tm6,g
3085@TOP@human_GAPDH_TAA_len41_fa20_ta0_fm14_tm6*114*t,0,4,0,2194,2198,0.0,114,3085@TOP@human_GAPDH_TAA_len41_fa20_ta0_fm14_tm6,t
3085@TOP@human_GAPDH_TAA_len41_fa20_ta0_fm14_tm6*115*c,0,2209,0,0,2209,0.0,115,3085@TOP@human_GAPDH_TAA_len41_fa20_ta0_fm14_tm6,c
3085@TOP@human_GAPDH_TAA_len41_fa20_ta0_fm14_tm6*116*c,1,2195,0,0,2196,0.0,116,3085@TOP@human_GAPDH_TAA_len41_fa20_ta0_fm14_tm6,c
3085@TOP@human_GAPDH_TAA_len41_fa20_ta0_fm14_tm6*117*a,2198,0,6,0,2204,0.003,117,3085@TOP@human_GAPDH_TAA_len41_fa20_ta0_fm14_tm6,a
3085@TOP@human_GAPDH_TAA_len41_fa20_ta0_fm14_tm6*118*a,2142,0,46,0,2188,0.021,118,3085@TOP@human_GAPDH_TAA_len41_fa20_ta0_fm14_tm6,a
3085@TOP@human_GAPDH_TAA_len41_fa20_ta0_fm14_tm6*119*g,0,0,2180,0,2180,1.0,119,3085@TOP@human_GAPDH_TAA_len41_fa20_ta0_fm14_tm6,g
3085@TOP@human_GAPDH_TAA_len41_fa20_ta0_fm14_tm6*120*g,0,0,2179,0,2179,1.0,120,3085@TOP@human_GAPDH_TAA_len41_fa20_ta0_fm14_tm6,g
3085@TOP@human_GAPDH_TAA_len41_fa20_ta0_fm14_tm6*121*a,2200,0,2,0,2202,0.001,121,3085@TOP@human_GAPDH_TAA_len41_fa20_ta0_fm14_tm6,a
3085@TOP@human_GAPDH_TAA_len41_fa20_ta0_fm14_tm6*122*g,0,0,2200,0,2200,1.0,122,3085@TOP@human_GAPDH_TAA_len41_fa20_ta0_fm14_tm6,g
3085@TOP@human_GAPDH_TAA_len41_fa20_ta0_fm14_tm6*123*t,0,0,0,2167,2167,0.0,123,3085@TOP@human_GAPDH_TAA_len41_fa20_ta0_fm14_tm6,t
3085@TOP@human_GAPDH_TAA_len41_fa20_ta0_fm14_tm6*124*a,2019,0,147,0,2166,0.068,124,3085@TOP@human_GAPDH_TAA_len41_fa20_ta0_fm14_tm6,a
3085@TOP@human_GAPDH_TAA_len41_fa20_ta0_fm14_tm6*125*a,2102,0,66,0,2168,0.03,125,3085@TOP@human_GAPDH_TAA_len41_fa20_ta0_fm14_tm6,a
3085@TOP@human_GAPDH_TAA_len41_fa20_ta0_fm14_tm6*126*g,0,0,2174,0,2174,1.0,126,3085@TOP@human_GAPDH_TAA_len41_fa20_ta0_fm14_tm6,g
3085@TOP@human_GAPDH_TAA_len41_fa20_ta0_fm14_tm6*127*a,2186,0,2,0,2188,0.001,127,3085@TOP@human_GAPDH_TAA_len41_fa20_ta0_fm14_tm6,a
3085@TOP@human_GAPDH_TAA_len41_fa20_ta0_fm14_tm6*128*c,0,2205,0,0,2205,0.0,128,3085@TOP@human_GAPDH_TAA_len41_fa20_ta0_fm14_tm6,c
3085@TOP@human_GAPDH_TAA_len41_fa20_ta0_fm14_tm6*129*c,0,2174,0,0,2174,0.0,129,3085@TOP@human_GAPDH_TAA_len41_fa20_ta0_fm14_tm6,c
3085@TOP@human_GAPDH_TAA_len41_fa20_ta0_fm14_tm6*130*c,0,2200,0,0,2200,0.0,130,3085@TOP@human_GAPDH_TAA_len41_fa20_ta0_fm14_tm6,c
3085@TOP@human_GAPDH_TAA_len41_fa20_ta0_fm14_tm6*131*c,2,2203,0,0,2205,0.0,131,3085@TOP@human_GAPDH_TAA_len41_fa20_ta0_fm14_tm6,c
3085@TOP@human_GAPDH_TAA_len41_fa20_ta0_fm14_tm6*132*t,0,0,0,2163,2163,0.0,132,3085@TOP@human_GAPDH_TAA_len41_fa20_ta0_fm14_tm6,t
3085@TOP@human_GAPDH_TAA_len41_fa20_ta0_fm14_tm6*133*g,0,0,2170,0,2170,1.0,133,3085@TOP@human_GAPDH_TAA_len41_fa20_ta0_fm14_tm6,g
3085@TOP@human_GAPDH_TAA_len41_fa20_ta0_fm14_tm6*134*g,0,0,2182,0,2182,1.0,134,3085@TOP@human_GAPDH_TAA_len41_fa20_ta0_fm14_tm6,g
3086@TOP@human_GAPDH_TAA_len41_fa20_ta0_fm14_tm6*114*t,0,0,0,1679,1679,0.0,114,3086@TOP@human_GAPDH_TAA_len41_fa20_ta0_fm14_tm6,t
3086@TOP@human_GAPDH_TAA_len41_fa20_ta0_fm14_tm6*115*c,0,1689,0,0,1689,0.0,115,3086@TOP@human_GAPDH_TAA_len41_fa20_ta0_fm14_tm6,c
3086@TOP@human_GAPDH_TAA_len41_fa20_ta0_fm14_tm6*116*c,0,1683,0,0,1683,0.0,116,3086@TOP@human_GAPDH_TAA_len41_fa20_ta0_fm14_tm6,c
3086@TOP@human_GAPDH_TAA_len41_fa20_ta0_fm14_tm6*117*a,1680,0,1,0,1681,0.001,117,3086@TOP@human_GAPDH_TAA_len41_fa20_ta0_fm14_tm6,a
3086@TOP@human_GAPDH_TAA_len41_fa20_ta0_fm14_tm6*118*a,1658,0,18,0,1676,0.011,118,3086@TOP@human_GAPDH_TAA_len41_fa20_ta0_fm14_tm6,a
3086@TOP@human_GAPDH_TAA_len41_fa20_ta0_fm14_tm6*119*g,0,0,1672,0,1672,1.0,119,3086@TOP@human_GAPDH_TAA_len41_fa20_ta0_fm14_tm6,g
3086@TOP@human_GAPDH_TAA_len41_fa20_ta0_fm14_tm6*120*g,0,0,1653,0,1653,1.0,120,3086@TOP@human_GAPDH_TAA_len41_fa20_ta0_fm14_tm6,g
3086@TOP@human_GAPDH_TAA_len41_fa20_ta0_fm14_tm6*121*a,1680,0,1,0,1681,0.001,121,3086@TOP@human_GAPDH_TAA_len41_fa20_ta0_fm14_tm6,a
3086@TOP@human_GAPDH_TAA_len41_fa20_ta0_fm14_tm6*122*g,0,0,1678,0,1678,1.0,122,3086@TOP@human_GAPDH_TAA_len41_fa20_ta0_fm14_tm6,g
3086@TOP@human_GAPDH_TAA_len41_fa20_ta0_fm14_tm6*123*t,0,1,0,1669,1670,0.0,123,3086@TOP@human_GAPDH_TAA_len41_fa20_ta0_fm14_tm6,t
3086@TOP@human_GAPDH_TAA_len41_fa20_ta0_fm14_tm6*124*a,1601,0,54,0,1655,0.033,124,3086@TOP@human_GAPDH_TAA_len41_fa20_ta0_fm14_tm6,a
3086@TOP@human_GAPDH_TAA_len41_fa20_ta0_fm14_tm6*125*a,1633,0,34,0,1667,0.02,125,3086@TOP@human_GAPDH_TAA_len41_fa20_ta0_fm14_tm6,a
3086@TOP@human_GAPDH_TAA_len41_fa20_ta0_fm14_tm6*126*g,0,0,1658,0,1658,1.0,126,3086@TOP@human_GAPDH_TAA_len41_fa20_ta0_fm14_tm6,g
3086@TOP@human_GAPDH_TAA_len41_fa20_ta0_fm14_tm6*127*a,1674,0,2,0,1676,0.001,127,3086@TOP@human_GAPDH_TAA_len41_fa20_ta0_fm14_tm6,a
3086@TOP@human_GAPDH_TAA_len41_fa20_ta0_fm14_tm6*128*c,0,1686,0,0,1686,0.0,128,3086@TOP@human_GAPDH_TAA_len41_fa20_ta0_fm14_tm6,c
3086@TOP@human_GAPDH_TAA_len41_fa20_ta0_fm14_tm6*129*c,0,1667,0,0,1667,0.0,129,3086@TOP@human_GAPDH_TAA_len41_fa20_ta0_fm14_tm6,c
3086@TOP@human_GAPDH_TAA_len41_fa20_ta0_fm14_tm6*130*c,0,1680,0,0,1680,0.0,130,3086@TOP@human_GAPDH_TAA_len41_fa20_ta0_fm14_tm6,c
3086@TOP@human_GAPDH_TAA_len41_fa20_ta0_fm14_tm6*131*c,0,1687,0,0,1687,0.0,131,3086@TOP@human_GAPDH_TAA_len41_fa20_ta0_fm14_tm6,c
3086@TOP@human_GAPDH_TAA_len41_fa20_ta0_fm14_tm6*132*t,0,0,0,1663,1663,0.0,132,3086@TOP@human_GAPDH_TAA_len41_fa20_ta0_fm14_tm6,t
3086@TOP@human_GAPDH_TAA_len41_fa20_ta0_fm14_tm6*133*g,0,0,1655,0,1655,1.0,133,3086@TOP@human_GAPDH_TAA_len41_fa20_ta0_fm14_tm6,g
3086@TOP@human_GAPDH_TAA_len41_fa20_ta0_fm14_tm6*134*g,0,1,1660,0,1661,0.999,134,3086@TOP@human_GAPDH_TAA_len41_fa20_ta0_fm14_tm6,g
3087@TOP@human_GAPDH_TAA_len41_fa20_ta0_fm14_tm6*114*t,0,0,0,2325,2325,0.0,114,3087@TOP@human_GAPDH_TAA_len41_fa20_ta0_fm14_tm6,t
3087@TOP@human_GAPDH_TAA_len41_fa20_ta0_fm14_tm6*115*c,0,2338,0,0,2338,0.0,115,3087@TOP@human_GAPDH_TAA_len41_fa20_ta0_fm14_tm6,c
3087@TOP@human_GAPDH_TAA_len41_fa20_ta0_fm14_tm6*116*c,0,2319,0,0,2319,0.0,116,3087@TOP@human_GAPDH_TAA_len41_fa20_ta0_fm14_tm6,c
3087@TOP@human_GAPDH_TAA_len41_fa20_ta0_fm14_tm6*117*a,2321,0,5,0,2326,0.002,117,3087@TOP@human_GAPDH_TAA_len41_fa20_ta0_fm14_tm6,a
3087@TOP@human_GAPDH_TAA_len41_fa20_ta0_fm14_tm6*118*a,2270,0,39,0,2309,0.017,118,3087@TOP@human_GAPDH_TAA_len41_fa20_ta0_fm14_tm6,a
3087@TOP@human_GAPDH_TAA_len41_fa20_ta0_fm14_tm6*119*g,0,0,2301,1,2302,1.0,119,3087@TOP@human_GAPDH_TAA_len41_fa20_ta0_fm14_tm6,g
3087@TOP@human_GAPDH_TAA_len41_fa20_ta0_fm14_tm6*120*g,0,0,2288,0,2288,1.0,120,3087@TOP@human_GAPDH_TAA_len41_fa20_ta0_fm14_tm6,g
3087@TOP@human_GAPDH_TAA_len41_fa20_ta0_fm14_tm6*121*a,2322,0,0,1,2323,0.0,121,3087@TOP@human_GAPDH_TAA_len41_fa20_ta0_fm14_tm6,a
3087@TOP@human_GAPDH_TAA_len41_fa20_ta0_fm14_tm6*122*g,0,0,2329,0,2329,1.0,122,3087@TOP@human_GAPDH_TAA_len41_fa20_ta0_fm14_tm6,g
3087@TOP@human_GAPDH_TAA_len41_fa20_ta0_fm14_tm6*123*t,0,1,0,2307,2308,0.0,123,3087@TOP@human_GAPDH_TAA_len41_fa20_ta0_fm14_tm6,t
3087@TOP@human_GAPDH_TAA_len41_fa20_ta0_fm14_tm6*124*a,2202,0,94,0,2296,0.041,124,3087@TOP@human_GAPDH_TAA_len41_fa20_ta0_fm14_tm6,a
3087@TOP@human_GAPDH_TAA_len41_fa20_ta0_fm14_tm6*125*a,2221,0,70,0,2291,0.031,125,3087@TOP@human_GAPDH_TAA_len41_fa20_ta0_fm14_tm6,a
3087@TOP@human_GAPDH_TAA_len41_fa20_ta0_fm14_tm6*126*g,0,0,2292,0,2292,1.0,126,3087@TOP@human_GAPDH_TAA_len41_fa20_ta0_fm14_tm6,g
3087@TOP@human_GAPDH_TAA_len41_fa20_ta0_fm14_tm6*127*a,2318,0,1,0,2319,0.0,127,3087@TOP@human_GAPDH_TAA_len41_fa20_ta0_fm14_tm6,a
3087@TOP@human_GAPDH_TAA_len41_fa20_ta0_fm14_tm6*128*c,0,2330,0,0,2330,0.0,128,3087@TOP@human_GAPDH_TAA_len41_fa20_ta0_fm14_tm6,c
3087@TOP@human_GAPDH_TAA_len41_fa20_ta0_fm14_tm6*129*c,1,2310,0,0,2311,0.0,129,3087@TOP@human_GAPDH_TAA_len41_fa20_ta0_fm14_tm6,c
3087@TOP@human_GAPDH_TAA_len41_fa20_ta0_fm14_tm6*130*c,4,2321,0,0,2325,0.0,130,3087@TOP@human_GAPDH_TAA_len41_fa20_ta0_fm14_tm6,c
3087@TOP@human_GAPDH_TAA_len41_fa20_ta0_fm14_tm6*131*c,0,2329,0,0,2329,0.0,131,3087@TOP@human_GAPDH_TAA_len41_fa20_ta0_fm14_tm6,c
3087@TOP@human_GAPDH_TAA_len41_fa20_ta0_fm14_tm6*132*t,0,0,0,2302,2302,0.0,132,3087@TOP@human_GAPDH_TAA_len41_fa20_ta0_fm14_tm6,t
3087@TOP@human_GAPDH_TAA_len41_fa20_ta0_fm14_tm6*133*g,0,0,2285,0,2285,1.0,133,3087@TOP@human_GAPDH_TAA_len41_fa20_ta0_fm14_tm6,g
3087@TOP@human_GAPDH_TAA_len41_fa20_ta0_fm14_tm6*134*g,0,2,2288,0,2290,0.999,134,3087@TOP@human_GAPDH_TAA_len41_fa20_ta0_fm14_tm6,g
3088@TOP@human_GAPDH_TAA_len41_fa20_ta0_fm14_tm6*114*t,0,0,0,3319,3319,0.0,114,3088@TOP@human_GAPDH_TAA_len41_fa20_ta0_fm14_tm6,t
3088@TOP@human_GAPDH_TAA_len41_fa20_ta0_fm14_tm6*115*c,0,3331,0,0,3331,0.0,115,3088@TOP@human_GAPDH_TAA_len41_fa20_ta0_fm14_tm6,c
3088@TOP@human_GAPDH_TAA_len41_fa20_ta0_fm14_tm6*116*c,0,3317,0,0,3317,0.0,116,3088@TOP@human_GAPDH_TAA_len41_fa20_ta0_fm14_tm6,c
3088@TOP@human_GAPDH_TAA_len41_fa20_ta0_fm14_tm6*117*a,3311,0,4,0,3315,0.001,117,3088@TOP@human_GAPDH_TAA_len41_fa20_ta0_fm14_tm6,a
3088@TOP@human_GAPDH_TAA_len41_fa20_ta0_fm14_tm6*118*a,3242,0,51,0,3293,0.015,118,3088@TOP@human_GAPDH_TAA_len41_fa20_ta0_fm14_tm6,a
3088@TOP@human_GAPDH_TAA_len41_fa20_ta0_fm14_tm6*119*g,0,0,3293,0,3293,1.0,119,3088@TOP@human_GAPDH_TAA_len41_fa20_ta0_fm14_tm6,g
3088@TOP@human_GAPDH_TAA_len41_fa20_ta0_fm14_tm6*120*g,0,0,3272,0,3272,1.0,120,3088@TOP@human_GAPDH_TAA_len41_fa20_ta0_fm14_tm6,g
3088@TOP@human_GAPDH_TAA_len41_fa20_ta0_fm14_tm6*121*a,3310,0,0,0,3310,0.0,121,3088@TOP@human_GAPDH_TAA_len41_fa20_ta0_fm14_tm6,a
3088@TOP@human_GAPDH_TAA_len41_fa20_ta0_fm14_tm6*122*g,0,0,3315,0,3315,1.0,122,3088@TOP@human_GAPDH_TAA_len41_fa20_ta0_fm14_tm6,g
3088@TOP@human_GAPDH_TAA_len41_fa20_ta0_fm14_tm6*123*t,0,0,1,3286,3287,0.0,123,3088@TOP@human_GAPDH_TAA_len41_fa20_ta0_fm14_tm6,t
3088@TOP@human_GAPDH_TAA_len41_fa20_ta0_fm14_tm6*124*a,3104,0,160,0,3264,0.049,124,3088@TOP@human_GAPDH_TAA_len41_fa20_ta0_fm14_tm6,a
3088@TOP@human_GAPDH_TAA_len41_fa20_ta0_fm14_tm6*125*a,3202,0,56,0,3258,0.017,125,3088@TOP@human_GAPDH_TAA_len41_fa20_ta0_fm14_tm6,a
3088@TOP@human_GAPDH_TAA_len41_fa20_ta0_fm14_tm6*126*g,0,0,3271,0,3271,1.0,126,3088@TOP@human_GAPDH_TAA_len41_fa20_ta0_fm14_tm6,g
3088@TOP@human_GAPDH_TAA_len41_fa20_ta0_fm14_tm6*127*a,3312,0,2,0,3314,0.001,127,3088@TOP@human_GAPDH_TAA_len41_fa20_ta0_fm14_tm6,a
3088@TOP@human_GAPDH_TAA_len41_fa20_ta0_fm14_tm6*128*c,0,3321,0,0,3321,0.0,128,3088@TOP@human_GAPDH_TAA_len41_fa20_ta0_fm14_tm6,c
3088@TOP@human_GAPDH_TAA_len41_fa20_ta0_fm14_tm6*129*c,0,3296,0,0,3296,0.0,129,3088@TOP@human_GAPDH_TAA_len41_fa20_ta0_fm14_tm6,c
3088@TOP@human_GAPDH_TAA_len41_fa20_ta0_fm14_tm6*130*c,1,3308,0,0,3309,0.0,130,3088@TOP@human_GAPDH_TAA_len41_fa20_ta0_fm14_tm6,c
3088@TOP@human_GAPDH_TAA_len41_fa20_ta0_fm14_tm6*131*c,3,3324,0,0,3327,0.0,131,3088@TOP@human_GAPDH_TAA_len41_fa20_ta0_fm14_tm6,c
3088@TOP@human_GAPDH_TAA_len41_fa20_ta0_fm14_tm6*132*t,0,1,0,3282,3283,0.0,132,3088@TOP@human_GAPDH_TAA_len41_fa20_ta0_fm14_tm6,t
3088@TOP@human_GAPDH_TAA_len41_fa20_ta0_fm14_tm6*133*g,0,0,3270,0,3270,1.0,133,3088@TOP@human_GAPDH_TAA_len41_fa20_ta0_fm14_tm6,g
3088@TOP@human_GAPDH_TAA_len41_fa20_ta0_fm14_tm6*134*g,0,1,3297,0,3298,1.0,134,3088@TOP@human_GAPDH_TAA_len41_fa20_ta0_fm14_tm6,g
3089@TOP@human_GAPDH_TAA_len41_fa20_ta0_fm14_tm6*114*t,2,3,0,29458,29463,0.0,114,3089@TOP@human_GAPDH_TAA_len41_fa20_ta0_fm14_tm6,t
3089@TOP@human_GAPDH_TAA_len41_fa20_ta0_fm14_tm6*115*c,1,29621,0,0,29622,0.0,115,3089@TOP@human_GAPDH_TAA_len41_fa20_ta0_fm14_tm6,c
3089@TOP@human_GAPDH_TAA_len41_fa20_ta0_fm14_tm6*116*c,0,29513,0,2,29515,0.0,116,3089@TOP@human_GAPDH_TAA_len41_fa20_ta0_fm14_tm6,c
3089@TOP@human_GAPDH_TAA_len41_fa20_ta0_fm14_tm6*117*a,29457,0,46,0,29503,0.002,117,3089@TOP@human_GAPDH_TAA_len41_fa20_ta0_fm14_tm6,a
3089@TOP@human_GAPDH_TAA_len41_fa20_ta0_fm14_tm6*118*a,29078,1,275,2,29356,0.009,118,3089@TOP@human_GAPDH_TAA_len41_fa20_ta0_fm14_tm6,a
3089@TOP@human_GAPDH_TAA_len41_fa20_ta0_fm14_tm6*119*g,2,1,29253,3,29259,1.0,119,3089@TOP@human_GAPDH_TAA_len41_fa20_ta0_fm14_tm6,g
3089@TOP@human_GAPDH_TAA_len41_fa20_ta0_fm14_tm6*120*g,2,0,29148,5,29155,1.0,120,3089@TOP@human_GAPDH_TAA_len41_fa20_ta0_fm14_tm6,g
3089@TOP@human_GAPDH_TAA_len41_fa20_ta0_fm14_tm6*121*a,29474,0,3,1,29478,0.0,121,3089@TOP@human_GAPDH_TAA_len41_fa20_ta0_fm14_tm6,a
3089@TOP@human_GAPDH_TAA_len41_fa20_ta0_fm14_tm6*122*g,1,0,29514,0,29515,1.0,122,3089@TOP@human_GAPDH_TAA_len41_fa20_ta0_fm14_tm6,g
3089@TOP@human_GAPDH_TAA_len41_fa20_ta0_fm14_tm6*123*t,0,2,0,29165,29167,0.0,123,3089@TOP@human_GAPDH_TAA_len41_fa20_ta0_fm14_tm6,t
3089@TOP@human_GAPDH_TAA_len41_fa20_ta0_fm14_tm6*124*a,28229,1,800,0,29030,0.028,124,3089@TOP@human_GAPDH_TAA_len41_fa20_ta0_fm14_tm6,a
3089@TOP@human_GAPDH_TAA_len41_fa20_ta0_fm14_tm6*125*a,28585,3,381,0,28969,0.013,125,3089@TOP@human_GAPDH_TAA_len41_fa20_ta0_fm14_tm6,a
3089@TOP@human_GAPDH_TAA_len41_fa20_ta0_fm14_tm6*126*g,0,0,29100,2,29102,1.0,126,3089@TOP@human_GAPDH_TAA_len41_fa20_ta0_fm14_tm6,g
3089@TOP@human_GAPDH_TAA_len41_fa20_ta0_fm14_tm6*127*a,29405,4,10,0,29419,0.0,127,3089@TOP@human_GAPDH_TAA_len41_fa20_ta0_fm14_tm6,a
3089@TOP@human_GAPDH_TAA_len41_fa20_ta0_fm14_tm6*128*c,0,29566,1,6,29573,0.0,128,3089@TOP@human_GAPDH_TAA_len41_fa20_ta0_fm14_tm6,c
3089@TOP@human_GAPDH_TAA_len41_fa20_ta0_fm14_tm6*129*c,0,29341,1,5,29347,0.0,129,3089@TOP@human_GAPDH_TAA_len41_fa20_ta0_fm14_tm6,c
3089@TOP@human_GAPDH_TAA_len41_fa20_ta0_fm14_tm6*130*c,2,29502,0,0,29504,0.0,130,3089@TOP@human_GAPDH_TAA_len41_fa20_ta0_fm14_tm6,c
3089@TOP@human_GAPDH_TAA_len41_fa20_ta0_fm14_tm6*131*c,3,29580,0,1,29584,0.0,131,3089@TOP@human_GAPDH_TAA_len41_fa20_ta0_fm14_tm6,c
3089@TOP@human_GAPDH_TAA_len41_fa20_ta0_fm14_tm6*132*t,3,7,0,29156,29166,0.0,132,3089@TOP@human_GAPDH_TAA_len41_fa20_ta0_fm14_tm6,t
3089@TOP@human_GAPDH_TAA_len41_fa20_ta0_fm14_tm6*133*g,1,1,29046,2,29050,1.0,133,3089@TOP@human_GAPDH_TAA_len41_fa20_ta0_fm14_tm6,g
3089@TOP@human_GAPDH_TAA_len41_fa20_ta0_fm14_tm6*134*g,4,9,29206,0,29219,1.0,134,3089@TOP@human_GAPDH_TAA_len41_fa20_ta0_fm14_tm6,g
3090@TOP@human_GAPDH_TAA_len41_fa20_ta0_fm14_tm6*114*t,1,2,0,26960,26963,0.0,114,3090@TOP@human_GAPDH_TAA_len41_fa20_ta0_fm14_tm6,t
3090@TOP@human_GAPDH_TAA_len41_fa20_ta0_fm14_tm6*115*c,0,27115,0,2,27117,0.0,115,3090@TOP@human_GAPDH_TAA_len41_fa20_ta0_fm14_tm6,c
3090@TOP@human_GAPDH_TAA_len41_fa20_ta0_fm14_tm6*116*c,0,27016,0,1,27017,0.0,116,3090@TOP@human_GAPDH_TAA_len41_fa20_ta0_fm14_tm6,c
3090@TOP@human_GAPDH_TAA_len41_fa20_ta0_fm14_tm6*117*a,26950,0,34,0,26984,0.001,117,3090@TOP@human_GAPDH_TAA_len41_fa20_ta0_fm14_tm6,a
3090@TOP@human_GAPDH_TAA_len41_fa20_ta0_fm14_tm6*118*a,26506,0,314,1,26821,0.012,118,3090@TOP@human_GAPDH_TAA_len41_fa20_ta0_fm14_tm6,a
3090@TOP@human_GAPDH_TAA_len41_fa20_ta0_fm14_tm6*119*g,2,0,26799,2,26803,1.0,119,3090@TOP@human_GAPDH_TAA_len41_fa20_ta0_fm14_tm6,g
3090@TOP@human_GAPDH_TAA_len41_fa20_ta0_fm14_tm6*120*g,1,1,26697,1,26700,1.0,120,3090@TOP@human_GAPDH_TAA_len41_fa20_ta0_fm14_tm6,g
3090@TOP@human_GAPDH_TAA_len41_fa20_ta0_fm14_tm6*121*a,26935,0,5,0,26940,0.0,121,3090@TOP@human_GAPDH_TAA_len41_fa20_ta0_fm14_tm6,a
3090@TOP@human_GAPDH_TAA_len41_fa20_ta0_fm14_tm6*122*g,2,0,27012,3,27017,1.0,122,3090@TOP@human_GAPDH_TAA_len41_fa20_ta0_fm14_tm6,g
3090@TOP@human_GAPDH_TAA_len41_fa20_ta0_fm14_tm6*123*t,4,3,2,26590,26599,0.0,123,3090@TOP@human_GAPDH_TAA_len41_fa20_ta0_fm14_tm6,t
3090@TOP@human_GAPDH_TAA_len41_fa20_ta0_fm14_tm6*124*a,25710,2,763,1,26476,0.029,124,3090@TOP@human_GAPDH_TAA_len41_fa20_ta0_fm14_tm6,a
3090@TOP@human_GAPDH_TAA_len41_fa20_ta0_fm14_tm6*125*a,26080,0,407,3,26490,0.015,125,3090@TOP@human_GAPDH_TAA_len41_fa20_ta0_fm14_tm6,a
3090@TOP@human_GAPDH_TAA_len41_fa20_ta0_fm14_tm6*126*g,5,0,26656,2,26663,1.0,126,3090@TOP@human_GAPDH_TAA_len41_fa20_ta0_fm14_tm6,g
3090@TOP@human_GAPDH_TAA_len41_fa20_ta0_fm14_tm6*127*a,26855,0,28,2,26885,0.001,127,3090@TOP@human_GAPDH_TAA_len41_fa20_ta0_fm14_tm6,a
3090@TOP@human_GAPDH_TAA_len41_fa20_ta0_fm14_tm6*128*c,1,27053,2,2,27058,0.0,128,3090@TOP@human_GAPDH_TAA_len41_fa20_ta0_fm14_tm6,c
3090@TOP@human_GAPDH_TAA_len41_fa20_ta0_fm14_tm6*129*c,6,26866,0,0,26872,0.0,129,3090@TOP@human_GAPDH_TAA_len41_fa20_ta0_fm14_tm6,c
3090@TOP@human_GAPDH_TAA_len41_fa20_ta0_fm14_tm6*130*c,2,27004,0,1,27007,0.0,130,3090@TOP@human_GAPDH_TAA_len41_fa20_ta0_fm14_tm6,c
3090@TOP@human_GAPDH_TAA_len41_fa20_ta0_fm14_tm6*131*c,1,27069,0,0,27070,0.0,131,3090@TOP@human_GAPDH_TAA_len41_fa20_ta0_fm14_tm6,c
3090@TOP@human_GAPDH_TAA_len41_fa20_ta0_fm14_tm6*132*t,1,6,0,26633,26640,0.0,132,3090@TOP@human_GAPDH_TAA_len41_fa20_ta0_fm14_tm6,t
3090@TOP@human_GAPDH_TAA_len41_fa20_ta0_fm14_tm6*133*g,4,0,26671,0,26675,1.0,133,3090@TOP@human_GAPDH_TAA_len41_fa20_ta0_fm14_tm6,g
3090@TOP@human_GAPDH_TAA_len41_fa20_ta0_fm14_tm6*134*g,2,4,26815,3,26824,1.0,134,3090@TOP@human_GAPDH_TAA_len41_fa20_ta0_fm14_tm6,g
3091@TOP@human_GAPDH_TAA_len41_fa20_ta0_fm14_tm6*114*t,0,1,0,1230,1231,0.0,114,3091@TOP@human_GAPDH_TAA_len41_fa20_ta0_fm14_tm6,t
3091@TOP@human_GAPDH_TAA_len41_fa20_ta0_fm14_tm6*115*c,0,1245,0,0,1245,0.0,115,3091@TOP@human_GAPDH_TAA_len41_fa20_ta0_fm14_tm6,c
3091@TOP@human_GAPDH_TAA_len41_fa20_ta0_fm14_tm6*116*c,0,1240,0,0,1240,0.0,116,3091@TOP@human_GAPDH_TAA_len41_fa20_ta0_fm14_tm6,c
3091@TOP@human_GAPDH_TAA_len41_fa20_ta0_fm14_tm6*117*a,1233,0,6,0,1239,0.005,117,3091@TOP@human_GAPDH_TAA_len41_fa20_ta0_fm14_tm6,a
3091@TOP@human_GAPDH_TAA_len41_fa20_ta0_fm14_tm6*118*a,1157,0,68,0,1225,0.056,118,3091@TOP@human_GAPDH_TAA_len41_fa20_ta0_fm14_tm6,a
3091@TOP@human_GAPDH_TAA_len41_fa20_ta0_fm14_tm6*119*g,0,0,1231,0,1231,1.0,119,3091@TOP@human_GAPDH_TAA_len41_fa20_ta0_fm14_tm6,g
3091@TOP@human_GAPDH_TAA_len41_fa20_ta0_fm14_tm6*120*g,0,0,1226,0,1226,1.0,120,3091@TOP@human_GAPDH_TAA_len41_fa20_ta0_fm14_tm6,g
3091@TOP@human_GAPDH_TAA_len41_fa20_ta0_fm14_tm6*121*a,1238,0,2,0,1240,0.002,121,3091@TOP@human_GAPDH_TAA_len41_fa20_ta0_fm14_tm6,a
3091@TOP@human_GAPDH_TAA_len41_fa20_ta0_fm14_tm6*122*g,0,0,1239,0,1239,1.0,122,3091@TOP@human_GAPDH_TAA_len41_fa20_ta0_fm14_tm6,g
3091@TOP@human_GAPDH_TAA_len41_fa20_ta0_fm14_tm6*123*t,0,2,0,1215,1217,0.0,123,3091@TOP@human_GAPDH_TAA_len41_fa20_ta0_fm14_tm6,t
3091@TOP@human_GAPDH_TAA_len41_fa20_ta0_fm14_tm6*124*a,1166,0,52,0,1218,0.043,124,3091@TOP@human_GAPDH_TAA_len41_fa20_ta0_fm14_tm6,a
3091@TOP@human_GAPDH_TAA_len41_fa20_ta0_fm14_tm6*125*a,1166,0,41,0,1207,0.034,125,3091@TOP@human_GAPDH_TAA_len41_fa20_ta0_fm14_tm6,a
3091@TOP@human_GAPDH_TAA_len41_fa20_ta0_fm14_tm6*126*g,0,0,1216,0,1216,1.0,126,3091@TOP@human_GAPDH_TAA_len41_fa20_ta0_fm14_tm6,g
3091@TOP@human_GAPDH_TAA_len41_fa20_ta0_fm14_tm6*127*a,1229,0,2,0,1231,0.002,127,3091@TOP@human_GAPDH_TAA_len41_fa20_ta0_fm14_tm6,a
3091@TOP@human_GAPDH_TAA_len41_fa20_ta0_fm14_tm6*128*c,1,1240,0,0,1241,0.0,128,3091@TOP@human_GAPDH_TAA_len41_fa20_ta0_fm14_tm6,c
3091@TOP@human_GAPDH_TAA_len41_fa20_ta0_fm14_tm6*129*c,2,1226,0,0,1228,0.0,129,3091@TOP@human_GAPDH_TAA_len41_fa20_ta0_fm14_tm6,c
3091@TOP@human_GAPDH_TAA_len41_fa20_ta0_fm14_tm6*130*c,0,1241,0,0,1241,0.0,130,3091@TOP@human_GAPDH_TAA_len41_fa20_ta0_fm14_tm6,c
3091@TOP@human_GAPDH_TAA_len41_fa20_ta0_fm14_tm6*131*c,0,1245,0,0,1245,0.0,131,3091@TOP@human_GAPDH_TAA_len41_fa20_ta0_fm14_tm6,c
3091@TOP@human_GAPDH_TAA_len41_fa20_ta0_fm14_tm6*132*t,1,0,0,1218,1219,0.0,132,3091@TOP@human_GAPDH_TAA_len41_fa20_ta0_fm14_tm6,t
3091@TOP@human_GAPDH_TAA_len41_fa20_ta0_fm14_tm6*133*g,0,0,1222,0,1222,1.0,133,3091@TOP@human_GAPDH_TAA_len41_fa20_ta0_fm14_tm6,g
3091@TOP@human_GAPDH_TAA_len41_fa20_ta0_fm14_tm6*134*g,0,0,1228,0,1228,1.0,134,3091@TOP@human_GAPDH_TAA_len41_fa20_ta0_fm14_tm6,g
3092@TOP@human_GAPDH_TAA_len41_fa20_ta0_fm14_tm6*114*t,0,1,1,2453,2455,0.0,114,3092@TOP@human_GAPDH_TAA_len41_fa20_ta0_fm14_tm6,t
3092@TOP@human_GAPDH_TAA_len41_fa20_ta0_fm14_tm6*115*c,0,2470,0,0,2470,0.0,115,3092@TOP@human_GAPDH_TAA_len41_fa20_ta0_fm14_tm6,c
3092@TOP@human_GAPDH_TAA_len41_fa20_ta0_fm14_tm6*116*c,0,2463,0,0,2463,0.0,116,3092@TOP@human_GAPDH_TAA_len41_fa20_ta0_fm14_tm6,c
3092@TOP@human_GAPDH_TAA_len41_fa20_ta0_fm14_tm6*117*a,2455,0,3,0,2458,0.001,117,3092@TOP@human_GAPDH_TAA_len41_fa20_ta0_fm14_tm6,a
3092@TOP@human_GAPDH_TAA_len41_fa20_ta0_fm14_tm6*118*a,2324,0,110,0,2434,0.045,118,3092@TOP@human_GAPDH_TAA_len41_fa20_ta0_fm14_tm6,a
3092@TOP@human_GAPDH_TAA_len41_fa20_ta0_fm14_tm6*119*g,0,0,2445,0,2445,1.0,119,3092@TOP@human_GAPDH_TAA_len41_fa20_ta0_fm14_tm6,g
3092@TOP@human_GAPDH_TAA_len41_fa20_ta0_fm14_tm6*120*g,0,0,2442,0,2442,1.0,120,3092@TOP@human_GAPDH_TAA_len41_fa20_ta0_fm14_tm6,g
3092@TOP@human_GAPDH_TAA_len41_fa20_ta0_fm14_tm6*121*a,2443,0,3,0,2446,0.001,121,3092@TOP@human_GAPDH_TAA_len41_fa20_ta0_fm14_tm6,a
3092@TOP@human_GAPDH_TAA_len41_fa20_ta0_fm14_tm6*122*g,0,0,2458,0,2458,1.0,122,3092@TOP@human_GAPDH_TAA_len41_fa20_ta0_fm14_tm6,g
3092@TOP@human_GAPDH_TAA_len41_fa20_ta0_fm14_tm6*123*t,0,0,2,2419,2421,0.001,123,3092@TOP@human_GAPDH_TAA_len41_fa20_ta0_fm14_tm6,t
3092@TOP@human_GAPDH_TAA_len41_fa20_ta0_fm14_tm6*124*a,2237,1,172,0,2410,0.071,124,3092@TOP@human_GAPDH_TAA_len41_fa20_ta0_fm14_tm6,a
3092@TOP@human_GAPDH_TAA_len41_fa20_ta0_fm14_tm6*125*a,2363,0,48,0,2411,0.02,125,3092@TOP@human_GAPDH_TAA_len41_fa20_ta0_fm14_tm6,a
3092@TOP@human_GAPDH_TAA_len41_fa20_ta0_fm14_tm6*126*g,0,0,2431,0,2431,1.0,126,3092@TOP@human_GAPDH_TAA_len41_fa20_ta0_fm14_tm6,g
3092@TOP@human_GAPDH_TAA_len41_fa20_ta0_fm14_tm6*127*a,2443,0,2,0,2445,0.001,127,3092@TOP@human_GAPDH_TAA_len41_fa20_ta0_fm14_tm6,a
3092@TOP@human_GAPDH_TAA_len41_fa20_ta0_fm14_tm6*128*c,0,2462,0,0,2462,0.0,128,3092@TOP@human_GAPDH_TAA_len41_fa20_ta0_fm14_tm6,c
3092@TOP@human_GAPDH_TAA_len41_fa20_ta0_fm14_tm6*129*c,0,2446,0,0,2446,0.0,129,3092@TOP@human_GAPDH_TAA_len41_fa20_ta0_fm14_tm6,c
3092@TOP@human_GAPDH_TAA_len41_fa20_ta0_fm14_tm6*130*c,0,2458,0,1,2459,0.0,130,3092@TOP@human_GAPDH_TAA_len41_fa20_ta0_fm14_tm6,c
3092@TOP@human_GAPDH_TAA_len41_fa20_ta0_fm14_tm6*131*c,1,2463,0,0,2464,0.0,131,3092@TOP@human_GAPDH_TAA_len41_fa20_ta0_fm14_tm6,c
3092@TOP@human_GAPDH_TAA_len41_fa20_ta0_fm14_tm6*132*t,1,1,0,2429,2431,0.0,132,3092@TOP@human_GAPDH_TAA_len41_fa20_ta0_fm14_tm6,t
3092@TOP@human_GAPDH_TAA_len41_fa20_ta0_fm14_tm6*133*g,0,0,2427,0,2427,1.0,133,3092@TOP@human_GAPDH_TAA_len41_fa20_ta0_fm14_tm6,g
3092@TOP@human_GAPDH_TAA_len41_fa20_ta0_fm14_tm6*134*g,0,0,2439,0,2439,1.0,134,3092@TOP@human_GAPDH_TAA_len41_fa20_ta0_fm14_tm6,g
3093@TOP@human_GAPDH_TAA_len41_fa20_ta0_fm14_tm6*114*t,2,11,2,20765,20780,0.0,114,3093@TOP@human_GAPDH_TAA_len41_fa20_ta0_fm14_tm6,t
3093@TOP@human_GAPDH_TAA_len41_fa20_ta0_fm14_tm6*115*c,1,20913,0,0,20914,0.0,115,3093@TOP@human_GAPDH_TAA_len41_fa20_ta0_fm14_tm6,c
3093@TOP@human_GAPDH_TAA_len41_fa20_ta0_fm14_tm6*116*c,1,20809,0,1,20811,0.0,116,3093@TOP@human_GAPDH_TAA_len41_fa20_ta0_fm14_tm6,c
3093@TOP@human_GAPDH_TAA_len41_fa20_ta0_fm14_tm6*117*a,20773,0,40,1,20814,0.002,117,3093@TOP@human_GAPDH_TAA_len41_fa20_ta0_fm14_tm6,a
3093@TOP@human_GAPDH_TAA_len41_fa20_ta0_fm14_tm6*118*a,20448,0,244,0,20692,0.012,118,3093@TOP@human_GAPDH_TAA_len41_fa20_ta0_fm14_tm6,a
3093@TOP@human_GAPDH_TAA_len41_fa20_ta0_fm14_tm6*119*g,0,0,20683,0,20683,1.0,119,3093@TOP@human_GAPDH_TAA_len41_fa20_ta0_fm14_tm6,g
3093@TOP@human_GAPDH_TAA_len41_fa20_ta0_fm14_tm6*120*g,0,0,20564,2,20566,1.0,120,3093@TOP@human_GAPDH_TAA_len41_fa20_ta0_fm14_tm6,g
3093@TOP@human_GAPDH_TAA_len41_fa20_ta0_fm14_tm6*121*a,20826,0,6,1,20833,0.0,121,3093@TOP@human_GAPDH_TAA_len41_fa20_ta0_fm14_tm6,a
3093@TOP@human_GAPDH_TAA_len41_fa20_ta0_fm14_tm6*122*g,0,0,20818,0,20818,1.0,122,3093@TOP@human_GAPDH_TAA_len41_fa20_ta0_fm14_tm6,g
3093@TOP@human_GAPDH_TAA_len41_fa20_ta0_fm14_tm6*123*t,3,2,2,20564,20571,0.0,123,3093@TOP@human_GAPDH_TAA_len41_fa20_ta0_fm14_tm6,t
3093@TOP@human_GAPDH_TAA_len41_fa20_ta0_fm14_tm6*124*a,19521,0,983,0,20504,0.048,124,3093@TOP@human_GAPDH_TAA_len41_fa20_ta0_fm14_tm6,a
3093@TOP@human_GAPDH_TAA_len41_fa20_ta0_fm14_tm6*125*a,20089,1,362,0,20452,0.018,125,3093@TOP@human_GAPDH_TAA_len41_fa20_ta0_fm14_tm6,a
3093@TOP@human_GAPDH_TAA_len41_fa20_ta0_fm14_tm6*126*g,1,0,20559,1,20561,1.0,126,3093@TOP@human_GAPDH_TAA_len41_fa20_ta0_fm14_tm6,g
3093@TOP@human_GAPDH_TAA_len41_fa20_ta0_fm14_tm6*127*a,20762,0,13,0,20775,0.001,127,3093@TOP@human_GAPDH_TAA_len41_fa20_ta0_fm14_tm6,a
3093@TOP@human_GAPDH_TAA_len41_fa20_ta0_fm14_tm6*128*c,2,20851,3,0,20856,0.0,128,3093@TOP@human_GAPDH_TAA_len41_fa20_ta0_fm14_tm6,c
3093@TOP@human_GAPDH_TAA_len41_fa20_ta0_fm14_tm6*129*c,5,20725,0,2,20732,0.0,129,3093@TOP@human_GAPDH_TAA_len41_fa20_ta0_fm14_tm6,c
3093@TOP@human_GAPDH_TAA_len41_fa20_ta0_fm14_tm6*130*c,0,20826,0,9,20835,0.0,130,3093@TOP@human_GAPDH_TAA_len41_fa20_ta0_fm14_tm6,c
3093@TOP@human_GAPDH_TAA_len41_fa20_ta0_fm14_tm6*131*c,1,20880,0,1,20882,0.0,131,3093@TOP@human_GAPDH_TAA_len41_fa20_ta0_fm14_tm6,c
3093@TOP@human_GAPDH_TAA_len41_fa20_ta0_fm14_tm6*132*t,2,5,4,20570,20581,0.0,132,3093@TOP@human_GAPDH_TAA_len41_fa20_ta0_fm14_tm6,t
3093@TOP@human_GAPDH_TAA_len41_fa20_ta0_fm14_tm6*133*g,0,0,20519,3,20522,1.0,133,3093@TOP@human_GAPDH_TAA_len41_fa20_ta0_fm14_tm6,g
3093@TOP@human_GAPDH_TAA_len41_fa20_ta0_fm14_tm6*134*g,1,2,20638,1,20642,1.0,134,3093@TOP@human_GAPDH_TAA_len41_fa20_ta0_fm14_tm6,g
3094@TOP@human_GAPDH_TAA_len41_fa20_ta0_fm14_tm6*114*t,3,1,1,7455,7460,0.0,114,3094@TOP@human_GAPDH_TAA_len41_fa20_ta0_fm14_tm6,t
3094@TOP@human_GAPDH_TAA_len41_fa20_ta0_fm14_tm6*115*c,0,7496,0,0,7496,0.0,115,3094@TOP@human_GAPDH_TAA_len41_fa20_ta0_fm14_tm6,c
3094@TOP@human_GAPDH_TAA_len41_fa20_ta0_fm14_tm6*116*c,0,7465,0,0,7465,0.0,116,3094@TOP@human_GAPDH_TAA_len41_fa20_ta0_fm14_tm6,c
3094@TOP@human_GAPDH_TAA_len41_fa20_ta0_fm14_tm6*117*a,7448,0,14,0,7462,0.002,117,3094@TOP@human_GAPDH_TAA_len41_fa20_ta0_fm14_tm6,a
3094@TOP@human_GAPDH_TAA_len41_fa20_ta0_fm14_tm6*118*a,7154,0,265,0,7419,0.036,118,3094@TOP@human_GAPDH_TAA_len41_fa20_ta0_fm14_tm6,a
3094@TOP@human_GAPDH_TAA_len41_fa20_ta0_fm14_tm6*119*g,3,0,7399,3,7405,0.999,119,3094@TOP@human_GAPDH_TAA_len41_fa20_ta0_fm14_tm6,g
3094@TOP@human_GAPDH_TAA_len41_fa20_ta0_fm14_tm6*120*g,0,0,7380,0,7380,1.0,120,3094@TOP@human_GAPDH_TAA_len41_fa20_ta0_fm14_tm6,g
3094@TOP@human_GAPDH_TAA_len41_fa20_ta0_fm14_tm6*121*a,7455,0,2,0,7457,0.0,121,3094@TOP@human_GAPDH_TAA_len41_fa20_ta0_fm14_tm6,a
3094@TOP@human_GAPDH_TAA_len41_fa20_ta0_fm14_tm6*122*g,0,0,7465,0,7465,1.0,122,3094@TOP@human_GAPDH_TAA_len41_fa20_ta0_fm14_tm6,g
3094@TOP@human_GAPDH_TAA_len41_fa20_ta0_fm14_tm6*123*t,0,1,0,7349,7350,0.0,123,3094@TOP@human_GAPDH_TAA_len41_fa20_ta0_fm14_tm6,t
3094@TOP@human_GAPDH_TAA_len41_fa20_ta0_fm14_tm6*124*a,7074,0,273,0,7347,0.037,124,3094@TOP@human_GAPDH_TAA_len41_fa20_ta0_fm14_tm6,a
3094@TOP@human_GAPDH_TAA_len41_fa20_ta0_fm14_tm6*125*a,7126,0,221,0,7347,0.03,125,3094@TOP@human_GAPDH_TAA_len41_fa20_ta0_fm14_tm6,a
3094@TOP@human_GAPDH_TAA_len41_fa20_ta0_fm14_tm6*126*g,1,0,7368,1,7370,1.0,126,3094@TOP@human_GAPDH_TAA_len41_fa20_ta0_fm14_tm6,g
3094@TOP@human_GAPDH_TAA_len41_fa20_ta0_fm14_tm6*127*a,7442,0,2,0,7444,0.0,127,3094@TOP@human_GAPDH_TAA_len41_fa20_ta0_fm14_tm6,a
3094@TOP@human_GAPDH_TAA_len41_fa20_ta0_fm14_tm6*128*c,0,7481,1,0,7482,0.0,128,3094@TOP@human_GAPDH_TAA_len41_fa20_ta0_fm14_tm6,c
3094@TOP@human_GAPDH_TAA_len41_fa20_ta0_fm14_tm6*129*c,0,7419,1,0,7420,0.0,129,3094@TOP@human_GAPDH_TAA_len41_fa20_ta0_fm14_tm6,c
3094@TOP@human_GAPDH_TAA_len41_fa20_ta0_fm14_tm6*130*c,0,7483,0,0,7483,0.0,130,3094@TOP@human_GAPDH_TAA_len41_fa20_ta0_fm14_tm6,c
3094@TOP@human_GAPDH_TAA_len41_fa20_ta0_fm14_tm6*131*c,2,7479,0,0,7481,0.0,131,3094@TOP@human_GAPDH_TAA_len41_fa20_ta0_fm14_tm6,c
3094@TOP@human_GAPDH_TAA_len41_fa20_ta0_fm14_tm6*132*t,1,3,2,7380,7386,0.0,132,3094@TOP@human_GAPDH_TAA_len41_fa20_ta0_fm14_tm6,t
3094@TOP@human_GAPDH_TAA_len41_fa20_ta0_fm14_tm6*133*g,0,0,7352,1,7353,1.0,133,3094@TOP@human_GAPDH_TAA_len41_fa20_ta0_fm14_tm6,g
3094@TOP@human_GAPDH_TAA_len41_fa20_ta0_fm14_tm6*134*g,2,2,7384,2,7390,0.999,134,3094@TOP@human_GAPDH_TAA_len41_fa20_ta0_fm14_tm6,g
3095@TOP@human_GAPDH_TAA_len41_fa20_ta0_fm14_tm6*114*t,0,1,0,7843,7844,0.0,114,3095@TOP@human_GAPDH_TAA_len41_fa20_ta0_fm14_tm6,t
3095@TOP@human_GAPDH_TAA_len41_fa20_ta0_fm14_tm6*115*c,0,7876,0,0,7876,0.0,115,3095@TOP@human_GAPDH_TAA_len41_fa20_ta0_fm14_tm6,c
3095@TOP@human_GAPDH_TAA_len41_fa20_ta0_fm14_tm6*116*c,1,7826,0,0,7827,0.0,116,3095@TOP@human_GAPDH_TAA_len41_fa20_ta0_fm14_tm6,c
3095@TOP@human_GAPDH_TAA_len41_fa20_ta0_fm14_tm6*117*a,7822,0,18,0,7840,0.002,117,3095@TOP@human_GAPDH_TAA_len41_fa20_ta0_fm14_tm6,a
3095@TOP@human_GAPDH_TAA_len41_fa20_ta0_fm14_tm6*118*a,7644,0,154,0,7798,0.02,118,3095@TOP@human_GAPDH_TAA_len41_fa20_ta0_fm14_tm6,a
3095@TOP@human_GAPDH_TAA_len41_fa20_ta0_fm14_tm6*119*g,0,0,7783,0,7783,1.0,119,3095@TOP@human_GAPDH_TAA_len41_fa20_ta0_fm14_tm6,g
3095@TOP@human_GAPDH_TAA_len41_fa20_ta0_fm14_tm6*120*g,0,0,7756,0,7756,1.0,120,3095@TOP@human_GAPDH_TAA_len41_fa20_ta0_fm14_tm6,g
3095@TOP@human_GAPDH_TAA_len41_fa20_ta0_fm14_tm6*121*a,7823,0,2,0,7825,0.0,121,3095@TOP@human_GAPDH_TAA_len41_fa20_ta0_fm14_tm6,a
3095@TOP@human_GAPDH_TAA_len41_fa20_ta0_fm14_tm6*122*g,0,0,7842,0,7842,1.0,122,3095@TOP@human_GAPDH_TAA_len41_fa20_ta0_fm14_tm6,g
3095@TOP@human_GAPDH_TAA_len41_fa20_ta0_fm14_tm6*123*t,1,1,1,7739,7742,0.0,123,3095@TOP@human_GAPDH_TAA_len41_fa20_ta0_fm14_tm6,t
3095@TOP@human_GAPDH_TAA_len41_fa20_ta0_fm14_tm6*124*a,7160,0,553,0,7713,0.072,124,3095@TOP@human_GAPDH_TAA_len41_fa20_ta0_fm14_tm6,a
3095@TOP@human_GAPDH_TAA_len41_fa20_ta0_fm14_tm6*125*a,7576,0,139,0,7715,0.018,125,3095@TOP@human_GAPDH_TAA_len41_fa20_ta0_fm14_tm6,a
3095@TOP@human_GAPDH_TAA_len41_fa20_ta0_fm14_tm6*126*g,0,0,7742,0,7742,1.0,126,3095@TOP@human_GAPDH_TAA_len41_fa20_ta0_fm14_tm6,g
3095@TOP@human_GAPDH_TAA_len41_fa20_ta0_fm14_tm6*127*a,7808,0,7,0,7815,0.001,127,3095@TOP@human_GAPDH_TAA_len41_fa20_ta0_fm14_tm6,a
3095@TOP@human_GAPDH_TAA_len41_fa20_ta0_fm14_tm6*128*c,0,7855,0,0,7855,0.0,128,3095@TOP@human_GAPDH_TAA_len41_fa20_ta0_fm14_tm6,c
3095@TOP@human_GAPDH_TAA_len41_fa20_ta0_fm14_tm6*129*c,0,7802,0,0,7802,0.0,129,3095@TOP@human_GAPDH_TAA_len41_fa20_ta0_fm14_tm6,c
3095@TOP@human_GAPDH_TAA_len41_fa20_ta0_fm14_tm6*130*c,0,7849,0,0,7849,0.0,130,3095@TOP@human_GAPDH_TAA_len41_fa20_ta0_fm14_tm6,c
3095@TOP@human_GAPDH_TAA_len41_fa20_ta0_fm14_tm6*131*c,0,7864,0,1,7865,0.0,131,3095@TOP@human_GAPDH_TAA_len41_fa20_ta0_fm14_tm6,c
3095@TOP@human_GAPDH_TAA_len41_fa20_ta0_fm14_tm6*132*t,17,2,1,7745,7765,0.0,132,3095@TOP@human_GAPDH_TAA_len41_fa20_ta0_fm14_tm6,t
3095@TOP@human_GAPDH_TAA_len41_fa20_ta0_fm14_tm6*133*g,1,0,7743,0,7744,1.0,133,3095@TOP@human_GAPDH_TAA_len41_fa20_ta0_fm14_tm6,g
3095@TOP@human_GAPDH_TAA_len41_fa20_ta0_fm14_tm6*134*g,0,1,7784,0,7785,1.0,134,3095@TOP@human_GAPDH_TAA_len41_fa20_ta0_fm14_tm6,g
3096@TOP@human_GAPDH_TAA_len41_fa20_ta0_fm14_tm6*114*t,0,0,0,1014,1014,0.0,114,3096@TOP@human_GAPDH_TAA_len41_fa20_ta0_fm14_tm6,t
3096@TOP@human_GAPDH_TAA_len41_fa20_ta0_fm14_tm6*115*c,0,1020,0,0,1020,0.0,115,3096@TOP@human_GAPDH_TAA_len41_fa20_ta0_fm14_tm6,c
3096@TOP@human_GAPDH_TAA_len41_fa20_ta0_fm14_tm6*116*c,0,1013,0,0,1013,0.0,116,3096@TOP@human_GAPDH_TAA_len41_fa20_ta0_fm14_tm6,c
3096@TOP@human_GAPDH_TAA_len41_fa20_ta0_fm14_tm6*117*a,1012,0,4,0,1016,0.004,117,3096@TOP@human_GAPDH_TAA_len41_fa20_ta0_fm14_tm6,a
3096@TOP@human_GAPDH_TAA_len41_fa20_ta0_fm14_tm6*118*a,976,0,31,0,1007,0.031,118,3096@TOP@human_GAPDH_TAA_len41_fa20_ta0_fm14_tm6,a
3096@TOP@human_GAPDH_TAA_len41_fa20_ta0_fm14_tm6*119*g,0,0,1003,0,1003,1.0,119,3096@TOP@human_GAPDH_TAA_len41_fa20_ta0_fm14_tm6,g
3096@TOP@human_GAPDH_TAA_len41_fa20_ta0_fm14_tm6*120*g,0,0,999,0,999,1.0,120,3096@TOP@human_GAPDH_TAA_len41_fa20_ta0_fm14_tm6,g
3096@TOP@human_GAPDH_TAA_len41_fa20_ta0_fm14_tm6*121*a,1013,0,0,0,1013,0.0,121,3096@TOP@human_GAPDH_TAA_len41_fa20_ta0_fm14_tm6,a
3096@TOP@human_GAPDH_TAA_len41_fa20_ta0_fm14_tm6*122*g,0,0,1014,0,1014,1.0,122,3096@TOP@human_GAPDH_TAA_len41_fa20_ta0_fm14_tm6,g
3096@TOP@human_GAPDH_TAA_len41_fa20_ta0_fm14_tm6*123*t,0,0,0,1004,1004,0.0,123,3096@TOP@human_GAPDH_TAA_len41_fa20_ta0_fm14_tm6,t
3096@TOP@human_GAPDH_TAA_len41_fa20_ta0_fm14_tm6*124*a,949,0,54,0,1003,0.054,124,3096@TOP@human_GAPDH_TAA_len41_fa20_ta0_fm14_tm6,a
3096@TOP@human_GAPDH_TAA_len41_fa20_ta0_fm14_tm6*125*a,961,1,27,0,989,0.027,125,3096@TOP@human_GAPDH_TAA_len41_fa20_ta0_fm14_tm6,a
3096@TOP@human_GAPDH_TAA_len41_fa20_ta0_fm14_tm6*126*g,0,0,1001,0,1001,1.0,126,3096@TOP@human_GAPDH_TAA_len41_fa20_ta0_fm14_tm6,g
3096@TOP@human_GAPDH_TAA_len41_fa20_ta0_fm14_tm6*127*a,1011,0,2,0,1013,0.002,127,3096@TOP@human_GAPDH_TAA_len41_fa20_ta0_fm14_tm6,a
3096@TOP@human_GAPDH_TAA_len41_fa20_ta0_fm14_tm6*128*c,0,1018,0,0,1018,0.0,128,3096@TOP@human_GAPDH_TAA_len41_fa20_ta0_fm14_tm6,c
3096@TOP@human_GAPDH_TAA_len41_fa20_ta0_fm14_tm6*129*c,0,1013,0,0,1013,0.0,129,3096@TOP@human_GAPDH_TAA_len41_fa20_ta0_fm14_tm6,c
3096@TOP@human_GAPDH_TAA_len41_fa20_ta0_fm14_tm6*130*c,0,1015,0,0,1015,0.0,130,3096@TOP@human_GAPDH_TAA_len41_fa20_ta0_fm14_tm6,c
3096@TOP@human_GAPDH_TAA_len41_fa20_ta0_fm14_tm6*131*c,0,1018,0,0,1018,0.0,131,3096@TOP@human_GAPDH_TAA_len41_fa20_ta0_fm14_tm6,c
3096@TOP@human_GAPDH_TAA_len41_fa20_ta0_fm14_tm6*132*t,0,0,0,1007,1007,0.0,132,3096@TOP@human_GAPDH_TAA_len41_fa20_ta0_fm14_tm6,t
3096@TOP@human_GAPDH_TAA_len41_fa20_ta0_fm14_tm6*133*g,0,0,1006,0,1006,1.0,133,3096@TOP@human_GAPDH_TAA_len41_fa20_ta0_fm14_tm6,g
3096@TOP@human_GAPDH_TAA_len41_fa20_ta0_fm14_tm6*134*g,0,1,1002,0,1003,0.999,134,3096@TOP@human_GAPDH_TAA_len41_fa20_ta0_fm14_tm6,g
3097@TOP@human_GAPDH_TAA_len41_fa20_ta0_fm14_tm6*114*t,1,6,0,7859,7866,0.0,114,3097@TOP@human_GAPDH_TAA_len41_fa20_ta0_fm14_tm6,t
3097@TOP@human_GAPDH_TAA_len41_fa20_ta0_fm14_tm6*115*c,0,7915,0,0,7915,0.0,115,3097@TOP@human_GAPDH_TAA_len41_fa20_ta0_fm14_tm6,c
3097@TOP@human_GAPDH_TAA_len41_fa20_ta0_fm14_tm6*116*c,0,7877,0,0,7877,0.0,116,3097@TOP@human_GAPDH_TAA_len41_fa20_ta0_fm14_tm6,c
3097@TOP@human_GAPDH_TAA_len41_fa20_ta0_fm14_tm6*117*a,7850,0,25,1,7876,0.003,117,3097@TOP@human_GAPDH_TAA_len41_fa20_ta0_fm14_tm6,a
3097@TOP@human_GAPDH_TAA_len41_fa20_ta0_fm14_tm6*118*a,7685,2,149,0,7836,0.019,118,3097@TOP@human_GAPDH_TAA_len41_fa20_ta0_fm14_tm6,a
3097@TOP@human_GAPDH_TAA_len41_fa20_ta0_fm14_tm6*119*g,0,2,7820,1,7823,1.0,119,3097@TOP@human_GAPDH_TAA_len41_fa20_ta0_fm14_tm6,g
3097@TOP@human_GAPDH_TAA_len41_fa20_ta0_fm14_tm6*120*g,1,0,7808,0,7809,1.0,120,3097@TOP@human_GAPDH_TAA_len41_fa20_ta0_fm14_tm6,g
3097@TOP@human_GAPDH_TAA_len41_fa20_ta0_fm14_tm6*121*a,7875,0,0,0,7875,0.0,121,3097@TOP@human_GAPDH_TAA_len41_fa20_ta0_fm14_tm6,a
3097@TOP@human_GAPDH_TAA_len41_fa20_ta0_fm14_tm6*122*g,0,0,7890,0,7890,1.0,122,3097@TOP@human_GAPDH_TAA_len41_fa20_ta0_fm14_tm6,g
3097@TOP@human_GAPDH_TAA_len41_fa20_ta0_fm14_tm6*123*t,3,0,0,7766,7769,0.0,123,3097@TOP@human_GAPDH_TAA_len41_fa20_ta0_fm14_tm6,t
3097@TOP@human_GAPDH_TAA_len41_fa20_ta0_fm14_tm6*124*a,7435,0,321,0,7756,0.041,124,3097@TOP@human_GAPDH_TAA_len41_fa20_ta0_fm14_tm6,a
3097@TOP@human_GAPDH_TAA_len41_fa20_ta0_fm14_tm6*125*a,7573,0,165,0,7738,0.021,125,3097@TOP@human_GAPDH_TAA_len41_fa20_ta0_fm14_tm6,a
3097@TOP@human_GAPDH_TAA_len41_fa20_ta0_fm14_tm6*126*g,0,0,7758,0,7758,1.0,126,3097@TOP@human_GAPDH_TAA_len41_fa20_ta0_fm14_tm6,g
3097@TOP@human_GAPDH_TAA_len41_fa20_ta0_fm14_tm6*127*a,7848,1,3,0,7852,0.0,127,3097@TOP@human_GAPDH_TAA_len41_fa20_ta0_fm14_tm6,a
3097@TOP@human_GAPDH_TAA_len41_fa20_ta0_fm14_tm6*128*c,0,7899,0,1,7900,0.0,128,3097@TOP@human_GAPDH_TAA_len41_fa20_ta0_fm14_tm6,c
3097@TOP@human_GAPDH_TAA_len41_fa20_ta0_fm14_tm6*129*c,0,7835,0,0,7835,0.0,129,3097@TOP@human_GAPDH_TAA_len41_fa20_ta0_fm14_tm6,c
3097@TOP@human_GAPDH_TAA_len41_fa20_ta0_fm14_tm6*130*c,0,7879,0,0,7879,0.0,130,3097@TOP@human_GAPDH_TAA_len41_fa20_ta0_fm14_tm6,c
3097@TOP@human_GAPDH_TAA_len41_fa20_ta0_fm14_tm6*131*c,3,7901,0,0,7904,0.0,131,3097@TOP@human_GAPDH_TAA_len41_fa20_ta0_fm14_tm6,c
3097@TOP@human_GAPDH_TAA_len41_fa20_ta0_fm14_tm6*132*t,1,1,2,7782,7786,0.0,132,3097@TOP@human_GAPDH_TAA_len41_fa20_ta0_fm14_tm6,t
3097@TOP@human_GAPDH_TAA_len41_fa20_ta0_fm14_tm6*133*g,0,0,7765,0,7765,1.0,133,3097@TOP@human_GAPDH_TAA_len41_fa20_ta0_fm14_tm6,g
3097@TOP@human_GAPDH_TAA_len41_fa20_ta0_fm14_tm6*134*g,1,1,7819,0,7821,1.0,134,3097@TOP@human_GAPDH_TAA_len41_fa20_ta0_fm14_tm6,g
3098@TOP@human_GAPDH_TAA_len41_fa20_ta0_fm14_tm6*114*t,1,5,0,21311,21317,0.0,114,3098@TOP@human_GAPDH_TAA_len41_fa20_ta0_fm14_tm6,t
3098@TOP@human_GAPDH_TAA_len41_fa20_ta0_fm14_tm6*115*c,0,21433,0,1,21434,0.0,115,3098@TOP@human_GAPDH_TAA_len41_fa20_ta0_fm14_tm6,c
3098@TOP@human_GAPDH_TAA_len41_fa20_ta0_fm14_tm6*116*c,1,21347,0,2,21350,0.0,116,3098@TOP@human_GAPDH_TAA_len41_fa20_ta0_fm14_tm6,c
3098@TOP@human_GAPDH_TAA_len41_fa20_ta0_fm14_tm6*117*a,21259,0,67,0,21326,0.003,117,3098@TOP@human_GAPDH_TAA_len41_fa20_ta0_fm14_tm6,a
3098@TOP@human_GAPDH_TAA_len41_fa20_ta0_fm14_tm6*118*a,20571,1,650,2,21224,0.031,118,3098@TOP@human_GAPDH_TAA_len41_fa20_ta0_fm14_tm6,a
3098@TOP@human_GAPDH_TAA_len41_fa20_ta0_fm14_tm6*119*g,0,0,21192,1,21193,1.0,119,3098@TOP@human_GAPDH_TAA_len41_fa20_ta0_fm14_tm6,g
3098@TOP@human_GAPDH_TAA_len41_fa20_ta0_fm14_tm6*120*g,2,2,21104,1,21109,1.0,120,3098@TOP@human_GAPDH_TAA_len41_fa20_ta0_fm14_tm6,g
3098@TOP@human_GAPDH_TAA_len41_fa20_ta0_fm14_tm6*121*a,21314,0,2,1,21317,0.0,121,3098@TOP@human_GAPDH_TAA_len41_fa20_ta0_fm14_tm6,a
3098@TOP@human_GAPDH_TAA_len41_fa20_ta0_fm14_tm6*122*g,4,1,21325,1,21331,1.0,122,3098@TOP@human_GAPDH_TAA_len41_fa20_ta0_fm14_tm6,g
3098@TOP@human_GAPDH_TAA_len41_fa20_ta0_fm14_tm6*123*t,4,0,2,21047,21053,0.0,123,3098@TOP@human_GAPDH_TAA_len41_fa20_ta0_fm14_tm6,t
3098@TOP@human_GAPDH_TAA_len41_fa20_ta0_fm14_tm6*124*a,20001,0,998,0,20999,0.048,124,3098@TOP@human_GAPDH_TAA_len41_fa20_ta0_fm14_tm6,a
3098@TOP@human_GAPDH_TAA_len41_fa20_ta0_fm14_tm6*125*a,20566,1,365,0,20932,0.017,125,3098@TOP@human_GAPDH_TAA_len41_fa20_ta0_fm14_tm6,a
3098@TOP@human_GAPDH_TAA_len41_fa20_ta0_fm14_tm6*126*g,2,1,21057,0,21060,1.0,126,3098@TOP@human_GAPDH_TAA_len41_fa20_ta0_fm14_tm6,g
3098@TOP@human_GAPDH_TAA_len41_fa20_ta0_fm14_tm6*127*a,21282,2,14,0,21298,0.001,127,3098@TOP@human_GAPDH_TAA_len41_fa20_ta0_fm14_tm6,a
3098@TOP@human_GAPDH_TAA_len41_fa20_ta0_fm14_tm6*128*c,2,21371,0,0,21373,0.0,128,3098@TOP@human_GAPDH_TAA_len41_fa20_ta0_fm14_tm6,c
3098@TOP@human_GAPDH_TAA_len41_fa20_ta0_fm14_tm6*129*c,0,21238,0,1,21239,0.0,129,3098@TOP@human_GAPDH_TAA_len41_fa20_ta0_fm14_tm6,c
3098@TOP@human_GAPDH_TAA_len41_fa20_ta0_fm14_tm6*130*c,2,21333,0,3,21338,0.0,130,3098@TOP@human_GAPDH_TAA_len41_fa20_ta0_fm14_tm6,c
3098@TOP@human_GAPDH_TAA_len41_fa20_ta0_fm14_tm6*131*c,2,21375,0,2,21379,0.0,131,3098@TOP@human_GAPDH_TAA_len41_fa20_ta0_fm14_tm6,c
3098@TOP@human_GAPDH_TAA_len41_fa20_ta0_fm14_tm6*132*t,5,6,1,21070,21082,0.0,132,3098@TOP@human_GAPDH_TAA_len41_fa20_ta0_fm14_tm6,t
3098@TOP@human_GAPDH_TAA_len41_fa20_ta0_fm14_tm6*133*g,1,1,21032,0,21034,1.0,133,3098@TOP@human_GAPDH_TAA_len41_fa20_ta0_fm14_tm6,g
3098@TOP@human_GAPDH_TAA_len41_fa20_ta0_fm14_tm6*134*g,1,4,21147,0,21152,1.0,134,3098@TOP@human_GAPDH_TAA_len41_fa20_ta0_fm14_tm6,g
3099@TOP@human_GAPDH_TAA_len41_fa20_ta0_fm14_tm6*114*t,2,3,0,15087,15092,0.0,114,3099@TOP@human_GAPDH_TAA_len41_fa20_ta0_fm14_tm6,t
3099@TOP@human_GAPDH_TAA_len41_fa20_ta0_fm14_tm6*115*c,0,15183,0,2,15185,0.0,115,3099@TOP@human_GAPDH_TAA_len41_fa20_ta0_fm14_tm6,c
3099@TOP@human_GAPDH_TAA_len41_fa20_ta0_fm14_tm6*116*c,0,15118,0,4,15122,0.0,116,3099@TOP@human_GAPDH_TAA_len41_fa20_ta0_fm14_tm6,c
3099@TOP@human_GAPDH_TAA_len41_fa20_ta0_fm14_tm6*117*a,15084,0,42,0,15126,0.003,117,3099@TOP@human_GAPDH_TAA_len41_fa20_ta0_fm14_tm6,a
3099@TOP@human_GAPDH_TAA_len41_fa20_ta0_fm14_tm6*118*a,14760,0,298,0,15058,0.02,118,3099@TOP@human_GAPDH_TAA_len41_fa20_ta0_fm14_tm6,a
3099@TOP@human_GAPDH_TAA_len41_fa20_ta0_fm14_tm6*119*g,0,1,15020,1,15022,1.0,119,3099@TOP@human_GAPDH_TAA_len41_fa20_ta0_fm14_tm6,g
3099@TOP@human_GAPDH_TAA_len41_fa20_ta0_fm14_tm6*120*g,1,1,14927,3,14932,1.0,120,3099@TOP@human_GAPDH_TAA_len41_fa20_ta0_fm14_tm6,g
3099@TOP@human_GAPDH_TAA_len41_fa20_ta0_fm14_tm6*121*a,15097,0,2,0,15099,0.0,121,3099@TOP@human_GAPDH_TAA_len41_fa20_ta0_fm14_tm6,a
3099@TOP@human_GAPDH_TAA_len41_fa20_ta0_fm14_tm6*122*g,0,0,15120,2,15122,1.0,122,3099@TOP@human_GAPDH_TAA_len41_fa20_ta0_fm14_tm6,g
3099@TOP@human_GAPDH_TAA_len41_fa20_ta0_fm14_tm6*123*t,1,3,0,14895,14899,0.0,123,3099@TOP@human_GAPDH_TAA_len41_fa20_ta0_fm14_tm6,t
3099@TOP@human_GAPDH_TAA_len41_fa20_ta0_fm14_tm6*124*a,14392,0,458,0,14850,0.031,124,3099@TOP@human_GAPDH_TAA_len41_fa20_ta0_fm14_tm6,a
3099@TOP@human_GAPDH_TAA_len41_fa20_ta0_fm14_tm6*125*a,14596,0,234,1,14831,0.016,125,3099@TOP@human_GAPDH_TAA_len41_fa20_ta0_fm14_tm6,a
3099@TOP@human_GAPDH_TAA_len41_fa20_ta0_fm14_tm6*126*g,1,0,14927,0,14928,1.0,126,3099@TOP@human_GAPDH_TAA_len41_fa20_ta0_fm14_tm6,g
3099@TOP@human_GAPDH_TAA_len41_fa20_ta0_fm14_tm6*127*a,15049,0,4,0,15053,0.0,127,3099@TOP@human_GAPDH_TAA_len41_fa20_ta0_fm14_tm6,a
3099@TOP@human_GAPDH_TAA_len41_fa20_ta0_fm14_tm6*128*c,0,15145,1,0,15146,0.0,128,3099@TOP@human_GAPDH_TAA_len41_fa20_ta0_fm14_tm6,c
3099@TOP@human_GAPDH_TAA_len41_fa20_ta0_fm14_tm6*129*c,0,15042,0,0,15042,0.0,129,3099@TOP@human_GAPDH_TAA_len41_fa20_ta0_fm14_tm6,c
3099@TOP@human_GAPDH_TAA_len41_fa20_ta0_fm14_tm6*130*c,0,15123,0,0,15123,0.0,130,3099@TOP@human_GAPDH_TAA_len41_fa20_ta0_fm14_tm6,c
3099@TOP@human_GAPDH_TAA_len41_fa20_ta0_fm14_tm6*131*c,0,15168,0,0,15168,0.0,131,3099@TOP@human_GAPDH_TAA_len41_fa20_ta0_fm14_tm6,c
3099@TOP@human_GAPDH_TAA_len41_fa20_ta0_fm14_tm6*132*t,2,4,4,14925,14935,0.0,132,3099@TOP@human_GAPDH_TAA_len41_fa20_ta0_fm14_tm6,t
3099@TOP@human_GAPDH_TAA_len41_fa20_ta0_fm14_tm6*133*g,2,3,14878,0,14883,1.0,133,3099@TOP@human_GAPDH_TAA_len41_fa20_ta0_fm14_tm6,g
3099@TOP@human_GAPDH_TAA_len41_fa20_ta0_fm14_tm6*134*g,0,4,14988,0,14992,1.0,134,3099@TOP@human_GAPDH_TAA_len41_fa20_ta0_fm14_tm6,g
3100@TOP@human_GAPDH_TAA_len41_fa20_ta0_fm14_tm6*114*t,2,6,3,31615,31626,0.0,114,3100@TOP@human_GAPDH_TAA_len41_fa20_ta0_fm14_tm6,t
3100@TOP@human_GAPDH_TAA_len41_fa20_ta0_fm14_tm6*115*c,3,31800,0,1,31804,0.0,115,3100@TOP@human_GAPDH_TAA_len41_fa20_ta0_fm14_tm6,c
3100@TOP@human_GAPDH_TAA_len41_fa20_ta0_fm14_tm6*116*c,0,31653,0,1,31654,0.0,116,3100@TOP@human_GAPDH_TAA_len41_fa20_ta0_fm14_tm6,c
3100@TOP@human_GAPDH_TAA_len41_fa20_ta0_fm14_tm6*117*a,31624,0,37,0,31661,0.001,117,3100@TOP@human_GAPDH_TAA_len41_fa20_ta0_fm14_tm6,a
3100@TOP@human_GAPDH_TAA_len41_fa20_ta0_fm14_tm6*118*a,31107,1,381,1,31490,0.012,118,3100@TOP@human_GAPDH_TAA_len41_fa20_ta0_fm14_tm6,a
3100@TOP@human_GAPDH_TAA_len41_fa20_ta0_fm14_tm6*119*g,0,0,31390,1,31391,1.0,119,3100@TOP@human_GAPDH_TAA_len41_fa20_ta0_fm14_tm6,g
3100@TOP@human_GAPDH_TAA_len41_fa20_ta0_fm14_tm6*120*g,4,0,31292,0,31296,1.0,120,3100@TOP@human_GAPDH_TAA_len41_fa20_ta0_fm14_tm6,g
3100@TOP@human_GAPDH_TAA_len41_fa20_ta0_fm14_tm6*121*a,31629,0,5,0,31634,0.0,121,3100@TOP@human_GAPDH_TAA_len41_fa20_ta0_fm14_tm6,a
3100@TOP@human_GAPDH_TAA_len41_fa20_ta0_fm14_tm6*122*g,1,1,31667,1,31670,1.0,122,3100@TOP@human_GAPDH_TAA_len41_fa20_ta0_fm14_tm6,g
3100@TOP@human_GAPDH_TAA_len41_fa20_ta0_fm14_tm6*123*t,2,3,3,31249,31257,0.0,123,3100@TOP@human_GAPDH_TAA_len41_fa20_ta0_fm14_tm6,t
3100@TOP@human_GAPDH_TAA_len41_fa20_ta0_fm14_tm6*124*a,30239,7,892,0,31138,0.029,124,3100@TOP@human_GAPDH_TAA_len41_fa20_ta0_fm14_tm6,a
3100@TOP@human_GAPDH_TAA_len41_fa20_ta0_fm14_tm6*125*a,30566,1,495,1,31063,0.016,125,3100@TOP@human_GAPDH_TAA_len41_fa20_ta0_fm14_tm6,a
3100@TOP@human_GAPDH_TAA_len41_fa20_ta0_fm14_tm6*126*g,1,2,31211,0,31214,1.0,126,3100@TOP@human_GAPDH_TAA_len41_fa20_ta0_fm14_tm6,g
3100@TOP@human_GAPDH_TAA_len41_fa20_ta0_fm14_tm6*127*a,31525,2,15,0,31542,0.0,127,3100@TOP@human_GAPDH_TAA_len41_fa20_ta0_fm14_tm6,a
3100@TOP@human_GAPDH_TAA_len41_fa20_ta0_fm14_tm6*128*c,0,31735,2,1,31738,0.0,128,3100@TOP@human_GAPDH_TAA_len41_fa20_ta0_fm14_tm6,c
3100@TOP@human_GAPDH_TAA_len41_fa20_ta0_fm14_tm6*129*c,6,31493,0,0,31499,0.0,129,3100@TOP@human_GAPDH_TAA_len41_fa20_ta0_fm14_tm6,c
3100@TOP@human_GAPDH_TAA_len41_fa20_ta0_fm14_tm6*130*c,7,31675,0,0,31682,0.0,130,3100@TOP@human_GAPDH_TAA_len41_fa20_ta0_fm14_tm6,c
3100@TOP@human_GAPDH_TAA_len41_fa20_ta0_fm14_tm6*131*c,2,31722,0,3,31727,0.0,131,3100@TOP@human_GAPDH_TAA_len41_fa20_ta0_fm14_tm6,c
3100@TOP@human_GAPDH_TAA_len41_fa20_ta0_fm14_tm6*132*t,6,7,0,31268,31281,0.0,132,3100@TOP@human_GAPDH_TAA_len41_fa20_ta0_fm14_tm6,t
3100@TOP@human_GAPDH_TAA_len41_fa20_ta0_fm14_tm6*133*g,1,1,31237,0,31239,1.0,133,3100@TOP@human_GAPDH_TAA_len41_fa20_ta0_fm14_tm6,g
3100@TOP@human_GAPDH_TAA_len41_fa20_ta0_fm14_tm6*134*g,3,1,31397,2,31403,1.0,134,3100@TOP@human_GAPDH_TAA_len41_fa20_ta0_fm14_tm6,g
3101@TOP@human_GAPDH_TAA_len41_fa20_ta0_fm14_tm6*114*t,0,4,1,12932,12937,0.0,114,3101@TOP@human_GAPDH_TAA_len41_fa20_ta0_fm14_tm6,t
3101@TOP@human_GAPDH_TAA_len41_fa20_ta0_fm14_tm6*115*c,1,12994,0,0,12995,0.0,115,3101@TOP@human_GAPDH_TAA_len41_fa20_ta0_fm14_tm6,c
3101@TOP@human_GAPDH_TAA_len41_fa20_ta0_fm14_tm6*116*c,0,12938,0,1,12939,0.0,116,3101@TOP@human_GAPDH_TAA_len41_fa20_ta0_fm14_tm6,c
3101@TOP@human_GAPDH_TAA_len41_fa20_ta0_fm14_tm6*117*a,12890,3,23,1,12917,0.002,117,3101@TOP@human_GAPDH_TAA_len41_fa20_ta0_fm14_tm6,a
3101@TOP@human_GAPDH_TAA_len41_fa20_ta0_fm14_tm6*118*a,12546,0,314,0,12860,0.024,118,3101@TOP@human_GAPDH_TAA_len41_fa20_ta0_fm14_tm6,a
3101@TOP@human_GAPDH_TAA_len41_fa20_ta0_fm14_tm6*119*g,0,0,12858,0,12858,1.0,119,3101@TOP@human_GAPDH_TAA_len41_fa20_ta0_fm14_tm6,g
3101@TOP@human_GAPDH_TAA_len41_fa20_ta0_fm14_tm6*120*g,0,0,12771,3,12774,1.0,120,3101@TOP@human_GAPDH_TAA_len41_fa20_ta0_fm14_tm6,g
3101@TOP@human_GAPDH_TAA_len41_fa20_ta0_fm14_tm6*121*a,12912,0,3,0,12915,0.0,121,3101@TOP@human_GAPDH_TAA_len41_fa20_ta0_fm14_tm6,a
3101@TOP@human_GAPDH_TAA_len41_fa20_ta0_fm14_tm6*122*g,0,0,12943,1,12944,1.0,122,3101@TOP@human_GAPDH_TAA_len41_fa20_ta0_fm14_tm6,g
3101@TOP@human_GAPDH_TAA_len41_fa20_ta0_fm14_tm6*123*t,1,3,2,12746,12752,0.0,123,3101@TOP@human_GAPDH_TAA_len41_fa20_ta0_fm14_tm6,t
3101@TOP@human_GAPDH_TAA_len41_fa20_ta0_fm14_tm6*124*a,12237,0,471,0,12708,0.037,124,3101@TOP@human_GAPDH_TAA_len41_fa20_ta0_fm14_tm6,a
3101@TOP@human_GAPDH_TAA_len41_fa20_ta0_fm14_tm6*125*a,12504,0,208,3,12715,0.016,125,3101@TOP@human_GAPDH_TAA_len41_fa20_ta0_fm14_tm6,a
3101@TOP@human_GAPDH_TAA_len41_fa20_ta0_fm14_tm6*126*g,0,0,12748,0,12748,1.0,126,3101@TOP@human_GAPDH_TAA_len41_fa20_ta0_fm14_tm6,g
3101@TOP@human_GAPDH_TAA_len41_fa20_ta0_fm14_tm6*127*a,12889,0,7,1,12897,0.001,127,3101@TOP@human_GAPDH_TAA_len41_fa20_ta0_fm14_tm6,a
3101@TOP@human_GAPDH_TAA_len41_fa20_ta0_fm14_tm6*128*c,0,12959,1,1,12961,0.0,128,3101@TOP@human_GAPDH_TAA_len41_fa20_ta0_fm14_tm6,c
3101@TOP@human_GAPDH_TAA_len41_fa20_ta0_fm14_tm6*129*c,0,12866,0,0,12866,0.0,129,3101@TOP@human_GAPDH_TAA_len41_fa20_ta0_fm14_tm6,c
3101@TOP@human_GAPDH_TAA_len41_fa20_ta0_fm14_tm6*130*c,1,12931,0,2,12934,0.0,130,3101@TOP@human_GAPDH_TAA_len41_fa20_ta0_fm14_tm6,c
3101@TOP@human_GAPDH_TAA_len41_fa20_ta0_fm14_tm6*131*c,2,12970,0,4,12976,0.0,131,3101@TOP@human_GAPDH_TAA_len41_fa20_ta0_fm14_tm6,c
3101@TOP@human_GAPDH_TAA_len41_fa20_ta0_fm14_tm6*132*t,3,5,1,12779,12788,0.0,132,3101@TOP@human_GAPDH_TAA_len41_fa20_ta0_fm14_tm6,t
3101@TOP@human_GAPDH_TAA_len41_fa20_ta0_fm14_tm6*133*g,1,0,12788,2,12791,1.0,133,3101@TOP@human_GAPDH_TAA_len41_fa20_ta0_fm14_tm6,g
3101@TOP@human_GAPDH_TAA_len41_fa20_ta0_fm14_tm6*134*g,0,5,12817,0,12822,1.0,134,3101@TOP@human_GAPDH_TAA_len41_fa20_ta0_fm14_tm6,g
3102@TOP@human_GAPDH_TAA_len41_fa20_ta0_fm14_tm6*114*t,0,5,0,8315,8320,0.0,114,3102@TOP@human_GAPDH_TAA_len41_fa20_ta0_fm14_tm6,t
3102@TOP@human_GAPDH_TAA_len41_fa20_ta0_fm14_tm6*115*c,0,8371,0,0,8371,0.0,115,3102@TOP@human_GAPDH_TAA_len41_fa20_ta0_fm14_tm6,c
3102@TOP@human_GAPDH_TAA_len41_fa20_ta0_fm14_tm6*116*c,0,8339,0,2,8341,0.0,116,3102@TOP@human_GAPDH_TAA_len41_fa20_ta0_fm14_tm6,c
3102@TOP@human_GAPDH_TAA_len41_fa20_ta0_fm14_tm6*117*a,8328,1,13,0,8342,0.002,117,3102@TOP@human_GAPDH_TAA_len41_fa20_ta0_fm14_tm6,a
3102@TOP@human_GAPDH_TAA_len41_fa20_ta0_fm14_tm6*118*a,8145,0,137,0,8282,0.017,118,3102@TOP@human_GAPDH_TAA_len41_fa20_ta0_fm14_tm6,a
3102@TOP@human_GAPDH_TAA_len41_fa20_ta0_fm14_tm6*119*g,0,0,8269,0,8269,1.0,119,3102@TOP@human_GAPDH_TAA_len41_fa20_ta0_fm14_tm6,g
3102@TOP@human_GAPDH_TAA_len41_fa20_ta0_fm14_tm6*120*g,0,0,8224,0,8224,1.0,120,3102@TOP@human_GAPDH_TAA_len41_fa20_ta0_fm14_tm6,g
3102@TOP@human_GAPDH_TAA_len41_fa20_ta0_fm14_tm6*121*a,8327,0,6,0,8333,0.001,121,3102@TOP@human_GAPDH_TAA_len41_fa20_ta0_fm14_tm6,a
3102@TOP@human_GAPDH_TAA_len41_fa20_ta0_fm14_tm6*122*g,0,0,8343,0,8343,1.0,122,3102@TOP@human_GAPDH_TAA_len41_fa20_ta0_fm14_tm6,g
3102@TOP@human_GAPDH_TAA_len41_fa20_ta0_fm14_tm6*123*t,0,0,1,8230,8231,0.0,123,3102@TOP@human_GAPDH_TAA_len41_fa20_ta0_fm14_tm6,t
3102@TOP@human_GAPDH_TAA_len41_fa20_ta0_fm14_tm6*124*a,7698,0,531,0,8229,0.065,124,3102@TOP@human_GAPDH_TAA_len41_fa20_ta0_fm14_tm6,a
3102@TOP@human_GAPDH_TAA_len41_fa20_ta0_fm14_tm6*125*a,8036,0,154,0,8190,0.019,125,3102@TOP@human_GAPDH_TAA_len41_fa20_ta0_fm14_tm6,a
3102@TOP@human_GAPDH_TAA_len41_fa20_ta0_fm14_tm6*126*g,0,0,8243,0,8243,1.0,126,3102@TOP@human_GAPDH_TAA_len41_fa20_ta0_fm14_tm6,g
3102@TOP@human_GAPDH_TAA_len41_fa20_ta0_fm14_tm6*127*a,8293,0,4,0,8297,0.0,127,3102@TOP@human_GAPDH_TAA_len41_fa20_ta0_fm14_tm6,a
3102@TOP@human_GAPDH_TAA_len41_fa20_ta0_fm14_tm6*128*c,0,8345,0,0,8345,0.0,128,3102@TOP@human_GAPDH_TAA_len41_fa20_ta0_fm14_tm6,c
3102@TOP@human_GAPDH_TAA_len41_fa20_ta0_fm14_tm6*129*c,0,8298,0,0,8298,0.0,129,3102@TOP@human_GAPDH_TAA_len41_fa20_ta0_fm14_tm6,c
3102@TOP@human_GAPDH_TAA_len41_fa20_ta0_fm14_tm6*130*c,3,8332,0,0,8335,0.0,130,3102@TOP@human_GAPDH_TAA_len41_fa20_ta0_fm14_tm6,c
3102@TOP@human_GAPDH_TAA_len41_fa20_ta0_fm14_tm6*131*c,0,8355,0,1,8356,0.0,131,3102@TOP@human_GAPDH_TAA_len41_fa20_ta0_fm14_tm6,c
3102@TOP@human_GAPDH_TAA_len41_fa20_ta0_fm14_tm6*132*t,0,3,1,8220,8224,0.0,132,3102@TOP@human_GAPDH_TAA_len41_fa20_ta0_fm14_tm6,t
3102@TOP@human_GAPDH_TAA_len41_fa20_ta0_fm14_tm6*133*g,0,0,8225,0,8225,1.0,133,3102@TOP@human_GAPDH_TAA_len41_fa20_ta0_fm14_tm6,g
3102@TOP@human_GAPDH_TAA_len41_fa20_ta0_fm14_tm6*134*g,0,1,8260,1,8262,1.0,134,3102@TOP@human_GAPDH_TAA_len41_fa20_ta0_fm14_tm6,g
3103@TOP@human_GAPDH_TAA_len41_fa20_ta0_fm14_tm6*114*t,1,3,0,19987,19991,0.0,114,3103@TOP@human_GAPDH_TAA_len41_fa20_ta0_fm14_tm6,t
3103@TOP@human_GAPDH_TAA_len41_fa20_ta0_fm14_tm6*115*c,0,20083,1,0,20084,0.0,115,3103@TOP@human_GAPDH_TAA_len41_fa20_ta0_fm14_tm6,c
3103@TOP@human_GAPDH_TAA_len41_fa20_ta0_fm14_tm6*116*c,1,20006,0,1,20008,0.0,116,3103@TOP@human_GAPDH_TAA_len41_fa20_ta0_fm14_tm6,c
3103@TOP@human_GAPDH_TAA_len41_fa20_ta0_fm14_tm6*117*a,20005,2,15,0,20022,0.001,117,3103@TOP@human_GAPDH_TAA_len41_fa20_ta0_fm14_tm6,a
3103@TOP@human_GAPDH_TAA_len41_fa20_ta0_fm14_tm6*118*a,19592,0,299,0,19891,0.015,118,3103@TOP@human_GAPDH_TAA_len41_fa20_ta0_fm14_tm6,a
3103@TOP@human_GAPDH_TAA_len41_fa20_ta0_fm14_tm6*119*g,0,0,19888,0,19888,1.0,119,3103@TOP@human_GAPDH_TAA_len41_fa20_ta0_fm14_tm6,g
3103@TOP@human_GAPDH_TAA_len41_fa20_ta0_fm14_tm6*120*g,3,0,19797,0,19800,1.0,120,3103@TOP@human_GAPDH_TAA_len41_fa20_ta0_fm14_tm6,g
3103@TOP@human_GAPDH_TAA_len41_fa20_ta0_fm14_tm6*121*a,19990,0,9,0,19999,0.0,121,3103@TOP@human_GAPDH_TAA_len41_fa20_ta0_fm14_tm6,a
3103@TOP@human_GAPDH_TAA_len41_fa20_ta0_fm14_tm6*122*g,5,0,20011,0,20016,1.0,122,3103@TOP@human_GAPDH_TAA_len41_fa20_ta0_fm14_tm6,g
3103@TOP@human_GAPDH_TAA_len41_fa20_ta0_fm14_tm6*123*t,2,5,2,19777,19786,0.0,123,3103@TOP@human_GAPDH_TAA_len41_fa20_ta0_fm14_tm6,t
3103@TOP@human_GAPDH_TAA_len41_fa20_ta0_fm14_tm6*124*a,19017,2,660,0,19679,0.034,124,3103@TOP@human_GAPDH_TAA_len41_fa20_ta0_fm14_tm6,a
3103@TOP@human_GAPDH_TAA_len41_fa20_ta0_fm14_tm6*125*a,19317,0,358,1,19676,0.018,125,3103@TOP@human_GAPDH_TAA_len41_fa20_ta0_fm14_tm6,a
3103@TOP@human_GAPDH_TAA_len41_fa20_ta0_fm14_tm6*126*g,0,0,19781,0,19781,1.0,126,3103@TOP@human_GAPDH_TAA_len41_fa20_ta0_fm14_tm6,g
3103@TOP@human_GAPDH_TAA_len41_fa20_ta0_fm14_tm6*127*a,19908,2,22,0,19932,0.001,127,3103@TOP@human_GAPDH_TAA_len41_fa20_ta0_fm14_tm6,a
3103@TOP@human_GAPDH_TAA_len41_fa20_ta0_fm14_tm6*128*c,1,20036,5,0,20042,0.0,128,3103@TOP@human_GAPDH_TAA_len41_fa20_ta0_fm14_tm6,c
3103@TOP@human_GAPDH_TAA_len41_fa20_ta0_fm14_tm6*129*c,0,19907,1,1,19909,0.0,129,3103@TOP@human_GAPDH_TAA_len41_fa20_ta0_fm14_tm6,c
3103@TOP@human_GAPDH_TAA_len41_fa20_ta0_fm14_tm6*130*c,6,20004,0,0,20010,0.0,130,3103@TOP@human_GAPDH_TAA_len41_fa20_ta0_fm14_tm6,c
3103@TOP@human_GAPDH_TAA_len41_fa20_ta0_fm14_tm6*131*c,2,20057,0,2,20061,0.0,131,3103@TOP@human_GAPDH_TAA_len41_fa20_ta0_fm14_tm6,c
3103@TOP@human_GAPDH_TAA_len41_fa20_ta0_fm14_tm6*132*t,0,2,1,19779,19782,0.0,132,3103@TOP@human_GAPDH_TAA_len41_fa20_ta0_fm14_tm6,t
3103@TOP@human_GAPDH_TAA_len41_fa20_ta0_fm14_tm6*133*g,2,0,19765,0,19767,1.0,133,3103@TOP@human_GAPDH_TAA_len41_fa20_ta0_fm14_tm6,g
3103@TOP@human_GAPDH_TAA_len41_fa20_ta0_fm14_tm6*134*g,2,8,19857,2,19869,0.999,134,3103@TOP@human_GAPDH_TAA_len41_fa20_ta0_fm14_tm6,g
3104@TOP@human_GAPDH_TAA_len41_fa20_ta0_fm14_tm6*114*t,1,5,0,25327,25333,0.0,114,3104@TOP@human_GAPDH_TAA_len41_fa20_ta0_fm14_tm6,t
3104@TOP@human_GAPDH_TAA_len41_fa20_ta0_fm14_tm6*115*c,0,25475,0,3,25478,0.0,115,3104@TOP@human_GAPDH_TAA_len41_fa20_ta0_fm14_tm6,c
3104@TOP@human_GAPDH_TAA_len41_fa20_ta0_fm14_tm6*116*c,1,25393,0,0,25394,0.0,116,3104@TOP@human_GAPDH_TAA_len41_fa20_ta0_fm14_tm6,c
3104@TOP@human_GAPDH_TAA_len41_fa20_ta0_fm14_tm6*117*a,25330,0,34,0,25364,0.001,117,3104@TOP@human_GAPDH_TAA_len41_fa20_ta0_fm14_tm6,a
3104@TOP@human_GAPDH_TAA_len41_fa20_ta0_fm14_tm6*118*a,24870,2,361,0,25233,0.014,118,3104@TOP@human_GAPDH_TAA_len41_fa20_ta0_fm14_tm6,a
3104@TOP@human_GAPDH_TAA_len41_fa20_ta0_fm14_tm6*119*g,3,2,25145,0,25150,1.0,119,3104@TOP@human_GAPDH_TAA_len41_fa20_ta0_fm14_tm6,g
3104@TOP@human_GAPDH_TAA_len41_fa20_ta0_fm14_tm6*120*g,3,3,25079,0,25085,1.0,120,3104@TOP@human_GAPDH_TAA_len41_fa20_ta0_fm14_tm6,g
3104@TOP@human_GAPDH_TAA_len41_fa20_ta0_fm14_tm6*121*a,25357,0,6,0,25363,0.0,121,3104@TOP@human_GAPDH_TAA_len41_fa20_ta0_fm14_tm6,a
3104@TOP@human_GAPDH_TAA_len41_fa20_ta0_fm14_tm6*122*g,1,0,25359,0,25360,1.0,122,3104@TOP@human_GAPDH_TAA_len41_fa20_ta0_fm14_tm6,g
3104@TOP@human_GAPDH_TAA_len41_fa20_ta0_fm14_tm6*123*t,2,2,2,24991,24997,0.0,123,3104@TOP@human_GAPDH_TAA_len41_fa20_ta0_fm14_tm6,t
3104@TOP@human_GAPDH_TAA_len41_fa20_ta0_fm14_tm6*124*a,23620,0,1317,0,24937,0.053,124,3104@TOP@human_GAPDH_TAA_len41_fa20_ta0_fm14_tm6,a
3104@TOP@human_GAPDH_TAA_len41_fa20_ta0_fm14_tm6*125*a,24537,3,395,2,24937,0.016,125,3104@TOP@human_GAPDH_TAA_len41_fa20_ta0_fm14_tm6,a
3104@TOP@human_GAPDH_TAA_len41_fa20_ta0_fm14_tm6*126*g,2,0,25048,1,25051,1.0,126,3104@TOP@human_GAPDH_TAA_len41_fa20_ta0_fm14_tm6,g
3104@TOP@human_GAPDH_TAA_len41_fa20_ta0_fm14_tm6*127*a,25269,0,18,2,25289,0.001,127,3104@TOP@human_GAPDH_TAA_len41_fa20_ta0_fm14_tm6,a
3104@TOP@human_GAPDH_TAA_len41_fa20_ta0_fm14_tm6*128*c,0,25421,3,0,25424,0.0,128,3104@TOP@human_GAPDH_TAA_len41_fa20_ta0_fm14_tm6,c
3104@TOP@human_GAPDH_TAA_len41_fa20_ta0_fm14_tm6*129*c,5,25239,0,1,25245,0.0,129,3104@TOP@human_GAPDH_TAA_len41_fa20_ta0_fm14_tm6,c
3104@TOP@human_GAPDH_TAA_len41_fa20_ta0_fm14_tm6*130*c,1,25371,0,0,25372,0.0,130,3104@TOP@human_GAPDH_TAA_len41_fa20_ta0_fm14_tm6,c
3104@TOP@human_GAPDH_TAA_len41_fa20_ta0_fm14_tm6*131*c,1,25427,0,8,25436,0.0,131,3104@TOP@human_GAPDH_TAA_len41_fa20_ta0_fm14_tm6,c
3104@TOP@human_GAPDH_TAA_len41_fa20_ta0_fm14_tm6*132*t,4,6,1,25052,25063,0.0,132,3104@TOP@human_GAPDH_TAA_len41_fa20_ta0_fm14_tm6,t
3104@TOP@human_GAPDH_TAA_len41_fa20_ta0_fm14_tm6*133*g,2,1,25038,0,25041,1.0,133,3104@TOP@human_GAPDH_TAA_len41_fa20_ta0_fm14_tm6,g
3104@TOP@human_GAPDH_TAA_len41_fa20_ta0_fm14_tm6*134*g,2,6,25147,1,25156,1.0,134,3104@TOP@human_GAPDH_TAA_len41_fa20_ta0_fm14_tm6,g
3105@TOP@human_GAPDH_TAA_len41_fa20_ta0_fm14_tm6*114*t,0,0,0,2221,2221,0.0,114,3105@TOP@human_GAPDH_TAA_len41_fa20_ta0_fm14_tm6,t
3105@TOP@human_GAPDH_TAA_len41_fa20_ta0_fm14_tm6*115*c,0,2237,0,0,2237,0.0,115,3105@TOP@human_GAPDH_TAA_len41_fa20_ta0_fm14_tm6,c
3105@TOP@human_GAPDH_TAA_len41_fa20_ta0_fm14_tm6*116*c,0,2230,0,0,2230,0.0,116,3105@TOP@human_GAPDH_TAA_len41_fa20_ta0_fm14_tm6,c
3105@TOP@human_GAPDH_TAA_len41_fa20_ta0_fm14_tm6*117*a,2227,0,5,0,2232,0.002,117,3105@TOP@human_GAPDH_TAA_len41_fa20_ta0_fm14_tm6,a
3105@TOP@human_GAPDH_TAA_len41_fa20_ta0_fm14_tm6*118*a,2187,0,24,0,2211,0.011,118,3105@TOP@human_GAPDH_TAA_len41_fa20_ta0_fm14_tm6,a
3105@TOP@human_GAPDH_TAA_len41_fa20_ta0_fm14_tm6*119*g,0,0,2217,0,2217,1.0,119,3105@TOP@human_GAPDH_TAA_len41_fa20_ta0_fm14_tm6,g
3105@TOP@human_GAPDH_TAA_len41_fa20_ta0_fm14_tm6*120*g,0,0,2195,1,2196,1.0,120,3105@TOP@human_GAPDH_TAA_len41_fa20_ta0_fm14_tm6,g
3105@TOP@human_GAPDH_TAA_len41_fa20_ta0_fm14_tm6*121*a,2222,0,1,0,2223,0.0,121,3105@TOP@human_GAPDH_TAA_len41_fa20_ta0_fm14_tm6,a
3105@TOP@human_GAPDH_TAA_len41_fa20_ta0_fm14_tm6*122*g,0,0,2229,2,2231,0.999,122,3105@TOP@human_GAPDH_TAA_len41_fa20_ta0_fm14_tm6,g
3105@TOP@human_GAPDH_TAA_len41_fa20_ta0_fm14_tm6*123*t,0,0,0,2201,2201,0.0,123,3105@TOP@human_GAPDH_TAA_len41_fa20_ta0_fm14_tm6,t
3105@TOP@human_GAPDH_TAA_len41_fa20_ta0_fm14_tm6*124*a,2105,0,86,0,2191,0.039,124,3105@TOP@human_GAPDH_TAA_len41_fa20_ta0_fm14_tm6,a
3105@TOP@human_GAPDH_TAA_len41_fa20_ta0_fm14_tm6*125*a,2116,0,63,0,2179,0.029,125,3105@TOP@human_GAPDH_TAA_len41_fa20_ta0_fm14_tm6,a
3105@TOP@human_GAPDH_TAA_len41_fa20_ta0_fm14_tm6*126*g,0,0,2196,0,2196,1.0,126,3105@TOP@human_GAPDH_TAA_len41_fa20_ta0_fm14_tm6,g
3105@TOP@human_GAPDH_TAA_len41_fa20_ta0_fm14_tm6*127*a,2210,0,0,0,2210,0.0,127,3105@TOP@human_GAPDH_TAA_len41_fa20_ta0_fm14_tm6,a
3105@TOP@human_GAPDH_TAA_len41_fa20_ta0_fm14_tm6*128*c,0,2231,0,0,2231,0.0,128,3105@TOP@human_GAPDH_TAA_len41_fa20_ta0_fm14_tm6,c
3105@TOP@human_GAPDH_TAA_len41_fa20_ta0_fm14_tm6*129*c,0,2212,0,0,2212,0.0,129,3105@TOP@human_GAPDH_TAA_len41_fa20_ta0_fm14_tm6,c
3105@TOP@human_GAPDH_TAA_len41_fa20_ta0_fm14_tm6*130*c,0,2224,0,0,2224,0.0,130,3105@TOP@human_GAPDH_TAA_len41_fa20_ta0_fm14_tm6,c
3105@TOP@human_GAPDH_TAA_len41_fa20_ta0_fm14_tm6*131*c,3,2228,0,0,2231,0.0,131,3105@TOP@human_GAPDH_TAA_len41_fa20_ta0_fm14_tm6,c
3105@TOP@human_GAPDH_TAA_len41_fa20_ta0_fm14_tm6*132*t,0,0,0,2195,2195,0.0,132,3105@TOP@human_GAPDH_TAA_len41_fa20_ta0_fm14_tm6,t
3105@TOP@human_GAPDH_TAA_len41_fa20_ta0_fm14_tm6*133*g,0,0,2197,0,2197,1.0,133,3105@TOP@human_GAPDH_TAA_len41_fa20_ta0_fm14_tm6,g
3105@TOP@human_GAPDH_TAA_len41_fa20_ta0_fm14_tm6*134*g,0,0,2213,0,2213,1.0,134,3105@TOP@human_GAPDH_TAA_len41_fa20_ta0_fm14_tm6,g
3106@TOP@human_GAPDH_TAA_len41_fa20_ta0_fm14_tm6*114*t,0,2,0,5393,5395,0.0,114,3106@TOP@human_GAPDH_TAA_len41_fa20_ta0_fm14_tm6,t
3106@TOP@human_GAPDH_TAA_len41_fa20_ta0_fm14_tm6*115*c,0,5417,0,1,5418,0.0,115,3106@TOP@human_GAPDH_TAA_len41_fa20_ta0_fm14_tm6,c
3106@TOP@human_GAPDH_TAA_len41_fa20_ta0_fm14_tm6*116*c,0,5403,0,0,5403,0.0,116,3106@TOP@human_GAPDH_TAA_len41_fa20_ta0_fm14_tm6,c
3106@TOP@human_GAPDH_TAA_len41_fa20_ta0_fm14_tm6*117*a,5392,0,14,0,5406,0.003,117,3106@TOP@human_GAPDH_TAA_len41_fa20_ta0_fm14_tm6,a
3106@TOP@human_GAPDH_TAA_len41_fa20_ta0_fm14_tm6*118*a,5272,0,101,0,5373,0.019,118,3106@TOP@human_GAPDH_TAA_len41_fa20_ta0_fm14_tm6,a
3106@TOP@human_GAPDH_TAA_len41_fa20_ta0_fm14_tm6*119*g,2,0,5355,0,5357,1.0,119,3106@TOP@human_GAPDH_TAA_len41_fa20_ta0_fm14_tm6,g
3106@TOP@human_GAPDH_TAA_len41_fa20_ta0_fm14_tm6*120*g,1,0,5351,0,5352,1.0,120,3106@TOP@human_GAPDH_TAA_len41_fa20_ta0_fm14_tm6,g
3106@TOP@human_GAPDH_TAA_len41_fa20_ta0_fm14_tm6*121*a,5385,0,1,0,5386,0.0,121,3106@TOP@human_GAPDH_TAA_len41_fa20_ta0_fm14_tm6,a
3106@TOP@human_GAPDH_TAA_len41_fa20_ta0_fm14_tm6*122*g,0,0,5404,0,5404,1.0,122,3106@TOP@human_GAPDH_TAA_len41_fa20_ta0_fm14_tm6,g
3106@TOP@human_GAPDH_TAA_len41_fa20_ta0_fm14_tm6*123*t,0,2,3,5332,5337,0.001,123,3106@TOP@human_GAPDH_TAA_len41_fa20_ta0_fm14_tm6,t
3106@TOP@human_GAPDH_TAA_len41_fa20_ta0_fm14_tm6*124*a,5104,1,219,0,5324,0.041,124,3106@TOP@human_GAPDH_TAA_len41_fa20_ta0_fm14_tm6,a
3106@TOP@human_GAPDH_TAA_len41_fa20_ta0_fm14_tm6*125*a,5204,0,101,0,5305,0.019,125,3106@TOP@human_GAPDH_TAA_len41_fa20_ta0_fm14_tm6,a
3106@TOP@human_GAPDH_TAA_len41_fa20_ta0_fm14_tm6*126*g,4,0,5311,0,5315,0.999,126,3106@TOP@human_GAPDH_TAA_len41_fa20_ta0_fm14_tm6,g
3106@TOP@human_GAPDH_TAA_len41_fa20_ta0_fm14_tm6*127*a,5383,0,3,0,5386,0.001,127,3106@TOP@human_GAPDH_TAA_len41_fa20_ta0_fm14_tm6,a
3106@TOP@human_GAPDH_TAA_len41_fa20_ta0_fm14_tm6*128*c,0,5409,1,0,5410,0.0,128,3106@TOP@human_GAPDH_TAA_len41_fa20_ta0_fm14_tm6,c
3106@TOP@human_GAPDH_TAA_len41_fa20_ta0_fm14_tm6*129*c,0,5361,0,1,5362,0.0,129,3106@TOP@human_GAPDH_TAA_len41_fa20_ta0_fm14_tm6,c
3106@TOP@human_GAPDH_TAA_len41_fa20_ta0_fm14_tm6*130*c,1,5394,0,2,5397,0.0,130,3106@TOP@human_GAPDH_TAA_len41_fa20_ta0_fm14_tm6,c
3106@TOP@human_GAPDH_TAA_len41_fa20_ta0_fm14_tm6*131*c,0,5406,0,0,5406,0.0,131,3106@TOP@human_GAPDH_TAA_len41_fa20_ta0_fm14_tm6,c
3106@TOP@human_GAPDH_TAA_len41_fa20_ta0_fm14_tm6*132*t,0,0,0,5333,5333,0.0,132,3106@TOP@human_GAPDH_TAA_len41_fa20_ta0_fm14_tm6,t
3106@TOP@human_GAPDH_TAA_len41_fa20_ta0_fm14_tm6*133*g,1,0,5328,0,5329,1.0,133,3106@TOP@human_GAPDH_TAA_len41_fa20_ta0_fm14_tm6,g
3106@TOP@human_GAPDH_TAA_len41_fa20_ta0_fm14_tm6*134*g,0,4,5352,0,5356,0.999,134,3106@TOP@human_GAPDH_TAA_len41_fa20_ta0_fm14_tm6,g
3107@TOP@human_GAPDH_TAA_len41_fa20_ta0_fm14_tm6*114*t,0,0,0,1218,1218,0.0,114,3107@TOP@human_GAPDH_TAA_len41_fa20_ta0_fm14_tm6,t
3107@TOP@human_GAPDH_TAA_len41_fa20_ta0_fm14_tm6*115*c,0,1226,0,0,1226,0.0,115,3107@TOP@human_GAPDH_TAA_len41_fa20_ta0_fm14_tm6,c
3107@TOP@human_GAPDH_TAA_len41_fa20_ta0_fm14_tm6*116*c,0,1220,0,0,1220,0.0,116,3107@TOP@human_GAPDH_TAA_len41_fa20_ta0_fm14_tm6,c
3107@TOP@human_GAPDH_TAA_len41_fa20_ta0_fm14_tm6*117*a,1218,0,2,0,1220,0.002,117,3107@TOP@human_GAPDH_TAA_len41_fa20_ta0_fm14_tm6,a
3107@TOP@human_GAPDH_TAA_len41_fa20_ta0_fm14_tm6*118*a,1174,0,44,0,1218,0.036,118,3107@TOP@human_GAPDH_TAA_len41_fa20_ta0_fm14_tm6,a
3107@TOP@human_GAPDH_TAA_len41_fa20_ta0_fm14_tm6*119*g,0,0,1211,0,1211,1.0,119,3107@TOP@human_GAPDH_TAA_len41_fa20_ta0_fm14_tm6,g
3107@TOP@human_GAPDH_TAA_len41_fa20_ta0_fm14_tm6*120*g,0,0,1212,0,1212,1.0,120,3107@TOP@human_GAPDH_TAA_len41_fa20_ta0_fm14_tm6,g
3107@TOP@human_GAPDH_TAA_len41_fa20_ta0_fm14_tm6*121*a,1220,0,0,0,1220,0.0,121,3107@TOP@human_GAPDH_TAA_len41_fa20_ta0_fm14_tm6,a
3107@TOP@human_GAPDH_TAA_len41_fa20_ta0_fm14_tm6*122*g,0,0,1223,0,1223,1.0,122,3107@TOP@human_GAPDH_TAA_len41_fa20_ta0_fm14_tm6,g
3107@TOP@human_GAPDH_TAA_len41_fa20_ta0_fm14_tm6*123*t,0,0,0,1208,1208,0.0,123,3107@TOP@human_GAPDH_TAA_len41_fa20_ta0_fm14_tm6,t
3107@TOP@human_GAPDH_TAA_len41_fa20_ta0_fm14_tm6*124*a,1086,0,120,0,1206,0.1,124,3107@TOP@human_GAPDH_TAA_len41_fa20_ta0_fm14_tm6,a
3107@TOP@human_GAPDH_TAA_len41_fa20_ta0_fm14_tm6*125*a,1131,1,70,0,1202,0.058,125,3107@TOP@human_GAPDH_TAA_len41_fa20_ta0_fm14_tm6,a
3107@TOP@human_GAPDH_TAA_len41_fa20_ta0_fm14_tm6*126*g,0,0,1203,0,1203,1.0,126,3107@TOP@human_GAPDH_TAA_len41_fa20_ta0_fm14_tm6,g
3107@TOP@human_GAPDH_TAA_len41_fa20_ta0_fm14_tm6*127*a,1220,0,0,0,1220,0.0,127,3107@TOP@human_GAPDH_TAA_len41_fa20_ta0_fm14_tm6,a
3107@TOP@human_GAPDH_TAA_len41_fa20_ta0_fm14_tm6*128*c,0,1223,0,0,1223,0.0,128,3107@TOP@human_GAPDH_TAA_len41_fa20_ta0_fm14_tm6,c
3107@TOP@human_GAPDH_TAA_len41_fa20_ta0_fm14_tm6*129*c,0,1211,0,0,1211,0.0,129,3107@TOP@human_GAPDH_TAA_len41_fa20_ta0_fm14_tm6,c
3107@TOP@human_GAPDH_TAA_len41_fa20_ta0_fm14_tm6*130*c,0,1220,0,0,1220,0.0,130,3107@TOP@human_GAPDH_TAA_len41_fa20_ta0_fm14_tm6,c
3107@TOP@human_GAPDH_TAA_len41_fa20_ta0_fm14_tm6*131*c,0,1224,0,0,1224,0.0,131,3107@TOP@human_GAPDH_TAA_len41_fa20_ta0_fm14_tm6,c
3107@TOP@human_GAPDH_TAA_len41_fa20_ta0_fm14_tm6*132*t,1,0,0,1205,1206,0.0,132,3107@TOP@human_GAPDH_TAA_len41_fa20_ta0_fm14_tm6,t
3107@TOP@human_GAPDH_TAA_len41_fa20_ta0_fm14_tm6*133*g,0,0,1208,0,1208,1.0,133,3107@TOP@human_GAPDH_TAA_len41_fa20_ta0_fm14_tm6,g
3107@TOP@human_GAPDH_TAA_len41_fa20_ta0_fm14_tm6*134*g,0,0,1209,0,1209,1.0,134,3107@TOP@human_GAPDH_TAA_len41_fa20_ta0_fm14_tm6,g
3108@TOP@human_GAPDH_TAA_len41_fa20_ta0_fm14_tm6*114*t,0,1,0,2235,2236,0.0,114,3108@TOP@human_GAPDH_TAA_len41_fa20_ta0_fm14_tm6,t
3108@TOP@human_GAPDH_TAA_len41_fa20_ta0_fm14_tm6*115*c,1,2256,0,0,2257,0.0,115,3108@TOP@human_GAPDH_TAA_len41_fa20_ta0_fm14_tm6,c
3108@TOP@human_GAPDH_TAA_len41_fa20_ta0_fm14_tm6*116*c,0,2237,0,0,2237,0.0,116,3108@TOP@human_GAPDH_TAA_len41_fa20_ta0_fm14_tm6,c
3108@TOP@human_GAPDH_TAA_len41_fa20_ta0_fm14_tm6*117*a,2240,0,6,0,2246,0.003,117,3108@TOP@human_GAPDH_TAA_len41_fa20_ta0_fm14_tm6,a
3108@TOP@human_GAPDH_TAA_len41_fa20_ta0_fm14_tm6*118*a,2194,0,40,0,2234,0.018,118,3108@TOP@human_GAPDH_TAA_len41_fa20_ta0_fm14_tm6,a
3108@TOP@human_GAPDH_TAA_len41_fa20_ta0_fm14_tm6*119*g,0,0,2215,0,2215,1.0,119,3108@TOP@human_GAPDH_TAA_len41_fa20_ta0_fm14_tm6,g
3108@TOP@human_GAPDH_TAA_len41_fa20_ta0_fm14_tm6*120*g,0,1,2215,0,2216,1.0,120,3108@TOP@human_GAPDH_TAA_len41_fa20_ta0_fm14_tm6,g
3108@TOP@human_GAPDH_TAA_len41_fa20_ta0_fm14_tm6*121*a,2240,0,0,0,2240,0.0,121,3108@TOP@human_GAPDH_TAA_len41_fa20_ta0_fm14_tm6,a
3108@TOP@human_GAPDH_TAA_len41_fa20_ta0_fm14_tm6*122*g,0,0,2242,0,2242,1.0,122,3108@TOP@human_GAPDH_TAA_len41_fa20_ta0_fm14_tm6,g
3108@TOP@human_GAPDH_TAA_len41_fa20_ta0_fm14_tm6*123*t,0,0,0,2211,2211,0.0,123,3108@TOP@human_GAPDH_TAA_len41_fa20_ta0_fm14_tm6,t
3108@TOP@human_GAPDH_TAA_len41_fa20_ta0_fm14_tm6*124*a,2149,1,53,0,2203,0.024,124,3108@TOP@human_GAPDH_TAA_len41_fa20_ta0_fm14_tm6,a
3108@TOP@human_GAPDH_TAA_len41_fa20_ta0_fm14_tm6*125*a,2165,0,32,0,2197,0.015,125,3108@TOP@human_GAPDH_TAA_len41_fa20_ta0_fm14_tm6,a
3108@TOP@human_GAPDH_TAA_len41_fa20_ta0_fm14_tm6*126*g,0,0,2209,1,2210,1.0,126,3108@TOP@human_GAPDH_TAA_len41_fa20_ta0_fm14_tm6,g
3108@TOP@human_GAPDH_TAA_len41_fa20_ta0_fm14_tm6*127*a,2232,0,2,0,2234,0.001,127,3108@TOP@human_GAPDH_TAA_len41_fa20_ta0_fm14_tm6,a
3108@TOP@human_GAPDH_TAA_len41_fa20_ta0_fm14_tm6*128*c,0,2251,0,0,2251,0.0,128,3108@TOP@human_GAPDH_TAA_len41_fa20_ta0_fm14_tm6,c
3108@TOP@human_GAPDH_TAA_len41_fa20_ta0_fm14_tm6*129*c,0,2232,0,0,2232,0.0,129,3108@TOP@human_GAPDH_TAA_len41_fa20_ta0_fm14_tm6,c
3108@TOP@human_GAPDH_TAA_len41_fa20_ta0_fm14_tm6*130*c,0,2247,0,0,2247,0.0,130,3108@TOP@human_GAPDH_TAA_len41_fa20_ta0_fm14_tm6,c
3108@TOP@human_GAPDH_TAA_len41_fa20_ta0_fm14_tm6*131*c,0,2249,0,1,2250,0.0,131,3108@TOP@human_GAPDH_TAA_len41_fa20_ta0_fm14_tm6,c
3108@TOP@human_GAPDH_TAA_len41_fa20_ta0_fm14_tm6*132*t,0,0,0,2218,2218,0.0,132,3108@TOP@human_GAPDH_TAA_len41_fa20_ta0_fm14_tm6,t
3108@TOP@human_GAPDH_TAA_len41_fa20_ta0_fm14_tm6*133*g,0,0,2207,0,2207,1.0,133,3108@TOP@human_GAPDH_TAA_len41_fa20_ta0_fm14_tm6,g
3108@TOP@human_GAPDH_TAA_len41_fa20_ta0_fm14_tm6*134*g,0,0,2237,0,2237,1.0,134,3108@TOP@human_GAPDH_TAA_len41_fa20_ta0_fm14_tm6,g
3109@TOP@human_GAPDH_TAA_len41_fa20_ta0_fm14_tm6*114*t,0,0,0,303,303,0.0,114,3109@TOP@human_GAPDH_TAA_len41_fa20_ta0_fm14_tm6,t
3109@TOP@human_GAPDH_TAA_len41_fa20_ta0_fm14_tm6*115*c,0,306,0,0,306,0.0,115,3109@TOP@human_GAPDH_TAA_len41_fa20_ta0_fm14_tm6,c
3109@TOP@human_GAPDH_TAA_len41_fa20_ta0_fm14_tm6*116*c,0,304,0,0,304,0.0,116,3109@TOP@human_GAPDH_TAA_len41_fa20_ta0_fm14_tm6,c
3109@TOP@human_GAPDH_TAA_len41_fa20_ta0_fm14_tm6*117*a,304,0,0,0,304,0.0,117,3109@TOP@human_GAPDH_TAA_len41_fa20_ta0_fm14_tm6,a
3109@TOP@human_GAPDH_TAA_len41_fa20_ta0_fm14_tm6*118*a,288,0,13,0,301,0.043,118,3109@TOP@human_GAPDH_TAA_len41_fa20_ta0_fm14_tm6,a
3109@TOP@human_GAPDH_TAA_len41_fa20_ta0_fm14_tm6*119*g,0,0,302,0,302,1.0,119,3109@TOP@human_GAPDH_TAA_len41_fa20_ta0_fm14_tm6,g
3109@TOP@human_GAPDH_TAA_len41_fa20_ta0_fm14_tm6*120*g,0,0,295,0,295,1.0,120,3109@TOP@human_GAPDH_TAA_len41_fa20_ta0_fm14_tm6,g
3109@TOP@human_GAPDH_TAA_len41_fa20_ta0_fm14_tm6*121*a,305,0,0,0,305,0.0,121,3109@TOP@human_GAPDH_TAA_len41_fa20_ta0_fm14_tm6,a
3109@TOP@human_GAPDH_TAA_len41_fa20_ta0_fm14_tm6*122*g,0,0,300,0,300,1.0,122,3109@TOP@human_GAPDH_TAA_len41_fa20_ta0_fm14_tm6,g
3109@TOP@human_GAPDH_TAA_len41_fa20_ta0_fm14_tm6*123*t,0,0,0,300,300,0.0,123,3109@TOP@human_GAPDH_TAA_len41_fa20_ta0_fm14_tm6,t
3109@TOP@human_GAPDH_TAA_len41_fa20_ta0_fm14_tm6*124*a,279,0,19,0,298,0.064,124,3109@TOP@human_GAPDH_TAA_len41_fa20_ta0_fm14_tm6,a
3109@TOP@human_GAPDH_TAA_len41_fa20_ta0_fm14_tm6*125*a,289,0,7,0,296,0.024,125,3109@TOP@human_GAPDH_TAA_len41_fa20_ta0_fm14_tm6,a
3109@TOP@human_GAPDH_TAA_len41_fa20_ta0_fm14_tm6*126*g,0,0,296,0,296,1.0,126,3109@TOP@human_GAPDH_TAA_len41_fa20_ta0_fm14_tm6,g
3109@TOP@human_GAPDH_TAA_len41_fa20_ta0_fm14_tm6*127*a,304,0,0,0,304,0.0,127,3109@TOP@human_GAPDH_TAA_len41_fa20_ta0_fm14_tm6,a
3109@TOP@human_GAPDH_TAA_len41_fa20_ta0_fm14_tm6*128*c,0,306,0,0,306,0.0,128,3109@TOP@human_GAPDH_TAA_len41_fa20_ta0_fm14_tm6,c
3109@TOP@human_GAPDH_TAA_len41_fa20_ta0_fm14_tm6*129*c,0,300,0,0,300,0.0,129,3109@TOP@human_GAPDH_TAA_len41_fa20_ta0_fm14_tm6,c
3109@TOP@human_GAPDH_TAA_len41_fa20_ta0_fm14_tm6*130*c,0,303,0,0,303,0.0,130,3109@TOP@human_GAPDH_TAA_len41_fa20_ta0_fm14_tm6,c
3109@TOP@human_GAPDH_TAA_len41_fa20_ta0_fm14_tm6*131*c,0,304,0,0,304,0.0,131,3109@TOP@human_GAPDH_TAA_len41_fa20_ta0_fm14_tm6,c
3109@TOP@human_GAPDH_TAA_len41_fa20_ta0_fm14_tm6*132*t,0,0,0,296,296,0.0,132,3109@TOP@human_GAPDH_TAA_len41_fa20_ta0_fm14_tm6,t
3109@TOP@human_GAPDH_TAA_len41_fa20_ta0_fm14_tm6*133*g,0,0,297,0,297,1.0,133,3109@TOP@human_GAPDH_TAA_len41_fa20_ta0_fm14_tm6,g
3109@TOP@human_GAPDH_TAA_len41_fa20_ta0_fm14_tm6*134*g,0,0,300,0,300,1.0,134,3109@TOP@human_GAPDH_TAA_len41_fa20_ta0_fm14_tm6,g
3110@TOP@human_GAPDH_TAA_len41_fa20_ta0_fm14_tm6*114*t,0,1,0,1266,1267,0.0,114,3110@TOP@human_GAPDH_TAA_len41_fa20_ta0_fm14_tm6,t
3110@TOP@human_GAPDH_TAA_len41_fa20_ta0_fm14_tm6*115*c,0,1274,0,0,1274,0.0,115,3110@TOP@human_GAPDH_TAA_len41_fa20_ta0_fm14_tm6,c
3110@TOP@human_GAPDH_TAA_len41_fa20_ta0_fm14_tm6*116*c,0,1267,0,0,1267,0.0,116,3110@TOP@human_GAPDH_TAA_len41_fa20_ta0_fm14_tm6,c
3110@TOP@human_GAPDH_TAA_len41_fa20_ta0_fm14_tm6*117*a,1263,0,6,0,1269,0.005,117,3110@TOP@human_GAPDH_TAA_len41_fa20_ta0_fm14_tm6,a
3110@TOP@human_GAPDH_TAA_len41_fa20_ta0_fm14_tm6*118*a,1244,0,20,0,1264,0.016,118,3110@TOP@human_GAPDH_TAA_len41_fa20_ta0_fm14_tm6,a
3110@TOP@human_GAPDH_TAA_len41_fa20_ta0_fm14_tm6*119*g,0,0,1260,0,1260,1.0,119,3110@TOP@human_GAPDH_TAA_len41_fa20_ta0_fm14_tm6,g
3110@TOP@human_GAPDH_TAA_len41_fa20_ta0_fm14_tm6*120*g,0,0,1261,0,1261,1.0,120,3110@TOP@human_GAPDH_TAA_len41_fa20_ta0_fm14_tm6,g
3110@TOP@human_GAPDH_TAA_len41_fa20_ta0_fm14_tm6*121*a,1262,0,1,0,1263,0.001,121,3110@TOP@human_GAPDH_TAA_len41_fa20_ta0_fm14_tm6,a
3110@TOP@human_GAPDH_TAA_len41_fa20_ta0_fm14_tm6*122*g,0,0,1271,0,1271,1.0,122,3110@TOP@human_GAPDH_TAA_len41_fa20_ta0_fm14_tm6,g
3110@TOP@human_GAPDH_TAA_len41_fa20_ta0_fm14_tm6*123*t,0,1,0,1245,1246,0.0,123,3110@TOP@human_GAPDH_TAA_len41_fa20_ta0_fm14_tm6,t
3110@TOP@human_GAPDH_TAA_len41_fa20_ta0_fm14_tm6*124*a,1186,0,65,0,1251,0.052,124,3110@TOP@human_GAPDH_TAA_len41_fa20_ta0_fm14_tm6,a
3110@TOP@human_GAPDH_TAA_len41_fa20_ta0_fm14_tm6*125*a,1229,0,21,0,1250,0.017,125,3110@TOP@human_GAPDH_TAA_len41_fa20_ta0_fm14_tm6,a
3110@TOP@human_GAPDH_TAA_len41_fa20_ta0_fm14_tm6*126*g,0,0,1252,0,1252,1.0,126,3110@TOP@human_GAPDH_TAA_len41_fa20_ta0_fm14_tm6,g
3110@TOP@human_GAPDH_TAA_len41_fa20_ta0_fm14_tm6*127*a,1262,0,0,2,1264,0.0,127,3110@TOP@human_GAPDH_TAA_len41_fa20_ta0_fm14_tm6,a
3110@TOP@human_GAPDH_TAA_len41_fa20_ta0_fm14_tm6*128*c,0,1269,0,0,1269,0.0,128,3110@TOP@human_GAPDH_TAA_len41_fa20_ta0_fm14_tm6,c
3110@TOP@human_GAPDH_TAA_len41_fa20_ta0_fm14_tm6*129*c,0,1260,0,0,1260,0.0,129,3110@TOP@human_GAPDH_TAA_len41_fa20_ta0_fm14_tm6,c
3110@TOP@human_GAPDH_TAA_len41_fa20_ta0_fm14_tm6*130*c,0,1272,0,0,1272,0.0,130,3110@TOP@human_GAPDH_TAA_len41_fa20_ta0_fm14_tm6,c
3110@TOP@human_GAPDH_TAA_len41_fa20_ta0_fm14_tm6*131*c,0,1273,0,0,1273,0.0,131,3110@TOP@human_GAPDH_TAA_len41_fa20_ta0_fm14_tm6,c
3110@TOP@human_GAPDH_TAA_len41_fa20_ta0_fm14_tm6*132*t,0,1,0,1245,1246,0.0,132,3110@TOP@human_GAPDH_TAA_len41_fa20_ta0_fm14_tm6,t
3110@TOP@human_GAPDH_TAA_len41_fa20_ta0_fm14_tm6*133*g,0,0,1250,1,1251,0.999,133,3110@TOP@human_GAPDH_TAA_len41_fa20_ta0_fm14_tm6,g
3110@TOP@human_GAPDH_TAA_len41_fa20_ta0_fm14_tm6*134*g,0,0,1253,0,1253,1.0,134,3110@TOP@human_GAPDH_TAA_len41_fa20_ta0_fm14_tm6,g
3111@TOP@human_GAPDH_TAA_len41_fa20_ta0_fm14_tm6*114*t,2,4,0,3931,3937,0.0,114,3111@TOP@human_GAPDH_TAA_len41_fa20_ta0_fm14_tm6,t
3111@TOP@human_GAPDH_TAA_len41_fa20_ta0_fm14_tm6*115*c,0,3960,0,0,3960,0.0,115,3111@TOP@human_GAPDH_TAA_len41_fa20_ta0_fm14_tm6,c
3111@TOP@human_GAPDH_TAA_len41_fa20_ta0_fm14_tm6*116*c,1,3949,0,0,3950,0.0,116,3111@TOP@human_GAPDH_TAA_len41_fa20_ta0_fm14_tm6,c
3111@TOP@human_GAPDH_TAA_len41_fa20_ta0_fm14_tm6*117*a,3934,0,9,0,3943,0.002,117,3111@TOP@human_GAPDH_TAA_len41_fa20_ta0_fm14_tm6,a
3111@TOP@human_GAPDH_TAA_len41_fa20_ta0_fm14_tm6*118*a,3825,0,104,0,3929,0.026,118,3111@TOP@human_GAPDH_TAA_len41_fa20_ta0_fm14_tm6,a
3111@TOP@human_GAPDH_TAA_len41_fa20_ta0_fm14_tm6*119*g,0,0,3913,0,3913,1.0,119,3111@TOP@human_GAPDH_TAA_len41_fa20_ta0_fm14_tm6,g
3111@TOP@human_GAPDH_TAA_len41_fa20_ta0_fm14_tm6*120*g,0,0,3894,1,3895,1.0,120,3111@TOP@human_GAPDH_TAA_len41_fa20_ta0_fm14_tm6,g
3111@TOP@human_GAPDH_TAA_len41_fa20_ta0_fm14_tm6*121*a,3945,0,1,0,3946,0.0,121,3111@TOP@human_GAPDH_TAA_len41_fa20_ta0_fm14_tm6,a
3111@TOP@human_GAPDH_TAA_len41_fa20_ta0_fm14_tm6*122*g,0,0,3948,0,3948,1.0,122,3111@TOP@human_GAPDH_TAA_len41_fa20_ta0_fm14_tm6,g
3111@TOP@human_GAPDH_TAA_len41_fa20_ta0_fm14_tm6*123*t,0,2,1,3894,3897,0.0,123,3111@TOP@human_GAPDH_TAA_len41_fa20_ta0_fm14_tm6,t
3111@TOP@human_GAPDH_TAA_len41_fa20_ta0_fm14_tm6*124*a,3743,0,143,0,3886,0.037,124,3111@TOP@human_GAPDH_TAA_len41_fa20_ta0_fm14_tm6,a
3111@TOP@human_GAPDH_TAA_len41_fa20_ta0_fm14_tm6*125*a,3758,0,118,0,3876,0.03,125,3111@TOP@human_GAPDH_TAA_len41_fa20_ta0_fm14_tm6,a
3111@TOP@human_GAPDH_TAA_len41_fa20_ta0_fm14_tm6*126*g,0,0,3892,0,3892,1.0,126,3111@TOP@human_GAPDH_TAA_len41_fa20_ta0_fm14_tm6,g
3111@TOP@human_GAPDH_TAA_len41_fa20_ta0_fm14_tm6*127*a,3932,0,2,0,3934,0.001,127,3111@TOP@human_GAPDH_TAA_len41_fa20_ta0_fm14_tm6,a
3111@TOP@human_GAPDH_TAA_len41_fa20_ta0_fm14_tm6*128*c,0,3950,2,0,3952,0.001,128,3111@TOP@human_GAPDH_TAA_len41_fa20_ta0_fm14_tm6,c
3111@TOP@human_GAPDH_TAA_len41_fa20_ta0_fm14_tm6*129*c,0,3915,0,0,3915,0.0,129,3111@TOP@human_GAPDH_TAA_len41_fa20_ta0_fm14_tm6,c
3111@TOP@human_GAPDH_TAA_len41_fa20_ta0_fm14_tm6*130*c,0,3941,0,0,3941,0.0,130,3111@TOP@human_GAPDH_TAA_len41_fa20_ta0_fm14_tm6,c
3111@TOP@human_GAPDH_TAA_len41_fa20_ta0_fm14_tm6*131*c,0,3948,0,0,3948,0.0,131,3111@TOP@human_GAPDH_TAA_len41_fa20_ta0_fm14_tm6,c
3111@TOP@human_GAPDH_TAA_len41_fa20_ta0_fm14_tm6*132*t,1,3,0,3887,3891,0.0,132,3111@TOP@human_GAPDH_TAA_len41_fa20_ta0_fm14_tm6,t
3111@TOP@human_GAPDH_TAA_len41_fa20_ta0_fm14_tm6*133*g,0,0,3894,0,3894,1.0,133,3111@TOP@human_GAPDH_TAA_len41_fa20_ta0_fm14_tm6,g
3111@TOP@human_GAPDH_TAA_len41_fa20_ta0_fm14_tm6*134*g,0,0,3902,1,3903,1.0,134,3111@TOP@human_GAPDH_TAA_len41_fa20_ta0_fm14_tm6,g
3112@TOP@human_GAPDH_TAA_len41_fa20_ta0_fm14_tm6*114*t,1,1,0,5273,5275,0.0,114,3112@TOP@human_GAPDH_TAA_len41_fa20_ta0_fm14_tm6,t
3112@TOP@human_GAPDH_TAA_len41_fa20_ta0_fm14_tm6*115*c,0,5303,0,0,5303,0.0,115,3112@TOP@human_GAPDH_TAA_len41_fa20_ta0_fm14_tm6,c
3112@TOP@human_GAPDH_TAA_len41_fa20_ta0_fm14_tm6*116*c,0,5277,0,0,5277,0.0,116,3112@TOP@human_GAPDH_TAA_len41_fa20_ta0_fm14_tm6,c
3112@TOP@human_GAPDH_TAA_len41_fa20_ta0_fm14_tm6*117*a,5266,0,10,0,5276,0.002,117,3112@TOP@human_GAPDH_TAA_len41_fa20_ta0_fm14_tm6,a
3112@TOP@human_GAPDH_TAA_len41_fa20_ta0_fm14_tm6*118*a,5130,0,115,0,5245,0.022,118,3112@TOP@human_GAPDH_TAA_len41_fa20_ta0_fm14_tm6,a
3112@TOP@human_GAPDH_TAA_len41_fa20_ta0_fm14_tm6*119*g,0,0,5226,1,5227,1.0,119,3112@TOP@human_GAPDH_TAA_len41_fa20_ta0_fm14_tm6,g
3112@TOP@human_GAPDH_TAA_len41_fa20_ta0_fm14_tm6*120*g,0,0,5218,0,5218,1.0,120,3112@TOP@human_GAPDH_TAA_len41_fa20_ta0_fm14_tm6,g
3112@TOP@human_GAPDH_TAA_len41_fa20_ta0_fm14_tm6*121*a,5273,0,0,0,5273,0.0,121,3112@TOP@human_GAPDH_TAA_len41_fa20_ta0_fm14_tm6,a
3112@TOP@human_GAPDH_TAA_len41_fa20_ta0_fm14_tm6*122*g,0,0,5282,0,5282,1.0,122,3112@TOP@human_GAPDH_TAA_len41_fa20_ta0_fm14_tm6,g
3112@TOP@human_GAPDH_TAA_len41_fa20_ta0_fm14_tm6*123*t,1,1,0,5201,5203,0.0,123,3112@TOP@human_GAPDH_TAA_len41_fa20_ta0_fm14_tm6,t
3112@TOP@human_GAPDH_TAA_len41_fa20_ta0_fm14_tm6*124*a,4881,0,316,0,5197,0.061,124,3112@TOP@human_GAPDH_TAA_len41_fa20_ta0_fm14_tm6,a
3112@TOP@human_GAPDH_TAA_len41_fa20_ta0_fm14_tm6*125*a,5072,0,108,0,5180,0.021,125,3112@TOP@human_GAPDH_TAA_len41_fa20_ta0_fm14_tm6,a
3112@TOP@human_GAPDH_TAA_len41_fa20_ta0_fm14_tm6*126*g,0,0,5196,0,5196,1.0,126,3112@TOP@human_GAPDH_TAA_len41_fa20_ta0_fm14_tm6,g
3112@TOP@human_GAPDH_TAA_len41_fa20_ta0_fm14_tm6*127*a,5265,1,3,1,5270,0.001,127,3112@TOP@human_GAPDH_TAA_len41_fa20_ta0_fm14_tm6,a
3112@TOP@human_GAPDH_TAA_len41_fa20_ta0_fm14_tm6*128*c,0,5295,1,3,5299,0.0,128,3112@TOP@human_GAPDH_TAA_len41_fa20_ta0_fm14_tm6,c
3112@TOP@human_GAPDH_TAA_len41_fa20_ta0_fm14_tm6*129*c,0,5250,0,1,5251,0.0,129,3112@TOP@human_GAPDH_TAA_len41_fa20_ta0_fm14_tm6,c
3112@TOP@human_GAPDH_TAA_len41_fa20_ta0_fm14_tm6*130*c,0,5277,0,0,5277,0.0,130,3112@TOP@human_GAPDH_TAA_len41_fa20_ta0_fm14_tm6,c
3112@TOP@human_GAPDH_TAA_len41_fa20_ta0_fm14_tm6*131*c,1,5299,0,1,5301,0.0,131,3112@TOP@human_GAPDH_TAA_len41_fa20_ta0_fm14_tm6,c
3112@TOP@human_GAPDH_TAA_len41_fa20_ta0_fm14_tm6*132*t,0,5,0,5223,5228,0.0,132,3112@TOP@human_GAPDH_TAA_len41_fa20_ta0_fm14_tm6,t
3112@TOP@human_GAPDH_TAA_len41_fa20_ta0_fm14_tm6*133*g,0,0,5201,0,5201,1.0,133,3112@TOP@human_GAPDH_TAA_len41_fa20_ta0_fm14_tm6,g
3112@TOP@human_GAPDH_TAA_len41_fa20_ta0_fm14_tm6*134*g,0,0,5229,0,5229,1.0,134,3112@TOP@human_GAPDH_TAA_len41_fa20_ta0_fm14_tm6,g
3113@TOP@human_GAPDH_TAA_len41_fa20_ta0_fm14_tm6*114*t,1,5,0,2768,2774,0.0,114,3113@TOP@human_GAPDH_TAA_len41_fa20_ta0_fm14_tm6,t
3113@TOP@human_GAPDH_TAA_len41_fa20_ta0_fm14_tm6*115*c,0,2792,0,0,2792,0.0,115,3113@TOP@human_GAPDH_TAA_len41_fa20_ta0_fm14_tm6,c
3113@TOP@human_GAPDH_TAA_len41_fa20_ta0_fm14_tm6*116*c,0,2781,0,2,2783,0.0,116,3113@TOP@human_GAPDH_TAA_len41_fa20_ta0_fm14_tm6,c
3113@TOP@human_GAPDH_TAA_len41_fa20_ta0_fm14_tm6*117*a,2783,0,1,0,2784,0.0,117,3113@TOP@human_GAPDH_TAA_len41_fa20_ta0_fm14_tm6,a
3113@TOP@human_GAPDH_TAA_len41_fa20_ta0_fm14_tm6*118*a,2707,0,55,0,2762,0.02,118,3113@TOP@human_GAPDH_TAA_len41_fa20_ta0_fm14_tm6,a
3113@TOP@human_GAPDH_TAA_len41_fa20_ta0_fm14_tm6*119*g,0,0,2767,0,2767,1.0,119,3113@TOP@human_GAPDH_TAA_len41_fa20_ta0_fm14_tm6,g
3113@TOP@human_GAPDH_TAA_len41_fa20_ta0_fm14_tm6*120*g,0,0,2741,0,2741,1.0,120,3113@TOP@human_GAPDH_TAA_len41_fa20_ta0_fm14_tm6,g
3113@TOP@human_GAPDH_TAA_len41_fa20_ta0_fm14_tm6*121*a,2778,0,0,0,2778,0.0,121,3113@TOP@human_GAPDH_TAA_len41_fa20_ta0_fm14_tm6,a
3113@TOP@human_GAPDH_TAA_len41_fa20_ta0_fm14_tm6*122*g,1,0,2778,0,2779,1.0,122,3113@TOP@human_GAPDH_TAA_len41_fa20_ta0_fm14_tm6,g
3113@TOP@human_GAPDH_TAA_len41_fa20_ta0_fm14_tm6*123*t,0,0,0,2737,2737,0.0,123,3113@TOP@human_GAPDH_TAA_len41_fa20_ta0_fm14_tm6,t
3113@TOP@human_GAPDH_TAA_len41_fa20_ta0_fm14_tm6*124*a,2645,0,96,0,2741,0.035,124,3113@TOP@human_GAPDH_TAA_len41_fa20_ta0_fm14_tm6,a
3113@TOP@human_GAPDH_TAA_len41_fa20_ta0_fm14_tm6*125*a,2660,1,74,0,2735,0.027,125,3113@TOP@human_GAPDH_TAA_len41_fa20_ta0_fm14_tm6,a
3113@TOP@human_GAPDH_TAA_len41_fa20_ta0_fm14_tm6*126*g,0,0,2747,0,2747,1.0,126,3113@TOP@human_GAPDH_TAA_len41_fa20_ta0_fm14_tm6,g
3113@TOP@human_GAPDH_TAA_len41_fa20_ta0_fm14_tm6*127*a,2765,0,0,0,2765,0.0,127,3113@TOP@human_GAPDH_TAA_len41_fa20_ta0_fm14_tm6,a
3113@TOP@human_GAPDH_TAA_len41_fa20_ta0_fm14_tm6*128*c,0,2784,0,0,2784,0.0,128,3113@TOP@human_GAPDH_TAA_len41_fa20_ta0_fm14_tm6,c
3113@TOP@human_GAPDH_TAA_len41_fa20_ta0_fm14_tm6*129*c,0,2767,0,0,2767,0.0,129,3113@TOP@human_GAPDH_TAA_len41_fa20_ta0_fm14_tm6,c
3113@TOP@human_GAPDH_TAA_len41_fa20_ta0_fm14_tm6*130*c,0,2785,0,0,2785,0.0,130,3113@TOP@human_GAPDH_TAA_len41_fa20_ta0_fm14_tm6,c
3113@TOP@human_GAPDH_TAA_len41_fa20_ta0_fm14_tm6*131*c,0,2788,0,0,2788,0.0,131,3113@TOP@human_GAPDH_TAA_len41_fa20_ta0_fm14_tm6,c
3113@TOP@human_GAPDH_TAA_len41_fa20_ta0_fm14_tm6*132*t,1,1,0,2749,2751,0.0,132,3113@TOP@human_GAPDH_TAA_len41_fa20_ta0_fm14_tm6,t
3113@TOP@human_GAPDH_TAA_len41_fa20_ta0_fm14_tm6*133*g,0,0,2748,0,2748,1.0,133,3113@TOP@human_GAPDH_TAA_len41_fa20_ta0_fm14_tm6,g
3113@TOP@human_GAPDH_TAA_len41_fa20_ta0_fm14_tm6*134*g,0,2,2758,0,2760,0.999,134,3113@TOP@human_GAPDH_TAA_len41_fa20_ta0_fm14_tm6,g
3114@TOP@human_GAPDH_TAA_len41_fa20_ta0_fm14_tm6*114*t,1,2,0,6002,6005,0.0,114,3114@TOP@human_GAPDH_TAA_len41_fa20_ta0_fm14_tm6,t
3114@TOP@human_GAPDH_TAA_len41_fa20_ta0_fm14_tm6*115*c,0,6042,0,0,6042,0.0,115,3114@TOP@human_GAPDH_TAA_len41_fa20_ta0_fm14_tm6,c
3114@TOP@human_GAPDH_TAA_len41_fa20_ta0_fm14_tm6*116*c,0,6023,0,1,6024,0.0,116,3114@TOP@human_GAPDH_TAA_len41_fa20_ta0_fm14_tm6,c
3114@TOP@human_GAPDH_TAA_len41_fa20_ta0_fm14_tm6*117*a,5994,0,19,0,6013,0.003,117,3114@TOP@human_GAPDH_TAA_len41_fa20_ta0_fm14_tm6,a
3114@TOP@human_GAPDH_TAA_len41_fa20_ta0_fm14_tm6*118*a,5842,0,145,2,5989,0.024,118,3114@TOP@human_GAPDH_TAA_len41_fa20_ta0_fm14_tm6,a
3114@TOP@human_GAPDH_TAA_len41_fa20_ta0_fm14_tm6*119*g,0,0,5974,0,5974,1.0,119,3114@TOP@human_GAPDH_TAA_len41_fa20_ta0_fm14_tm6,g
3114@TOP@human_GAPDH_TAA_len41_fa20_ta0_fm14_tm6*120*g,0,0,5958,1,5959,1.0,120,3114@TOP@human_GAPDH_TAA_len41_fa20_ta0_fm14_tm6,g
3114@TOP@human_GAPDH_TAA_len41_fa20_ta0_fm14_tm6*121*a,6000,0,5,0,6005,0.001,121,3114@TOP@human_GAPDH_TAA_len41_fa20_ta0_fm14_tm6,a
3114@TOP@human_GAPDH_TAA_len41_fa20_ta0_fm14_tm6*122*g,0,0,6017,0,6017,1.0,122,3114@TOP@human_GAPDH_TAA_len41_fa20_ta0_fm14_tm6,g
3114@TOP@human_GAPDH_TAA_len41_fa20_ta0_fm14_tm6*123*t,0,0,3,5917,5920,0.001,123,3114@TOP@human_GAPDH_TAA_len41_fa20_ta0_fm14_tm6,t
3114@TOP@human_GAPDH_TAA_len41_fa20_ta0_fm14_tm6*124*a,5514,0,419,0,5933,0.071,124,3114@TOP@human_GAPDH_TAA_len41_fa20_ta0_fm14_tm6,a
3114@TOP@human_GAPDH_TAA_len41_fa20_ta0_fm14_tm6*125*a,5775,1,134,0,5910,0.023,125,3114@TOP@human_GAPDH_TAA_len41_fa20_ta0_fm14_tm6,a
3114@TOP@human_GAPDH_TAA_len41_fa20_ta0_fm14_tm6*126*g,0,0,5942,1,5943,1.0,126,3114@TOP@human_GAPDH_TAA_len41_fa20_ta0_fm14_tm6,g
3114@TOP@human_GAPDH_TAA_len41_fa20_ta0_fm14_tm6*127*a,5996,0,0,0,5996,0.0,127,3114@TOP@human_GAPDH_TAA_len41_fa20_ta0_fm14_tm6,a
3114@TOP@human_GAPDH_TAA_len41_fa20_ta0_fm14_tm6*128*c,1,6024,0,0,6025,0.0,128,3114@TOP@human_GAPDH_TAA_len41_fa20_ta0_fm14_tm6,c
3114@TOP@human_GAPDH_TAA_len41_fa20_ta0_fm14_tm6*129*c,1,5986,0,0,5987,0.0,129,3114@TOP@human_GAPDH_TAA_len41_fa20_ta0_fm14_tm6,c
3114@TOP@human_GAPDH_TAA_len41_fa20_ta0_fm14_tm6*130*c,0,6017,1,0,6018,0.0,130,3114@TOP@human_GAPDH_TAA_len41_fa20_ta0_fm14_tm6,c
3114@TOP@human_GAPDH_TAA_len41_fa20_ta0_fm14_tm6*131*c,1,6029,0,0,6030,0.0,131,3114@TOP@human_GAPDH_TAA_len41_fa20_ta0_fm14_tm6,c
3114@TOP@human_GAPDH_TAA_len41_fa20_ta0_fm14_tm6*132*t,0,1,0,5941,5942,0.0,132,3114@TOP@human_GAPDH_TAA_len41_fa20_ta0_fm14_tm6,t
3114@TOP@human_GAPDH_TAA_len41_fa20_ta0_fm14_tm6*133*g,1,0,5937,0,5938,1.0,133,3114@TOP@human_GAPDH_TAA_len41_fa20_ta0_fm14_tm6,g
3114@TOP@human_GAPDH_TAA_len41_fa20_ta0_fm14_tm6*134*g,2,3,5964,0,5969,0.999,134,3114@TOP@human_GAPDH_TAA_len41_fa20_ta0_fm14_tm6,g
3115@TOP@human_GAPDH_TAA_len41_fa20_ta0_fm14_tm6*114*t,0,1,0,3609,3610,0.0,114,3115@TOP@human_GAPDH_TAA_len41_fa20_ta0_fm14_tm6,t
3115@TOP@human_GAPDH_TAA_len41_fa20_ta0_fm14_tm6*115*c,0,3637,0,0,3637,0.0,115,3115@TOP@human_GAPDH_TAA_len41_fa20_ta0_fm14_tm6,c
3115@TOP@human_GAPDH_TAA_len41_fa20_ta0_fm14_tm6*116*c,1,3620,0,0,3621,0.0,116,3115@TOP@human_GAPDH_TAA_len41_fa20_ta0_fm14_tm6,c
3115@TOP@human_GAPDH_TAA_len41_fa20_ta0_fm14_tm6*117*a,3611,1,12,0,3624,0.003,117,3115@TOP@human_GAPDH_TAA_len41_fa20_ta0_fm14_tm6,a
3115@TOP@human_GAPDH_TAA_len41_fa20_ta0_fm14_tm6*118*a,3474,0,121,0,3595,0.034,118,3115@TOP@human_GAPDH_TAA_len41_fa20_ta0_fm14_tm6,a
3115@TOP@human_GAPDH_TAA_len41_fa20_ta0_fm14_tm6*119*g,0,0,3598,0,3598,1.0,119,3115@TOP@human_GAPDH_TAA_len41_fa20_ta0_fm14_tm6,g
3115@TOP@human_GAPDH_TAA_len41_fa20_ta0_fm14_tm6*120*g,0,1,3574,0,3575,1.0,120,3115@TOP@human_GAPDH_TAA_len41_fa20_ta0_fm14_tm6,g
3115@TOP@human_GAPDH_TAA_len41_fa20_ta0_fm14_tm6*121*a,3617,0,0,0,3617,0.0,121,3115@TOP@human_GAPDH_TAA_len41_fa20_ta0_fm14_tm6,a
3115@TOP@human_GAPDH_TAA_len41_fa20_ta0_fm14_tm6*122*g,0,0,3623,0,3623,1.0,122,3115@TOP@human_GAPDH_TAA_len41_fa20_ta0_fm14_tm6,g
3115@TOP@human_GAPDH_TAA_len41_fa20_ta0_fm14_tm6*123*t,0,1,0,3585,3586,0.0,123,3115@TOP@human_GAPDH_TAA_len41_fa20_ta0_fm14_tm6,t
3115@TOP@human_GAPDH_TAA_len41_fa20_ta0_fm14_tm6*124*a,3383,0,175,0,3558,0.049,124,3115@TOP@human_GAPDH_TAA_len41_fa20_ta0_fm14_tm6,a
3115@TOP@human_GAPDH_TAA_len41_fa20_ta0_fm14_tm6*125*a,3458,0,99,0,3557,0.028,125,3115@TOP@human_GAPDH_TAA_len41_fa20_ta0_fm14_tm6,a
3115@TOP@human_GAPDH_TAA_len41_fa20_ta0_fm14_tm6*126*g,0,0,3562,0,3562,1.0,126,3115@TOP@human_GAPDH_TAA_len41_fa20_ta0_fm14_tm6,g
3115@TOP@human_GAPDH_TAA_len41_fa20_ta0_fm14_tm6*127*a,3606,0,4,0,3610,0.001,127,3115@TOP@human_GAPDH_TAA_len41_fa20_ta0_fm14_tm6,a
3115@TOP@human_GAPDH_TAA_len41_fa20_ta0_fm14_tm6*128*c,0,3623,0,0,3623,0.0,128,3115@TOP@human_GAPDH_TAA_len41_fa20_ta0_fm14_tm6,c
3115@TOP@human_GAPDH_TAA_len41_fa20_ta0_fm14_tm6*129*c,0,3599,0,1,3600,0.0,129,3115@TOP@human_GAPDH_TAA_len41_fa20_ta0_fm14_tm6,c
3115@TOP@human_GAPDH_TAA_len41_fa20_ta0_fm14_tm6*130*c,1,3622,0,0,3623,0.0,130,3115@TOP@human_GAPDH_TAA_len41_fa20_ta0_fm14_tm6,c
3115@TOP@human_GAPDH_TAA_len41_fa20_ta0_fm14_tm6*131*c,0,3626,0,2,3628,0.0,131,3115@TOP@human_GAPDH_TAA_len41_fa20_ta0_fm14_tm6,c
3115@TOP@human_GAPDH_TAA_len41_fa20_ta0_fm14_tm6*132*t,1,0,0,3580,3581,0.0,132,3115@TOP@human_GAPDH_TAA_len41_fa20_ta0_fm14_tm6,t
3115@TOP@human_GAPDH_TAA_len41_fa20_ta0_fm14_tm6*133*g,0,1,3568,0,3569,1.0,133,3115@TOP@human_GAPDH_TAA_len41_fa20_ta0_fm14_tm6,g
3115@TOP@human_GAPDH_TAA_len41_fa20_ta0_fm14_tm6*134*g,0,1,3596,1,3598,0.999,134,3115@TOP@human_GAPDH_TAA_len41_fa20_ta0_fm14_tm6,g
3116@TOP@human_GAPDH_TAA_len41_fa20_ta0_fm14_tm6*114*t,0,2,0,6515,6517,0.0,114,3116@TOP@human_GAPDH_TAA_len41_fa20_ta0_fm14_tm6,t
3116@TOP@human_GAPDH_TAA_len41_fa20_ta0_fm14_tm6*115*c,0,6545,0,0,6545,0.0,115,3116@TOP@human_GAPDH_TAA_len41_fa20_ta0_fm14_tm6,c
3116@TOP@human_GAPDH_TAA_len41_fa20_ta0_fm14_tm6*116*c,1,6528,0,0,6529,0.0,116,3116@TOP@human_GAPDH_TAA_len41_fa20_ta0_fm14_tm6,c
3116@TOP@human_GAPDH_TAA_len41_fa20_ta0_fm14_tm6*117*a,6511,0,10,2,6523,0.002,117,3116@TOP@human_GAPDH_TAA_len41_fa20_ta0_fm14_tm6,a
3116@TOP@human_GAPDH_TAA_len41_fa20_ta0_fm14_tm6*118*a,6347,1,124,0,6472,0.019,118,3116@TOP@human_GAPDH_TAA_len41_fa20_ta0_fm14_tm6,a
3116@TOP@human_GAPDH_TAA_len41_fa20_ta0_fm14_tm6*119*g,0,0,6468,0,6468,1.0,119,3116@TOP@human_GAPDH_TAA_len41_fa20_ta0_fm14_tm6,g
3116@TOP@human_GAPDH_TAA_len41_fa20_ta0_fm14_tm6*120*g,0,0,6445,0,6445,1.0,120,3116@TOP@human_GAPDH_TAA_len41_fa20_ta0_fm14_tm6,g
3116@TOP@human_GAPDH_TAA_len41_fa20_ta0_fm14_tm6*121*a,6506,0,3,0,6509,0.0,121,3116@TOP@human_GAPDH_TAA_len41_fa20_ta0_fm14_tm6,a
3116@TOP@human_GAPDH_TAA_len41_fa20_ta0_fm14_tm6*122*g,2,0,6523,3,6528,0.999,122,3116@TOP@human_GAPDH_TAA_len41_fa20_ta0_fm14_tm6,g
3116@TOP@human_GAPDH_TAA_len41_fa20_ta0_fm14_tm6*123*t,2,0,0,6417,6419,0.0,123,3116@TOP@human_GAPDH_TAA_len41_fa20_ta0_fm14_tm6,t
3116@TOP@human_GAPDH_TAA_len41_fa20_ta0_fm14_tm6*124*a,6043,1,376,0,6420,0.059,124,3116@TOP@human_GAPDH_TAA_len41_fa20_ta0_fm14_tm6,a
3116@TOP@human_GAPDH_TAA_len41_fa20_ta0_fm14_tm6*125*a,6280,0,118,0,6398,0.018,125,3116@TOP@human_GAPDH_TAA_len41_fa20_ta0_fm14_tm6,a
3116@TOP@human_GAPDH_TAA_len41_fa20_ta0_fm14_tm6*126*g,0,0,6447,1,6448,1.0,126,3116@TOP@human_GAPDH_TAA_len41_fa20_ta0_fm14_tm6,g
3116@TOP@human_GAPDH_TAA_len41_fa20_ta0_fm14_tm6*127*a,6506,0,3,0,6509,0.0,127,3116@TOP@human_GAPDH_TAA_len41_fa20_ta0_fm14_tm6,a
3116@TOP@human_GAPDH_TAA_len41_fa20_ta0_fm14_tm6*128*c,0,6534,0,2,6536,0.0,128,3116@TOP@human_GAPDH_TAA_len41_fa20_ta0_fm14_tm6,c
3116@TOP@human_GAPDH_TAA_len41_fa20_ta0_fm14_tm6*129*c,1,6487,0,0,6488,0.0,129,3116@TOP@human_GAPDH_TAA_len41_fa20_ta0_fm14_tm6,c
3116@TOP@human_GAPDH_TAA_len41_fa20_ta0_fm14_tm6*130*c,1,6516,0,1,6518,0.0,130,3116@TOP@human_GAPDH_TAA_len41_fa20_ta0_fm14_tm6,c
3116@TOP@human_GAPDH_TAA_len41_fa20_ta0_fm14_tm6*131*c,0,6538,0,0,6538,0.0,131,3116@TOP@human_GAPDH_TAA_len41_fa20_ta0_fm14_tm6,c
3116@TOP@human_GAPDH_TAA_len41_fa20_ta0_fm14_tm6*132*t,3,2,0,6441,6446,0.0,132,3116@TOP@human_GAPDH_TAA_len41_fa20_ta0_fm14_tm6,t
3116@TOP@human_GAPDH_TAA_len41_fa20_ta0_fm14_tm6*133*g,0,0,6444,0,6444,1.0,133,3116@TOP@human_GAPDH_TAA_len41_fa20_ta0_fm14_tm6,g
3116@TOP@human_GAPDH_TAA_len41_fa20_ta0_fm14_tm6*134*g,0,0,6479,0,6479,1.0,134,3116@TOP@human_GAPDH_TAA_len41_fa20_ta0_fm14_tm6,g
3117@TOP@human_GAPDH_TAA_len41_fa20_ta0_fm14_tm6*114*t,0,0,0,1095,1095,0.0,114,3117@TOP@human_GAPDH_TAA_len41_fa20_ta0_fm14_tm6,t
3117@TOP@human_GAPDH_TAA_len41_fa20_ta0_fm14_tm6*115*c,0,1109,0,0,1109,0.0,115,3117@TOP@human_GAPDH_TAA_len41_fa20_ta0_fm14_tm6,c
3117@TOP@human_GAPDH_TAA_len41_fa20_ta0_fm14_tm6*116*c,0,1102,0,0,1102,0.0,116,3117@TOP@human_GAPDH_TAA_len41_fa20_ta0_fm14_tm6,c
3117@TOP@human_GAPDH_TAA_len41_fa20_ta0_fm14_tm6*117*a,1100,0,1,0,1101,0.001,117,3117@TOP@human_GAPDH_TAA_len41_fa20_ta0_fm14_tm6,a
3117@TOP@human_GAPDH_TAA_len41_fa20_ta0_fm14_tm6*118*a,1057,0,18,0,1075,0.017,118,3117@TOP@human_GAPDH_TAA_len41_fa20_ta0_fm14_tm6,a
3117@TOP@human_GAPDH_TAA_len41_fa20_ta0_fm14_tm6*119*g,0,0,1092,0,1092,1.0,119,3117@TOP@human_GAPDH_TAA_len41_fa20_ta0_fm14_tm6,g
3117@TOP@human_GAPDH_TAA_len41_fa20_ta0_fm14_tm6*120*g,0,0,1091,0,1091,1.0,120,3117@TOP@human_GAPDH_TAA_len41_fa20_ta0_fm14_tm6,g
3117@TOP@human_GAPDH_TAA_len41_fa20_ta0_fm14_tm6*121*a,1095,0,0,0,1095,0.0,121,3117@TOP@human_GAPDH_TAA_len41_fa20_ta0_fm14_tm6,a
3117@TOP@human_GAPDH_TAA_len41_fa20_ta0_fm14_tm6*122*g,0,0,1092,0,1092,1.0,122,3117@TOP@human_GAPDH_TAA_len41_fa20_ta0_fm14_tm6,g
3117@TOP@human_GAPDH_TAA_len41_fa20_ta0_fm14_tm6*123*t,0,2,0,1079,1081,0.0,123,3117@TOP@human_GAPDH_TAA_len41_fa20_ta0_fm14_tm6,t
3117@TOP@human_GAPDH_TAA_len41_fa20_ta0_fm14_tm6*124*a,929,0,149,0,1078,0.138,124,3117@TOP@human_GAPDH_TAA_len41_fa20_ta0_fm14_tm6,a
3117@TOP@human_GAPDH_TAA_len41_fa20_ta0_fm14_tm6*125*a,1010,1,62,0,1073,0.058,125,3117@TOP@human_GAPDH_TAA_len41_fa20_ta0_fm14_tm6,a
3117@TOP@human_GAPDH_TAA_len41_fa20_ta0_fm14_tm6*126*g,0,0,1092,0,1092,1.0,126,3117@TOP@human_GAPDH_TAA_len41_fa20_ta0_fm14_tm6,g
3117@TOP@human_GAPDH_TAA_len41_fa20_ta0_fm14_tm6*127*a,1091,0,1,0,1092,0.001,127,3117@TOP@human_GAPDH_TAA_len41_fa20_ta0_fm14_tm6,a
3117@TOP@human_GAPDH_TAA_len41_fa20_ta0_fm14_tm6*128*c,0,1105,0,0,1105,0.0,128,3117@TOP@human_GAPDH_TAA_len41_fa20_ta0_fm14_tm6,c
3117@TOP@human_GAPDH_TAA_len41_fa20_ta0_fm14_tm6*129*c,0,1095,0,0,1095,0.0,129,3117@TOP@human_GAPDH_TAA_len41_fa20_ta0_fm14_tm6,c
3117@TOP@human_GAPDH_TAA_len41_fa20_ta0_fm14_tm6*130*c,0,1100,0,0,1100,0.0,130,3117@TOP@human_GAPDH_TAA_len41_fa20_ta0_fm14_tm6,c
3117@TOP@human_GAPDH_TAA_len41_fa20_ta0_fm14_tm6*131*c,0,1104,0,0,1104,0.0,131,3117@TOP@human_GAPDH_TAA_len41_fa20_ta0_fm14_tm6,c
3117@TOP@human_GAPDH_TAA_len41_fa20_ta0_fm14_tm6*132*t,0,0,0,1081,1081,0.0,132,3117@TOP@human_GAPDH_TAA_len41_fa20_ta0_fm14_tm6,t
3117@TOP@human_GAPDH_TAA_len41_fa20_ta0_fm14_tm6*133*g,0,0,1081,0,1081,1.0,133,3117@TOP@human_GAPDH_TAA_len41_fa20_ta0_fm14_tm6,g
3117@TOP@human_GAPDH_TAA_len41_fa20_ta0_fm14_tm6*134*g,0,0,1087,0,1087,1.0,134,3117@TOP@human_GAPDH_TAA_len41_fa20_ta0_fm14_tm6,g
3118@TOP@human_GAPDH_TAA_len41_fa20_ta0_fm14_tm6*114*t,1,4,0,1399,1404,0.0,114,3118@TOP@human_GAPDH_TAA_len41_fa20_ta0_fm14_tm6,t
3118@TOP@human_GAPDH_TAA_len41_fa20_ta0_fm14_tm6*115*c,0,1416,0,0,1416,0.0,115,3118@TOP@human_GAPDH_TAA_len41_fa20_ta0_fm14_tm6,c
3118@TOP@human_GAPDH_TAA_len41_fa20_ta0_fm14_tm6*116*c,0,1406,0,0,1406,0.0,116,3118@TOP@human_GAPDH_TAA_len41_fa20_ta0_fm14_tm6,c
3118@TOP@human_GAPDH_TAA_len41_fa20_ta0_fm14_tm6*117*a,1407,0,1,0,1408,0.001,117,3118@TOP@human_GAPDH_TAA_len41_fa20_ta0_fm14_tm6,a
3118@TOP@human_GAPDH_TAA_len41_fa20_ta0_fm14_tm6*118*a,1372,0,27,0,1399,0.019,118,3118@TOP@human_GAPDH_TAA_len41_fa20_ta0_fm14_tm6,a
3118@TOP@human_GAPDH_TAA_len41_fa20_ta0_fm14_tm6*119*g,0,0,1395,0,1395,1.0,119,3118@TOP@human_GAPDH_TAA_len41_fa20_ta0_fm14_tm6,g
3118@TOP@human_GAPDH_TAA_len41_fa20_ta0_fm14_tm6*120*g,0,0,1392,0,1392,1.0,120,3118@TOP@human_GAPDH_TAA_len41_fa20_ta0_fm14_tm6,g
3118@TOP@human_GAPDH_TAA_len41_fa20_ta0_fm14_tm6*121*a,1409,0,1,0,1410,0.001,121,3118@TOP@human_GAPDH_TAA_len41_fa20_ta0_fm14_tm6,a
3118@TOP@human_GAPDH_TAA_len41_fa20_ta0_fm14_tm6*122*g,0,0,1410,0,1410,1.0,122,3118@TOP@human_GAPDH_TAA_len41_fa20_ta0_fm14_tm6,g
3118@TOP@human_GAPDH_TAA_len41_fa20_ta0_fm14_tm6*123*t,0,0,0,1385,1385,0.0,123,3118@TOP@human_GAPDH_TAA_len41_fa20_ta0_fm14_tm6,t
3118@TOP@human_GAPDH_TAA_len41_fa20_ta0_fm14_tm6*124*a,1333,0,45,0,1378,0.033,124,3118@TOP@human_GAPDH_TAA_len41_fa20_ta0_fm14_tm6,a
3118@TOP@human_GAPDH_TAA_len41_fa20_ta0_fm14_tm6*125*a,1360,0,21,0,1381,0.015,125,3118@TOP@human_GAPDH_TAA_len41_fa20_ta0_fm14_tm6,a
3118@TOP@human_GAPDH_TAA_len41_fa20_ta0_fm14_tm6*126*g,0,0,1381,0,1381,1.0,126,3118@TOP@human_GAPDH_TAA_len41_fa20_ta0_fm14_tm6,g
3118@TOP@human_GAPDH_TAA_len41_fa20_ta0_fm14_tm6*127*a,1398,2,0,0,1400,0.0,127,3118@TOP@human_GAPDH_TAA_len41_fa20_ta0_fm14_tm6,a
3118@TOP@human_GAPDH_TAA_len41_fa20_ta0_fm14_tm6*128*c,0,1412,0,0,1412,0.0,128,3118@TOP@human_GAPDH_TAA_len41_fa20_ta0_fm14_tm6,c
3118@TOP@human_GAPDH_TAA_len41_fa20_ta0_fm14_tm6*129*c,1,1397,0,0,1398,0.0,129,3118@TOP@human_GAPDH_TAA_len41_fa20_ta0_fm14_tm6,c
3118@TOP@human_GAPDH_TAA_len41_fa20_ta0_fm14_tm6*130*c,0,1406,0,0,1406,0.0,130,3118@TOP@human_GAPDH_TAA_len41_fa20_ta0_fm14_tm6,c
3118@TOP@human_GAPDH_TAA_len41_fa20_ta0_fm14_tm6*131*c,0,1412,0,0,1412,0.0,131,3118@TOP@human_GAPDH_TAA_len41_fa20_ta0_fm14_tm6,c
3118@TOP@human_GAPDH_TAA_len41_fa20_ta0_fm14_tm6*132*t,1,0,0,1390,1391,0.0,132,3118@TOP@human_GAPDH_TAA_len41_fa20_ta0_fm14_tm6,t
3118@TOP@human_GAPDH_TAA_len41_fa20_ta0_fm14_tm6*133*g,2,0,1387,0,1389,0.999,133,3118@TOP@human_GAPDH_TAA_len41_fa20_ta0_fm14_tm6,g
3118@TOP@human_GAPDH_TAA_len41_fa20_ta0_fm14_tm6*134*g,0,0,1395,0,1395,1.0,134,3118@TOP@human_GAPDH_TAA_len41_fa20_ta0_fm14_tm6,g
3119@TOP@human_GAPDH_TAA_len41_fa20_ta0_fm14_tm6*114*t,1,0,0,3484,3485,0.0,114,3119@TOP@human_GAPDH_TAA_len41_fa20_ta0_fm14_tm6,t
3119@TOP@human_GAPDH_TAA_len41_fa20_ta0_fm14_tm6*115*c,0,3508,0,0,3508,0.0,115,3119@TOP@human_GAPDH_TAA_len41_fa20_ta0_fm14_tm6,c
3119@TOP@human_GAPDH_TAA_len41_fa20_ta0_fm14_tm6*116*c,0,3490,0,0,3490,0.0,116,3119@TOP@human_GAPDH_TAA_len41_fa20_ta0_fm14_tm6,c
3119@TOP@human_GAPDH_TAA_len41_fa20_ta0_fm14_tm6*117*a,3492,0,4,0,3496,0.001,117,3119@TOP@human_GAPDH_TAA_len41_fa20_ta0_fm14_tm6,a
3119@TOP@human_GAPDH_TAA_len41_fa20_ta0_fm14_tm6*118*a,3425,0,40,0,3465,0.012,118,3119@TOP@human_GAPDH_TAA_len41_fa20_ta0_fm14_tm6,a
3119@TOP@human_GAPDH_TAA_len41_fa20_ta0_fm14_tm6*119*g,0,0,3462,0,3462,1.0,119,3119@TOP@human_GAPDH_TAA_len41_fa20_ta0_fm14_tm6,g
3119@TOP@human_GAPDH_TAA_len41_fa20_ta0_fm14_tm6*120*g,0,0,3450,0,3450,1.0,120,3119@TOP@human_GAPDH_TAA_len41_fa20_ta0_fm14_tm6,g
3119@TOP@human_GAPDH_TAA_len41_fa20_ta0_fm14_tm6*121*a,3490,0,0,0,3490,0.0,121,3119@TOP@human_GAPDH_TAA_len41_fa20_ta0_fm14_tm6,a
3119@TOP@human_GAPDH_TAA_len41_fa20_ta0_fm14_tm6*122*g,0,0,3482,0,3482,1.0,122,3119@TOP@human_GAPDH_TAA_len41_fa20_ta0_fm14_tm6,g
3119@TOP@human_GAPDH_TAA_len41_fa20_ta0_fm14_tm6*123*t,0,0,0,3448,3448,0.0,123,3119@TOP@human_GAPDH_TAA_len41_fa20_ta0_fm14_tm6,t
3119@TOP@human_GAPDH_TAA_len41_fa20_ta0_fm14_tm6*124*a,3308,0,120,0,3428,0.035,124,3119@TOP@human_GAPDH_TAA_len41_fa20_ta0_fm14_tm6,a
3119@TOP@human_GAPDH_TAA_len41_fa20_ta0_fm14_tm6*125*a,3359,0,82,0,3441,0.024,125,3119@TOP@human_GAPDH_TAA_len41_fa20_ta0_fm14_tm6,a
3119@TOP@human_GAPDH_TAA_len41_fa20_ta0_fm14_tm6*126*g,0,0,3437,1,3438,1.0,126,3119@TOP@human_GAPDH_TAA_len41_fa20_ta0_fm14_tm6,g
3119@TOP@human_GAPDH_TAA_len41_fa20_ta0_fm14_tm6*127*a,3481,0,2,0,3483,0.001,127,3119@TOP@human_GAPDH_TAA_len41_fa20_ta0_fm14_tm6,a
3119@TOP@human_GAPDH_TAA_len41_fa20_ta0_fm14_tm6*128*c,0,3495,0,0,3495,0.0,128,3119@TOP@human_GAPDH_TAA_len41_fa20_ta0_fm14_tm6,c
3119@TOP@human_GAPDH_TAA_len41_fa20_ta0_fm14_tm6*129*c,1,3463,0,0,3464,0.0,129,3119@TOP@human_GAPDH_TAA_len41_fa20_ta0_fm14_tm6,c
3119@TOP@human_GAPDH_TAA_len41_fa20_ta0_fm14_tm6*130*c,1,3478,0,0,3479,0.0,130,3119@TOP@human_GAPDH_TAA_len41_fa20_ta0_fm14_tm6,c
3119@TOP@human_GAPDH_TAA_len41_fa20_ta0_fm14_tm6*131*c,0,3495,0,0,3495,0.0,131,3119@TOP@human_GAPDH_TAA_len41_fa20_ta0_fm14_tm6,c
3119@TOP@human_GAPDH_TAA_len41_fa20_ta0_fm14_tm6*132*t,1,1,0,3442,3444,0.0,132,3119@TOP@human_GAPDH_TAA_len41_fa20_ta0_fm14_tm6,t
3119@TOP@human_GAPDH_TAA_len41_fa20_ta0_fm14_tm6*133*g,0,0,3428,0,3428,1.0,133,3119@TOP@human_GAPDH_TAA_len41_fa20_ta0_fm14_tm6,g
3119@TOP@human_GAPDH_TAA_len41_fa20_ta0_fm14_tm6*134*g,0,0,3452,0,3452,1.0,134,3119@TOP@human_GAPDH_TAA_len41_fa20_ta0_fm14_tm6,g
3120@TOP@human_GAPDH_TAA_len41_fa20_ta0_fm14_tm6*114*t,1,1,0,3437,3439,0.0,114,3120@TOP@human_GAPDH_TAA_len41_fa20_ta0_fm14_tm6,t
3120@TOP@human_GAPDH_TAA_len41_fa20_ta0_fm14_tm6*115*c,0,3468,0,0,3468,0.0,115,3120@TOP@human_GAPDH_TAA_len41_fa20_ta0_fm14_tm6,c
3120@TOP@human_GAPDH_TAA_len41_fa20_ta0_fm14_tm6*116*c,0,3451,0,0,3451,0.0,116,3120@TOP@human_GAPDH_TAA_len41_fa20_ta0_fm14_tm6,c
3120@TOP@human_GAPDH_TAA_len41_fa20_ta0_fm14_tm6*117*a,3447,0,1,0,3448,0.0,117,3120@TOP@human_GAPDH_TAA_len41_fa20_ta0_fm14_tm6,a
3120@TOP@human_GAPDH_TAA_len41_fa20_ta0_fm14_tm6*118*a,3386,0,44,0,3430,0.013,118,3120@TOP@human_GAPDH_TAA_len41_fa20_ta0_fm14_tm6,a
3120@TOP@human_GAPDH_TAA_len41_fa20_ta0_fm14_tm6*119*g,0,0,3430,0,3430,1.0,119,3120@TOP@human_GAPDH_TAA_len41_fa20_ta0_fm14_tm6,g
3120@TOP@human_GAPDH_TAA_len41_fa20_ta0_fm14_tm6*120*g,0,0,3407,0,3407,1.0,120,3120@TOP@human_GAPDH_TAA_len41_fa20_ta0_fm14_tm6,g
3120@TOP@human_GAPDH_TAA_len41_fa20_ta0_fm14_tm6*121*a,3448,0,0,0,3448,0.0,121,3120@TOP@human_GAPDH_TAA_len41_fa20_ta0_fm14_tm6,a
3120@TOP@human_GAPDH_TAA_len41_fa20_ta0_fm14_tm6*122*g,0,0,3440,0,3440,1.0,122,3120@TOP@human_GAPDH_TAA_len41_fa20_ta0_fm14_tm6,g
3120@TOP@human_GAPDH_TAA_len41_fa20_ta0_fm14_tm6*123*t,0,0,0,3393,3393,0.0,123,3120@TOP@human_GAPDH_TAA_len41_fa20_ta0_fm14_tm6,t
3120@TOP@human_GAPDH_TAA_len41_fa20_ta0_fm14_tm6*124*a,3146,0,253,0,3399,0.074,124,3120@TOP@human_GAPDH_TAA_len41_fa20_ta0_fm14_tm6,a
3120@TOP@human_GAPDH_TAA_len41_fa20_ta0_fm14_tm6*125*a,3294,0,83,0,3377,0.025,125,3120@TOP@human_GAPDH_TAA_len41_fa20_ta0_fm14_tm6,a
3120@TOP@human_GAPDH_TAA_len41_fa20_ta0_fm14_tm6*126*g,0,0,3396,0,3396,1.0,126,3120@TOP@human_GAPDH_TAA_len41_fa20_ta0_fm14_tm6,g
3120@TOP@human_GAPDH_TAA_len41_fa20_ta0_fm14_tm6*127*a,3443,0,1,0,3444,0.0,127,3120@TOP@human_GAPDH_TAA_len41_fa20_ta0_fm14_tm6,a
3120@TOP@human_GAPDH_TAA_len41_fa20_ta0_fm14_tm6*128*c,1,3459,0,0,3460,0.0,128,3120@TOP@human_GAPDH_TAA_len41_fa20_ta0_fm14_tm6,c
3120@TOP@human_GAPDH_TAA_len41_fa20_ta0_fm14_tm6*129*c,0,3421,0,0,3421,0.0,129,3120@TOP@human_GAPDH_TAA_len41_fa20_ta0_fm14_tm6,c
3120@TOP@human_GAPDH_TAA_len41_fa20_ta0_fm14_tm6*130*c,0,3454,0,0,3454,0.0,130,3120@TOP@human_GAPDH_TAA_len41_fa20_ta0_fm14_tm6,c
3120@TOP@human_GAPDH_TAA_len41_fa20_ta0_fm14_tm6*131*c,0,3458,0,0,3458,0.0,131,3120@TOP@human_GAPDH_TAA_len41_fa20_ta0_fm14_tm6,c
3120@TOP@human_GAPDH_TAA_len41_fa20_ta0_fm14_tm6*132*t,0,0,0,3401,3401,0.0,132,3120@TOP@human_GAPDH_TAA_len41_fa20_ta0_fm14_tm6,t
3120@TOP@human_GAPDH_TAA_len41_fa20_ta0_fm14_tm6*133*g,1,0,3401,0,3402,1.0,133,3120@TOP@human_GAPDH_TAA_len41_fa20_ta0_fm14_tm6,g
3120@TOP@human_GAPDH_TAA_len41_fa20_ta0_fm14_tm6*134*g,0,6,3421,0,3427,0.998,134,3120@TOP@human_GAPDH_TAA_len41_fa20_ta0_fm14_tm6,g
3121@TOP@human_GAPDH_TAA_len41_fa20_ta0_fm14_tm6*114*t,0,2,0,3238,3240,0.0,114,3121@TOP@human_GAPDH_TAA_len41_fa20_ta0_fm14_tm6,t
3121@TOP@human_GAPDH_TAA_len41_fa20_ta0_fm14_tm6*115*c,0,3260,0,0,3260,0.0,115,3121@TOP@human_GAPDH_TAA_len41_fa20_ta0_fm14_tm6,c
3121@TOP@human_GAPDH_TAA_len41_fa20_ta0_fm14_tm6*116*c,0,3234,0,0,3234,0.0,116,3121@TOP@human_GAPDH_TAA_len41_fa20_ta0_fm14_tm6,c
3121@TOP@human_GAPDH_TAA_len41_fa20_ta0_fm14_tm6*117*a,3234,0,8,0,3242,0.002,117,3121@TOP@human_GAPDH_TAA_len41_fa20_ta0_fm14_tm6,a
3121@TOP@human_GAPDH_TAA_len41_fa20_ta0_fm14_tm6*118*a,3112,0,117,0,3229,0.036,118,3121@TOP@human_GAPDH_TAA_len41_fa20_ta0_fm14_tm6,a
3121@TOP@human_GAPDH_TAA_len41_fa20_ta0_fm14_tm6*119*g,0,0,3228,0,3228,1.0,119,3121@TOP@human_GAPDH_TAA_len41_fa20_ta0_fm14_tm6,g
3121@TOP@human_GAPDH_TAA_len41_fa20_ta0_fm14_tm6*120*g,0,0,3216,0,3216,1.0,120,3121@TOP@human_GAPDH_TAA_len41_fa20_ta0_fm14_tm6,g
3121@TOP@human_GAPDH_TAA_len41_fa20_ta0_fm14_tm6*121*a,3240,0,0,0,3240,0.0,121,3121@TOP@human_GAPDH_TAA_len41_fa20_ta0_fm14_tm6,a
3121@TOP@human_GAPDH_TAA_len41_fa20_ta0_fm14_tm6*122*g,0,0,3247,0,3247,1.0,122,3121@TOP@human_GAPDH_TAA_len41_fa20_ta0_fm14_tm6,g
3121@TOP@human_GAPDH_TAA_len41_fa20_ta0_fm14_tm6*123*t,1,0,0,3214,3215,0.0,123,3121@TOP@human_GAPDH_TAA_len41_fa20_ta0_fm14_tm6,t
3121@TOP@human_GAPDH_TAA_len41_fa20_ta0_fm14_tm6*124*a,3074,1,117,0,3192,0.037,124,3121@TOP@human_GAPDH_TAA_len41_fa20_ta0_fm14_tm6,a
3121@TOP@human_GAPDH_TAA_len41_fa20_ta0_fm14_tm6*125*a,3105,0,68,1,3174,0.021,125,3121@TOP@human_GAPDH_TAA_len41_fa20_ta0_fm14_tm6,a
3121@TOP@human_GAPDH_TAA_len41_fa20_ta0_fm14_tm6*126*g,0,0,3208,0,3208,1.0,126,3121@TOP@human_GAPDH_TAA_len41_fa20_ta0_fm14_tm6,g
3121@TOP@human_GAPDH_TAA_len41_fa20_ta0_fm14_tm6*127*a,3228,0,9,0,3237,0.003,127,3121@TOP@human_GAPDH_TAA_len41_fa20_ta0_fm14_tm6,a
3121@TOP@human_GAPDH_TAA_len41_fa20_ta0_fm14_tm6*128*c,0,3250,0,0,3250,0.0,128,3121@TOP@human_GAPDH_TAA_len41_fa20_ta0_fm14_tm6,c
3121@TOP@human_GAPDH_TAA_len41_fa20_ta0_fm14_tm6*129*c,0,3225,0,0,3225,0.0,129,3121@TOP@human_GAPDH_TAA_len41_fa20_ta0_fm14_tm6,c
3121@TOP@human_GAPDH_TAA_len41_fa20_ta0_fm14_tm6*130*c,0,3237,0,0,3237,0.0,130,3121@TOP@human_GAPDH_TAA_len41_fa20_ta0_fm14_tm6,c
3121@TOP@human_GAPDH_TAA_len41_fa20_ta0_fm14_tm6*131*c,0,3250,0,0,3250,0.0,131,3121@TOP@human_GAPDH_TAA_len41_fa20_ta0_fm14_tm6,c
3121@TOP@human_GAPDH_TAA_len41_fa20_ta0_fm14_tm6*132*t,0,0,0,3202,3202,0.0,132,3121@TOP@human_GAPDH_TAA_len41_fa20_ta0_fm14_tm6,t
3121@TOP@human_GAPDH_TAA_len41_fa20_ta0_fm14_tm6*133*g,0,0,3196,0,3196,1.0,133,3121@TOP@human_GAPDH_TAA_len41_fa20_ta0_fm14_tm6,g
3121@TOP@human_GAPDH_TAA_len41_fa20_ta0_fm14_tm6*134*g,0,0,3207,0,3207,1.0,134,3121@TOP@human_GAPDH_TAA_len41_fa20_ta0_fm14_tm6,g
3122@TOP@human_GAPDH_TAA_len41_fa20_ta0_fm14_tm6*114*t,0,0,0,1951,1951,0.0,114,3122@TOP@human_GAPDH_TAA_len41_fa20_ta0_fm14_tm6,t
3122@TOP@human_GAPDH_TAA_len41_fa20_ta0_fm14_tm6*115*c,0,1968,0,0,1968,0.0,115,3122@TOP@human_GAPDH_TAA_len41_fa20_ta0_fm14_tm6,c
3122@TOP@human_GAPDH_TAA_len41_fa20_ta0_fm14_tm6*116*c,0,1956,0,0,1956,0.0,116,3122@TOP@human_GAPDH_TAA_len41_fa20_ta0_fm14_tm6,c
3122@TOP@human_GAPDH_TAA_len41_fa20_ta0_fm14_tm6*117*a,1953,0,4,0,1957,0.002,117,3122@TOP@human_GAPDH_TAA_len41_fa20_ta0_fm14_tm6,a
3122@TOP@human_GAPDH_TAA_len41_fa20_ta0_fm14_tm6*118*a,1886,0,64,0,1950,0.033,118,3122@TOP@human_GAPDH_TAA_len41_fa20_ta0_fm14_tm6,a
3122@TOP@human_GAPDH_TAA_len41_fa20_ta0_fm14_tm6*119*g,0,0,1938,0,1938,1.0,119,3122@TOP@human_GAPDH_TAA_len41_fa20_ta0_fm14_tm6,g
3122@TOP@human_GAPDH_TAA_len41_fa20_ta0_fm14_tm6*120*g,0,0,1935,0,1935,1.0,120,3122@TOP@human_GAPDH_TAA_len41_fa20_ta0_fm14_tm6,g
3122@TOP@human_GAPDH_TAA_len41_fa20_ta0_fm14_tm6*121*a,1955,0,0,0,1955,0.0,121,3122@TOP@human_GAPDH_TAA_len41_fa20_ta0_fm14_tm6,a
3122@TOP@human_GAPDH_TAA_len41_fa20_ta0_fm14_tm6*122*g,0,0,1960,0,1960,1.0,122,3122@TOP@human_GAPDH_TAA_len41_fa20_ta0_fm14_tm6,g
3122@TOP@human_GAPDH_TAA_len41_fa20_ta0_fm14_tm6*123*t,0,0,0,1918,1918,0.0,123,3122@TOP@human_GAPDH_TAA_len41_fa20_ta0_fm14_tm6,t
3122@TOP@human_GAPDH_TAA_len41_fa20_ta0_fm14_tm6*124*a,1852,0,80,0,1932,0.041,124,3122@TOP@human_GAPDH_TAA_len41_fa20_ta0_fm14_tm6,a
3122@TOP@human_GAPDH_TAA_len41_fa20_ta0_fm14_tm6*125*a,1866,0,50,0,1916,0.026,125,3122@TOP@human_GAPDH_TAA_len41_fa20_ta0_fm14_tm6,a
3122@TOP@human_GAPDH_TAA_len41_fa20_ta0_fm14_tm6*126*g,0,0,1937,0,1937,1.0,126,3122@TOP@human_GAPDH_TAA_len41_fa20_ta0_fm14_tm6,g
3122@TOP@human_GAPDH_TAA_len41_fa20_ta0_fm14_tm6*127*a,1947,0,5,0,1952,0.003,127,3122@TOP@human_GAPDH_TAA_len41_fa20_ta0_fm14_tm6,a
3122@TOP@human_GAPDH_TAA_len41_fa20_ta0_fm14_tm6*128*c,0,1962,0,0,1962,0.0,128,3122@TOP@human_GAPDH_TAA_len41_fa20_ta0_fm14_tm6,c
3122@TOP@human_GAPDH_TAA_len41_fa20_ta0_fm14_tm6*129*c,0,1950,0,0,1950,0.0,129,3122@TOP@human_GAPDH_TAA_len41_fa20_ta0_fm14_tm6,c
3122@TOP@human_GAPDH_TAA_len41_fa20_ta0_fm14_tm6*130*c,0,1958,0,0,1958,0.0,130,3122@TOP@human_GAPDH_TAA_len41_fa20_ta0_fm14_tm6,c
3122@TOP@human_GAPDH_TAA_len41_fa20_ta0_fm14_tm6*131*c,0,1965,0,0,1965,0.0,131,3122@TOP@human_GAPDH_TAA_len41_fa20_ta0_fm14_tm6,c
3122@TOP@human_GAPDH_TAA_len41_fa20_ta0_fm14_tm6*132*t,1,0,0,1927,1928,0.0,132,3122@TOP@human_GAPDH_TAA_len41_fa20_ta0_fm14_tm6,t
3122@TOP@human_GAPDH_TAA_len41_fa20_ta0_fm14_tm6*133*g,0,0,1925,0,1925,1.0,133,3122@TOP@human_GAPDH_TAA_len41_fa20_ta0_fm14_tm6,g
3122@TOP@human_GAPDH_TAA_len41_fa20_ta0_fm14_tm6*134*g,0,0,1943,0,1943,1.0,134,3122@TOP@human_GAPDH_TAA_len41_fa20_ta0_fm14_tm6,g
3123@TOP@human_GAPDH_TAA_len41_fa20_ta0_fm14_tm6*114*t,0,3,0,2439,2442,0.0,114,3123@TOP@human_GAPDH_TAA_len41_fa20_ta0_fm14_tm6,t
3123@TOP@human_GAPDH_TAA_len41_fa20_ta0_fm14_tm6*115*c,0,2455,0,0,2455,0.0,115,3123@TOP@human_GAPDH_TAA_len41_fa20_ta0_fm14_tm6,c
3123@TOP@human_GAPDH_TAA_len41_fa20_ta0_fm14_tm6*116*c,0,2442,0,0,2442,0.0,116,3123@TOP@human_GAPDH_TAA_len41_fa20_ta0_fm14_tm6,c
3123@TOP@human_GAPDH_TAA_len41_fa20_ta0_fm14_tm6*117*a,2431,0,12,0,2443,0.005,117,3123@TOP@human_GAPDH_TAA_len41_fa20_ta0_fm14_tm6,a
3123@TOP@human_GAPDH_TAA_len41_fa20_ta0_fm14_tm6*118*a,2345,0,86,0,2431,0.035,118,3123@TOP@human_GAPDH_TAA_len41_fa20_ta0_fm14_tm6,a
3123@TOP@human_GAPDH_TAA_len41_fa20_ta0_fm14_tm6*119*g,0,0,2422,0,2422,1.0,119,3123@TOP@human_GAPDH_TAA_len41_fa20_ta0_fm14_tm6,g
3123@TOP@human_GAPDH_TAA_len41_fa20_ta0_fm14_tm6*120*g,0,0,2423,0,2423,1.0,120,3123@TOP@human_GAPDH_TAA_len41_fa20_ta0_fm14_tm6,g
3123@TOP@human_GAPDH_TAA_len41_fa20_ta0_fm14_tm6*121*a,2444,0,0,0,2444,0.0,121,3123@TOP@human_GAPDH_TAA_len41_fa20_ta0_fm14_tm6,a
3123@TOP@human_GAPDH_TAA_len41_fa20_ta0_fm14_tm6*122*g,0,0,2439,0,2439,1.0,122,3123@TOP@human_GAPDH_TAA_len41_fa20_ta0_fm14_tm6,g
3123@TOP@human_GAPDH_TAA_len41_fa20_ta0_fm14_tm6*123*t,0,1,0,2414,2415,0.0,123,3123@TOP@human_GAPDH_TAA_len41_fa20_ta0_fm14_tm6,t
3123@TOP@human_GAPDH_TAA_len41_fa20_ta0_fm14_tm6*124*a,2256,0,154,0,2410,0.064,124,3123@TOP@human_GAPDH_TAA_len41_fa20_ta0_fm14_tm6,a
3123@TOP@human_GAPDH_TAA_len41_fa20_ta0_fm14_tm6*125*a,2306,0,94,0,2400,0.039,125,3123@TOP@human_GAPDH_TAA_len41_fa20_ta0_fm14_tm6,a
3123@TOP@human_GAPDH_TAA_len41_fa20_ta0_fm14_tm6*126*g,0,0,2406,0,2406,1.0,126,3123@TOP@human_GAPDH_TAA_len41_fa20_ta0_fm14_tm6,g
3123@TOP@human_GAPDH_TAA_len41_fa20_ta0_fm14_tm6*127*a,2428,0,4,0,2432,0.002,127,3123@TOP@human_GAPDH_TAA_len41_fa20_ta0_fm14_tm6,a
3123@TOP@human_GAPDH_TAA_len41_fa20_ta0_fm14_tm6*128*c,0,2449,0,0,2449,0.0,128,3123@TOP@human_GAPDH_TAA_len41_fa20_ta0_fm14_tm6,c
3123@TOP@human_GAPDH_TAA_len41_fa20_ta0_fm14_tm6*129*c,0,2438,0,0,2438,0.0,129,3123@TOP@human_GAPDH_TAA_len41_fa20_ta0_fm14_tm6,c
3123@TOP@human_GAPDH_TAA_len41_fa20_ta0_fm14_tm6*130*c,0,2444,0,0,2444,0.0,130,3123@TOP@human_GAPDH_TAA_len41_fa20_ta0_fm14_tm6,c
3123@TOP@human_GAPDH_TAA_len41_fa20_ta0_fm14_tm6*131*c,0,2454,0,0,2454,0.0,131,3123@TOP@human_GAPDH_TAA_len41_fa20_ta0_fm14_tm6,c
3123@TOP@human_GAPDH_TAA_len41_fa20_ta0_fm14_tm6*132*t,0,0,0,2423,2423,0.0,132,3123@TOP@human_GAPDH_TAA_len41_fa20_ta0_fm14_tm6,t
3123@TOP@human_GAPDH_TAA_len41_fa20_ta0_fm14_tm6*133*g,0,0,2392,0,2392,1.0,133,3123@TOP@human_GAPDH_TAA_len41_fa20_ta0_fm14_tm6,g
3123@TOP@human_GAPDH_TAA_len41_fa20_ta0_fm14_tm6*134*g,0,1,2426,0,2427,1.0,134,3123@TOP@human_GAPDH_TAA_len41_fa20_ta0_fm14_tm6,g
3124@TOP@human_GAPDH_TAA_len41_fa20_ta0_fm14_tm6*114*t,1,1,0,1885,1887,0.0,114,3124@TOP@human_GAPDH_TAA_len41_fa20_ta0_fm14_tm6,t
3124@TOP@human_GAPDH_TAA_len41_fa20_ta0_fm14_tm6*115*c,2,1898,0,0,1900,0.0,115,3124@TOP@human_GAPDH_TAA_len41_fa20_ta0_fm14_tm6,c
3124@TOP@human_GAPDH_TAA_len41_fa20_ta0_fm14_tm6*116*c,0,1892,0,0,1892,0.0,116,3124@TOP@human_GAPDH_TAA_len41_fa20_ta0_fm14_tm6,c
3124@TOP@human_GAPDH_TAA_len41_fa20_ta0_fm14_tm6*117*a,1888,0,6,0,1894,0.003,117,3124@TOP@human_GAPDH_TAA_len41_fa20_ta0_fm14_tm6,a
3124@TOP@human_GAPDH_TAA_len41_fa20_ta0_fm14_tm6*118*a,1855,0,25,0,1880,0.013,118,3124@TOP@human_GAPDH_TAA_len41_fa20_ta0_fm14_tm6,a
3124@TOP@human_GAPDH_TAA_len41_fa20_ta0_fm14_tm6*119*g,0,0,1883,0,1883,1.0,119,3124@TOP@human_GAPDH_TAA_len41_fa20_ta0_fm14_tm6,g
3124@TOP@human_GAPDH_TAA_len41_fa20_ta0_fm14_tm6*120*g,1,0,1868,1,1870,0.999,120,3124@TOP@human_GAPDH_TAA_len41_fa20_ta0_fm14_tm6,g
3124@TOP@human_GAPDH_TAA_len41_fa20_ta0_fm14_tm6*121*a,1880,0,0,0,1880,0.0,121,3124@TOP@human_GAPDH_TAA_len41_fa20_ta0_fm14_tm6,a
3124@TOP@human_GAPDH_TAA_len41_fa20_ta0_fm14_tm6*122*g,1,0,1886,0,1887,0.999,122,3124@TOP@human_GAPDH_TAA_len41_fa20_ta0_fm14_tm6,g
3124@TOP@human_GAPDH_TAA_len41_fa20_ta0_fm14_tm6*123*t,1,0,0,1857,1858,0.0,123,3124@TOP@human_GAPDH_TAA_len41_fa20_ta0_fm14_tm6,t
3124@TOP@human_GAPDH_TAA_len41_fa20_ta0_fm14_tm6*124*a,1751,0,105,0,1856,0.057,124,3124@TOP@human_GAPDH_TAA_len41_fa20_ta0_fm14_tm6,a
3124@TOP@human_GAPDH_TAA_len41_fa20_ta0_fm14_tm6*125*a,1810,0,44,0,1854,0.024,125,3124@TOP@human_GAPDH_TAA_len41_fa20_ta0_fm14_tm6,a
3124@TOP@human_GAPDH_TAA_len41_fa20_ta0_fm14_tm6*126*g,0,0,1860,0,1860,1.0,126,3124@TOP@human_GAPDH_TAA_len41_fa20_ta0_fm14_tm6,g
3124@TOP@human_GAPDH_TAA_len41_fa20_ta0_fm14_tm6*127*a,1881,0,4,1,1886,0.002,127,3124@TOP@human_GAPDH_TAA_len41_fa20_ta0_fm14_tm6,a
3124@TOP@human_GAPDH_TAA_len41_fa20_ta0_fm14_tm6*128*c,0,1895,0,0,1895,0.0,128,3124@TOP@human_GAPDH_TAA_len41_fa20_ta0_fm14_tm6,c
3124@TOP@human_GAPDH_TAA_len41_fa20_ta0_fm14_tm6*129*c,0,1879,0,0,1879,0.0,129,3124@TOP@human_GAPDH_TAA_len41_fa20_ta0_fm14_tm6,c
3124@TOP@human_GAPDH_TAA_len41_fa20_ta0_fm14_tm6*130*c,0,1892,0,1,1893,0.0,130,3124@TOP@human_GAPDH_TAA_len41_fa20_ta0_fm14_tm6,c
3124@TOP@human_GAPDH_TAA_len41_fa20_ta0_fm14_tm6*131*c,0,1895,0,0,1895,0.0,131,3124@TOP@human_GAPDH_TAA_len41_fa20_ta0_fm14_tm6,c
3124@TOP@human_GAPDH_TAA_len41_fa20_ta0_fm14_tm6*132*t,0,4,0,1863,1867,0.0,132,3124@TOP@human_GAPDH_TAA_len41_fa20_ta0_fm14_tm6,t
3124@TOP@human_GAPDH_TAA_len41_fa20_ta0_fm14_tm6*133*g,0,0,1872,0,1872,1.0,133,3124@TOP@human_GAPDH_TAA_len41_fa20_ta0_fm14_tm6,g
3124@TOP@human_GAPDH_TAA_len41_fa20_ta0_fm14_tm6*134*g,1,0,1869,0,1870,0.999,134,3124@TOP@human_GAPDH_TAA_len41_fa20_ta0_fm14_tm6,g
3125@TOP@human_GAPDH_TAA_len41_fa20_ta0_fm14_tm6*114*t,0,2,0,1910,1912,0.0,114,3125@TOP@human_GAPDH_TAA_len41_fa20_ta0_fm14_tm6,t
3125@TOP@human_GAPDH_TAA_len41_fa20_ta0_fm14_tm6*115*c,0,1920,0,0,1920,0.0,115,3125@TOP@human_GAPDH_TAA_len41_fa20_ta0_fm14_tm6,c
3125@TOP@human_GAPDH_TAA_len41_fa20_ta0_fm14_tm6*116*c,0,1918,0,0,1918,0.0,116,3125@TOP@human_GAPDH_TAA_len41_fa20_ta0_fm14_tm6,c
3125@TOP@human_GAPDH_TAA_len41_fa20_ta0_fm14_tm6*117*a,1910,0,4,0,1914,0.002,117,3125@TOP@human_GAPDH_TAA_len41_fa20_ta0_fm14_tm6,a
3125@TOP@human_GAPDH_TAA_len41_fa20_ta0_fm14_tm6*118*a,1880,0,22,0,1902,0.012,118,3125@TOP@human_GAPDH_TAA_len41_fa20_ta0_fm14_tm6,a
3125@TOP@human_GAPDH_TAA_len41_fa20_ta0_fm14_tm6*119*g,0,0,1889,0,1889,1.0,119,3125@TOP@human_GAPDH_TAA_len41_fa20_ta0_fm14_tm6,g
3125@TOP@human_GAPDH_TAA_len41_fa20_ta0_fm14_tm6*120*g,0,0,1897,0,1897,1.0,120,3125@TOP@human_GAPDH_TAA_len41_fa20_ta0_fm14_tm6,g
3125@TOP@human_GAPDH_TAA_len41_fa20_ta0_fm14_tm6*121*a,1909,0,4,0,1913,0.002,121,3125@TOP@human_GAPDH_TAA_len41_fa20_ta0_fm14_tm6,a
3125@TOP@human_GAPDH_TAA_len41_fa20_ta0_fm14_tm6*122*g,0,1,1916,0,1917,0.999,122,3125@TOP@human_GAPDH_TAA_len41_fa20_ta0_fm14_tm6,g
3125@TOP@human_GAPDH_TAA_len41_fa20_ta0_fm14_tm6*123*t,0,0,1,1881,1882,0.001,123,3125@TOP@human_GAPDH_TAA_len41_fa20_ta0_fm14_tm6,t
3125@TOP@human_GAPDH_TAA_len41_fa20_ta0_fm14_tm6*124*a,1694,0,187,0,1881,0.099,124,3125@TOP@human_GAPDH_TAA_len41_fa20_ta0_fm14_tm6,a
3125@TOP@human_GAPDH_TAA_len41_fa20_ta0_fm14_tm6*125*a,1741,0,144,0,1885,0.076,125,3125@TOP@human_GAPDH_TAA_len41_fa20_ta0_fm14_tm6,a
3125@TOP@human_GAPDH_TAA_len41_fa20_ta0_fm14_tm6*126*g,0,0,1890,0,1890,1.0,126,3125@TOP@human_GAPDH_TAA_len41_fa20_ta0_fm14_tm6,g
3125@TOP@human_GAPDH_TAA_len41_fa20_ta0_fm14_tm6*127*a,1897,0,1,0,1898,0.001,127,3125@TOP@human_GAPDH_TAA_len41_fa20_ta0_fm14_tm6,a
3125@TOP@human_GAPDH_TAA_len41_fa20_ta0_fm14_tm6*128*c,0,1914,0,0,1914,0.0,128,3125@TOP@human_GAPDH_TAA_len41_fa20_ta0_fm14_tm6,c
3125@TOP@human_GAPDH_TAA_len41_fa20_ta0_fm14_tm6*129*c,0,1909,0,0,1909,0.0,129,3125@TOP@human_GAPDH_TAA_len41_fa20_ta0_fm14_tm6,c
3125@TOP@human_GAPDH_TAA_len41_fa20_ta0_fm14_tm6*130*c,0,1918,0,0,1918,0.0,130,3125@TOP@human_GAPDH_TAA_len41_fa20_ta0_fm14_tm6,c
3125@TOP@human_GAPDH_TAA_len41_fa20_ta0_fm14_tm6*131*c,1,1922,0,0,1923,0.0,131,3125@TOP@human_GAPDH_TAA_len41_fa20_ta0_fm14_tm6,c
3125@TOP@human_GAPDH_TAA_len41_fa20_ta0_fm14_tm6*132*t,0,0,0,1899,1899,0.0,132,3125@TOP@human_GAPDH_TAA_len41_fa20_ta0_fm14_tm6,t
3125@TOP@human_GAPDH_TAA_len41_fa20_ta0_fm14_tm6*133*g,0,0,1887,1,1888,0.999,133,3125@TOP@human_GAPDH_TAA_len41_fa20_ta0_fm14_tm6,g
3125@TOP@human_GAPDH_TAA_len41_fa20_ta0_fm14_tm6*134*g,0,0,1899,0,1899,1.0,134,3125@TOP@human_GAPDH_TAA_len41_fa20_ta0_fm14_tm6,g
3126@TOP@human_GAPDH_TAA_len41_fa20_ta0_fm14_tm6*114*t,2,2,0,2624,2628,0.0,114,3126@TOP@human_GAPDH_TAA_len41_fa20_ta0_fm14_tm6,t
3126@TOP@human_GAPDH_TAA_len41_fa20_ta0_fm14_tm6*115*c,0,2644,0,0,2644,0.0,115,3126@TOP@human_GAPDH_TAA_len41_fa20_ta0_fm14_tm6,c
3126@TOP@human_GAPDH_TAA_len41_fa20_ta0_fm14_tm6*116*c,0,2631,0,0,2631,0.0,116,3126@TOP@human_GAPDH_TAA_len41_fa20_ta0_fm14_tm6,c
3126@TOP@human_GAPDH_TAA_len41_fa20_ta0_fm14_tm6*117*a,2623,0,9,0,2632,0.003,117,3126@TOP@human_GAPDH_TAA_len41_fa20_ta0_fm14_tm6,a
3126@TOP@human_GAPDH_TAA_len41_fa20_ta0_fm14_tm6*118*a,2570,0,45,0,2615,0.017,118,3126@TOP@human_GAPDH_TAA_len41_fa20_ta0_fm14_tm6,a
3126@TOP@human_GAPDH_TAA_len41_fa20_ta0_fm14_tm6*119*g,0,0,2610,0,2610,1.0,119,3126@TOP@human_GAPDH_TAA_len41_fa20_ta0_fm14_tm6,g
3126@TOP@human_GAPDH_TAA_len41_fa20_ta0_fm14_tm6*120*g,0,0,2595,0,2595,1.0,120,3126@TOP@human_GAPDH_TAA_len41_fa20_ta0_fm14_tm6,g
3126@TOP@human_GAPDH_TAA_len41_fa20_ta0_fm14_tm6*121*a,2629,0,5,0,2634,0.002,121,3126@TOP@human_GAPDH_TAA_len41_fa20_ta0_fm14_tm6,a
3126@TOP@human_GAPDH_TAA_len41_fa20_ta0_fm14_tm6*122*g,0,0,2631,0,2631,1.0,122,3126@TOP@human_GAPDH_TAA_len41_fa20_ta0_fm14_tm6,g
3126@TOP@human_GAPDH_TAA_len41_fa20_ta0_fm14_tm6*123*t,1,0,0,2595,2596,0.0,123,3126@TOP@human_GAPDH_TAA_len41_fa20_ta0_fm14_tm6,t
3126@TOP@human_GAPDH_TAA_len41_fa20_ta0_fm14_tm6*124*a,2401,0,192,0,2593,0.074,124,3126@TOP@human_GAPDH_TAA_len41_fa20_ta0_fm14_tm6,a
3126@TOP@human_GAPDH_TAA_len41_fa20_ta0_fm14_tm6*125*a,2466,1,113,1,2581,0.044,125,3126@TOP@human_GAPDH_TAA_len41_fa20_ta0_fm14_tm6,a
3126@TOP@human_GAPDH_TAA_len41_fa20_ta0_fm14_tm6*126*g,0,0,2596,0,2596,1.0,126,3126@TOP@human_GAPDH_TAA_len41_fa20_ta0_fm14_tm6,g
3126@TOP@human_GAPDH_TAA_len41_fa20_ta0_fm14_tm6*127*a,2613,0,8,0,2621,0.003,127,3126@TOP@human_GAPDH_TAA_len41_fa20_ta0_fm14_tm6,a
3126@TOP@human_GAPDH_TAA_len41_fa20_ta0_fm14_tm6*128*c,0,2637,0,0,2637,0.0,128,3126@TOP@human_GAPDH_TAA_len41_fa20_ta0_fm14_tm6,c
3126@TOP@human_GAPDH_TAA_len41_fa20_ta0_fm14_tm6*129*c,0,2614,0,0,2614,0.0,129,3126@TOP@human_GAPDH_TAA_len41_fa20_ta0_fm14_tm6,c
3126@TOP@human_GAPDH_TAA_len41_fa20_ta0_fm14_tm6*130*c,1,2629,0,1,2631,0.0,130,3126@TOP@human_GAPDH_TAA_len41_fa20_ta0_fm14_tm6,c
3126@TOP@human_GAPDH_TAA_len41_fa20_ta0_fm14_tm6*131*c,0,2639,0,0,2639,0.0,131,3126@TOP@human_GAPDH_TAA_len41_fa20_ta0_fm14_tm6,c
3126@TOP@human_GAPDH_TAA_len41_fa20_ta0_fm14_tm6*132*t,0,0,0,2602,2602,0.0,132,3126@TOP@human_GAPDH_TAA_len41_fa20_ta0_fm14_tm6,t
3126@TOP@human_GAPDH_TAA_len41_fa20_ta0_fm14_tm6*133*g,0,0,2573,0,2573,1.0,133,3126@TOP@human_GAPDH_TAA_len41_fa20_ta0_fm14_tm6,g
3126@TOP@human_GAPDH_TAA_len41_fa20_ta0_fm14_tm6*134*g,0,0,2604,1,2605,1.0,134,3126@TOP@human_GAPDH_TAA_len41_fa20_ta0_fm14_tm6,g
3127@TOP@human_GAPDH_TAA_len41_fa20_ta0_fm14_tm6*114*t,0,1,0,1013,1014,0.0,114,3127@TOP@human_GAPDH_TAA_len41_fa20_ta0_fm14_tm6,t
3127@TOP@human_GAPDH_TAA_len41_fa20_ta0_fm14_tm6*115*c,0,1025,0,0,1025,0.0,115,3127@TOP@human_GAPDH_TAA_len41_fa20_ta0_fm14_tm6,c
3127@TOP@human_GAPDH_TAA_len41_fa20_ta0_fm14_tm6*116*c,0,1019,0,0,1019,0.0,116,3127@TOP@human_GAPDH_TAA_len41_fa20_ta0_fm14_tm6,c
3127@TOP@human_GAPDH_TAA_len41_fa20_ta0_fm14_tm6*117*a,1017,0,0,0,1017,0.0,117,3127@TOP@human_GAPDH_TAA_len41_fa20_ta0_fm14_tm6,a
3127@TOP@human_GAPDH_TAA_len41_fa20_ta0_fm14_tm6*118*a,986,0,22,0,1008,0.022,118,3127@TOP@human_GAPDH_TAA_len41_fa20_ta0_fm14_tm6,a
3127@TOP@human_GAPDH_TAA_len41_fa20_ta0_fm14_tm6*119*g,0,0,1001,0,1001,1.0,119,3127@TOP@human_GAPDH_TAA_len41_fa20_ta0_fm14_tm6,g
3127@TOP@human_GAPDH_TAA_len41_fa20_ta0_fm14_tm6*120*g,0,0,1001,0,1001,1.0,120,3127@TOP@human_GAPDH_TAA_len41_fa20_ta0_fm14_tm6,g
3127@TOP@human_GAPDH_TAA_len41_fa20_ta0_fm14_tm6*121*a,1020,0,0,0,1020,0.0,121,3127@TOP@human_GAPDH_TAA_len41_fa20_ta0_fm14_tm6,a
3127@TOP@human_GAPDH_TAA_len41_fa20_ta0_fm14_tm6*122*g,0,0,1016,0,1016,1.0,122,3127@TOP@human_GAPDH_TAA_len41_fa20_ta0_fm14_tm6,g
3127@TOP@human_GAPDH_TAA_len41_fa20_ta0_fm14_tm6*123*t,0,0,0,1003,1003,0.0,123,3127@TOP@human_GAPDH_TAA_len41_fa20_ta0_fm14_tm6,t
3127@TOP@human_GAPDH_TAA_len41_fa20_ta0_fm14_tm6*124*a,945,0,61,0,1006,0.061,124,3127@TOP@human_GAPDH_TAA_len41_fa20_ta0_fm14_tm6,a
3127@TOP@human_GAPDH_TAA_len41_fa20_ta0_fm14_tm6*125*a,975,0,25,0,1000,0.025,125,3127@TOP@human_GAPDH_TAA_len41_fa20_ta0_fm14_tm6,a
3127@TOP@human_GAPDH_TAA_len41_fa20_ta0_fm14_tm6*126*g,0,0,997,0,997,1.0,126,3127@TOP@human_GAPDH_TAA_len41_fa20_ta0_fm14_tm6,g
3127@TOP@human_GAPDH_TAA_len41_fa20_ta0_fm14_tm6*127*a,1013,0,2,0,1015,0.002,127,3127@TOP@human_GAPDH_TAA_len41_fa20_ta0_fm14_tm6,a
3127@TOP@human_GAPDH_TAA_len41_fa20_ta0_fm14_tm6*128*c,0,1023,0,0,1023,0.0,128,3127@TOP@human_GAPDH_TAA_len41_fa20_ta0_fm14_tm6,c
3127@TOP@human_GAPDH_TAA_len41_fa20_ta0_fm14_tm6*129*c,0,1012,0,0,1012,0.0,129,3127@TOP@human_GAPDH_TAA_len41_fa20_ta0_fm14_tm6,c
3127@TOP@human_GAPDH_TAA_len41_fa20_ta0_fm14_tm6*130*c,0,1017,0,0,1017,0.0,130,3127@TOP@human_GAPDH_TAA_len41_fa20_ta0_fm14_tm6,c
3127@TOP@human_GAPDH_TAA_len41_fa20_ta0_fm14_tm6*131*c,0,1017,0,0,1017,0.0,131,3127@TOP@human_GAPDH_TAA_len41_fa20_ta0_fm14_tm6,c
3127@TOP@human_GAPDH_TAA_len41_fa20_ta0_fm14_tm6*132*t,0,0,0,1004,1004,0.0,132,3127@TOP@human_GAPDH_TAA_len41_fa20_ta0_fm14_tm6,t
3127@TOP@human_GAPDH_TAA_len41_fa20_ta0_fm14_tm6*133*g,0,0,991,0,991,1.0,133,3127@TOP@human_GAPDH_TAA_len41_fa20_ta0_fm14_tm6,g
3127@TOP@human_GAPDH_TAA_len41_fa20_ta0_fm14_tm6*134*g,2,0,1003,0,1005,0.998,134,3127@TOP@human_GAPDH_TAA_len41_fa20_ta0_fm14_tm6,g
3128@TOP@human_GAPDH_TAA_len41_fa20_ta0_fm14_tm6*114*t,2,2,0,5041,5045,0.0,114,3128@TOP@human_GAPDH_TAA_len41_fa20_ta0_fm14_tm6,t
3128@TOP@human_GAPDH_TAA_len41_fa20_ta0_fm14_tm6*115*c,0,5077,0,2,5079,0.0,115,3128@TOP@human_GAPDH_TAA_len41_fa20_ta0_fm14_tm6,c
3128@TOP@human_GAPDH_TAA_len41_fa20_ta0_fm14_tm6*116*c,0,5066,0,0,5066,0.0,116,3128@TOP@human_GAPDH_TAA_len41_fa20_ta0_fm14_tm6,c
3128@TOP@human_GAPDH_TAA_len41_fa20_ta0_fm14_tm6*117*a,5036,0,18,0,5054,0.004,117,3128@TOP@human_GAPDH_TAA_len41_fa20_ta0_fm14_tm6,a
3128@TOP@human_GAPDH_TAA_len41_fa20_ta0_fm14_tm6*118*a,4971,0,50,0,5021,0.01,118,3128@TOP@human_GAPDH_TAA_len41_fa20_ta0_fm14_tm6,a
3128@TOP@human_GAPDH_TAA_len41_fa20_ta0_fm14_tm6*119*g,0,0,5022,0,5022,1.0,119,3128@TOP@human_GAPDH_TAA_len41_fa20_ta0_fm14_tm6,g
3128@TOP@human_GAPDH_TAA_len41_fa20_ta0_fm14_tm6*120*g,0,0,4990,0,4990,1.0,120,3128@TOP@human_GAPDH_TAA_len41_fa20_ta0_fm14_tm6,g
3128@TOP@human_GAPDH_TAA_len41_fa20_ta0_fm14_tm6*121*a,5032,0,1,0,5033,0.0,121,3128@TOP@human_GAPDH_TAA_len41_fa20_ta0_fm14_tm6,a
3128@TOP@human_GAPDH_TAA_len41_fa20_ta0_fm14_tm6*122*g,1,0,5052,0,5053,1.0,122,3128@TOP@human_GAPDH_TAA_len41_fa20_ta0_fm14_tm6,g
3128@TOP@human_GAPDH_TAA_len41_fa20_ta0_fm14_tm6*123*t,0,2,0,4960,4962,0.0,123,3128@TOP@human_GAPDH_TAA_len41_fa20_ta0_fm14_tm6,t
3128@TOP@human_GAPDH_TAA_len41_fa20_ta0_fm14_tm6*124*a,4740,1,226,0,4967,0.046,124,3128@TOP@human_GAPDH_TAA_len41_fa20_ta0_fm14_tm6,a
3128@TOP@human_GAPDH_TAA_len41_fa20_ta0_fm14_tm6*125*a,4797,0,187,0,4984,0.038,125,3128@TOP@human_GAPDH_TAA_len41_fa20_ta0_fm14_tm6,a
3128@TOP@human_GAPDH_TAA_len41_fa20_ta0_fm14_tm6*126*g,0,0,4993,0,4993,1.0,126,3128@TOP@human_GAPDH_TAA_len41_fa20_ta0_fm14_tm6,g
3128@TOP@human_GAPDH_TAA_len41_fa20_ta0_fm14_tm6*127*a,5025,0,7,0,5032,0.001,127,3128@TOP@human_GAPDH_TAA_len41_fa20_ta0_fm14_tm6,a
3128@TOP@human_GAPDH_TAA_len41_fa20_ta0_fm14_tm6*128*c,0,5059,0,0,5059,0.0,128,3128@TOP@human_GAPDH_TAA_len41_fa20_ta0_fm14_tm6,c
3128@TOP@human_GAPDH_TAA_len41_fa20_ta0_fm14_tm6*129*c,3,5017,0,0,5020,0.0,129,3128@TOP@human_GAPDH_TAA_len41_fa20_ta0_fm14_tm6,c
3128@TOP@human_GAPDH_TAA_len41_fa20_ta0_fm14_tm6*130*c,1,5041,0,1,5043,0.0,130,3128@TOP@human_GAPDH_TAA_len41_fa20_ta0_fm14_tm6,c
3128@TOP@human_GAPDH_TAA_len41_fa20_ta0_fm14_tm6*131*c,0,5069,0,0,5069,0.0,131,3128@TOP@human_GAPDH_TAA_len41_fa20_ta0_fm14_tm6,c
3128@TOP@human_GAPDH_TAA_len41_fa20_ta0_fm14_tm6*132*t,0,0,1,4979,4980,0.0,132,3128@TOP@human_GAPDH_TAA_len41_fa20_ta0_fm14_tm6,t
3128@TOP@human_GAPDH_TAA_len41_fa20_ta0_fm14_tm6*133*g,1,0,4961,0,4962,1.0,133,3128@TOP@human_GAPDH_TAA_len41_fa20_ta0_fm14_tm6,g
3128@TOP@human_GAPDH_TAA_len41_fa20_ta0_fm14_tm6*134*g,0,6,4995,0,5001,0.999,134,3128@TOP@human_GAPDH_TAA_len41_fa20_ta0_fm14_tm6,g
3129@TOP@human_GAPDH_TAA_len41_fa20_ta0_fm14_tm6*114*t,0,4,0,12987,12991,0.0,114,3129@TOP@human_GAPDH_TAA_len41_fa20_ta0_fm14_tm6,t
3129@TOP@human_GAPDH_TAA_len41_fa20_ta0_fm14_tm6*115*c,0,13064,0,1,13065,0.0,115,3129@TOP@human_GAPDH_TAA_len41_fa20_ta0_fm14_tm6,c
3129@TOP@human_GAPDH_TAA_len41_fa20_ta0_fm14_tm6*116*c,0,13014,0,0,13014,0.0,116,3129@TOP@human_GAPDH_TAA_len41_fa20_ta0_fm14_tm6,c
3129@TOP@human_GAPDH_TAA_len41_fa20_ta0_fm14_tm6*117*a,12924,1,83,1,13009,0.006,117,3129@TOP@human_GAPDH_TAA_len41_fa20_ta0_fm14_tm6,a
3129@TOP@human_GAPDH_TAA_len41_fa20_ta0_fm14_tm6*118*a,12767,1,168,1,12937,0.013,118,3129@TOP@human_GAPDH_TAA_len41_fa20_ta0_fm14_tm6,a
3129@TOP@human_GAPDH_TAA_len41_fa20_ta0_fm14_tm6*119*g,4,0,12884,1,12889,1.0,119,3129@TOP@human_GAPDH_TAA_len41_fa20_ta0_fm14_tm6,g
3129@TOP@human_GAPDH_TAA_len41_fa20_ta0_fm14_tm6*120*g,0,0,12842,1,12843,1.0,120,3129@TOP@human_GAPDH_TAA_len41_fa20_ta0_fm14_tm6,g
3129@TOP@human_GAPDH_TAA_len41_fa20_ta0_fm14_tm6*121*a,12994,0,5,1,13000,0.0,121,3129@TOP@human_GAPDH_TAA_len41_fa20_ta0_fm14_tm6,a
3129@TOP@human_GAPDH_TAA_len41_fa20_ta0_fm14_tm6*122*g,0,0,13021,0,13021,1.0,122,3129@TOP@human_GAPDH_TAA_len41_fa20_ta0_fm14_tm6,g
3129@TOP@human_GAPDH_TAA_len41_fa20_ta0_fm14_tm6*123*t,0,2,2,12834,12838,0.0,123,3129@TOP@human_GAPDH_TAA_len41_fa20_ta0_fm14_tm6,t
3129@TOP@human_GAPDH_TAA_len41_fa20_ta0_fm14_tm6*124*a,11641,0,1153,0,12794,0.09,124,3129@TOP@human_GAPDH_TAA_len41_fa20_ta0_fm14_tm6,a
3129@TOP@human_GAPDH_TAA_len41_fa20_ta0_fm14_tm6*125*a,12536,0,257,3,12796,0.02,125,3129@TOP@human_GAPDH_TAA_len41_fa20_ta0_fm14_tm6,a
3129@TOP@human_GAPDH_TAA_len41_fa20_ta0_fm14_tm6*126*g,0,0,12850,1,12851,1.0,126,3129@TOP@human_GAPDH_TAA_len41_fa20_ta0_fm14_tm6,g
3129@TOP@human_GAPDH_TAA_len41_fa20_ta0_fm14_tm6*127*a,12961,0,4,0,12965,0.0,127,3129@TOP@human_GAPDH_TAA_len41_fa20_ta0_fm14_tm6,a
3129@TOP@human_GAPDH_TAA_len41_fa20_ta0_fm14_tm6*128*c,0,13025,1,0,13026,0.0,128,3129@TOP@human_GAPDH_TAA_len41_fa20_ta0_fm14_tm6,c
3129@TOP@human_GAPDH_TAA_len41_fa20_ta0_fm14_tm6*129*c,2,12935,0,0,12937,0.0,129,3129@TOP@human_GAPDH_TAA_len41_fa20_ta0_fm14_tm6,c
3129@TOP@human_GAPDH_TAA_len41_fa20_ta0_fm14_tm6*130*c,1,13016,0,2,13019,0.0,130,3129@TOP@human_GAPDH_TAA_len41_fa20_ta0_fm14_tm6,c
3129@TOP@human_GAPDH_TAA_len41_fa20_ta0_fm14_tm6*131*c,1,13030,0,2,13033,0.0,131,3129@TOP@human_GAPDH_TAA_len41_fa20_ta0_fm14_tm6,c
3129@TOP@human_GAPDH_TAA_len41_fa20_ta0_fm14_tm6*132*t,0,6,0,12829,12835,0.0,132,3129@TOP@human_GAPDH_TAA_len41_fa20_ta0_fm14_tm6,t
3129@TOP@human_GAPDH_TAA_len41_fa20_ta0_fm14_tm6*133*g,0,1,12832,0,12833,1.0,133,3129@TOP@human_GAPDH_TAA_len41_fa20_ta0_fm14_tm6,g
3129@TOP@human_GAPDH_TAA_len41_fa20_ta0_fm14_tm6*134*g,1,0,12875,0,12876,1.0,134,3129@TOP@human_GAPDH_TAA_len41_fa20_ta0_fm14_tm6,g
3130@TOP@human_GAPDH_TAA_len41_fa20_ta0_fm14_tm6*114*t,0,1,0,3108,3109,0.0,114,3130@TOP@human_GAPDH_TAA_len41_fa20_ta0_fm14_tm6,t
3130@TOP@human_GAPDH_TAA_len41_fa20_ta0_fm14_tm6*115*c,0,3124,0,0,3124,0.0,115,3130@TOP@human_GAPDH_TAA_len41_fa20_ta0_fm14_tm6,c
3130@TOP@human_GAPDH_TAA_len41_fa20_ta0_fm14_tm6*116*c,0,3117,0,0,3117,0.0,116,3130@TOP@human_GAPDH_TAA_len41_fa20_ta0_fm14_tm6,c
3130@TOP@human_GAPDH_TAA_len41_fa20_ta0_fm14_tm6*117*a,3102,0,7,0,3109,0.002,117,3130@TOP@human_GAPDH_TAA_len41_fa20_ta0_fm14_tm6,a
3130@TOP@human_GAPDH_TAA_len41_fa20_ta0_fm14_tm6*118*a,3055,0,41,0,3096,0.013,118,3130@TOP@human_GAPDH_TAA_len41_fa20_ta0_fm14_tm6,a
3130@TOP@human_GAPDH_TAA_len41_fa20_ta0_fm14_tm6*119*g,0,0,3093,0,3093,1.0,119,3130@TOP@human_GAPDH_TAA_len41_fa20_ta0_fm14_tm6,g
3130@TOP@human_GAPDH_TAA_len41_fa20_ta0_fm14_tm6*120*g,0,0,3071,0,3071,1.0,120,3130@TOP@human_GAPDH_TAA_len41_fa20_ta0_fm14_tm6,g
3130@TOP@human_GAPDH_TAA_len41_fa20_ta0_fm14_tm6*121*a,3114,0,0,0,3114,0.0,121,3130@TOP@human_GAPDH_TAA_len41_fa20_ta0_fm14_tm6,a
3130@TOP@human_GAPDH_TAA_len41_fa20_ta0_fm14_tm6*122*g,0,0,3113,0,3113,1.0,122,3130@TOP@human_GAPDH_TAA_len41_fa20_ta0_fm14_tm6,g
3130@TOP@human_GAPDH_TAA_len41_fa20_ta0_fm14_tm6*123*t,0,0,0,3071,3071,0.0,123,3130@TOP@human_GAPDH_TAA_len41_fa20_ta0_fm14_tm6,t
3130@TOP@human_GAPDH_TAA_len41_fa20_ta0_fm14_tm6*124*a,2935,0,125,0,3060,0.041,124,3130@TOP@human_GAPDH_TAA_len41_fa20_ta0_fm14_tm6,a
3130@TOP@human_GAPDH_TAA_len41_fa20_ta0_fm14_tm6*125*a,2982,0,73,0,3055,0.024,125,3130@TOP@human_GAPDH_TAA_len41_fa20_ta0_fm14_tm6,a
3130@TOP@human_GAPDH_TAA_len41_fa20_ta0_fm14_tm6*126*g,0,0,3078,0,3078,1.0,126,3130@TOP@human_GAPDH_TAA_len41_fa20_ta0_fm14_tm6,g
3130@TOP@human_GAPDH_TAA_len41_fa20_ta0_fm14_tm6*127*a,3103,0,2,0,3105,0.001,127,3130@TOP@human_GAPDH_TAA_len41_fa20_ta0_fm14_tm6,a
3130@TOP@human_GAPDH_TAA_len41_fa20_ta0_fm14_tm6*128*c,0,3114,0,1,3115,0.0,128,3130@TOP@human_GAPDH_TAA_len41_fa20_ta0_fm14_tm6,c
3130@TOP@human_GAPDH_TAA_len41_fa20_ta0_fm14_tm6*129*c,0,3095,0,0,3095,0.0,129,3130@TOP@human_GAPDH_TAA_len41_fa20_ta0_fm14_tm6,c
3130@TOP@human_GAPDH_TAA_len41_fa20_ta0_fm14_tm6*130*c,0,3110,0,0,3110,0.0,130,3130@TOP@human_GAPDH_TAA_len41_fa20_ta0_fm14_tm6,c
3130@TOP@human_GAPDH_TAA_len41_fa20_ta0_fm14_tm6*131*c,0,3120,0,0,3120,0.0,131,3130@TOP@human_GAPDH_TAA_len41_fa20_ta0_fm14_tm6,c
3130@TOP@human_GAPDH_TAA_len41_fa20_ta0_fm14_tm6*132*t,1,0,0,3074,3075,0.0,132,3130@TOP@human_GAPDH_TAA_len41_fa20_ta0_fm14_tm6,t
3130@TOP@human_GAPDH_TAA_len41_fa20_ta0_fm14_tm6*133*g,0,0,3066,0,3066,1.0,133,3130@TOP@human_GAPDH_TAA_len41_fa20_ta0_fm14_tm6,g
3130@TOP@human_GAPDH_TAA_len41_fa20_ta0_fm14_tm6*134*g,0,0,3093,0,3093,1.0,134,3130@TOP@human_GAPDH_TAA_len41_fa20_ta0_fm14_tm6,g
3131@TOP@human_GAPDH_TAA_len41_fa20_ta0_fm14_tm6*114*t,1,1,0,4161,4163,0.0,114,3131@TOP@human_GAPDH_TAA_len41_fa20_ta0_fm14_tm6,t
3131@TOP@human_GAPDH_TAA_len41_fa20_ta0_fm14_tm6*115*c,0,4191,0,0,4191,0.0,115,3131@TOP@human_GAPDH_TAA_len41_fa20_ta0_fm14_tm6,c
3131@TOP@human_GAPDH_TAA_len41_fa20_ta0_fm14_tm6*116*c,0,4172,0,1,4173,0.0,116,3131@TOP@human_GAPDH_TAA_len41_fa20_ta0_fm14_tm6,c
3131@TOP@human_GAPDH_TAA_len41_fa20_ta0_fm14_tm6*117*a,4153,0,14,0,4167,0.003,117,3131@TOP@human_GAPDH_TAA_len41_fa20_ta0_fm14_tm6,a
3131@TOP@human_GAPDH_TAA_len41_fa20_ta0_fm14_tm6*118*a,4072,0,66,1,4139,0.016,118,3131@TOP@human_GAPDH_TAA_len41_fa20_ta0_fm14_tm6,a
3131@TOP@human_GAPDH_TAA_len41_fa20_ta0_fm14_tm6*119*g,0,0,4120,0,4120,1.0,119,3131@TOP@human_GAPDH_TAA_len41_fa20_ta0_fm14_tm6,g
3131@TOP@human_GAPDH_TAA_len41_fa20_ta0_fm14_tm6*120*g,0,0,4106,0,4106,1.0,120,3131@TOP@human_GAPDH_TAA_len41_fa20_ta0_fm14_tm6,g
3131@TOP@human_GAPDH_TAA_len41_fa20_ta0_fm14_tm6*121*a,4162,0,0,0,4162,0.0,121,3131@TOP@human_GAPDH_TAA_len41_fa20_ta0_fm14_tm6,a
3131@TOP@human_GAPDH_TAA_len41_fa20_ta0_fm14_tm6*122*g,0,0,4165,0,4165,1.0,122,3131@TOP@human_GAPDH_TAA_len41_fa20_ta0_fm14_tm6,g
3131@TOP@human_GAPDH_TAA_len41_fa20_ta0_fm14_tm6*123*t,0,7,1,4076,4084,0.0,123,3131@TOP@human_GAPDH_TAA_len41_fa20_ta0_fm14_tm6,t
3131@TOP@human_GAPDH_TAA_len41_fa20_ta0_fm14_tm6*124*a,3864,0,244,0,4108,0.059,124,3131@TOP@human_GAPDH_TAA_len41_fa20_ta0_fm14_tm6,a
3131@TOP@human_GAPDH_TAA_len41_fa20_ta0_fm14_tm6*125*a,3965,0,109,1,4075,0.027,125,3131@TOP@human_GAPDH_TAA_len41_fa20_ta0_fm14_tm6,a
3131@TOP@human_GAPDH_TAA_len41_fa20_ta0_fm14_tm6*126*g,0,0,4118,0,4118,1.0,126,3131@TOP@human_GAPDH_TAA_len41_fa20_ta0_fm14_tm6,g
3131@TOP@human_GAPDH_TAA_len41_fa20_ta0_fm14_tm6*127*a,4150,0,2,0,4152,0.0,127,3131@TOP@human_GAPDH_TAA_len41_fa20_ta0_fm14_tm6,a
3131@TOP@human_GAPDH_TAA_len41_fa20_ta0_fm14_tm6*128*c,0,4179,0,0,4179,0.0,128,3131@TOP@human_GAPDH_TAA_len41_fa20_ta0_fm14_tm6,c
3131@TOP@human_GAPDH_TAA_len41_fa20_ta0_fm14_tm6*129*c,0,4137,0,0,4137,0.0,129,3131@TOP@human_GAPDH_TAA_len41_fa20_ta0_fm14_tm6,c
3131@TOP@human_GAPDH_TAA_len41_fa20_ta0_fm14_tm6*130*c,0,4161,0,0,4161,0.0,130,3131@TOP@human_GAPDH_TAA_len41_fa20_ta0_fm14_tm6,c
3131@TOP@human_GAPDH_TAA_len41_fa20_ta0_fm14_tm6*131*c,1,4174,0,0,4175,0.0,131,3131@TOP@human_GAPDH_TAA_len41_fa20_ta0_fm14_tm6,c
3131@TOP@human_GAPDH_TAA_len41_fa20_ta0_fm14_tm6*132*t,0,0,1,4111,4112,0.0,132,3131@TOP@human_GAPDH_TAA_len41_fa20_ta0_fm14_tm6,t
3131@TOP@human_GAPDH_TAA_len41_fa20_ta0_fm14_tm6*133*g,0,0,4103,0,4103,1.0,133,3131@TOP@human_GAPDH_TAA_len41_fa20_ta0_fm14_tm6,g
3131@TOP@human_GAPDH_TAA_len41_fa20_ta0_fm14_tm6*134*g,0,0,4117,0,4117,1.0,134,3131@TOP@human_GAPDH_TAA_len41_fa20_ta0_fm14_tm6,g
3132@TOP@human_GAPDH_TAA_len41_fa20_ta0_fm14_tm6*114*t,0,13,0,32601,32614,0.0,114,3132@TOP@human_GAPDH_TAA_len41_fa20_ta0_fm14_tm6,t
3132@TOP@human_GAPDH_TAA_len41_fa20_ta0_fm14_tm6*115*c,3,32794,0,1,32798,0.0,115,3132@TOP@human_GAPDH_TAA_len41_fa20_ta0_fm14_tm6,c
3132@TOP@human_GAPDH_TAA_len41_fa20_ta0_fm14_tm6*116*c,3,32690,1,0,32694,0.0,116,3132@TOP@human_GAPDH_TAA_len41_fa20_ta0_fm14_tm6,c
3132@TOP@human_GAPDH_TAA_len41_fa20_ta0_fm14_tm6*117*a,32578,0,41,1,32620,0.001,117,3132@TOP@human_GAPDH_TAA_len41_fa20_ta0_fm14_tm6,a
3132@TOP@human_GAPDH_TAA_len41_fa20_ta0_fm14_tm6*118*a,32025,1,408,0,32434,0.013,118,3132@TOP@human_GAPDH_TAA_len41_fa20_ta0_fm14_tm6,a
3132@TOP@human_GAPDH_TAA_len41_fa20_ta0_fm14_tm6*119*g,1,0,32387,3,32391,1.0,119,3132@TOP@human_GAPDH_TAA_len41_fa20_ta0_fm14_tm6,g
3132@TOP@human_GAPDH_TAA_len41_fa20_ta0_fm14_tm6*120*g,1,0,32254,0,32255,1.0,120,3132@TOP@human_GAPDH_TAA_len41_fa20_ta0_fm14_tm6,g
3132@TOP@human_GAPDH_TAA_len41_fa20_ta0_fm14_tm6*121*a,32597,0,8,0,32605,0.0,121,3132@TOP@human_GAPDH_TAA_len41_fa20_ta0_fm14_tm6,a
3132@TOP@human_GAPDH_TAA_len41_fa20_ta0_fm14_tm6*122*g,4,0,32669,1,32674,1.0,122,3132@TOP@human_GAPDH_TAA_len41_fa20_ta0_fm14_tm6,g
3132@TOP@human_GAPDH_TAA_len41_fa20_ta0_fm14_tm6*123*t,2,3,2,32171,32178,0.0,123,3132@TOP@human_GAPDH_TAA_len41_fa20_ta0_fm14_tm6,t
3132@TOP@human_GAPDH_TAA_len41_fa20_ta0_fm14_tm6*124*a,31128,0,961,0,32089,0.03,124,3132@TOP@human_GAPDH_TAA_len41_fa20_ta0_fm14_tm6,a
3132@TOP@human_GAPDH_TAA_len41_fa20_ta0_fm14_tm6*125*a,31469,1,579,2,32051,0.018,125,3132@TOP@human_GAPDH_TAA_len41_fa20_ta0_fm14_tm6,a
3132@TOP@human_GAPDH_TAA_len41_fa20_ta0_fm14_tm6*126*g,0,0,32209,2,32211,1.0,126,3132@TOP@human_GAPDH_TAA_len41_fa20_ta0_fm14_tm6,g
3132@TOP@human_GAPDH_TAA_len41_fa20_ta0_fm14_tm6*127*a,32463,0,23,0,32486,0.001,127,3132@TOP@human_GAPDH_TAA_len41_fa20_ta0_fm14_tm6,a
3132@TOP@human_GAPDH_TAA_len41_fa20_ta0_fm14_tm6*128*c,2,32689,1,0,32692,0.0,128,3132@TOP@human_GAPDH_TAA_len41_fa20_ta0_fm14_tm6,c
3132@TOP@human_GAPDH_TAA_len41_fa20_ta0_fm14_tm6*129*c,3,32506,0,2,32511,0.0,129,3132@TOP@human_GAPDH_TAA_len41_fa20_ta0_fm14_tm6,c
3132@TOP@human_GAPDH_TAA_len41_fa20_ta0_fm14_tm6*130*c,0,32647,0,0,32647,0.0,130,3132@TOP@human_GAPDH_TAA_len41_fa20_ta0_fm14_tm6,c
3132@TOP@human_GAPDH_TAA_len41_fa20_ta0_fm14_tm6*131*c,2,32728,0,3,32733,0.0,131,3132@TOP@human_GAPDH_TAA_len41_fa20_ta0_fm14_tm6,c
3132@TOP@human_GAPDH_TAA_len41_fa20_ta0_fm14_tm6*132*t,2,8,1,32233,32244,0.0,132,3132@TOP@human_GAPDH_TAA_len41_fa20_ta0_fm14_tm6,t
3132@TOP@human_GAPDH_TAA_len41_fa20_ta0_fm14_tm6*133*g,10,1,32194,1,32206,1.0,133,3132@TOP@human_GAPDH_TAA_len41_fa20_ta0_fm14_tm6,g
3132@TOP@human_GAPDH_TAA_len41_fa20_ta0_fm14_tm6*134*g,0,2,32373,2,32377,1.0,134,3132@TOP@human_GAPDH_TAA_len41_fa20_ta0_fm14_tm6,g
3133@TOP@human_GAPDH_TAA_len41_fa20_ta0_fm14_tm6*114*t,0,16,0,22031,22047,0.0,114,3133@TOP@human_GAPDH_TAA_len41_fa20_ta0_fm14_tm6,t
3133@TOP@human_GAPDH_TAA_len41_fa20_ta0_fm14_tm6*115*c,0,22177,0,0,22177,0.0,115,3133@TOP@human_GAPDH_TAA_len41_fa20_ta0_fm14_tm6,c
3133@TOP@human_GAPDH_TAA_len41_fa20_ta0_fm14_tm6*116*c,0,22098,1,2,22101,0.0,116,3133@TOP@human_GAPDH_TAA_len41_fa20_ta0_fm14_tm6,c
3133@TOP@human_GAPDH_TAA_len41_fa20_ta0_fm14_tm6*117*a,22025,0,40,0,22065,0.002,117,3133@TOP@human_GAPDH_TAA_len41_fa20_ta0_fm14_tm6,a
3133@TOP@human_GAPDH_TAA_len41_fa20_ta0_fm14_tm6*118*a,21675,1,278,0,21954,0.013,118,3133@TOP@human_GAPDH_TAA_len41_fa20_ta0_fm14_tm6,a
3133@TOP@human_GAPDH_TAA_len41_fa20_ta0_fm14_tm6*119*g,0,2,21920,2,21924,1.0,119,3133@TOP@human_GAPDH_TAA_len41_fa20_ta0_fm14_tm6,g
3133@TOP@human_GAPDH_TAA_len41_fa20_ta0_fm14_tm6*120*g,1,1,21846,2,21850,1.0,120,3133@TOP@human_GAPDH_TAA_len41_fa20_ta0_fm14_tm6,g
3133@TOP@human_GAPDH_TAA_len41_fa20_ta0_fm14_tm6*121*a,22033,0,3,0,22036,0.0,121,3133@TOP@human_GAPDH_TAA_len41_fa20_ta0_fm14_tm6,a
3133@TOP@human_GAPDH_TAA_len41_fa20_ta0_fm14_tm6*122*g,1,1,22092,1,22095,1.0,122,3133@TOP@human_GAPDH_TAA_len41_fa20_ta0_fm14_tm6,g
3133@TOP@human_GAPDH_TAA_len41_fa20_ta0_fm14_tm6*123*t,3,0,3,21802,21808,0.0,123,3133@TOP@human_GAPDH_TAA_len41_fa20_ta0_fm14_tm6,t
3133@TOP@human_GAPDH_TAA_len41_fa20_ta0_fm14_tm6*124*a,20924,0,748,0,21672,0.035,124,3133@TOP@human_GAPDH_TAA_len41_fa20_ta0_fm14_tm6,a
3133@TOP@human_GAPDH_TAA_len41_fa20_ta0_fm14_tm6*125*a,21252,1,369,3,21625,0.017,125,3133@TOP@human_GAPDH_TAA_len41_fa20_ta0_fm14_tm6,a
3133@TOP@human_GAPDH_TAA_len41_fa20_ta0_fm14_tm6*126*g,0,0,21756,1,21757,1.0,126,3133@TOP@human_GAPDH_TAA_len41_fa20_ta0_fm14_tm6,g
3133@TOP@human_GAPDH_TAA_len41_fa20_ta0_fm14_tm6*127*a,21956,1,15,0,21972,0.001,127,3133@TOP@human_GAPDH_TAA_len41_fa20_ta0_fm14_tm6,a
3133@TOP@human_GAPDH_TAA_len41_fa20_ta0_fm14_tm6*128*c,0,22116,3,1,22120,0.0,128,3133@TOP@human_GAPDH_TAA_len41_fa20_ta0_fm14_tm6,c
3133@TOP@human_GAPDH_TAA_len41_fa20_ta0_fm14_tm6*129*c,1,21952,0,0,21953,0.0,129,3133@TOP@human_GAPDH_TAA_len41_fa20_ta0_fm14_tm6,c
3133@TOP@human_GAPDH_TAA_len41_fa20_ta0_fm14_tm6*130*c,3,22088,0,3,22094,0.0,130,3133@TOP@human_GAPDH_TAA_len41_fa20_ta0_fm14_tm6,c
3133@TOP@human_GAPDH_TAA_len41_fa20_ta0_fm14_tm6*131*c,1,22130,0,1,22132,0.0,131,3133@TOP@human_GAPDH_TAA_len41_fa20_ta0_fm14_tm6,c
3133@TOP@human_GAPDH_TAA_len41_fa20_ta0_fm14_tm6*132*t,4,4,2,21824,21834,0.0,132,3133@TOP@human_GAPDH_TAA_len41_fa20_ta0_fm14_tm6,t
3133@TOP@human_GAPDH_TAA_len41_fa20_ta0_fm14_tm6*133*g,1,0,21755,0,21756,1.0,133,3133@TOP@human_GAPDH_TAA_len41_fa20_ta0_fm14_tm6,g
3133@TOP@human_GAPDH_TAA_len41_fa20_ta0_fm14_tm6*134*g,5,7,21854,1,21867,0.999,134,3133@TOP@human_GAPDH_TAA_len41_fa20_ta0_fm14_tm6,g
3134@TOP@human_GAPDH_TAA_len41_fa20_ta0_fm14_tm6*114*t,0,1,0,4342,4343,0.0,114,3134@TOP@human_GAPDH_TAA_len41_fa20_ta0_fm14_tm6,t
3134@TOP@human_GAPDH_TAA_len41_fa20_ta0_fm14_tm6*115*c,0,4367,0,0,4367,0.0,115,3134@TOP@human_GAPDH_TAA_len41_fa20_ta0_fm14_tm6,c
3134@TOP@human_GAPDH_TAA_len41_fa20_ta0_fm14_tm6*116*c,0,4356,0,1,4357,0.0,116,3134@TOP@human_GAPDH_TAA_len41_fa20_ta0_fm14_tm6,c
3134@TOP@human_GAPDH_TAA_len41_fa20_ta0_fm14_tm6*117*a,4345,0,3,0,4348,0.001,117,3134@TOP@human_GAPDH_TAA_len41_fa20_ta0_fm14_tm6,a
3134@TOP@human_GAPDH_TAA_len41_fa20_ta0_fm14_tm6*118*a,4216,0,101,0,4317,0.023,118,3134@TOP@human_GAPDH_TAA_len41_fa20_ta0_fm14_tm6,a
3134@TOP@human_GAPDH_TAA_len41_fa20_ta0_fm14_tm6*119*g,0,0,4326,0,4326,1.0,119,3134@TOP@human_GAPDH_TAA_len41_fa20_ta0_fm14_tm6,g
3134@TOP@human_GAPDH_TAA_len41_fa20_ta0_fm14_tm6*120*g,0,1,4306,0,4307,1.0,120,3134@TOP@human_GAPDH_TAA_len41_fa20_ta0_fm14_tm6,g
3134@TOP@human_GAPDH_TAA_len41_fa20_ta0_fm14_tm6*121*a,4348,0,1,0,4349,0.0,121,3134@TOP@human_GAPDH_TAA_len41_fa20_ta0_fm14_tm6,a
3134@TOP@human_GAPDH_TAA_len41_fa20_ta0_fm14_tm6*122*g,0,0,4354,0,4354,1.0,122,3134@TOP@human_GAPDH_TAA_len41_fa20_ta0_fm14_tm6,g
3134@TOP@human_GAPDH_TAA_len41_fa20_ta0_fm14_tm6*123*t,1,1,1,4285,4288,0.0,123,3134@TOP@human_GAPDH_TAA_len41_fa20_ta0_fm14_tm6,t
3134@TOP@human_GAPDH_TAA_len41_fa20_ta0_fm14_tm6*124*a,4094,0,174,0,4268,0.041,124,3134@TOP@human_GAPDH_TAA_len41_fa20_ta0_fm14_tm6,a
3134@TOP@human_GAPDH_TAA_len41_fa20_ta0_fm14_tm6*125*a,4183,1,78,0,4262,0.018,125,3134@TOP@human_GAPDH_TAA_len41_fa20_ta0_fm14_tm6,a
3134@TOP@human_GAPDH_TAA_len41_fa20_ta0_fm14_tm6*126*g,0,1,4283,0,4284,1.0,126,3134@TOP@human_GAPDH_TAA_len41_fa20_ta0_fm14_tm6,g
3134@TOP@human_GAPDH_TAA_len41_fa20_ta0_fm14_tm6*127*a,4325,0,3,0,4328,0.001,127,3134@TOP@human_GAPDH_TAA_len41_fa20_ta0_fm14_tm6,a
3134@TOP@human_GAPDH_TAA_len41_fa20_ta0_fm14_tm6*128*c,0,4351,0,0,4351,0.0,128,3134@TOP@human_GAPDH_TAA_len41_fa20_ta0_fm14_tm6,c
3134@TOP@human_GAPDH_TAA_len41_fa20_ta0_fm14_tm6*129*c,0,4316,0,0,4316,0.0,129,3134@TOP@human_GAPDH_TAA_len41_fa20_ta0_fm14_tm6,c
3134@TOP@human_GAPDH_TAA_len41_fa20_ta0_fm14_tm6*130*c,0,4354,0,2,4356,0.0,130,3134@TOP@human_GAPDH_TAA_len41_fa20_ta0_fm14_tm6,c
3134@TOP@human_GAPDH_TAA_len41_fa20_ta0_fm14_tm6*131*c,0,4359,0,0,4359,0.0,131,3134@TOP@human_GAPDH_TAA_len41_fa20_ta0_fm14_tm6,c
3134@TOP@human_GAPDH_TAA_len41_fa20_ta0_fm14_tm6*132*t,1,0,0,4296,4297,0.0,132,3134@TOP@human_GAPDH_TAA_len41_fa20_ta0_fm14_tm6,t
3134@TOP@human_GAPDH_TAA_len41_fa20_ta0_fm14_tm6*133*g,3,0,4288,1,4292,0.999,133,3134@TOP@human_GAPDH_TAA_len41_fa20_ta0_fm14_tm6,g
3134@TOP@human_GAPDH_TAA_len41_fa20_ta0_fm14_tm6*134*g,0,0,4320,0,4320,1.0,134,3134@TOP@human_GAPDH_TAA_len41_fa20_ta0_fm14_tm6,g
3135@TOP@human_GAPDH_TAA_len41_fa20_ta0_fm14_tm6*114*t,1,0,0,7743,7744,0.0,114,3135@TOP@human_GAPDH_TAA_len41_fa20_ta0_fm14_tm6,t
3135@TOP@human_GAPDH_TAA_len41_fa20_ta0_fm14_tm6*115*c,1,7790,0,1,7792,0.0,115,3135@TOP@human_GAPDH_TAA_len41_fa20_ta0_fm14_tm6,c
3135@TOP@human_GAPDH_TAA_len41_fa20_ta0_fm14_tm6*116*c,1,7757,1,0,7759,0.0,116,3135@TOP@human_GAPDH_TAA_len41_fa20_ta0_fm14_tm6,c
3135@TOP@human_GAPDH_TAA_len41_fa20_ta0_fm14_tm6*117*a,7747,0,9,0,7756,0.001,117,3135@TOP@human_GAPDH_TAA_len41_fa20_ta0_fm14_tm6,a
3135@TOP@human_GAPDH_TAA_len41_fa20_ta0_fm14_tm6*118*a,7561,0,144,0,7705,0.019,118,3135@TOP@human_GAPDH_TAA_len41_fa20_ta0_fm14_tm6,a
3135@TOP@human_GAPDH_TAA_len41_fa20_ta0_fm14_tm6*119*g,0,0,7696,1,7697,1.0,119,3135@TOP@human_GAPDH_TAA_len41_fa20_ta0_fm14_tm6,g
3135@TOP@human_GAPDH_TAA_len41_fa20_ta0_fm14_tm6*120*g,0,0,7674,1,7675,1.0,120,3135@TOP@human_GAPDH_TAA_len41_fa20_ta0_fm14_tm6,g
3135@TOP@human_GAPDH_TAA_len41_fa20_ta0_fm14_tm6*121*a,7747,0,4,0,7751,0.001,121,3135@TOP@human_GAPDH_TAA_len41_fa20_ta0_fm14_tm6,a
3135@TOP@human_GAPDH_TAA_len41_fa20_ta0_fm14_tm6*122*g,1,0,7762,0,7763,1.0,122,3135@TOP@human_GAPDH_TAA_len41_fa20_ta0_fm14_tm6,g
3135@TOP@human_GAPDH_TAA_len41_fa20_ta0_fm14_tm6*123*t,1,0,0,7627,7628,0.0,123,3135@TOP@human_GAPDH_TAA_len41_fa20_ta0_fm14_tm6,t
3135@TOP@human_GAPDH_TAA_len41_fa20_ta0_fm14_tm6*124*a,7291,0,373,0,7664,0.049,124,3135@TOP@human_GAPDH_TAA_len41_fa20_ta0_fm14_tm6,a
3135@TOP@human_GAPDH_TAA_len41_fa20_ta0_fm14_tm6*125*a,7360,0,268,0,7628,0.035,125,3135@TOP@human_GAPDH_TAA_len41_fa20_ta0_fm14_tm6,a
3135@TOP@human_GAPDH_TAA_len41_fa20_ta0_fm14_tm6*126*g,0,0,7660,0,7660,1.0,126,3135@TOP@human_GAPDH_TAA_len41_fa20_ta0_fm14_tm6,g
3135@TOP@human_GAPDH_TAA_len41_fa20_ta0_fm14_tm6*127*a,7716,0,12,0,7728,0.002,127,3135@TOP@human_GAPDH_TAA_len41_fa20_ta0_fm14_tm6,a
3135@TOP@human_GAPDH_TAA_len41_fa20_ta0_fm14_tm6*128*c,0,7775,1,0,7776,0.0,128,3135@TOP@human_GAPDH_TAA_len41_fa20_ta0_fm14_tm6,c
3135@TOP@human_GAPDH_TAA_len41_fa20_ta0_fm14_tm6*129*c,1,7726,0,0,7727,0.0,129,3135@TOP@human_GAPDH_TAA_len41_fa20_ta0_fm14_tm6,c
3135@TOP@human_GAPDH_TAA_len41_fa20_ta0_fm14_tm6*130*c,0,7750,0,0,7750,0.0,130,3135@TOP@human_GAPDH_TAA_len41_fa20_ta0_fm14_tm6,c
3135@TOP@human_GAPDH_TAA_len41_fa20_ta0_fm14_tm6*131*c,0,7785,0,0,7785,0.0,131,3135@TOP@human_GAPDH_TAA_len41_fa20_ta0_fm14_tm6,c
3135@TOP@human_GAPDH_TAA_len41_fa20_ta0_fm14_tm6*132*t,1,0,0,7671,7672,0.0,132,3135@TOP@human_GAPDH_TAA_len41_fa20_ta0_fm14_tm6,t
3135@TOP@human_GAPDH_TAA_len41_fa20_ta0_fm14_tm6*133*g,1,1,7633,1,7636,1.0,133,3135@TOP@human_GAPDH_TAA_len41_fa20_ta0_fm14_tm6,g
3135@TOP@human_GAPDH_TAA_len41_fa20_ta0_fm14_tm6*134*g,0,0,7709,1,7710,1.0,134,3135@TOP@human_GAPDH_TAA_len41_fa20_ta0_fm14_tm6,g
3136@TOP@human_GAPDH_TAA_len41_fa20_ta0_fm14_tm6*114*t,0,5,0,23158,23163,0.0,114,3136@TOP@human_GAPDH_TAA_len41_fa20_ta0_fm14_tm6,t
3136@TOP@human_GAPDH_TAA_len41_fa20_ta0_fm14_tm6*115*c,0,23300,0,1,23301,0.0,115,3136@TOP@human_GAPDH_TAA_len41_fa20_ta0_fm14_tm6,c
3136@TOP@human_GAPDH_TAA_len41_fa20_ta0_fm14_tm6*116*c,0,23211,0,1,23212,0.0,116,3136@TOP@human_GAPDH_TAA_len41_fa20_ta0_fm14_tm6,c
3136@TOP@human_GAPDH_TAA_len41_fa20_ta0_fm14_tm6*117*a,23153,0,43,0,23196,0.002,117,3136@TOP@human_GAPDH_TAA_len41_fa20_ta0_fm14_tm6,a
3136@TOP@human_GAPDH_TAA_len41_fa20_ta0_fm14_tm6*118*a,22795,1,269,1,23066,0.012,118,3136@TOP@human_GAPDH_TAA_len41_fa20_ta0_fm14_tm6,a
3136@TOP@human_GAPDH_TAA_len41_fa20_ta0_fm14_tm6*119*g,0,0,23010,0,23010,1.0,119,3136@TOP@human_GAPDH_TAA_len41_fa20_ta0_fm14_tm6,g
3136@TOP@human_GAPDH_TAA_len41_fa20_ta0_fm14_tm6*120*g,2,0,22886,0,22888,1.0,120,3136@TOP@human_GAPDH_TAA_len41_fa20_ta0_fm14_tm6,g
3136@TOP@human_GAPDH_TAA_len41_fa20_ta0_fm14_tm6*121*a,23191,0,3,0,23194,0.0,121,3136@TOP@human_GAPDH_TAA_len41_fa20_ta0_fm14_tm6,a
3136@TOP@human_GAPDH_TAA_len41_fa20_ta0_fm14_tm6*122*g,1,0,23187,0,23188,1.0,122,3136@TOP@human_GAPDH_TAA_len41_fa20_ta0_fm14_tm6,g
3136@TOP@human_GAPDH_TAA_len41_fa20_ta0_fm14_tm6*123*t,2,4,0,22865,22871,0.0,123,3136@TOP@human_GAPDH_TAA_len41_fa20_ta0_fm14_tm6,t
3136@TOP@human_GAPDH_TAA_len41_fa20_ta0_fm14_tm6*124*a,22173,1,594,0,22768,0.026,124,3136@TOP@human_GAPDH_TAA_len41_fa20_ta0_fm14_tm6,a
3136@TOP@human_GAPDH_TAA_len41_fa20_ta0_fm14_tm6*125*a,22500,3,273,1,22777,0.012,125,3136@TOP@human_GAPDH_TAA_len41_fa20_ta0_fm14_tm6,a
3136@TOP@human_GAPDH_TAA_len41_fa20_ta0_fm14_tm6*126*g,1,1,22855,2,22859,1.0,126,3136@TOP@human_GAPDH_TAA_len41_fa20_ta0_fm14_tm6,g
3136@TOP@human_GAPDH_TAA_len41_fa20_ta0_fm14_tm6*127*a,23104,0,20,0,23124,0.001,127,3136@TOP@human_GAPDH_TAA_len41_fa20_ta0_fm14_tm6,a
3136@TOP@human_GAPDH_TAA_len41_fa20_ta0_fm14_tm6*128*c,0,23238,1,2,23241,0.0,128,3136@TOP@human_GAPDH_TAA_len41_fa20_ta0_fm14_tm6,c
3136@TOP@human_GAPDH_TAA_len41_fa20_ta0_fm14_tm6*129*c,1,23038,0,2,23041,0.0,129,3136@TOP@human_GAPDH_TAA_len41_fa20_ta0_fm14_tm6,c
3136@TOP@human_GAPDH_TAA_len41_fa20_ta0_fm14_tm6*130*c,3,23210,0,2,23215,0.0,130,3136@TOP@human_GAPDH_TAA_len41_fa20_ta0_fm14_tm6,c
3136@TOP@human_GAPDH_TAA_len41_fa20_ta0_fm14_tm6*131*c,3,23264,0,5,23272,0.0,131,3136@TOP@human_GAPDH_TAA_len41_fa20_ta0_fm14_tm6,c
3136@TOP@human_GAPDH_TAA_len41_fa20_ta0_fm14_tm6*132*t,2,14,5,22906,22927,0.0,132,3136@TOP@human_GAPDH_TAA_len41_fa20_ta0_fm14_tm6,t
3136@TOP@human_GAPDH_TAA_len41_fa20_ta0_fm14_tm6*133*g,0,0,22848,2,22850,1.0,133,3136@TOP@human_GAPDH_TAA_len41_fa20_ta0_fm14_tm6,g
3136@TOP@human_GAPDH_TAA_len41_fa20_ta0_fm14_tm6*134*g,0,4,22950,2,22956,1.0,134,3136@TOP@human_GAPDH_TAA_len41_fa20_ta0_fm14_tm6,g
3137@TOP@human_GAPDH_TAA_len41_fa20_ta0_fm14_tm6*114*t,0,6,1,26954,26961,0.0,114,3137@TOP@human_GAPDH_TAA_len41_fa20_ta0_fm14_tm6,t
3137@TOP@human_GAPDH_TAA_len41_fa20_ta0_fm14_tm6*115*c,1,27107,0,0,27108,0.0,115,3137@TOP@human_GAPDH_TAA_len41_fa20_ta0_fm14_tm6,c
3137@TOP@human_GAPDH_TAA_len41_fa20_ta0_fm14_tm6*116*c,0,27015,0,2,27017,0.0,116,3137@TOP@human_GAPDH_TAA_len41_fa20_ta0_fm14_tm6,c
3137@TOP@human_GAPDH_TAA_len41_fa20_ta0_fm14_tm6*117*a,26918,0,41,0,26959,0.002,117,3137@TOP@human_GAPDH_TAA_len41_fa20_ta0_fm14_tm6,a
3137@TOP@human_GAPDH_TAA_len41_fa20_ta0_fm14_tm6*118*a,26475,0,324,1,26800,0.012,118,3137@TOP@human_GAPDH_TAA_len41_fa20_ta0_fm14_tm6,a
3137@TOP@human_GAPDH_TAA_len41_fa20_ta0_fm14_tm6*119*g,2,0,26762,0,26764,1.0,119,3137@TOP@human_GAPDH_TAA_len41_fa20_ta0_fm14_tm6,g
3137@TOP@human_GAPDH_TAA_len41_fa20_ta0_fm14_tm6*120*g,3,0,26675,0,26678,1.0,120,3137@TOP@human_GAPDH_TAA_len41_fa20_ta0_fm14_tm6,g
3137@TOP@human_GAPDH_TAA_len41_fa20_ta0_fm14_tm6*121*a,26939,0,11,0,26950,0.0,121,3137@TOP@human_GAPDH_TAA_len41_fa20_ta0_fm14_tm6,a
3137@TOP@human_GAPDH_TAA_len41_fa20_ta0_fm14_tm6*122*g,2,2,26986,0,26990,1.0,122,3137@TOP@human_GAPDH_TAA_len41_fa20_ta0_fm14_tm6,g
3137@TOP@human_GAPDH_TAA_len41_fa20_ta0_fm14_tm6*123*t,4,5,5,26630,26644,0.0,123,3137@TOP@human_GAPDH_TAA_len41_fa20_ta0_fm14_tm6,t
3137@TOP@human_GAPDH_TAA_len41_fa20_ta0_fm14_tm6*124*a,25764,0,821,0,26585,0.031,124,3137@TOP@human_GAPDH_TAA_len41_fa20_ta0_fm14_tm6,a
3137@TOP@human_GAPDH_TAA_len41_fa20_ta0_fm14_tm6*125*a,26081,2,432,1,26516,0.016,125,3137@TOP@human_GAPDH_TAA_len41_fa20_ta0_fm14_tm6,a
3137@TOP@human_GAPDH_TAA_len41_fa20_ta0_fm14_tm6*126*g,0,2,26634,0,26636,1.0,126,3137@TOP@human_GAPDH_TAA_len41_fa20_ta0_fm14_tm6,g
3137@TOP@human_GAPDH_TAA_len41_fa20_ta0_fm14_tm6*127*a,26883,1,9,1,26894,0.0,127,3137@TOP@human_GAPDH_TAA_len41_fa20_ta0_fm14_tm6,a
3137@TOP@human_GAPDH_TAA_len41_fa20_ta0_fm14_tm6*128*c,1,27031,2,0,27034,0.0,128,3137@TOP@human_GAPDH_TAA_len41_fa20_ta0_fm14_tm6,c
3137@TOP@human_GAPDH_TAA_len41_fa20_ta0_fm14_tm6*129*c,2,26836,0,4,26842,0.0,129,3137@TOP@human_GAPDH_TAA_len41_fa20_ta0_fm14_tm6,c
3137@TOP@human_GAPDH_TAA_len41_fa20_ta0_fm14_tm6*130*c,5,26982,0,0,26987,0.0,130,3137@TOP@human_GAPDH_TAA_len41_fa20_ta0_fm14_tm6,c
3137@TOP@human_GAPDH_TAA_len41_fa20_ta0_fm14_tm6*131*c,1,27040,0,4,27045,0.0,131,3137@TOP@human_GAPDH_TAA_len41_fa20_ta0_fm14_tm6,c
3137@TOP@human_GAPDH_TAA_len41_fa20_ta0_fm14_tm6*132*t,1,3,5,26694,26703,0.0,132,3137@TOP@human_GAPDH_TAA_len41_fa20_ta0_fm14_tm6,t
3137@TOP@human_GAPDH_TAA_len41_fa20_ta0_fm14_tm6*133*g,3,0,26617,3,26623,1.0,133,3137@TOP@human_GAPDH_TAA_len41_fa20_ta0_fm14_tm6,g
3137@TOP@human_GAPDH_TAA_len41_fa20_ta0_fm14_tm6*134*g,1,5,26767,4,26777,1.0,134,3137@TOP@human_GAPDH_TAA_len41_fa20_ta0_fm14_tm6,g
3138@TOP@human_GAPDH_TAA_len41_fa20_ta0_fm14_tm6*114*t,0,0,0,4177,4177,0.0,114,3138@TOP@human_GAPDH_TAA_len41_fa20_ta0_fm14_tm6,t
3138@TOP@human_GAPDH_TAA_len41_fa20_ta0_fm14_tm6*115*c,0,4207,0,0,4207,0.0,115,3138@TOP@human_GAPDH_TAA_len41_fa20_ta0_fm14_tm6,c
3138@TOP@human_GAPDH_TAA_len41_fa20_ta0_fm14_tm6*116*c,0,4182,0,0,4182,0.0,116,3138@TOP@human_GAPDH_TAA_len41_fa20_ta0_fm14_tm6,c
3138@TOP@human_GAPDH_TAA_len41_fa20_ta0_fm14_tm6*117*a,4177,0,4,0,4181,0.001,117,3138@TOP@human_GAPDH_TAA_len41_fa20_ta0_fm14_tm6,a
3138@TOP@human_GAPDH_TAA_len41_fa20_ta0_fm14_tm6*118*a,4079,0,92,0,4171,0.022,118,3138@TOP@human_GAPDH_TAA_len41_fa20_ta0_fm14_tm6,a
3138@TOP@human_GAPDH_TAA_len41_fa20_ta0_fm14_tm6*119*g,0,0,4147,2,4149,1.0,119,3138@TOP@human_GAPDH_TAA_len41_fa20_ta0_fm14_tm6,g
3138@TOP@human_GAPDH_TAA_len41_fa20_ta0_fm14_tm6*120*g,0,0,4141,0,4141,1.0,120,3138@TOP@human_GAPDH_TAA_len41_fa20_ta0_fm14_tm6,g
3138@TOP@human_GAPDH_TAA_len41_fa20_ta0_fm14_tm6*121*a,4183,0,0,0,4183,0.0,121,3138@TOP@human_GAPDH_TAA_len41_fa20_ta0_fm14_tm6,a
3138@TOP@human_GAPDH_TAA_len41_fa20_ta0_fm14_tm6*122*g,1,0,4180,0,4181,1.0,122,3138@TOP@human_GAPDH_TAA_len41_fa20_ta0_fm14_tm6,g
3138@TOP@human_GAPDH_TAA_len41_fa20_ta0_fm14_tm6*123*t,0,1,4,4127,4132,0.001,123,3138@TOP@human_GAPDH_TAA_len41_fa20_ta0_fm14_tm6,t
3138@TOP@human_GAPDH_TAA_len41_fa20_ta0_fm14_tm6*124*a,3963,0,144,0,4107,0.035,124,3138@TOP@human_GAPDH_TAA_len41_fa20_ta0_fm14_tm6,a
3138@TOP@human_GAPDH_TAA_len41_fa20_ta0_fm14_tm6*125*a,4040,1,68,0,4109,0.017,125,3138@TOP@human_GAPDH_TAA_len41_fa20_ta0_fm14_tm6,a
3138@TOP@human_GAPDH_TAA_len41_fa20_ta0_fm14_tm6*126*g,0,0,4138,0,4138,1.0,126,3138@TOP@human_GAPDH_TAA_len41_fa20_ta0_fm14_tm6,g
3138@TOP@human_GAPDH_TAA_len41_fa20_ta0_fm14_tm6*127*a,4179,0,0,0,4179,0.0,127,3138@TOP@human_GAPDH_TAA_len41_fa20_ta0_fm14_tm6,a
3138@TOP@human_GAPDH_TAA_len41_fa20_ta0_fm14_tm6*128*c,0,4200,0,0,4200,0.0,128,3138@TOP@human_GAPDH_TAA_len41_fa20_ta0_fm14_tm6,c
3138@TOP@human_GAPDH_TAA_len41_fa20_ta0_fm14_tm6*129*c,0,4161,0,0,4161,0.0,129,3138@TOP@human_GAPDH_TAA_len41_fa20_ta0_fm14_tm6,c
3138@TOP@human_GAPDH_TAA_len41_fa20_ta0_fm14_tm6*130*c,0,4190,0,0,4190,0.0,130,3138@TOP@human_GAPDH_TAA_len41_fa20_ta0_fm14_tm6,c
3138@TOP@human_GAPDH_TAA_len41_fa20_ta0_fm14_tm6*131*c,0,4194,0,0,4194,0.0,131,3138@TOP@human_GAPDH_TAA_len41_fa20_ta0_fm14_tm6,c
3138@TOP@human_GAPDH_TAA_len41_fa20_ta0_fm14_tm6*132*t,0,1,0,4133,4134,0.0,132,3138@TOP@human_GAPDH_TAA_len41_fa20_ta0_fm14_tm6,t
3138@TOP@human_GAPDH_TAA_len41_fa20_ta0_fm14_tm6*133*g,0,0,4142,0,4142,1.0,133,3138@TOP@human_GAPDH_TAA_len41_fa20_ta0_fm14_tm6,g
3138@TOP@human_GAPDH_TAA_len41_fa20_ta0_fm14_tm6*134*g,0,0,4150,0,4150,1.0,134,3138@TOP@human_GAPDH_TAA_len41_fa20_ta0_fm14_tm6,g
3139@TOP@human_GAPDH_TAA_len41_fa20_ta0_fm14_tm6*114*t,0,1,0,3176,3177,0.0,114,3139@TOP@human_GAPDH_TAA_len41_fa20_ta0_fm14_tm6,t
3139@TOP@human_GAPDH_TAA_len41_fa20_ta0_fm14_tm6*115*c,0,3195,0,0,3195,0.0,115,3139@TOP@human_GAPDH_TAA_len41_fa20_ta0_fm14_tm6,c
3139@TOP@human_GAPDH_TAA_len41_fa20_ta0_fm14_tm6*116*c,0,3183,0,0,3183,0.0,116,3139@TOP@human_GAPDH_TAA_len41_fa20_ta0_fm14_tm6,c
3139@TOP@human_GAPDH_TAA_len41_fa20_ta0_fm14_tm6*117*a,3174,0,5,0,3179,0.002,117,3139@TOP@human_GAPDH_TAA_len41_fa20_ta0_fm14_tm6,a
3139@TOP@human_GAPDH_TAA_len41_fa20_ta0_fm14_tm6*118*a,3113,0,45,0,3158,0.014,118,3139@TOP@human_GAPDH_TAA_len41_fa20_ta0_fm14_tm6,a
3139@TOP@human_GAPDH_TAA_len41_fa20_ta0_fm14_tm6*119*g,0,0,3169,0,3169,1.0,119,3139@TOP@human_GAPDH_TAA_len41_fa20_ta0_fm14_tm6,g
3139@TOP@human_GAPDH_TAA_len41_fa20_ta0_fm14_tm6*120*g,0,0,3148,0,3148,1.0,120,3139@TOP@human_GAPDH_TAA_len41_fa20_ta0_fm14_tm6,g
3139@TOP@human_GAPDH_TAA_len41_fa20_ta0_fm14_tm6*121*a,3180,0,0,0,3180,0.0,121,3139@TOP@human_GAPDH_TAA_len41_fa20_ta0_fm14_tm6,a
3139@TOP@human_GAPDH_TAA_len41_fa20_ta0_fm14_tm6*122*g,0,0,3184,0,3184,1.0,122,3139@TOP@human_GAPDH_TAA_len41_fa20_ta0_fm14_tm6,g
3139@TOP@human_GAPDH_TAA_len41_fa20_ta0_fm14_tm6*123*t,0,0,0,3129,3129,0.0,123,3139@TOP@human_GAPDH_TAA_len41_fa20_ta0_fm14_tm6,t
3139@TOP@human_GAPDH_TAA_len41_fa20_ta0_fm14_tm6*124*a,3003,0,122,0,3125,0.039,124,3139@TOP@human_GAPDH_TAA_len41_fa20_ta0_fm14_tm6,a
3139@TOP@human_GAPDH_TAA_len41_fa20_ta0_fm14_tm6*125*a,3060,0,50,1,3111,0.016,125,3139@TOP@human_GAPDH_TAA_len41_fa20_ta0_fm14_tm6,a
3139@TOP@human_GAPDH_TAA_len41_fa20_ta0_fm14_tm6*126*g,2,0,3135,0,3137,0.999,126,3139@TOP@human_GAPDH_TAA_len41_fa20_ta0_fm14_tm6,g
3139@TOP@human_GAPDH_TAA_len41_fa20_ta0_fm14_tm6*127*a,3164,0,1,0,3165,0.0,127,3139@TOP@human_GAPDH_TAA_len41_fa20_ta0_fm14_tm6,a
3139@TOP@human_GAPDH_TAA_len41_fa20_ta0_fm14_tm6*128*c,0,3187,0,0,3187,0.0,128,3139@TOP@human_GAPDH_TAA_len41_fa20_ta0_fm14_tm6,c
3139@TOP@human_GAPDH_TAA_len41_fa20_ta0_fm14_tm6*129*c,0,3156,0,0,3156,0.0,129,3139@TOP@human_GAPDH_TAA_len41_fa20_ta0_fm14_tm6,c
3139@TOP@human_GAPDH_TAA_len41_fa20_ta0_fm14_tm6*130*c,0,3181,0,0,3181,0.0,130,3139@TOP@human_GAPDH_TAA_len41_fa20_ta0_fm14_tm6,c
3139@TOP@human_GAPDH_TAA_len41_fa20_ta0_fm14_tm6*131*c,0,3187,0,1,3188,0.0,131,3139@TOP@human_GAPDH_TAA_len41_fa20_ta0_fm14_tm6,c
3139@TOP@human_GAPDH_TAA_len41_fa20_ta0_fm14_tm6*132*t,0,0,0,3137,3137,0.0,132,3139@TOP@human_GAPDH_TAA_len41_fa20_ta0_fm14_tm6,t
3139@TOP@human_GAPDH_TAA_len41_fa20_ta0_fm14_tm6*133*g,3,0,3132,0,3135,0.999,133,3139@TOP@human_GAPDH_TAA_len41_fa20_ta0_fm14_tm6,g
3139@TOP@human_GAPDH_TAA_len41_fa20_ta0_fm14_tm6*134*g,0,0,3145,0,3145,1.0,134,3139@TOP@human_GAPDH_TAA_len41_fa20_ta0_fm14_tm6,g
3140@TOP@human_GAPDH_TAA_len41_fa20_ta0_fm14_tm6*114*t,1,1,0,27202,27204,0.0,114,3140@TOP@human_GAPDH_TAA_len41_fa20_ta0_fm14_tm6,t
3140@TOP@human_GAPDH_TAA_len41_fa20_ta0_fm14_tm6*115*c,1,27332,0,1,27334,0.0,115,3140@TOP@human_GAPDH_TAA_len41_fa20_ta0_fm14_tm6,c
3140@TOP@human_GAPDH_TAA_len41_fa20_ta0_fm14_tm6*116*c,0,27235,0,4,27239,0.0,116,3140@TOP@human_GAPDH_TAA_len41_fa20_ta0_fm14_tm6,c
3140@TOP@human_GAPDH_TAA_len41_fa20_ta0_fm14_tm6*117*a,27170,0,36,0,27206,0.001,117,3140@TOP@human_GAPDH_TAA_len41_fa20_ta0_fm14_tm6,a
3140@TOP@human_GAPDH_TAA_len41_fa20_ta0_fm14_tm6*118*a,26644,0,423,2,27069,0.016,118,3140@TOP@human_GAPDH_TAA_len41_fa20_ta0_fm14_tm6,a
3140@TOP@human_GAPDH_TAA_len41_fa20_ta0_fm14_tm6*119*g,0,0,27030,2,27032,1.0,119,3140@TOP@human_GAPDH_TAA_len41_fa20_ta0_fm14_tm6,g
3140@TOP@human_GAPDH_TAA_len41_fa20_ta0_fm14_tm6*120*g,2,0,26917,1,26920,1.0,120,3140@TOP@human_GAPDH_TAA_len41_fa20_ta0_fm14_tm6,g
3140@TOP@human_GAPDH_TAA_len41_fa20_ta0_fm14_tm6*121*a,27192,0,6,1,27199,0.0,121,3140@TOP@human_GAPDH_TAA_len41_fa20_ta0_fm14_tm6,a
3140@TOP@human_GAPDH_TAA_len41_fa20_ta0_fm14_tm6*122*g,3,0,27229,1,27233,1.0,122,3140@TOP@human_GAPDH_TAA_len41_fa20_ta0_fm14_tm6,g
3140@TOP@human_GAPDH_TAA_len41_fa20_ta0_fm14_tm6*123*t,2,1,1,26859,26863,0.0,123,3140@TOP@human_GAPDH_TAA_len41_fa20_ta0_fm14_tm6,t
3140@TOP@human_GAPDH_TAA_len41_fa20_ta0_fm14_tm6*124*a,25831,0,938,0,26769,0.035,124,3140@TOP@human_GAPDH_TAA_len41_fa20_ta0_fm14_tm6,a
3140@TOP@human_GAPDH_TAA_len41_fa20_ta0_fm14_tm6*125*a,26303,1,405,3,26712,0.015,125,3140@TOP@human_GAPDH_TAA_len41_fa20_ta0_fm14_tm6,a
3140@TOP@human_GAPDH_TAA_len41_fa20_ta0_fm14_tm6*126*g,1,1,26852,0,26854,1.0,126,3140@TOP@human_GAPDH_TAA_len41_fa20_ta0_fm14_tm6,g
3140@TOP@human_GAPDH_TAA_len41_fa20_ta0_fm14_tm6*127*a,27092,0,22,1,27115,0.001,127,3140@TOP@human_GAPDH_TAA_len41_fa20_ta0_fm14_tm6,a
3140@TOP@human_GAPDH_TAA_len41_fa20_ta0_fm14_tm6*128*c,3,27276,0,3,27282,0.0,128,3140@TOP@human_GAPDH_TAA_len41_fa20_ta0_fm14_tm6,c
3140@TOP@human_GAPDH_TAA_len41_fa20_ta0_fm14_tm6*129*c,1,27088,0,0,27089,0.0,129,3140@TOP@human_GAPDH_TAA_len41_fa20_ta0_fm14_tm6,c
3140@TOP@human_GAPDH_TAA_len41_fa20_ta0_fm14_tm6*130*c,1,27228,1,0,27230,0.0,130,3140@TOP@human_GAPDH_TAA_len41_fa20_ta0_fm14_tm6,c
3140@TOP@human_GAPDH_TAA_len41_fa20_ta0_fm14_tm6*131*c,1,27295,0,0,27296,0.0,131,3140@TOP@human_GAPDH_TAA_len41_fa20_ta0_fm14_tm6,c
3140@TOP@human_GAPDH_TAA_len41_fa20_ta0_fm14_tm6*132*t,3,3,1,26924,26931,0.0,132,3140@TOP@human_GAPDH_TAA_len41_fa20_ta0_fm14_tm6,t
3140@TOP@human_GAPDH_TAA_len41_fa20_ta0_fm14_tm6*133*g,2,0,26838,2,26842,1.0,133,3140@TOP@human_GAPDH_TAA_len41_fa20_ta0_fm14_tm6,g
3140@TOP@human_GAPDH_TAA_len41_fa20_ta0_fm14_tm6*134*g,5,4,26962,1,26972,1.0,134,3140@TOP@human_GAPDH_TAA_len41_fa20_ta0_fm14_tm6,g
3141@TOP@human_GAPDH_TAA_len41_fa20_ta0_fm14_tm6*114*t,4,10,0,22157,22171,0.0,114,3141@TOP@human_GAPDH_TAA_len41_fa20_ta0_fm14_tm6,t
3141@TOP@human_GAPDH_TAA_len41_fa20_ta0_fm14_tm6*115*c,0,22280,0,3,22283,0.0,115,3141@TOP@human_GAPDH_TAA_len41_fa20_ta0_fm14_tm6,c
3141@TOP@human_GAPDH_TAA_len41_fa20_ta0_fm14_tm6*116*c,1,22207,0,3,22211,0.0,116,3141@TOP@human_GAPDH_TAA_len41_fa20_ta0_fm14_tm6,c
3141@TOP@human_GAPDH_TAA_len41_fa20_ta0_fm14_tm6*117*a,22156,0,28,0,22184,0.001,117,3141@TOP@human_GAPDH_TAA_len41_fa20_ta0_fm14_tm6,a
3141@TOP@human_GAPDH_TAA_len41_fa20_ta0_fm14_tm6*118*a,21816,0,262,1,22079,0.012,118,3141@TOP@human_GAPDH_TAA_len41_fa20_ta0_fm14_tm6,a
3141@TOP@human_GAPDH_TAA_len41_fa20_ta0_fm14_tm6*119*g,6,0,22034,4,22044,1.0,119,3141@TOP@human_GAPDH_TAA_len41_fa20_ta0_fm14_tm6,g
3141@TOP@human_GAPDH_TAA_len41_fa20_ta0_fm14_tm6*120*g,2,0,21955,1,21958,1.0,120,3141@TOP@human_GAPDH_TAA_len41_fa20_ta0_fm14_tm6,g
3141@TOP@human_GAPDH_TAA_len41_fa20_ta0_fm14_tm6*121*a,22178,0,6,3,22187,0.0,121,3141@TOP@human_GAPDH_TAA_len41_fa20_ta0_fm14_tm6,a
3141@TOP@human_GAPDH_TAA_len41_fa20_ta0_fm14_tm6*122*g,2,0,22216,0,22218,1.0,122,3141@TOP@human_GAPDH_TAA_len41_fa20_ta0_fm14_tm6,g
3141@TOP@human_GAPDH_TAA_len41_fa20_ta0_fm14_tm6*123*t,1,2,2,21948,21953,0.0,123,3141@TOP@human_GAPDH_TAA_len41_fa20_ta0_fm14_tm6,t
3141@TOP@human_GAPDH_TAA_len41_fa20_ta0_fm14_tm6*124*a,21234,1,630,0,21865,0.029,124,3141@TOP@human_GAPDH_TAA_len41_fa20_ta0_fm14_tm6,a
3141@TOP@human_GAPDH_TAA_len41_fa20_ta0_fm14_tm6*125*a,21433,3,353,3,21792,0.016,125,3141@TOP@human_GAPDH_TAA_len41_fa20_ta0_fm14_tm6,a
3141@TOP@human_GAPDH_TAA_len41_fa20_ta0_fm14_tm6*126*g,0,0,21922,0,21922,1.0,126,3141@TOP@human_GAPDH_TAA_len41_fa20_ta0_fm14_tm6,g
3141@TOP@human_GAPDH_TAA_len41_fa20_ta0_fm14_tm6*127*a,22118,1,13,0,22132,0.001,127,3141@TOP@human_GAPDH_TAA_len41_fa20_ta0_fm14_tm6,a
3141@TOP@human_GAPDH_TAA_len41_fa20_ta0_fm14_tm6*128*c,0,22221,4,1,22226,0.0,128,3141@TOP@human_GAPDH_TAA_len41_fa20_ta0_fm14_tm6,c
3141@TOP@human_GAPDH_TAA_len41_fa20_ta0_fm14_tm6*129*c,1,22051,1,2,22055,0.0,129,3141@TOP@human_GAPDH_TAA_len41_fa20_ta0_fm14_tm6,c
3141@TOP@human_GAPDH_TAA_len41_fa20_ta0_fm14_tm6*130*c,1,22214,0,1,22216,0.0,130,3141@TOP@human_GAPDH_TAA_len41_fa20_ta0_fm14_tm6,c
3141@TOP@human_GAPDH_TAA_len41_fa20_ta0_fm14_tm6*131*c,2,22251,1,1,22255,0.0,131,3141@TOP@human_GAPDH_TAA_len41_fa20_ta0_fm14_tm6,c
3141@TOP@human_GAPDH_TAA_len41_fa20_ta0_fm14_tm6*132*t,2,4,1,21932,21939,0.0,132,3141@TOP@human_GAPDH_TAA_len41_fa20_ta0_fm14_tm6,t
3141@TOP@human_GAPDH_TAA_len41_fa20_ta0_fm14_tm6*133*g,4,0,21935,2,21941,1.0,133,3141@TOP@human_GAPDH_TAA_len41_fa20_ta0_fm14_tm6,g
3141@TOP@human_GAPDH_TAA_len41_fa20_ta0_fm14_tm6*134*g,0,4,22001,0,22005,1.0,134,3141@TOP@human_GAPDH_TAA_len41_fa20_ta0_fm14_tm6,g
3142@TOP@human_GAPDH_TAA_len41_fa20_ta0_fm14_tm6*114*t,1,6,0,23727,23734,0.0,114,3142@TOP@human_GAPDH_TAA_len41_fa20_ta0_fm14_tm6,t
3142@TOP@human_GAPDH_TAA_len41_fa20_ta0_fm14_tm6*115*c,0,23862,0,2,23864,0.0,115,3142@TOP@human_GAPDH_TAA_len41_fa20_ta0_fm14_tm6,c
3142@TOP@human_GAPDH_TAA_len41_fa20_ta0_fm14_tm6*116*c,1,23792,0,0,23793,0.0,116,3142@TOP@human_GAPDH_TAA_len41_fa20_ta0_fm14_tm6,c
3142@TOP@human_GAPDH_TAA_len41_fa20_ta0_fm14_tm6*117*a,23729,0,34,0,23763,0.001,117,3142@TOP@human_GAPDH_TAA_len41_fa20_ta0_fm14_tm6,a
3142@TOP@human_GAPDH_TAA_len41_fa20_ta0_fm14_tm6*118*a,23407,0,241,0,23648,0.01,118,3142@TOP@human_GAPDH_TAA_len41_fa20_ta0_fm14_tm6,a
3142@TOP@human_GAPDH_TAA_len41_fa20_ta0_fm14_tm6*119*g,0,0,23621,1,23622,1.0,119,3142@TOP@human_GAPDH_TAA_len41_fa20_ta0_fm14_tm6,g
3142@TOP@human_GAPDH_TAA_len41_fa20_ta0_fm14_tm6*120*g,0,0,23510,0,23510,1.0,120,3142@TOP@human_GAPDH_TAA_len41_fa20_ta0_fm14_tm6,g
3142@TOP@human_GAPDH_TAA_len41_fa20_ta0_fm14_tm6*121*a,23745,0,8,0,23753,0.0,121,3142@TOP@human_GAPDH_TAA_len41_fa20_ta0_fm14_tm6,a
3142@TOP@human_GAPDH_TAA_len41_fa20_ta0_fm14_tm6*122*g,6,0,23766,1,23773,1.0,122,3142@TOP@human_GAPDH_TAA_len41_fa20_ta0_fm14_tm6,g
3142@TOP@human_GAPDH_TAA_len41_fa20_ta0_fm14_tm6*123*t,1,4,4,23503,23512,0.0,123,3142@TOP@human_GAPDH_TAA_len41_fa20_ta0_fm14_tm6,t
3142@TOP@human_GAPDH_TAA_len41_fa20_ta0_fm14_tm6*124*a,22769,3,651,0,23423,0.028,124,3142@TOP@human_GAPDH_TAA_len41_fa20_ta0_fm14_tm6,a
3142@TOP@human_GAPDH_TAA_len41_fa20_ta0_fm14_tm6*125*a,22993,1,370,2,23366,0.016,125,3142@TOP@human_GAPDH_TAA_len41_fa20_ta0_fm14_tm6,a
3142@TOP@human_GAPDH_TAA_len41_fa20_ta0_fm14_tm6*126*g,0,0,23486,1,23487,1.0,126,3142@TOP@human_GAPDH_TAA_len41_fa20_ta0_fm14_tm6,g
3142@TOP@human_GAPDH_TAA_len41_fa20_ta0_fm14_tm6*127*a,23672,0,10,0,23682,0.0,127,3142@TOP@human_GAPDH_TAA_len41_fa20_ta0_fm14_tm6,a
3142@TOP@human_GAPDH_TAA_len41_fa20_ta0_fm14_tm6*128*c,0,23816,1,0,23817,0.0,128,3142@TOP@human_GAPDH_TAA_len41_fa20_ta0_fm14_tm6,c
3142@TOP@human_GAPDH_TAA_len41_fa20_ta0_fm14_tm6*129*c,1,23624,0,0,23625,0.0,129,3142@TOP@human_GAPDH_TAA_len41_fa20_ta0_fm14_tm6,c
3142@TOP@human_GAPDH_TAA_len41_fa20_ta0_fm14_tm6*130*c,2,23765,0,0,23767,0.0,130,3142@TOP@human_GAPDH_TAA_len41_fa20_ta0_fm14_tm6,c
3142@TOP@human_GAPDH_TAA_len41_fa20_ta0_fm14_tm6*131*c,2,23826,0,0,23828,0.0,131,3142@TOP@human_GAPDH_TAA_len41_fa20_ta0_fm14_tm6,c
3142@TOP@human_GAPDH_TAA_len41_fa20_ta0_fm14_tm6*132*t,2,3,0,23528,23533,0.0,132,3142@TOP@human_GAPDH_TAA_len41_fa20_ta0_fm14_tm6,t
3142@TOP@human_GAPDH_TAA_len41_fa20_ta0_fm14_tm6*133*g,0,1,23476,0,23477,1.0,133,3142@TOP@human_GAPDH_TAA_len41_fa20_ta0_fm14_tm6,g
3142@TOP@human_GAPDH_TAA_len41_fa20_ta0_fm14_tm6*134*g,1,4,23580,1,23586,1.0,134,3142@TOP@human_GAPDH_TAA_len41_fa20_ta0_fm14_tm6,g
3143@TOP@human_GAPDH_TAA_len41_fa20_ta0_fm14_tm6*114*t,0,4,0,6862,6866,0.0,114,3143@TOP@human_GAPDH_TAA_len41_fa20_ta0_fm14_tm6,t
3143@TOP@human_GAPDH_TAA_len41_fa20_ta0_fm14_tm6*115*c,0,6905,0,2,6907,0.0,115,3143@TOP@human_GAPDH_TAA_len41_fa20_ta0_fm14_tm6,c
3143@TOP@human_GAPDH_TAA_len41_fa20_ta0_fm14_tm6*116*c,0,6873,0,0,6873,0.0,116,3143@TOP@human_GAPDH_TAA_len41_fa20_ta0_fm14_tm6,c
3143@TOP@human_GAPDH_TAA_len41_fa20_ta0_fm14_tm6*117*a,6858,0,15,0,6873,0.002,117,3143@TOP@human_GAPDH_TAA_len41_fa20_ta0_fm14_tm6,a
3143@TOP@human_GAPDH_TAA_len41_fa20_ta0_fm14_tm6*118*a,6741,0,95,0,6836,0.014,118,3143@TOP@human_GAPDH_TAA_len41_fa20_ta0_fm14_tm6,a
3143@TOP@human_GAPDH_TAA_len41_fa20_ta0_fm14_tm6*119*g,0,0,6805,0,6805,1.0,119,3143@TOP@human_GAPDH_TAA_len41_fa20_ta0_fm14_tm6,g
3143@TOP@human_GAPDH_TAA_len41_fa20_ta0_fm14_tm6*120*g,0,0,6804,2,6806,1.0,120,3143@TOP@human_GAPDH_TAA_len41_fa20_ta0_fm14_tm6,g
3143@TOP@human_GAPDH_TAA_len41_fa20_ta0_fm14_tm6*121*a,6871,0,0,0,6871,0.0,121,3143@TOP@human_GAPDH_TAA_len41_fa20_ta0_fm14_tm6,a
3143@TOP@human_GAPDH_TAA_len41_fa20_ta0_fm14_tm6*122*g,0,0,6874,0,6874,1.0,122,3143@TOP@human_GAPDH_TAA_len41_fa20_ta0_fm14_tm6,g
3143@TOP@human_GAPDH_TAA_len41_fa20_ta0_fm14_tm6*123*t,0,1,2,6795,6798,0.0,123,3143@TOP@human_GAPDH_TAA_len41_fa20_ta0_fm14_tm6,t
3143@TOP@human_GAPDH_TAA_len41_fa20_ta0_fm14_tm6*124*a,6568,0,198,1,6767,0.029,124,3143@TOP@human_GAPDH_TAA_len41_fa20_ta0_fm14_tm6,a
3143@TOP@human_GAPDH_TAA_len41_fa20_ta0_fm14_tm6*125*a,6608,2,117,1,6728,0.017,125,3143@TOP@human_GAPDH_TAA_len41_fa20_ta0_fm14_tm6,a
3143@TOP@human_GAPDH_TAA_len41_fa20_ta0_fm14_tm6*126*g,0,0,6769,0,6769,1.0,126,3143@TOP@human_GAPDH_TAA_len41_fa20_ta0_fm14_tm6,g
3143@TOP@human_GAPDH_TAA_len41_fa20_ta0_fm14_tm6*127*a,6854,0,1,0,6855,0.0,127,3143@TOP@human_GAPDH_TAA_len41_fa20_ta0_fm14_tm6,a
3143@TOP@human_GAPDH_TAA_len41_fa20_ta0_fm14_tm6*128*c,1,6897,0,0,6898,0.0,128,3143@TOP@human_GAPDH_TAA_len41_fa20_ta0_fm14_tm6,c
3143@TOP@human_GAPDH_TAA_len41_fa20_ta0_fm14_tm6*129*c,2,6825,0,0,6827,0.0,129,3143@TOP@human_GAPDH_TAA_len41_fa20_ta0_fm14_tm6,c
3143@TOP@human_GAPDH_TAA_len41_fa20_ta0_fm14_tm6*130*c,0,6877,0,0,6877,0.0,130,3143@TOP@human_GAPDH_TAA_len41_fa20_ta0_fm14_tm6,c
3143@TOP@human_GAPDH_TAA_len41_fa20_ta0_fm14_tm6*131*c,0,6893,0,2,6895,0.0,131,3143@TOP@human_GAPDH_TAA_len41_fa20_ta0_fm14_tm6,c
3143@TOP@human_GAPDH_TAA_len41_fa20_ta0_fm14_tm6*132*t,3,1,2,6808,6814,0.0,132,3143@TOP@human_GAPDH_TAA_len41_fa20_ta0_fm14_tm6,t
3143@TOP@human_GAPDH_TAA_len41_fa20_ta0_fm14_tm6*133*g,1,0,6787,0,6788,1.0,133,3143@TOP@human_GAPDH_TAA_len41_fa20_ta0_fm14_tm6,g
3143@TOP@human_GAPDH_TAA_len41_fa20_ta0_fm14_tm6*134*g,0,1,6834,0,6835,1.0,134,3143@TOP@human_GAPDH_TAA_len41_fa20_ta0_fm14_tm6,g
3144@TOP@human_GAPDH_TAA_len41_fa20_ta0_fm14_tm6*114*t,0,1,0,9814,9815,0.0,114,3144@TOP@human_GAPDH_TAA_len41_fa20_ta0_fm14_tm6,t
3144@TOP@human_GAPDH_TAA_len41_fa20_ta0_fm14_tm6*115*c,0,9859,0,0,9859,0.0,115,3144@TOP@human_GAPDH_TAA_len41_fa20_ta0_fm14_tm6,c
3144@TOP@human_GAPDH_TAA_len41_fa20_ta0_fm14_tm6*116*c,0,9827,0,0,9827,0.0,116,3144@TOP@human_GAPDH_TAA_len41_fa20_ta0_fm14_tm6,c
3144@TOP@human_GAPDH_TAA_len41_fa20_ta0_fm14_tm6*117*a,9806,0,11,0,9817,0.001,117,3144@TOP@human_GAPDH_TAA_len41_fa20_ta0_fm14_tm6,a
3144@TOP@human_GAPDH_TAA_len41_fa20_ta0_fm14_tm6*118*a,9615,0,145,0,9760,0.015,118,3144@TOP@human_GAPDH_TAA_len41_fa20_ta0_fm14_tm6,a
3144@TOP@human_GAPDH_TAA_len41_fa20_ta0_fm14_tm6*119*g,0,0,9746,1,9747,1.0,119,3144@TOP@human_GAPDH_TAA_len41_fa20_ta0_fm14_tm6,g
3144@TOP@human_GAPDH_TAA_len41_fa20_ta0_fm14_tm6*120*g,0,0,9692,1,9693,1.0,120,3144@TOP@human_GAPDH_TAA_len41_fa20_ta0_fm14_tm6,g
3144@TOP@human_GAPDH_TAA_len41_fa20_ta0_fm14_tm6*121*a,9806,0,2,1,9809,0.0,121,3144@TOP@human_GAPDH_TAA_len41_fa20_ta0_fm14_tm6,a
3144@TOP@human_GAPDH_TAA_len41_fa20_ta0_fm14_tm6*122*g,0,0,9813,0,9813,1.0,122,3144@TOP@human_GAPDH_TAA_len41_fa20_ta0_fm14_tm6,g
3144@TOP@human_GAPDH_TAA_len41_fa20_ta0_fm14_tm6*123*t,0,0,1,9684,9685,0.0,123,3144@TOP@human_GAPDH_TAA_len41_fa20_ta0_fm14_tm6,t
3144@TOP@human_GAPDH_TAA_len41_fa20_ta0_fm14_tm6*124*a,9347,1,309,0,9657,0.032,124,3144@TOP@human_GAPDH_TAA_len41_fa20_ta0_fm14_tm6,a
3144@TOP@human_GAPDH_TAA_len41_fa20_ta0_fm14_tm6*125*a,9490,0,159,2,9651,0.016,125,3144@TOP@human_GAPDH_TAA_len41_fa20_ta0_fm14_tm6,a
3144@TOP@human_GAPDH_TAA_len41_fa20_ta0_fm14_tm6*126*g,1,0,9688,0,9689,1.0,126,3144@TOP@human_GAPDH_TAA_len41_fa20_ta0_fm14_tm6,g
3144@TOP@human_GAPDH_TAA_len41_fa20_ta0_fm14_tm6*127*a,9764,0,11,0,9775,0.001,127,3144@TOP@human_GAPDH_TAA_len41_fa20_ta0_fm14_tm6,a
3144@TOP@human_GAPDH_TAA_len41_fa20_ta0_fm14_tm6*128*c,0,9844,1,0,9845,0.0,128,3144@TOP@human_GAPDH_TAA_len41_fa20_ta0_fm14_tm6,c
3144@TOP@human_GAPDH_TAA_len41_fa20_ta0_fm14_tm6*129*c,2,9755,0,1,9758,0.0,129,3144@TOP@human_GAPDH_TAA_len41_fa20_ta0_fm14_tm6,c
3144@TOP@human_GAPDH_TAA_len41_fa20_ta0_fm14_tm6*130*c,0,9823,0,0,9823,0.0,130,3144@TOP@human_GAPDH_TAA_len41_fa20_ta0_fm14_tm6,c
3144@TOP@human_GAPDH_TAA_len41_fa20_ta0_fm14_tm6*131*c,1,9838,0,0,9839,0.0,131,3144@TOP@human_GAPDH_TAA_len41_fa20_ta0_fm14_tm6,c
3144@TOP@human_GAPDH_TAA_len41_fa20_ta0_fm14_tm6*132*t,0,0,0,9727,9727,0.0,132,3144@TOP@human_GAPDH_TAA_len41_fa20_ta0_fm14_tm6,t
3144@TOP@human_GAPDH_TAA_len41_fa20_ta0_fm14_tm6*133*g,2,0,9657,4,9663,0.999,133,3144@TOP@human_GAPDH_TAA_len41_fa20_ta0_fm14_tm6,g
3144@TOP@human_GAPDH_TAA_len41_fa20_ta0_fm14_tm6*134*g,1,0,9756,0,9757,1.0,134,3144@TOP@human_GAPDH_TAA_len41_fa20_ta0_fm14_tm6,g
3145@TOP@human_GAPDH_TAA_len41_fa20_ta0_fm14_tm6*114*t,0,6,0,10659,10665,0.0,114,3145@TOP@human_GAPDH_TAA_len41_fa20_ta0_fm14_tm6,t
3145@TOP@human_GAPDH_TAA_len41_fa20_ta0_fm14_tm6*115*c,1,10715,0,0,10716,0.0,115,3145@TOP@human_GAPDH_TAA_len41_fa20_ta0_fm14_tm6,c
3145@TOP@human_GAPDH_TAA_len41_fa20_ta0_fm14_tm6*116*c,0,10672,0,0,10672,0.0,116,3145@TOP@human_GAPDH_TAA_len41_fa20_ta0_fm14_tm6,c
3145@TOP@human_GAPDH_TAA_len41_fa20_ta0_fm14_tm6*117*a,10647,0,23,0,10670,0.002,117,3145@TOP@human_GAPDH_TAA_len41_fa20_ta0_fm14_tm6,a
3145@TOP@human_GAPDH_TAA_len41_fa20_ta0_fm14_tm6*118*a,10506,0,117,0,10623,0.011,118,3145@TOP@human_GAPDH_TAA_len41_fa20_ta0_fm14_tm6,a
3145@TOP@human_GAPDH_TAA_len41_fa20_ta0_fm14_tm6*119*g,0,0,10601,0,10601,1.0,119,3145@TOP@human_GAPDH_TAA_len41_fa20_ta0_fm14_tm6,g
3145@TOP@human_GAPDH_TAA_len41_fa20_ta0_fm14_tm6*120*g,1,0,10528,1,10530,1.0,120,3145@TOP@human_GAPDH_TAA_len41_fa20_ta0_fm14_tm6,g
3145@TOP@human_GAPDH_TAA_len41_fa20_ta0_fm14_tm6*121*a,10662,0,1,0,10663,0.0,121,3145@TOP@human_GAPDH_TAA_len41_fa20_ta0_fm14_tm6,a
3145@TOP@human_GAPDH_TAA_len41_fa20_ta0_fm14_tm6*122*g,0,0,10662,0,10662,1.0,122,3145@TOP@human_GAPDH_TAA_len41_fa20_ta0_fm14_tm6,g
3145@TOP@human_GAPDH_TAA_len41_fa20_ta0_fm14_tm6*123*t,1,2,4,10509,10516,0.0,123,3145@TOP@human_GAPDH_TAA_len41_fa20_ta0_fm14_tm6,t
3145@TOP@human_GAPDH_TAA_len41_fa20_ta0_fm14_tm6*124*a,10216,1,306,0,10523,0.029,124,3145@TOP@human_GAPDH_TAA_len41_fa20_ta0_fm14_tm6,a
3145@TOP@human_GAPDH_TAA_len41_fa20_ta0_fm14_tm6*125*a,10321,0,160,2,10483,0.015,125,3145@TOP@human_GAPDH_TAA_len41_fa20_ta0_fm14_tm6,a
3145@TOP@human_GAPDH_TAA_len41_fa20_ta0_fm14_tm6*126*g,0,0,10513,0,10513,1.0,126,3145@TOP@human_GAPDH_TAA_len41_fa20_ta0_fm14_tm6,g
3145@TOP@human_GAPDH_TAA_len41_fa20_ta0_fm14_tm6*127*a,10615,0,3,0,10618,0.0,127,3145@TOP@human_GAPDH_TAA_len41_fa20_ta0_fm14_tm6,a
3145@TOP@human_GAPDH_TAA_len41_fa20_ta0_fm14_tm6*128*c,1,10694,0,0,10695,0.0,128,3145@TOP@human_GAPDH_TAA_len41_fa20_ta0_fm14_tm6,c
3145@TOP@human_GAPDH_TAA_len41_fa20_ta0_fm14_tm6*129*c,2,10603,0,0,10605,0.0,129,3145@TOP@human_GAPDH_TAA_len41_fa20_ta0_fm14_tm6,c
3145@TOP@human_GAPDH_TAA_len41_fa20_ta0_fm14_tm6*130*c,0,10664,0,4,10668,0.0,130,3145@TOP@human_GAPDH_TAA_len41_fa20_ta0_fm14_tm6,c
3145@TOP@human_GAPDH_TAA_len41_fa20_ta0_fm14_tm6*131*c,2,10695,0,0,10697,0.0,131,3145@TOP@human_GAPDH_TAA_len41_fa20_ta0_fm14_tm6,c
3145@TOP@human_GAPDH_TAA_len41_fa20_ta0_fm14_tm6*132*t,1,1,2,10528,10532,0.0,132,3145@TOP@human_GAPDH_TAA_len41_fa20_ta0_fm14_tm6,t
3145@TOP@human_GAPDH_TAA_len41_fa20_ta0_fm14_tm6*133*g,3,0,10530,0,10533,1.0,133,3145@TOP@human_GAPDH_TAA_len41_fa20_ta0_fm14_tm6,g
3145@TOP@human_GAPDH_TAA_len41_fa20_ta0_fm14_tm6*134*g,4,0,10564,0,10568,1.0,134,3145@TOP@human_GAPDH_TAA_len41_fa20_ta0_fm14_tm6,g
3146@TOP@human_GAPDH_TAA_len41_fa20_ta0_fm14_tm6*114*t,1,4,0,19740,19745,0.0,114,3146@TOP@human_GAPDH_TAA_len41_fa20_ta0_fm14_tm6,t
3146@TOP@human_GAPDH_TAA_len41_fa20_ta0_fm14_tm6*115*c,2,19854,0,2,19858,0.0,115,3146@TOP@human_GAPDH_TAA_len41_fa20_ta0_fm14_tm6,c
3146@TOP@human_GAPDH_TAA_len41_fa20_ta0_fm14_tm6*116*c,0,19778,0,2,19780,0.0,116,3146@TOP@human_GAPDH_TAA_len41_fa20_ta0_fm14_tm6,c
3146@TOP@human_GAPDH_TAA_len41_fa20_ta0_fm14_tm6*117*a,19747,0,20,0,19767,0.001,117,3146@TOP@human_GAPDH_TAA_len41_fa20_ta0_fm14_tm6,a
3146@TOP@human_GAPDH_TAA_len41_fa20_ta0_fm14_tm6*118*a,19351,2,277,0,19630,0.014,118,3146@TOP@human_GAPDH_TAA_len41_fa20_ta0_fm14_tm6,a
3146@TOP@human_GAPDH_TAA_len41_fa20_ta0_fm14_tm6*119*g,2,0,19634,0,19636,1.0,119,3146@TOP@human_GAPDH_TAA_len41_fa20_ta0_fm14_tm6,g
3146@TOP@human_GAPDH_TAA_len41_fa20_ta0_fm14_tm6*120*g,0,0,19546,0,19546,1.0,120,3146@TOP@human_GAPDH_TAA_len41_fa20_ta0_fm14_tm6,g
3146@TOP@human_GAPDH_TAA_len41_fa20_ta0_fm14_tm6*121*a,19754,1,7,0,19762,0.0,121,3146@TOP@human_GAPDH_TAA_len41_fa20_ta0_fm14_tm6,a
3146@TOP@human_GAPDH_TAA_len41_fa20_ta0_fm14_tm6*122*g,0,0,19785,0,19785,1.0,122,3146@TOP@human_GAPDH_TAA_len41_fa20_ta0_fm14_tm6,g
3146@TOP@human_GAPDH_TAA_len41_fa20_ta0_fm14_tm6*123*t,3,7,1,19508,19519,0.0,123,3146@TOP@human_GAPDH_TAA_len41_fa20_ta0_fm14_tm6,t
3146@TOP@human_GAPDH_TAA_len41_fa20_ta0_fm14_tm6*124*a,18789,2,591,0,19382,0.03,124,3146@TOP@human_GAPDH_TAA_len41_fa20_ta0_fm14_tm6,a
3146@TOP@human_GAPDH_TAA_len41_fa20_ta0_fm14_tm6*125*a,19058,0,310,0,19368,0.016,125,3146@TOP@human_GAPDH_TAA_len41_fa20_ta0_fm14_tm6,a
3146@TOP@human_GAPDH_TAA_len41_fa20_ta0_fm14_tm6*126*g,3,0,19503,2,19508,1.0,126,3146@TOP@human_GAPDH_TAA_len41_fa20_ta0_fm14_tm6,g
3146@TOP@human_GAPDH_TAA_len41_fa20_ta0_fm14_tm6*127*a,19687,0,9,0,19696,0.0,127,3146@TOP@human_GAPDH_TAA_len41_fa20_ta0_fm14_tm6,a
3146@TOP@human_GAPDH_TAA_len41_fa20_ta0_fm14_tm6*128*c,1,19788,2,0,19791,0.0,128,3146@TOP@human_GAPDH_TAA_len41_fa20_ta0_fm14_tm6,c
3146@TOP@human_GAPDH_TAA_len41_fa20_ta0_fm14_tm6*129*c,1,19650,0,0,19651,0.0,129,3146@TOP@human_GAPDH_TAA_len41_fa20_ta0_fm14_tm6,c
3146@TOP@human_GAPDH_TAA_len41_fa20_ta0_fm14_tm6*130*c,1,19776,0,1,19778,0.0,130,3146@TOP@human_GAPDH_TAA_len41_fa20_ta0_fm14_tm6,c
3146@TOP@human_GAPDH_TAA_len41_fa20_ta0_fm14_tm6*131*c,0,19817,0,3,19820,0.0,131,3146@TOP@human_GAPDH_TAA_len41_fa20_ta0_fm14_tm6,c
3146@TOP@human_GAPDH_TAA_len41_fa20_ta0_fm14_tm6*132*t,2,9,0,19524,19535,0.0,132,3146@TOP@human_GAPDH_TAA_len41_fa20_ta0_fm14_tm6,t
3146@TOP@human_GAPDH_TAA_len41_fa20_ta0_fm14_tm6*133*g,2,0,19499,0,19501,1.0,133,3146@TOP@human_GAPDH_TAA_len41_fa20_ta0_fm14_tm6,g
3146@TOP@human_GAPDH_TAA_len41_fa20_ta0_fm14_tm6*134*g,4,2,19604,0,19610,1.0,134,3146@TOP@human_GAPDH_TAA_len41_fa20_ta0_fm14_tm6,g
3147@TOP@human_GAPDH_TAA_len41_fa20_ta0_fm14_tm6*114*t,0,1,0,16596,16597,0.0,114,3147@TOP@human_GAPDH_TAA_len41_fa20_ta0_fm14_tm6,t
3147@TOP@human_GAPDH_TAA_len41_fa20_ta0_fm14_tm6*115*c,1,16686,0,0,16687,0.0,115,3147@TOP@human_GAPDH_TAA_len41_fa20_ta0_fm14_tm6,c
3147@TOP@human_GAPDH_TAA_len41_fa20_ta0_fm14_tm6*116*c,0,16627,0,0,16627,0.0,116,3147@TOP@human_GAPDH_TAA_len41_fa20_ta0_fm14_tm6,c
3147@TOP@human_GAPDH_TAA_len41_fa20_ta0_fm14_tm6*117*a,16576,1,25,0,16602,0.002,117,3147@TOP@human_GAPDH_TAA_len41_fa20_ta0_fm14_tm6,a
3147@TOP@human_GAPDH_TAA_len41_fa20_ta0_fm14_tm6*118*a,16328,0,179,1,16508,0.011,118,3147@TOP@human_GAPDH_TAA_len41_fa20_ta0_fm14_tm6,a
3147@TOP@human_GAPDH_TAA_len41_fa20_ta0_fm14_tm6*119*g,0,0,16515,2,16517,1.0,119,3147@TOP@human_GAPDH_TAA_len41_fa20_ta0_fm14_tm6,g
3147@TOP@human_GAPDH_TAA_len41_fa20_ta0_fm14_tm6*120*g,0,0,16423,0,16423,1.0,120,3147@TOP@human_GAPDH_TAA_len41_fa20_ta0_fm14_tm6,g
3147@TOP@human_GAPDH_TAA_len41_fa20_ta0_fm14_tm6*121*a,16595,0,4,0,16599,0.0,121,3147@TOP@human_GAPDH_TAA_len41_fa20_ta0_fm14_tm6,a
3147@TOP@human_GAPDH_TAA_len41_fa20_ta0_fm14_tm6*122*g,2,0,16613,0,16615,1.0,122,3147@TOP@human_GAPDH_TAA_len41_fa20_ta0_fm14_tm6,g
3147@TOP@human_GAPDH_TAA_len41_fa20_ta0_fm14_tm6*123*t,1,1,3,16385,16390,0.0,123,3147@TOP@human_GAPDH_TAA_len41_fa20_ta0_fm14_tm6,t
3147@TOP@human_GAPDH_TAA_len41_fa20_ta0_fm14_tm6*124*a,15808,0,527,0,16335,0.032,124,3147@TOP@human_GAPDH_TAA_len41_fa20_ta0_fm14_tm6,a
3147@TOP@human_GAPDH_TAA_len41_fa20_ta0_fm14_tm6*125*a,16023,0,267,2,16292,0.016,125,3147@TOP@human_GAPDH_TAA_len41_fa20_ta0_fm14_tm6,a
3147@TOP@human_GAPDH_TAA_len41_fa20_ta0_fm14_tm6*126*g,2,0,16434,1,16437,1.0,126,3147@TOP@human_GAPDH_TAA_len41_fa20_ta0_fm14_tm6,g
3147@TOP@human_GAPDH_TAA_len41_fa20_ta0_fm14_tm6*127*a,16557,0,11,0,16568,0.001,127,3147@TOP@human_GAPDH_TAA_len41_fa20_ta0_fm14_tm6,a
3147@TOP@human_GAPDH_TAA_len41_fa20_ta0_fm14_tm6*128*c,1,16648,1,1,16651,0.0,128,3147@TOP@human_GAPDH_TAA_len41_fa20_ta0_fm14_tm6,c
3147@TOP@human_GAPDH_TAA_len41_fa20_ta0_fm14_tm6*129*c,0,16538,0,0,16538,0.0,129,3147@TOP@human_GAPDH_TAA_len41_fa20_ta0_fm14_tm6,c
3147@TOP@human_GAPDH_TAA_len41_fa20_ta0_fm14_tm6*130*c,1,16617,0,1,16619,0.0,130,3147@TOP@human_GAPDH_TAA_len41_fa20_ta0_fm14_tm6,c
3147@TOP@human_GAPDH_TAA_len41_fa20_ta0_fm14_tm6*131*c,7,16654,0,1,16662,0.0,131,3147@TOP@human_GAPDH_TAA_len41_fa20_ta0_fm14_tm6,c
3147@TOP@human_GAPDH_TAA_len41_fa20_ta0_fm14_tm6*132*t,2,2,0,16410,16414,0.0,132,3147@TOP@human_GAPDH_TAA_len41_fa20_ta0_fm14_tm6,t
3147@TOP@human_GAPDH_TAA_len41_fa20_ta0_fm14_tm6*133*g,3,0,16379,0,16382,1.0,133,3147@TOP@human_GAPDH_TAA_len41_fa20_ta0_fm14_tm6,g
3147@TOP@human_GAPDH_TAA_len41_fa20_ta0_fm14_tm6*134*g,1,7,16518,2,16528,0.999,134,3147@TOP@human_GAPDH_TAA_len41_fa20_ta0_fm14_tm6,g
3148@TOP@human_GAPDH_TAA_len41_fa20_ta0_fm14_tm6*114*t,2,4,0,15777,15783,0.0,114,3148@TOP@human_GAPDH_TAA_len41_fa20_ta0_fm14_tm6,t
3148@TOP@human_GAPDH_TAA_len41_fa20_ta0_fm14_tm6*115*c,1,15859,0,0,15860,0.0,115,3148@TOP@human_GAPDH_TAA_len41_fa20_ta0_fm14_tm6,c
3148@TOP@human_GAPDH_TAA_len41_fa20_ta0_fm14_tm6*116*c,0,15790,0,2,15792,0.0,116,3148@TOP@human_GAPDH_TAA_len41_fa20_ta0_fm14_tm6,c
3148@TOP@human_GAPDH_TAA_len41_fa20_ta0_fm14_tm6*117*a,15752,0,16,0,15768,0.001,117,3148@TOP@human_GAPDH_TAA_len41_fa20_ta0_fm14_tm6,a
3148@TOP@human_GAPDH_TAA_len41_fa20_ta0_fm14_tm6*118*a,15580,0,141,0,15721,0.009,118,3148@TOP@human_GAPDH_TAA_len41_fa20_ta0_fm14_tm6,a
3148@TOP@human_GAPDH_TAA_len41_fa20_ta0_fm14_tm6*119*g,0,0,15660,1,15661,1.0,119,3148@TOP@human_GAPDH_TAA_len41_fa20_ta0_fm14_tm6,g
3148@TOP@human_GAPDH_TAA_len41_fa20_ta0_fm14_tm6*120*g,0,0,15596,0,15596,1.0,120,3148@TOP@human_GAPDH_TAA_len41_fa20_ta0_fm14_tm6,g
3148@TOP@human_GAPDH_TAA_len41_fa20_ta0_fm14_tm6*121*a,15783,1,6,0,15790,0.0,121,3148@TOP@human_GAPDH_TAA_len41_fa20_ta0_fm14_tm6,a
3148@TOP@human_GAPDH_TAA_len41_fa20_ta0_fm14_tm6*122*g,4,0,15801,0,15805,1.0,122,3148@TOP@human_GAPDH_TAA_len41_fa20_ta0_fm14_tm6,g
3148@TOP@human_GAPDH_TAA_len41_fa20_ta0_fm14_tm6*123*t,1,1,0,15576,15578,0.0,123,3148@TOP@human_GAPDH_TAA_len41_fa20_ta0_fm14_tm6,t
3148@TOP@human_GAPDH_TAA_len41_fa20_ta0_fm14_tm6*124*a,14791,0,713,0,15504,0.046,124,3148@TOP@human_GAPDH_TAA_len41_fa20_ta0_fm14_tm6,a
3148@TOP@human_GAPDH_TAA_len41_fa20_ta0_fm14_tm6*125*a,15257,1,261,0,15519,0.017,125,3148@TOP@human_GAPDH_TAA_len41_fa20_ta0_fm14_tm6,a
3148@TOP@human_GAPDH_TAA_len41_fa20_ta0_fm14_tm6*126*g,1,1,15599,0,15601,1.0,126,3148@TOP@human_GAPDH_TAA_len41_fa20_ta0_fm14_tm6,g
3148@TOP@human_GAPDH_TAA_len41_fa20_ta0_fm14_tm6*127*a,15725,0,8,0,15733,0.001,127,3148@TOP@human_GAPDH_TAA_len41_fa20_ta0_fm14_tm6,a
3148@TOP@human_GAPDH_TAA_len41_fa20_ta0_fm14_tm6*128*c,0,15816,3,4,15823,0.0,128,3148@TOP@human_GAPDH_TAA_len41_fa20_ta0_fm14_tm6,c
3148@TOP@human_GAPDH_TAA_len41_fa20_ta0_fm14_tm6*129*c,1,15719,0,0,15720,0.0,129,3148@TOP@human_GAPDH_TAA_len41_fa20_ta0_fm14_tm6,c
3148@TOP@human_GAPDH_TAA_len41_fa20_ta0_fm14_tm6*130*c,3,15802,0,1,15806,0.0,130,3148@TOP@human_GAPDH_TAA_len41_fa20_ta0_fm14_tm6,c
3148@TOP@human_GAPDH_TAA_len41_fa20_ta0_fm14_tm6*131*c,0,15826,0,2,15828,0.0,131,3148@TOP@human_GAPDH_TAA_len41_fa20_ta0_fm14_tm6,c
3148@TOP@human_GAPDH_TAA_len41_fa20_ta0_fm14_tm6*132*t,1,2,0,15608,15611,0.0,132,3148@TOP@human_GAPDH_TAA_len41_fa20_ta0_fm14_tm6,t
3148@TOP@human_GAPDH_TAA_len41_fa20_ta0_fm14_tm6*133*g,0,0,15543,1,15544,1.0,133,3148@TOP@human_GAPDH_TAA_len41_fa20_ta0_fm14_tm6,g
3148@TOP@human_GAPDH_TAA_len41_fa20_ta0_fm14_tm6*134*g,1,2,15654,1,15658,1.0,134,3148@TOP@human_GAPDH_TAA_len41_fa20_ta0_fm14_tm6,g
3149@TOP@human_GAPDH_TAA_len41_fa20_ta0_fm14_tm6*114*t,5,13,0,48532,48550,0.0,114,3149@TOP@human_GAPDH_TAA_len41_fa20_ta0_fm14_tm6,t
3149@TOP@human_GAPDH_TAA_len41_fa20_ta0_fm14_tm6*115*c,2,48834,2,3,48841,0.0,115,3149@TOP@human_GAPDH_TAA_len41_fa20_ta0_fm14_tm6,c
3149@TOP@human_GAPDH_TAA_len41_fa20_ta0_fm14_tm6*116*c,1,48667,0,2,48670,0.0,116,3149@TOP@human_GAPDH_TAA_len41_fa20_ta0_fm14_tm6,c
3149@TOP@human_GAPDH_TAA_len41_fa20_ta0_fm14_tm6*117*a,48557,1,55,0,48613,0.001,117,3149@TOP@human_GAPDH_TAA_len41_fa20_ta0_fm14_tm6,a
3149@TOP@human_GAPDH_TAA_len41_fa20_ta0_fm14_tm6*118*a,47821,0,535,4,48360,0.011,118,3149@TOP@human_GAPDH_TAA_len41_fa20_ta0_fm14_tm6,a
3149@TOP@human_GAPDH_TAA_len41_fa20_ta0_fm14_tm6*119*g,1,0,48299,4,48304,1.0,119,3149@TOP@human_GAPDH_TAA_len41_fa20_ta0_fm14_tm6,g
3149@TOP@human_GAPDH_TAA_len41_fa20_ta0_fm14_tm6*120*g,1,4,48078,0,48083,1.0,120,3149@TOP@human_GAPDH_TAA_len41_fa20_ta0_fm14_tm6,g
3149@TOP@human_GAPDH_TAA_len41_fa20_ta0_fm14_tm6*121*a,48558,0,9,0,48567,0.0,121,3149@TOP@human_GAPDH_TAA_len41_fa20_ta0_fm14_tm6,a
3149@TOP@human_GAPDH_TAA_len41_fa20_ta0_fm14_tm6*122*g,4,1,48655,1,48661,1.0,122,3149@TOP@human_GAPDH_TAA_len41_fa20_ta0_fm14_tm6,g
3149@TOP@human_GAPDH_TAA_len41_fa20_ta0_fm14_tm6*123*t,4,6,4,48005,48019,0.0,123,3149@TOP@human_GAPDH_TAA_len41_fa20_ta0_fm14_tm6,t
3149@TOP@human_GAPDH_TAA_len41_fa20_ta0_fm14_tm6*124*a,46299,2,1562,0,47863,0.033,124,3149@TOP@human_GAPDH_TAA_len41_fa20_ta0_fm14_tm6,a
3149@TOP@human_GAPDH_TAA_len41_fa20_ta0_fm14_tm6*125*a,47035,2,716,0,47753,0.015,125,3149@TOP@human_GAPDH_TAA_len41_fa20_ta0_fm14_tm6,a
3149@TOP@human_GAPDH_TAA_len41_fa20_ta0_fm14_tm6*126*g,3,1,48001,1,48006,1.0,126,3149@TOP@human_GAPDH_TAA_len41_fa20_ta0_fm14_tm6,g
3149@TOP@human_GAPDH_TAA_len41_fa20_ta0_fm14_tm6*127*a,48457,0,38,0,48495,0.001,127,3149@TOP@human_GAPDH_TAA_len41_fa20_ta0_fm14_tm6,a
3149@TOP@human_GAPDH_TAA_len41_fa20_ta0_fm14_tm6*128*c,0,48729,6,3,48738,0.0,128,3149@TOP@human_GAPDH_TAA_len41_fa20_ta0_fm14_tm6,c
3149@TOP@human_GAPDH_TAA_len41_fa20_ta0_fm14_tm6*129*c,7,48358,0,4,48369,0.0,129,3149@TOP@human_GAPDH_TAA_len41_fa20_ta0_fm14_tm6,c
3149@TOP@human_GAPDH_TAA_len41_fa20_ta0_fm14_tm6*130*c,1,48642,1,7,48651,0.0,130,3149@TOP@human_GAPDH_TAA_len41_fa20_ta0_fm14_tm6,c
3149@TOP@human_GAPDH_TAA_len41_fa20_ta0_fm14_tm6*131*c,2,48768,0,7,48777,0.0,131,3149@TOP@human_GAPDH_TAA_len41_fa20_ta0_fm14_tm6,c
3149@TOP@human_GAPDH_TAA_len41_fa20_ta0_fm14_tm6*132*t,6,5,2,48088,48101,0.0,132,3149@TOP@human_GAPDH_TAA_len41_fa20_ta0_fm14_tm6,t
3149@TOP@human_GAPDH_TAA_len41_fa20_ta0_fm14_tm6*133*g,1,3,47967,0,47971,1.0,133,3149@TOP@human_GAPDH_TAA_len41_fa20_ta0_fm14_tm6,g
3149@TOP@human_GAPDH_TAA_len41_fa20_ta0_fm14_tm6*134*g,0,4,48216,3,48223,1.0,134,3149@TOP@human_GAPDH_TAA_len41_fa20_ta0_fm14_tm6,g
3150@TOP@human_GAPDH_TAA_len41_fa20_ta0_fm14_tm6*114*t,0,4,0,2277,2281,0.0,114,3150@TOP@human_GAPDH_TAA_len41_fa20_ta0_fm14_tm6,t
3150@TOP@human_GAPDH_TAA_len41_fa20_ta0_fm14_tm6*115*c,0,2290,0,1,2291,0.0,115,3150@TOP@human_GAPDH_TAA_len41_fa20_ta0_fm14_tm6,c
3150@TOP@human_GAPDH_TAA_len41_fa20_ta0_fm14_tm6*116*c,0,2275,0,0,2275,0.0,116,3150@TOP@human_GAPDH_TAA_len41_fa20_ta0_fm14_tm6,c
3150@TOP@human_GAPDH_TAA_len41_fa20_ta0_fm14_tm6*117*a,2283,0,5,0,2288,0.002,117,3150@TOP@human_GAPDH_TAA_len41_fa20_ta0_fm14_tm6,a
3150@TOP@human_GAPDH_TAA_len41_fa20_ta0_fm14_tm6*118*a,2238,0,28,0,2266,0.012,118,3150@TOP@human_GAPDH_TAA_len41_fa20_ta0_fm14_tm6,a
3150@TOP@human_GAPDH_TAA_len41_fa20_ta0_fm14_tm6*119*g,0,0,2268,0,2268,1.0,119,3150@TOP@human_GAPDH_TAA_len41_fa20_ta0_fm14_tm6,g
3150@TOP@human_GAPDH_TAA_len41_fa20_ta0_fm14_tm6*120*g,0,0,2256,0,2256,1.0,120,3150@TOP@human_GAPDH_TAA_len41_fa20_ta0_fm14_tm6,g
3150@TOP@human_GAPDH_TAA_len41_fa20_ta0_fm14_tm6*121*a,2277,0,0,0,2277,0.0,121,3150@TOP@human_GAPDH_TAA_len41_fa20_ta0_fm14_tm6,a
3150@TOP@human_GAPDH_TAA_len41_fa20_ta0_fm14_tm6*122*g,0,0,2284,0,2284,1.0,122,3150@TOP@human_GAPDH_TAA_len41_fa20_ta0_fm14_tm6,g
3150@TOP@human_GAPDH_TAA_len41_fa20_ta0_fm14_tm6*123*t,1,0,1,2242,2244,0.0,123,3150@TOP@human_GAPDH_TAA_len41_fa20_ta0_fm14_tm6,t
3150@TOP@human_GAPDH_TAA_len41_fa20_ta0_fm14_tm6*124*a,2180,0,68,0,2248,0.03,124,3150@TOP@human_GAPDH_TAA_len41_fa20_ta0_fm14_tm6,a
3150@TOP@human_GAPDH_TAA_len41_fa20_ta0_fm14_tm6*125*a,2191,0,49,0,2240,0.022,125,3150@TOP@human_GAPDH_TAA_len41_fa20_ta0_fm14_tm6,a
3150@TOP@human_GAPDH_TAA_len41_fa20_ta0_fm14_tm6*126*g,0,0,2254,0,2254,1.0,126,3150@TOP@human_GAPDH_TAA_len41_fa20_ta0_fm14_tm6,g
3150@TOP@human_GAPDH_TAA_len41_fa20_ta0_fm14_tm6*127*a,2274,0,3,0,2277,0.001,127,3150@TOP@human_GAPDH_TAA_len41_fa20_ta0_fm14_tm6,a
3150@TOP@human_GAPDH_TAA_len41_fa20_ta0_fm14_tm6*128*c,0,2284,0,0,2284,0.0,128,3150@TOP@human_GAPDH_TAA_len41_fa20_ta0_fm14_tm6,c
3150@TOP@human_GAPDH_TAA_len41_fa20_ta0_fm14_tm6*129*c,0,2267,0,0,2267,0.0,129,3150@TOP@human_GAPDH_TAA_len41_fa20_ta0_fm14_tm6,c
3150@TOP@human_GAPDH_TAA_len41_fa20_ta0_fm14_tm6*130*c,1,2281,0,0,2282,0.0,130,3150@TOP@human_GAPDH_TAA_len41_fa20_ta0_fm14_tm6,c
3150@TOP@human_GAPDH_TAA_len41_fa20_ta0_fm14_tm6*131*c,0,2287,0,0,2287,0.0,131,3150@TOP@human_GAPDH_TAA_len41_fa20_ta0_fm14_tm6,c
3150@TOP@human_GAPDH_TAA_len41_fa20_ta0_fm14_tm6*132*t,0,0,0,2253,2253,0.0,132,3150@TOP@human_GAPDH_TAA_len41_fa20_ta0_fm14_tm6,t
3150@TOP@human_GAPDH_TAA_len41_fa20_ta0_fm14_tm6*133*g,0,0,2228,19,2247,0.992,133,3150@TOP@human_GAPDH_TAA_len41_fa20_ta0_fm14_tm6,g
3150@TOP@human_GAPDH_TAA_len41_fa20_ta0_fm14_tm6*134*g,0,1,2262,0,2263,1.0,134,3150@TOP@human_GAPDH_TAA_len41_fa20_ta0_fm14_tm6,g
3151@TOP@human_GAPDH_TAA_len41_fa20_ta0_fm14_tm6*114*t,1,0,0,2021,2022,0.0,114,3151@TOP@human_GAPDH_TAA_len41_fa20_ta0_fm14_tm6,t
3151@TOP@human_GAPDH_TAA_len41_fa20_ta0_fm14_tm6*115*c,0,2035,0,0,2035,0.0,115,3151@TOP@human_GAPDH_TAA_len41_fa20_ta0_fm14_tm6,c
3151@TOP@human_GAPDH_TAA_len41_fa20_ta0_fm14_tm6*116*c,0,2025,0,0,2025,0.0,116,3151@TOP@human_GAPDH_TAA_len41_fa20_ta0_fm14_tm6,c
3151@TOP@human_GAPDH_TAA_len41_fa20_ta0_fm14_tm6*117*a,2027,0,0,0,2027,0.0,117,3151@TOP@human_GAPDH_TAA_len41_fa20_ta0_fm14_tm6,a
3151@TOP@human_GAPDH_TAA_len41_fa20_ta0_fm14_tm6*118*a,1981,0,29,0,2010,0.014,118,3151@TOP@human_GAPDH_TAA_len41_fa20_ta0_fm14_tm6,a
3151@TOP@human_GAPDH_TAA_len41_fa20_ta0_fm14_tm6*119*g,0,0,2011,0,2011,1.0,119,3151@TOP@human_GAPDH_TAA_len41_fa20_ta0_fm14_tm6,g
3151@TOP@human_GAPDH_TAA_len41_fa20_ta0_fm14_tm6*120*g,0,0,1991,0,1991,1.0,120,3151@TOP@human_GAPDH_TAA_len41_fa20_ta0_fm14_tm6,g
3151@TOP@human_GAPDH_TAA_len41_fa20_ta0_fm14_tm6*121*a,2019,0,2,0,2021,0.001,121,3151@TOP@human_GAPDH_TAA_len41_fa20_ta0_fm14_tm6,a
3151@TOP@human_GAPDH_TAA_len41_fa20_ta0_fm14_tm6*122*g,0,1,2025,0,2026,1.0,122,3151@TOP@human_GAPDH_TAA_len41_fa20_ta0_fm14_tm6,g
3151@TOP@human_GAPDH_TAA_len41_fa20_ta0_fm14_tm6*123*t,1,0,0,1991,1992,0.0,123,3151@TOP@human_GAPDH_TAA_len41_fa20_ta0_fm14_tm6,t
3151@TOP@human_GAPDH_TAA_len41_fa20_ta0_fm14_tm6*124*a,1908,0,74,2,1984,0.037,124,3151@TOP@human_GAPDH_TAA_len41_fa20_ta0_fm14_tm6,a
3151@TOP@human_GAPDH_TAA_len41_fa20_ta0_fm14_tm6*125*a,1962,0,26,0,1988,0.013,125,3151@TOP@human_GAPDH_TAA_len41_fa20_ta0_fm14_tm6,a
3151@TOP@human_GAPDH_TAA_len41_fa20_ta0_fm14_tm6*126*g,0,0,1995,0,1995,1.0,126,3151@TOP@human_GAPDH_TAA_len41_fa20_ta0_fm14_tm6,g
3151@TOP@human_GAPDH_TAA_len41_fa20_ta0_fm14_tm6*127*a,2019,0,0,0,2019,0.0,127,3151@TOP@human_GAPDH_TAA_len41_fa20_ta0_fm14_tm6,a
3151@TOP@human_GAPDH_TAA_len41_fa20_ta0_fm14_tm6*128*c,0,2024,0,0,2024,0.0,128,3151@TOP@human_GAPDH_TAA_len41_fa20_ta0_fm14_tm6,c
3151@TOP@human_GAPDH_TAA_len41_fa20_ta0_fm14_tm6*129*c,1,2004,0,1,2006,0.0,129,3151@TOP@human_GAPDH_TAA_len41_fa20_ta0_fm14_tm6,c
3151@TOP@human_GAPDH_TAA_len41_fa20_ta0_fm14_tm6*130*c,0,2024,0,0,2024,0.0,130,3151@TOP@human_GAPDH_TAA_len41_fa20_ta0_fm14_tm6,c
3151@TOP@human_GAPDH_TAA_len41_fa20_ta0_fm14_tm6*131*c,0,2027,0,0,2027,0.0,131,3151@TOP@human_GAPDH_TAA_len41_fa20_ta0_fm14_tm6,c
3151@TOP@human_GAPDH_TAA_len41_fa20_ta0_fm14_tm6*132*t,0,0,0,1999,1999,0.0,132,3151@TOP@human_GAPDH_TAA_len41_fa20_ta0_fm14_tm6,t
3151@TOP@human_GAPDH_TAA_len41_fa20_ta0_fm14_tm6*133*g,0,0,2000,0,2000,1.0,133,3151@TOP@human_GAPDH_TAA_len41_fa20_ta0_fm14_tm6,g
3151@TOP@human_GAPDH_TAA_len41_fa20_ta0_fm14_tm6*134*g,0,0,2009,0,2009,1.0,134,3151@TOP@human_GAPDH_TAA_len41_fa20_ta0_fm14_tm6,g
3152@TOP@human_GAPDH_TAA_len41_fa20_ta0_fm14_tm6*114*t,0,1,0,3536,3537,0.0,114,3152@TOP@human_GAPDH_TAA_len41_fa20_ta0_fm14_tm6,t
3152@TOP@human_GAPDH_TAA_len41_fa20_ta0_fm14_tm6*115*c,0,3555,0,2,3557,0.0,115,3152@TOP@human_GAPDH_TAA_len41_fa20_ta0_fm14_tm6,c
3152@TOP@human_GAPDH_TAA_len41_fa20_ta0_fm14_tm6*116*c,0,3543,0,0,3543,0.0,116,3152@TOP@human_GAPDH_TAA_len41_fa20_ta0_fm14_tm6,c
3152@TOP@human_GAPDH_TAA_len41_fa20_ta0_fm14_tm6*117*a,3537,0,8,0,3545,0.002,117,3152@TOP@human_GAPDH_TAA_len41_fa20_ta0_fm14_tm6,a
3152@TOP@human_GAPDH_TAA_len41_fa20_ta0_fm14_tm6*118*a,3452,0,63,0,3515,0.018,118,3152@TOP@human_GAPDH_TAA_len41_fa20_ta0_fm14_tm6,a
3152@TOP@human_GAPDH_TAA_len41_fa20_ta0_fm14_tm6*119*g,2,0,3513,1,3516,0.999,119,3152@TOP@human_GAPDH_TAA_len41_fa20_ta0_fm14_tm6,g
3152@TOP@human_GAPDH_TAA_len41_fa20_ta0_fm14_tm6*120*g,0,0,3508,0,3508,1.0,120,3152@TOP@human_GAPDH_TAA_len41_fa20_ta0_fm14_tm6,g
3152@TOP@human_GAPDH_TAA_len41_fa20_ta0_fm14_tm6*121*a,3538,0,0,0,3538,0.0,121,3152@TOP@human_GAPDH_TAA_len41_fa20_ta0_fm14_tm6,a
3152@TOP@human_GAPDH_TAA_len41_fa20_ta0_fm14_tm6*122*g,0,1,3543,0,3544,1.0,122,3152@TOP@human_GAPDH_TAA_len41_fa20_ta0_fm14_tm6,g
3152@TOP@human_GAPDH_TAA_len41_fa20_ta0_fm14_tm6*123*t,0,0,0,3488,3488,0.0,123,3152@TOP@human_GAPDH_TAA_len41_fa20_ta0_fm14_tm6,t
3152@TOP@human_GAPDH_TAA_len41_fa20_ta0_fm14_tm6*124*a,3322,0,167,0,3489,0.048,124,3152@TOP@human_GAPDH_TAA_len41_fa20_ta0_fm14_tm6,a
3152@TOP@human_GAPDH_TAA_len41_fa20_ta0_fm14_tm6*125*a,3406,0,69,1,3476,0.02,125,3152@TOP@human_GAPDH_TAA_len41_fa20_ta0_fm14_tm6,a
3152@TOP@human_GAPDH_TAA_len41_fa20_ta0_fm14_tm6*126*g,0,0,3485,0,3485,1.0,126,3152@TOP@human_GAPDH_TAA_len41_fa20_ta0_fm14_tm6,g
3152@TOP@human_GAPDH_TAA_len41_fa20_ta0_fm14_tm6*127*a,3539,1,2,0,3542,0.001,127,3152@TOP@human_GAPDH_TAA_len41_fa20_ta0_fm14_tm6,a
3152@TOP@human_GAPDH_TAA_len41_fa20_ta0_fm14_tm6*128*c,0,3551,0,0,3551,0.0,128,3152@TOP@human_GAPDH_TAA_len41_fa20_ta0_fm14_tm6,c
3152@TOP@human_GAPDH_TAA_len41_fa20_ta0_fm14_tm6*129*c,3,3520,0,0,3523,0.0,129,3152@TOP@human_GAPDH_TAA_len41_fa20_ta0_fm14_tm6,c
3152@TOP@human_GAPDH_TAA_len41_fa20_ta0_fm14_tm6*130*c,0,3539,0,0,3539,0.0,130,3152@TOP@human_GAPDH_TAA_len41_fa20_ta0_fm14_tm6,c
3152@TOP@human_GAPDH_TAA_len41_fa20_ta0_fm14_tm6*131*c,0,3549,0,0,3549,0.0,131,3152@TOP@human_GAPDH_TAA_len41_fa20_ta0_fm14_tm6,c
3152@TOP@human_GAPDH_TAA_len41_fa20_ta0_fm14_tm6*132*t,1,3,0,3491,3495,0.0,132,3152@TOP@human_GAPDH_TAA_len41_fa20_ta0_fm14_tm6,t
3152@TOP@human_GAPDH_TAA_len41_fa20_ta0_fm14_tm6*133*g,0,0,3486,0,3486,1.0,133,3152@TOP@human_GAPDH_TAA_len41_fa20_ta0_fm14_tm6,g
3152@TOP@human_GAPDH_TAA_len41_fa20_ta0_fm14_tm6*134*g,0,3,3500,0,3503,0.999,134,3152@TOP@human_GAPDH_TAA_len41_fa20_ta0_fm14_tm6,g
3153@TOP@human_GAPDH_TAA_len41_fa20_ta0_fm14_tm6*114*t,0,0,0,2932,2932,0.0,114,3153@TOP@human_GAPDH_TAA_len41_fa20_ta0_fm14_tm6,t
3153@TOP@human_GAPDH_TAA_len41_fa20_ta0_fm14_tm6*115*c,0,2945,0,0,2945,0.0,115,3153@TOP@human_GAPDH_TAA_len41_fa20_ta0_fm14_tm6,c
3153@TOP@human_GAPDH_TAA_len41_fa20_ta0_fm14_tm6*116*c,0,2928,1,0,2929,0.0,116,3153@TOP@human_GAPDH_TAA_len41_fa20_ta0_fm14_tm6,c
3153@TOP@human_GAPDH_TAA_len41_fa20_ta0_fm14_tm6*117*a,2929,0,0,0,2929,0.0,117,3153@TOP@human_GAPDH_TAA_len41_fa20_ta0_fm14_tm6,a
3153@TOP@human_GAPDH_TAA_len41_fa20_ta0_fm14_tm6*118*a,2862,0,33,0,2895,0.011,118,3153@TOP@human_GAPDH_TAA_len41_fa20_ta0_fm14_tm6,a
3153@TOP@human_GAPDH_TAA_len41_fa20_ta0_fm14_tm6*119*g,0,0,2912,0,2912,1.0,119,3153@TOP@human_GAPDH_TAA_len41_fa20_ta0_fm14_tm6,g
3153@TOP@human_GAPDH_TAA_len41_fa20_ta0_fm14_tm6*120*g,0,0,2893,0,2893,1.0,120,3153@TOP@human_GAPDH_TAA_len41_fa20_ta0_fm14_tm6,g
3153@TOP@human_GAPDH_TAA_len41_fa20_ta0_fm14_tm6*121*a,2916,0,0,0,2916,0.0,121,3153@TOP@human_GAPDH_TAA_len41_fa20_ta0_fm14_tm6,a
3153@TOP@human_GAPDH_TAA_len41_fa20_ta0_fm14_tm6*122*g,0,0,2928,0,2928,1.0,122,3153@TOP@human_GAPDH_TAA_len41_fa20_ta0_fm14_tm6,g
3153@TOP@human_GAPDH_TAA_len41_fa20_ta0_fm14_tm6*123*t,0,0,0,2880,2880,0.0,123,3153@TOP@human_GAPDH_TAA_len41_fa20_ta0_fm14_tm6,t
3153@TOP@human_GAPDH_TAA_len41_fa20_ta0_fm14_tm6*124*a,2738,0,121,0,2859,0.042,124,3153@TOP@human_GAPDH_TAA_len41_fa20_ta0_fm14_tm6,a
3153@TOP@human_GAPDH_TAA_len41_fa20_ta0_fm14_tm6*125*a,2794,0,76,0,2870,0.026,125,3153@TOP@human_GAPDH_TAA_len41_fa20_ta0_fm14_tm6,a
3153@TOP@human_GAPDH_TAA_len41_fa20_ta0_fm14_tm6*126*g,0,0,2901,0,2901,1.0,126,3153@TOP@human_GAPDH_TAA_len41_fa20_ta0_fm14_tm6,g
3153@TOP@human_GAPDH_TAA_len41_fa20_ta0_fm14_tm6*127*a,2910,0,1,0,2911,0.0,127,3153@TOP@human_GAPDH_TAA_len41_fa20_ta0_fm14_tm6,a
3153@TOP@human_GAPDH_TAA_len41_fa20_ta0_fm14_tm6*128*c,0,2941,0,0,2941,0.0,128,3153@TOP@human_GAPDH_TAA_len41_fa20_ta0_fm14_tm6,c
3153@TOP@human_GAPDH_TAA_len41_fa20_ta0_fm14_tm6*129*c,0,2916,0,0,2916,0.0,129,3153@TOP@human_GAPDH_TAA_len41_fa20_ta0_fm14_tm6,c
3153@TOP@human_GAPDH_TAA_len41_fa20_ta0_fm14_tm6*130*c,0,2933,0,0,2933,0.0,130,3153@TOP@human_GAPDH_TAA_len41_fa20_ta0_fm14_tm6,c
3153@TOP@human_GAPDH_TAA_len41_fa20_ta0_fm14_tm6*131*c,0,2943,0,0,2943,0.0,131,3153@TOP@human_GAPDH_TAA_len41_fa20_ta0_fm14_tm6,c
3153@TOP@human_GAPDH_TAA_len41_fa20_ta0_fm14_tm6*132*t,0,0,0,2900,2900,0.0,132,3153@TOP@human_GAPDH_TAA_len41_fa20_ta0_fm14_tm6,t
3153@TOP@human_GAPDH_TAA_len41_fa20_ta0_fm14_tm6*133*g,0,0,2887,0,2887,1.0,133,3153@TOP@human_GAPDH_TAA_len41_fa20_ta0_fm14_tm6,g
3153@TOP@human_GAPDH_TAA_len41_fa20_ta0_fm14_tm6*134*g,0,0,2896,0,2896,1.0,134,3153@TOP@human_GAPDH_TAA_len41_fa20_ta0_fm14_tm6,g
3154@TOP@human_GAPDH_TAA_len41_fa20_ta0_fm14_tm6*114*t,0,0,0,1869,1869,0.0,114,3154@TOP@human_GAPDH_TAA_len41_fa20_ta0_fm14_tm6,t
3154@TOP@human_GAPDH_TAA_len41_fa20_ta0_fm14_tm6*115*c,0,1882,0,0,1882,0.0,115,3154@TOP@human_GAPDH_TAA_len41_fa20_ta0_fm14_tm6,c
3154@TOP@human_GAPDH_TAA_len41_fa20_ta0_fm14_tm6*116*c,0,1873,0,0,1873,0.0,116,3154@TOP@human_GAPDH_TAA_len41_fa20_ta0_fm14_tm6,c
3154@TOP@human_GAPDH_TAA_len41_fa20_ta0_fm14_tm6*117*a,1865,0,2,0,1867,0.001,117,3154@TOP@human_GAPDH_TAA_len41_fa20_ta0_fm14_tm6,a
3154@TOP@human_GAPDH_TAA_len41_fa20_ta0_fm14_tm6*118*a,1840,1,25,0,1866,0.013,118,3154@TOP@human_GAPDH_TAA_len41_fa20_ta0_fm14_tm6,a
3154@TOP@human_GAPDH_TAA_len41_fa20_ta0_fm14_tm6*119*g,0,1,1853,0,1854,0.999,119,3154@TOP@human_GAPDH_TAA_len41_fa20_ta0_fm14_tm6,g
3154@TOP@human_GAPDH_TAA_len41_fa20_ta0_fm14_tm6*120*g,0,0,1848,0,1848,1.0,120,3154@TOP@human_GAPDH_TAA_len41_fa20_ta0_fm14_tm6,g
3154@TOP@human_GAPDH_TAA_len41_fa20_ta0_fm14_tm6*121*a,1861,0,0,0,1861,0.0,121,3154@TOP@human_GAPDH_TAA_len41_fa20_ta0_fm14_tm6,a
3154@TOP@human_GAPDH_TAA_len41_fa20_ta0_fm14_tm6*122*g,0,0,1867,0,1867,1.0,122,3154@TOP@human_GAPDH_TAA_len41_fa20_ta0_fm14_tm6,g
3154@TOP@human_GAPDH_TAA_len41_fa20_ta0_fm14_tm6*123*t,1,0,1,1839,1841,0.001,123,3154@TOP@human_GAPDH_TAA_len41_fa20_ta0_fm14_tm6,t
3154@TOP@human_GAPDH_TAA_len41_fa20_ta0_fm14_tm6*124*a,1764,0,72,0,1836,0.039,124,3154@TOP@human_GAPDH_TAA_len41_fa20_ta0_fm14_tm6,a
3154@TOP@human_GAPDH_TAA_len41_fa20_ta0_fm14_tm6*125*a,1797,0,37,0,1834,0.02,125,3154@TOP@human_GAPDH_TAA_len41_fa20_ta0_fm14_tm6,a
3154@TOP@human_GAPDH_TAA_len41_fa20_ta0_fm14_tm6*126*g,0,0,1835,0,1835,1.0,126,3154@TOP@human_GAPDH_TAA_len41_fa20_ta0_fm14_tm6,g
3154@TOP@human_GAPDH_TAA_len41_fa20_ta0_fm14_tm6*127*a,1861,0,0,0,1861,0.0,127,3154@TOP@human_GAPDH_TAA_len41_fa20_ta0_fm14_tm6,a
3154@TOP@human_GAPDH_TAA_len41_fa20_ta0_fm14_tm6*128*c,0,1879,0,0,1879,0.0,128,3154@TOP@human_GAPDH_TAA_len41_fa20_ta0_fm14_tm6,c
3154@TOP@human_GAPDH_TAA_len41_fa20_ta0_fm14_tm6*129*c,0,1865,0,0,1865,0.0,129,3154@TOP@human_GAPDH_TAA_len41_fa20_ta0_fm14_tm6,c
3154@TOP@human_GAPDH_TAA_len41_fa20_ta0_fm14_tm6*130*c,0,1873,0,0,1873,0.0,130,3154@TOP@human_GAPDH_TAA_len41_fa20_ta0_fm14_tm6,c
3154@TOP@human_GAPDH_TAA_len41_fa20_ta0_fm14_tm6*131*c,0,1879,0,0,1879,0.0,131,3154@TOP@human_GAPDH_TAA_len41_fa20_ta0_fm14_tm6,c
3154@TOP@human_GAPDH_TAA_len41_fa20_ta0_fm14_tm6*132*t,0,0,0,1848,1848,0.0,132,3154@TOP@human_GAPDH_TAA_len41_fa20_ta0_fm14_tm6,t
3154@TOP@human_GAPDH_TAA_len41_fa20_ta0_fm14_tm6*133*g,1,1,1821,0,1823,0.999,133,3154@TOP@human_GAPDH_TAA_len41_fa20_ta0_fm14_tm6,g
3154@TOP@human_GAPDH_TAA_len41_fa20_ta0_fm14_tm6*134*g,0,0,1839,0,1839,1.0,134,3154@TOP@human_GAPDH_TAA_len41_fa20_ta0_fm14_tm6,g
3155@TOP@human_GAPDH_TAA_len41_fa20_ta0_fm14_tm6*114*t,2,0,0,2049,2051,0.0,114,3155@TOP@human_GAPDH_TAA_len41_fa20_ta0_fm14_tm6,t
3155@TOP@human_GAPDH_TAA_len41_fa20_ta0_fm14_tm6*115*c,2,2067,0,0,2069,0.0,115,3155@TOP@human_GAPDH_TAA_len41_fa20_ta0_fm14_tm6,c
3155@TOP@human_GAPDH_TAA_len41_fa20_ta0_fm14_tm6*116*c,0,2060,0,0,2060,0.0,116,3155@TOP@human_GAPDH_TAA_len41_fa20_ta0_fm14_tm6,c
3155@TOP@human_GAPDH_TAA_len41_fa20_ta0_fm14_tm6*117*a,2052,0,9,0,2061,0.004,117,3155@TOP@human_GAPDH_TAA_len41_fa20_ta0_fm14_tm6,a
3155@TOP@human_GAPDH_TAA_len41_fa20_ta0_fm14_tm6*118*a,2015,0,37,0,2052,0.018,118,3155@TOP@human_GAPDH_TAA_len41_fa20_ta0_fm14_tm6,a
3155@TOP@human_GAPDH_TAA_len41_fa20_ta0_fm14_tm6*119*g,1,0,2038,0,2039,1.0,119,3155@TOP@human_GAPDH_TAA_len41_fa20_ta0_fm14_tm6,g
3155@TOP@human_GAPDH_TAA_len41_fa20_ta0_fm14_tm6*120*g,0,0,2038,0,2038,1.0,120,3155@TOP@human_GAPDH_TAA_len41_fa20_ta0_fm14_tm6,g
3155@TOP@human_GAPDH_TAA_len41_fa20_ta0_fm14_tm6*121*a,2062,0,0,0,2062,0.0,121,3155@TOP@human_GAPDH_TAA_len41_fa20_ta0_fm14_tm6,a
3155@TOP@human_GAPDH_TAA_len41_fa20_ta0_fm14_tm6*122*g,0,0,2065,0,2065,1.0,122,3155@TOP@human_GAPDH_TAA_len41_fa20_ta0_fm14_tm6,g
3155@TOP@human_GAPDH_TAA_len41_fa20_ta0_fm14_tm6*123*t,0,0,1,2038,2039,0.0,123,3155@TOP@human_GAPDH_TAA_len41_fa20_ta0_fm14_tm6,t
3155@TOP@human_GAPDH_TAA_len41_fa20_ta0_fm14_tm6*124*a,1924,0,104,0,2028,0.051,124,3155@TOP@human_GAPDH_TAA_len41_fa20_ta0_fm14_tm6,a
3155@TOP@human_GAPDH_TAA_len41_fa20_ta0_fm14_tm6*125*a,1983,0,42,0,2025,0.021,125,3155@TOP@human_GAPDH_TAA_len41_fa20_ta0_fm14_tm6,a
3155@TOP@human_GAPDH_TAA_len41_fa20_ta0_fm14_tm6*126*g,1,0,2026,0,2027,1.0,126,3155@TOP@human_GAPDH_TAA_len41_fa20_ta0_fm14_tm6,g
3155@TOP@human_GAPDH_TAA_len41_fa20_ta0_fm14_tm6*127*a,2056,1,0,0,2057,0.0,127,3155@TOP@human_GAPDH_TAA_len41_fa20_ta0_fm14_tm6,a
3155@TOP@human_GAPDH_TAA_len41_fa20_ta0_fm14_tm6*128*c,0,2063,0,0,2063,0.0,128,3155@TOP@human_GAPDH_TAA_len41_fa20_ta0_fm14_tm6,c
3155@TOP@human_GAPDH_TAA_len41_fa20_ta0_fm14_tm6*129*c,0,2048,0,0,2048,0.0,129,3155@TOP@human_GAPDH_TAA_len41_fa20_ta0_fm14_tm6,c
3155@TOP@human_GAPDH_TAA_len41_fa20_ta0_fm14_tm6*130*c,0,2062,0,0,2062,0.0,130,3155@TOP@human_GAPDH_TAA_len41_fa20_ta0_fm14_tm6,c
3155@TOP@human_GAPDH_TAA_len41_fa20_ta0_fm14_tm6*131*c,0,2065,0,0,2065,0.0,131,3155@TOP@human_GAPDH_TAA_len41_fa20_ta0_fm14_tm6,c
3155@TOP@human_GAPDH_TAA_len41_fa20_ta0_fm14_tm6*132*t,1,0,0,2036,2037,0.0,132,3155@TOP@human_GAPDH_TAA_len41_fa20_ta0_fm14_tm6,t
3155@TOP@human_GAPDH_TAA_len41_fa20_ta0_fm14_tm6*133*g,0,0,2032,0,2032,1.0,133,3155@TOP@human_GAPDH_TAA_len41_fa20_ta0_fm14_tm6,g
3155@TOP@human_GAPDH_TAA_len41_fa20_ta0_fm14_tm6*134*g,0,0,2042,0,2042,1.0,134,3155@TOP@human_GAPDH_TAA_len41_fa20_ta0_fm14_tm6,g
3156@TOP@human_GAPDH_TAA_len41_fa20_ta0_fm14_tm6*114*t,0,2,0,3102,3104,0.0,114,3156@TOP@human_GAPDH_TAA_len41_fa20_ta0_fm14_tm6,t
3156@TOP@human_GAPDH_TAA_len41_fa20_ta0_fm14_tm6*115*c,1,3130,0,0,3131,0.0,115,3156@TOP@human_GAPDH_TAA_len41_fa20_ta0_fm14_tm6,c
3156@TOP@human_GAPDH_TAA_len41_fa20_ta0_fm14_tm6*116*c,0,3109,0,0,3109,0.0,116,3156@TOP@human_GAPDH_TAA_len41_fa20_ta0_fm14_tm6,c
3156@TOP@human_GAPDH_TAA_len41_fa20_ta0_fm14_tm6*117*a,3120,0,2,0,3122,0.001,117,3156@TOP@human_GAPDH_TAA_len41_fa20_ta0_fm14_tm6,a
3156@TOP@human_GAPDH_TAA_len41_fa20_ta0_fm14_tm6*118*a,3053,0,39,0,3092,0.013,118,3156@TOP@human_GAPDH_TAA_len41_fa20_ta0_fm14_tm6,a
3156@TOP@human_GAPDH_TAA_len41_fa20_ta0_fm14_tm6*119*g,0,0,3077,0,3077,1.0,119,3156@TOP@human_GAPDH_TAA_len41_fa20_ta0_fm14_tm6,g
3156@TOP@human_GAPDH_TAA_len41_fa20_ta0_fm14_tm6*120*g,0,1,3071,0,3072,1.0,120,3156@TOP@human_GAPDH_TAA_len41_fa20_ta0_fm14_tm6,g
3156@TOP@human_GAPDH_TAA_len41_fa20_ta0_fm14_tm6*121*a,3111,0,0,0,3111,0.0,121,3156@TOP@human_GAPDH_TAA_len41_fa20_ta0_fm14_tm6,a
3156@TOP@human_GAPDH_TAA_len41_fa20_ta0_fm14_tm6*122*g,0,0,3119,0,3119,1.0,122,3156@TOP@human_GAPDH_TAA_len41_fa20_ta0_fm14_tm6,g
3156@TOP@human_GAPDH_TAA_len41_fa20_ta0_fm14_tm6*123*t,0,0,0,3056,3056,0.0,123,3156@TOP@human_GAPDH_TAA_len41_fa20_ta0_fm14_tm6,t
3156@TOP@human_GAPDH_TAA_len41_fa20_ta0_fm14_tm6*124*a,2920,0,143,0,3063,0.047,124,3156@TOP@human_GAPDH_TAA_len41_fa20_ta0_fm14_tm6,a
3156@TOP@human_GAPDH_TAA_len41_fa20_ta0_fm14_tm6*125*a,2981,0,73,0,3054,0.024,125,3156@TOP@human_GAPDH_TAA_len41_fa20_ta0_fm14_tm6,a
3156@TOP@human_GAPDH_TAA_len41_fa20_ta0_fm14_tm6*126*g,0,0,3065,0,3065,1.0,126,3156@TOP@human_GAPDH_TAA_len41_fa20_ta0_fm14_tm6,g
3156@TOP@human_GAPDH_TAA_len41_fa20_ta0_fm14_tm6*127*a,3112,0,2,0,3114,0.001,127,3156@TOP@human_GAPDH_TAA_len41_fa20_ta0_fm14_tm6,a
3156@TOP@human_GAPDH_TAA_len41_fa20_ta0_fm14_tm6*128*c,0,3126,0,0,3126,0.0,128,3156@TOP@human_GAPDH_TAA_len41_fa20_ta0_fm14_tm6,c
3156@TOP@human_GAPDH_TAA_len41_fa20_ta0_fm14_tm6*129*c,0,3090,0,0,3090,0.0,129,3156@TOP@human_GAPDH_TAA_len41_fa20_ta0_fm14_tm6,c
3156@TOP@human_GAPDH_TAA_len41_fa20_ta0_fm14_tm6*130*c,0,3111,0,0,3111,0.0,130,3156@TOP@human_GAPDH_TAA_len41_fa20_ta0_fm14_tm6,c
3156@TOP@human_GAPDH_TAA_len41_fa20_ta0_fm14_tm6*131*c,0,3126,0,0,3126,0.0,131,3156@TOP@human_GAPDH_TAA_len41_fa20_ta0_fm14_tm6,c
3156@TOP@human_GAPDH_TAA_len41_fa20_ta0_fm14_tm6*132*t,0,0,0,3068,3068,0.0,132,3156@TOP@human_GAPDH_TAA_len41_fa20_ta0_fm14_tm6,t
3156@TOP@human_GAPDH_TAA_len41_fa20_ta0_fm14_tm6*133*g,2,0,3058,2,3062,0.999,133,3156@TOP@human_GAPDH_TAA_len41_fa20_ta0_fm14_tm6,g
3156@TOP@human_GAPDH_TAA_len41_fa20_ta0_fm14_tm6*134*g,0,0,3079,0,3079,1.0,134,3156@TOP@human_GAPDH_TAA_len41_fa20_ta0_fm14_tm6,g
3157@TOP@human_GAPDH_TAA_len41_fa20_ta0_fm14_tm6*114*t,1,0,0,12574,12575,0.0,114,3157@TOP@human_GAPDH_TAA_len41_fa20_ta0_fm14_tm6,t
3157@TOP@human_GAPDH_TAA_len41_fa20_ta0_fm14_tm6*115*c,1,12618,0,2,12621,0.0,115,3157@TOP@human_GAPDH_TAA_len41_fa20_ta0_fm14_tm6,c
3157@TOP@human_GAPDH_TAA_len41_fa20_ta0_fm14_tm6*116*c,0,12575,0,4,12579,0.0,116,3157@TOP@human_GAPDH_TAA_len41_fa20_ta0_fm14_tm6,c
3157@TOP@human_GAPDH_TAA_len41_fa20_ta0_fm14_tm6*117*a,12554,0,24,1,12579,0.002,117,3157@TOP@human_GAPDH_TAA_len41_fa20_ta0_fm14_tm6,a
3157@TOP@human_GAPDH_TAA_len41_fa20_ta0_fm14_tm6*118*a,12273,1,222,0,12496,0.018,118,3157@TOP@human_GAPDH_TAA_len41_fa20_ta0_fm14_tm6,a
3157@TOP@human_GAPDH_TAA_len41_fa20_ta0_fm14_tm6*119*g,1,0,12472,0,12473,1.0,119,3157@TOP@human_GAPDH_TAA_len41_fa20_ta0_fm14_tm6,g
3157@TOP@human_GAPDH_TAA_len41_fa20_ta0_fm14_tm6*120*g,0,0,12423,0,12423,1.0,120,3157@TOP@human_GAPDH_TAA_len41_fa20_ta0_fm14_tm6,g
3157@TOP@human_GAPDH_TAA_len41_fa20_ta0_fm14_tm6*121*a,12544,0,7,0,12551,0.001,121,3157@TOP@human_GAPDH_TAA_len41_fa20_ta0_fm14_tm6,a
3157@TOP@human_GAPDH_TAA_len41_fa20_ta0_fm14_tm6*122*g,0,0,12571,0,12571,1.0,122,3157@TOP@human_GAPDH_TAA_len41_fa20_ta0_fm14_tm6,g
3157@TOP@human_GAPDH_TAA_len41_fa20_ta0_fm14_tm6*123*t,2,0,0,12447,12449,0.0,123,3157@TOP@human_GAPDH_TAA_len41_fa20_ta0_fm14_tm6,t
3157@TOP@human_GAPDH_TAA_len41_fa20_ta0_fm14_tm6*124*a,11540,1,823,0,12364,0.067,124,3157@TOP@human_GAPDH_TAA_len41_fa20_ta0_fm14_tm6,a
3157@TOP@human_GAPDH_TAA_len41_fa20_ta0_fm14_tm6*125*a,12126,0,223,0,12349,0.018,125,3157@TOP@human_GAPDH_TAA_len41_fa20_ta0_fm14_tm6,a
3157@TOP@human_GAPDH_TAA_len41_fa20_ta0_fm14_tm6*126*g,1,0,12390,2,12393,1.0,126,3157@TOP@human_GAPDH_TAA_len41_fa20_ta0_fm14_tm6,g
3157@TOP@human_GAPDH_TAA_len41_fa20_ta0_fm14_tm6*127*a,12531,0,8,0,12539,0.001,127,3157@TOP@human_GAPDH_TAA_len41_fa20_ta0_fm14_tm6,a
3157@TOP@human_GAPDH_TAA_len41_fa20_ta0_fm14_tm6*128*c,0,12601,1,1,12603,0.0,128,3157@TOP@human_GAPDH_TAA_len41_fa20_ta0_fm14_tm6,c
3157@TOP@human_GAPDH_TAA_len41_fa20_ta0_fm14_tm6*129*c,2,12524,0,0,12526,0.0,129,3157@TOP@human_GAPDH_TAA_len41_fa20_ta0_fm14_tm6,c
3157@TOP@human_GAPDH_TAA_len41_fa20_ta0_fm14_tm6*130*c,1,12572,0,0,12573,0.0,130,3157@TOP@human_GAPDH_TAA_len41_fa20_ta0_fm14_tm6,c
3157@TOP@human_GAPDH_TAA_len41_fa20_ta0_fm14_tm6*131*c,0,12601,0,1,12602,0.0,131,3157@TOP@human_GAPDH_TAA_len41_fa20_ta0_fm14_tm6,c
3157@TOP@human_GAPDH_TAA_len41_fa20_ta0_fm14_tm6*132*t,1,4,2,12420,12427,0.0,132,3157@TOP@human_GAPDH_TAA_len41_fa20_ta0_fm14_tm6,t
3157@TOP@human_GAPDH_TAA_len41_fa20_ta0_fm14_tm6*133*g,0,1,12413,2,12416,1.0,133,3157@TOP@human_GAPDH_TAA_len41_fa20_ta0_fm14_tm6,g
3157@TOP@human_GAPDH_TAA_len41_fa20_ta0_fm14_tm6*134*g,1,3,12489,0,12493,1.0,134,3157@TOP@human_GAPDH_TAA_len41_fa20_ta0_fm14_tm6,g
3158@TOP@human_GAPDH_TAA_len41_fa20_ta0_fm14_tm6*114*t,0,0,0,1558,1558,0.0,114,3158@TOP@human_GAPDH_TAA_len41_fa20_ta0_fm14_tm6,t
3158@TOP@human_GAPDH_TAA_len41_fa20_ta0_fm14_tm6*115*c,0,1575,0,0,1575,0.0,115,3158@TOP@human_GAPDH_TAA_len41_fa20_ta0_fm14_tm6,c
3158@TOP@human_GAPDH_TAA_len41_fa20_ta0_fm14_tm6*116*c,0,1562,0,0,1562,0.0,116,3158@TOP@human_GAPDH_TAA_len41_fa20_ta0_fm14_tm6,c
3158@TOP@human_GAPDH_TAA_len41_fa20_ta0_fm14_tm6*117*a,1564,0,0,0,1564,0.0,117,3158@TOP@human_GAPDH_TAA_len41_fa20_ta0_fm14_tm6,a
3158@TOP@human_GAPDH_TAA_len41_fa20_ta0_fm14_tm6*118*a,1532,0,25,1,1558,0.016,118,3158@TOP@human_GAPDH_TAA_len41_fa20_ta0_fm14_tm6,a
3158@TOP@human_GAPDH_TAA_len41_fa20_ta0_fm14_tm6*119*g,0,0,1544,4,1548,0.997,119,3158@TOP@human_GAPDH_TAA_len41_fa20_ta0_fm14_tm6,g
3158@TOP@human_GAPDH_TAA_len41_fa20_ta0_fm14_tm6*120*g,0,0,1545,0,1545,1.0,120,3158@TOP@human_GAPDH_TAA_len41_fa20_ta0_fm14_tm6,g
3158@TOP@human_GAPDH_TAA_len41_fa20_ta0_fm14_tm6*121*a,1558,0,1,0,1559,0.001,121,3158@TOP@human_GAPDH_TAA_len41_fa20_ta0_fm14_tm6,a
3158@TOP@human_GAPDH_TAA_len41_fa20_ta0_fm14_tm6*122*g,0,0,1562,0,1562,1.0,122,3158@TOP@human_GAPDH_TAA_len41_fa20_ta0_fm14_tm6,g
3158@TOP@human_GAPDH_TAA_len41_fa20_ta0_fm14_tm6*123*t,0,0,0,1528,1528,0.0,123,3158@TOP@human_GAPDH_TAA_len41_fa20_ta0_fm14_tm6,t
3158@TOP@human_GAPDH_TAA_len41_fa20_ta0_fm14_tm6*124*a,1417,0,120,0,1537,0.078,124,3158@TOP@human_GAPDH_TAA_len41_fa20_ta0_fm14_tm6,a
3158@TOP@human_GAPDH_TAA_len41_fa20_ta0_fm14_tm6*125*a,1480,0,62,0,1542,0.04,125,3158@TOP@human_GAPDH_TAA_len41_fa20_ta0_fm14_tm6,a
3158@TOP@human_GAPDH_TAA_len41_fa20_ta0_fm14_tm6*126*g,0,0,1542,0,1542,1.0,126,3158@TOP@human_GAPDH_TAA_len41_fa20_ta0_fm14_tm6,g
3158@TOP@human_GAPDH_TAA_len41_fa20_ta0_fm14_tm6*127*a,1553,2,3,0,1558,0.002,127,3158@TOP@human_GAPDH_TAA_len41_fa20_ta0_fm14_tm6,a
3158@TOP@human_GAPDH_TAA_len41_fa20_ta0_fm14_tm6*128*c,0,1573,0,0,1573,0.0,128,3158@TOP@human_GAPDH_TAA_len41_fa20_ta0_fm14_tm6,c
3158@TOP@human_GAPDH_TAA_len41_fa20_ta0_fm14_tm6*129*c,0,1559,0,0,1559,0.0,129,3158@TOP@human_GAPDH_TAA_len41_fa20_ta0_fm14_tm6,c
3158@TOP@human_GAPDH_TAA_len41_fa20_ta0_fm14_tm6*130*c,0,1562,0,0,1562,0.0,130,3158@TOP@human_GAPDH_TAA_len41_fa20_ta0_fm14_tm6,c
3158@TOP@human_GAPDH_TAA_len41_fa20_ta0_fm14_tm6*131*c,0,1570,0,0,1570,0.0,131,3158@TOP@human_GAPDH_TAA_len41_fa20_ta0_fm14_tm6,c
3158@TOP@human_GAPDH_TAA_len41_fa20_ta0_fm14_tm6*132*t,0,0,0,1546,1546,0.0,132,3158@TOP@human_GAPDH_TAA_len41_fa20_ta0_fm14_tm6,t
3158@TOP@human_GAPDH_TAA_len41_fa20_ta0_fm14_tm6*133*g,0,0,1541,0,1541,1.0,133,3158@TOP@human_GAPDH_TAA_len41_fa20_ta0_fm14_tm6,g
3158@TOP@human_GAPDH_TAA_len41_fa20_ta0_fm14_tm6*134*g,0,0,1547,0,1547,1.0,134,3158@TOP@human_GAPDH_TAA_len41_fa20_ta0_fm14_tm6,g
3159@TOP@human_GAPDH_TAA_len41_fa20_ta0_fm14_tm6*114*t,1,2,0,3317,3320,0.0,114,3159@TOP@human_GAPDH_TAA_len41_fa20_ta0_fm14_tm6,t
3159@TOP@human_GAPDH_TAA_len41_fa20_ta0_fm14_tm6*115*c,1,3333,0,0,3334,0.0,115,3159@TOP@human_GAPDH_TAA_len41_fa20_ta0_fm14_tm6,c
3159@TOP@human_GAPDH_TAA_len41_fa20_ta0_fm14_tm6*116*c,0,3317,0,0,3317,0.0,116,3159@TOP@human_GAPDH_TAA_len41_fa20_ta0_fm14_tm6,c
3159@TOP@human_GAPDH_TAA_len41_fa20_ta0_fm14_tm6*117*a,3315,1,4,0,3320,0.001,117,3159@TOP@human_GAPDH_TAA_len41_fa20_ta0_fm14_tm6,a
3159@TOP@human_GAPDH_TAA_len41_fa20_ta0_fm14_tm6*118*a,3246,0,65,0,3311,0.02,118,3159@TOP@human_GAPDH_TAA_len41_fa20_ta0_fm14_tm6,a
3159@TOP@human_GAPDH_TAA_len41_fa20_ta0_fm14_tm6*119*g,0,0,3295,0,3295,1.0,119,3159@TOP@human_GAPDH_TAA_len41_fa20_ta0_fm14_tm6,g
3159@TOP@human_GAPDH_TAA_len41_fa20_ta0_fm14_tm6*120*g,1,0,3289,0,3290,1.0,120,3159@TOP@human_GAPDH_TAA_len41_fa20_ta0_fm14_tm6,g
3159@TOP@human_GAPDH_TAA_len41_fa20_ta0_fm14_tm6*121*a,3317,0,1,0,3318,0.0,121,3159@TOP@human_GAPDH_TAA_len41_fa20_ta0_fm14_tm6,a
3159@TOP@human_GAPDH_TAA_len41_fa20_ta0_fm14_tm6*122*g,0,0,3324,0,3324,1.0,122,3159@TOP@human_GAPDH_TAA_len41_fa20_ta0_fm14_tm6,g
3159@TOP@human_GAPDH_TAA_len41_fa20_ta0_fm14_tm6*123*t,3,0,0,3276,3279,0.0,123,3159@TOP@human_GAPDH_TAA_len41_fa20_ta0_fm14_tm6,t
3159@TOP@human_GAPDH_TAA_len41_fa20_ta0_fm14_tm6*124*a,2978,0,279,0,3257,0.086,124,3159@TOP@human_GAPDH_TAA_len41_fa20_ta0_fm14_tm6,a
3159@TOP@human_GAPDH_TAA_len41_fa20_ta0_fm14_tm6*125*a,3125,0,128,0,3253,0.039,125,3159@TOP@human_GAPDH_TAA_len41_fa20_ta0_fm14_tm6,a
3159@TOP@human_GAPDH_TAA_len41_fa20_ta0_fm14_tm6*126*g,0,0,3275,0,3275,1.0,126,3159@TOP@human_GAPDH_TAA_len41_fa20_ta0_fm14_tm6,g
3159@TOP@human_GAPDH_TAA_len41_fa20_ta0_fm14_tm6*127*a,3297,0,12,0,3309,0.004,127,3159@TOP@human_GAPDH_TAA_len41_fa20_ta0_fm14_tm6,a
3159@TOP@human_GAPDH_TAA_len41_fa20_ta0_fm14_tm6*128*c,0,3324,0,1,3325,0.0,128,3159@TOP@human_GAPDH_TAA_len41_fa20_ta0_fm14_tm6,c
3159@TOP@human_GAPDH_TAA_len41_fa20_ta0_fm14_tm6*129*c,0,3313,0,0,3313,0.0,129,3159@TOP@human_GAPDH_TAA_len41_fa20_ta0_fm14_tm6,c
3159@TOP@human_GAPDH_TAA_len41_fa20_ta0_fm14_tm6*130*c,0,3328,0,0,3328,0.0,130,3159@TOP@human_GAPDH_TAA_len41_fa20_ta0_fm14_tm6,c
3159@TOP@human_GAPDH_TAA_len41_fa20_ta0_fm14_tm6*131*c,0,3327,0,0,3327,0.0,131,3159@TOP@human_GAPDH_TAA_len41_fa20_ta0_fm14_tm6,c
3159@TOP@human_GAPDH_TAA_len41_fa20_ta0_fm14_tm6*132*t,0,1,1,3280,3282,0.0,132,3159@TOP@human_GAPDH_TAA_len41_fa20_ta0_fm14_tm6,t
3159@TOP@human_GAPDH_TAA_len41_fa20_ta0_fm14_tm6*133*g,0,0,3277,0,3277,1.0,133,3159@TOP@human_GAPDH_TAA_len41_fa20_ta0_fm14_tm6,g
3159@TOP@human_GAPDH_TAA_len41_fa20_ta0_fm14_tm6*134*g,0,0,3294,1,3295,1.0,134,3159@TOP@human_GAPDH_TAA_len41_fa20_ta0_fm14_tm6,g
3160@TOP@human_GAPDH_TAA_len41_fa20_ta0_fm14_tm6*114*t,0,2,0,15529,15531,0.0,114,3160@TOP@human_GAPDH_TAA_len41_fa20_ta0_fm14_tm6,t
3160@TOP@human_GAPDH_TAA_len41_fa20_ta0_fm14_tm6*115*c,1,15609,0,1,15611,0.0,115,3160@TOP@human_GAPDH_TAA_len41_fa20_ta0_fm14_tm6,c
3160@TOP@human_GAPDH_TAA_len41_fa20_ta0_fm14_tm6*116*c,0,15551,0,0,15551,0.0,116,3160@TOP@human_GAPDH_TAA_len41_fa20_ta0_fm14_tm6,c
3160@TOP@human_GAPDH_TAA_len41_fa20_ta0_fm14_tm6*117*a,15532,0,15,0,15547,0.001,117,3160@TOP@human_GAPDH_TAA_len41_fa20_ta0_fm14_tm6,a
3160@TOP@human_GAPDH_TAA_len41_fa20_ta0_fm14_tm6*118*a,15275,0,182,0,15457,0.012,118,3160@TOP@human_GAPDH_TAA_len41_fa20_ta0_fm14_tm6,a
3160@TOP@human_GAPDH_TAA_len41_fa20_ta0_fm14_tm6*119*g,0,0,15427,0,15427,1.0,119,3160@TOP@human_GAPDH_TAA_len41_fa20_ta0_fm14_tm6,g
3160@TOP@human_GAPDH_TAA_len41_fa20_ta0_fm14_tm6*120*g,2,0,15369,0,15371,1.0,120,3160@TOP@human_GAPDH_TAA_len41_fa20_ta0_fm14_tm6,g
3160@TOP@human_GAPDH_TAA_len41_fa20_ta0_fm14_tm6*121*a,15519,0,7,1,15527,0.0,121,3160@TOP@human_GAPDH_TAA_len41_fa20_ta0_fm14_tm6,a
3160@TOP@human_GAPDH_TAA_len41_fa20_ta0_fm14_tm6*122*g,0,0,15554,2,15556,1.0,122,3160@TOP@human_GAPDH_TAA_len41_fa20_ta0_fm14_tm6,g
3160@TOP@human_GAPDH_TAA_len41_fa20_ta0_fm14_tm6*123*t,3,0,1,15362,15366,0.0,123,3160@TOP@human_GAPDH_TAA_len41_fa20_ta0_fm14_tm6,t
3160@TOP@human_GAPDH_TAA_len41_fa20_ta0_fm14_tm6*124*a,14803,0,494,0,15297,0.032,124,3160@TOP@human_GAPDH_TAA_len41_fa20_ta0_fm14_tm6,a
3160@TOP@human_GAPDH_TAA_len41_fa20_ta0_fm14_tm6*125*a,14929,2,338,0,15269,0.022,125,3160@TOP@human_GAPDH_TAA_len41_fa20_ta0_fm14_tm6,a
3160@TOP@human_GAPDH_TAA_len41_fa20_ta0_fm14_tm6*126*g,0,0,15356,1,15357,1.0,126,3160@TOP@human_GAPDH_TAA_len41_fa20_ta0_fm14_tm6,g
3160@TOP@human_GAPDH_TAA_len41_fa20_ta0_fm14_tm6*127*a,15476,2,3,0,15481,0.0,127,3160@TOP@human_GAPDH_TAA_len41_fa20_ta0_fm14_tm6,a
3160@TOP@human_GAPDH_TAA_len41_fa20_ta0_fm14_tm6*128*c,0,15574,2,1,15577,0.0,128,3160@TOP@human_GAPDH_TAA_len41_fa20_ta0_fm14_tm6,c
3160@TOP@human_GAPDH_TAA_len41_fa20_ta0_fm14_tm6*129*c,0,15450,0,3,15453,0.0,129,3160@TOP@human_GAPDH_TAA_len41_fa20_ta0_fm14_tm6,c
3160@TOP@human_GAPDH_TAA_len41_fa20_ta0_fm14_tm6*130*c,1,15539,0,0,15540,0.0,130,3160@TOP@human_GAPDH_TAA_len41_fa20_ta0_fm14_tm6,c
3160@TOP@human_GAPDH_TAA_len41_fa20_ta0_fm14_tm6*131*c,0,15583,0,1,15584,0.0,131,3160@TOP@human_GAPDH_TAA_len41_fa20_ta0_fm14_tm6,c
3160@TOP@human_GAPDH_TAA_len41_fa20_ta0_fm14_tm6*132*t,0,4,3,15362,15369,0.0,132,3160@TOP@human_GAPDH_TAA_len41_fa20_ta0_fm14_tm6,t
3160@TOP@human_GAPDH_TAA_len41_fa20_ta0_fm14_tm6*133*g,0,0,15332,1,15333,1.0,133,3160@TOP@human_GAPDH_TAA_len41_fa20_ta0_fm14_tm6,g
3160@TOP@human_GAPDH_TAA_len41_fa20_ta0_fm14_tm6*134*g,0,4,15406,0,15410,1.0,134,3160@TOP@human_GAPDH_TAA_len41_fa20_ta0_fm14_tm6,g
3161@TOP@human_GAPDH_TAA_len41_fa20_ta0_fm14_tm6*114*t,3,4,0,15551,15558,0.0,114,3161@TOP@human_GAPDH_TAA_len41_fa20_ta0_fm14_tm6,t
3161@TOP@human_GAPDH_TAA_len41_fa20_ta0_fm14_tm6*115*c,0,15654,0,0,15654,0.0,115,3161@TOP@human_GAPDH_TAA_len41_fa20_ta0_fm14_tm6,c
3161@TOP@human_GAPDH_TAA_len41_fa20_ta0_fm14_tm6*116*c,1,15591,0,1,15593,0.0,116,3161@TOP@human_GAPDH_TAA_len41_fa20_ta0_fm14_tm6,c
3161@TOP@human_GAPDH_TAA_len41_fa20_ta0_fm14_tm6*117*a,15563,0,18,0,15581,0.001,117,3161@TOP@human_GAPDH_TAA_len41_fa20_ta0_fm14_tm6,a
3161@TOP@human_GAPDH_TAA_len41_fa20_ta0_fm14_tm6*118*a,15329,0,166,3,15498,0.011,118,3161@TOP@human_GAPDH_TAA_len41_fa20_ta0_fm14_tm6,a
3161@TOP@human_GAPDH_TAA_len41_fa20_ta0_fm14_tm6*119*g,0,0,15471,1,15472,1.0,119,3161@TOP@human_GAPDH_TAA_len41_fa20_ta0_fm14_tm6,g
3161@TOP@human_GAPDH_TAA_len41_fa20_ta0_fm14_tm6*120*g,6,0,15389,0,15395,1.0,120,3161@TOP@human_GAPDH_TAA_len41_fa20_ta0_fm14_tm6,g
3161@TOP@human_GAPDH_TAA_len41_fa20_ta0_fm14_tm6*121*a,15557,0,8,0,15565,0.001,121,3161@TOP@human_GAPDH_TAA_len41_fa20_ta0_fm14_tm6,a
3161@TOP@human_GAPDH_TAA_len41_fa20_ta0_fm14_tm6*122*g,1,0,15586,1,15588,1.0,122,3161@TOP@human_GAPDH_TAA_len41_fa20_ta0_fm14_tm6,g
3161@TOP@human_GAPDH_TAA_len41_fa20_ta0_fm14_tm6*123*t,0,2,1,15378,15381,0.0,123,3161@TOP@human_GAPDH_TAA_len41_fa20_ta0_fm14_tm6,t
3161@TOP@human_GAPDH_TAA_len41_fa20_ta0_fm14_tm6*124*a,14156,1,1197,0,15354,0.078,124,3161@TOP@human_GAPDH_TAA_len41_fa20_ta0_fm14_tm6,a
3161@TOP@human_GAPDH_TAA_len41_fa20_ta0_fm14_tm6*125*a,15024,0,278,0,15302,0.018,125,3161@TOP@human_GAPDH_TAA_len41_fa20_ta0_fm14_tm6,a
3161@TOP@human_GAPDH_TAA_len41_fa20_ta0_fm14_tm6*126*g,0,0,15375,1,15376,1.0,126,3161@TOP@human_GAPDH_TAA_len41_fa20_ta0_fm14_tm6,g
3161@TOP@human_GAPDH_TAA_len41_fa20_ta0_fm14_tm6*127*a,15526,1,3,1,15531,0.0,127,3161@TOP@human_GAPDH_TAA_len41_fa20_ta0_fm14_tm6,a
3161@TOP@human_GAPDH_TAA_len41_fa20_ta0_fm14_tm6*128*c,1,15612,0,0,15613,0.0,128,3161@TOP@human_GAPDH_TAA_len41_fa20_ta0_fm14_tm6,c
3161@TOP@human_GAPDH_TAA_len41_fa20_ta0_fm14_tm6*129*c,0,15507,0,0,15507,0.0,129,3161@TOP@human_GAPDH_TAA_len41_fa20_ta0_fm14_tm6,c
3161@TOP@human_GAPDH_TAA_len41_fa20_ta0_fm14_tm6*130*c,0,15590,0,0,15590,0.0,130,3161@TOP@human_GAPDH_TAA_len41_fa20_ta0_fm14_tm6,c
3161@TOP@human_GAPDH_TAA_len41_fa20_ta0_fm14_tm6*131*c,1,15624,0,0,15625,0.0,131,3161@TOP@human_GAPDH_TAA_len41_fa20_ta0_fm14_tm6,c
3161@TOP@human_GAPDH_TAA_len41_fa20_ta0_fm14_tm6*132*t,2,1,0,15412,15415,0.0,132,3161@TOP@human_GAPDH_TAA_len41_fa20_ta0_fm14_tm6,t
3161@TOP@human_GAPDH_TAA_len41_fa20_ta0_fm14_tm6*133*g,1,0,15413,0,15414,1.0,133,3161@TOP@human_GAPDH_TAA_len41_fa20_ta0_fm14_tm6,g
3161@TOP@human_GAPDH_TAA_len41_fa20_ta0_fm14_tm6*134*g,0,3,15440,1,15444,1.0,134,3161@TOP@human_GAPDH_TAA_len41_fa20_ta0_fm14_tm6,g
3162@TOP@human_GAPDH_TAA_len41_fa20_ta0_fm14_tm6*114*t,3,0,0,16749,16752,0.0,114,3162@TOP@human_GAPDH_TAA_len41_fa20_ta0_fm14_tm6,t
3162@TOP@human_GAPDH_TAA_len41_fa20_ta0_fm14_tm6*115*c,1,16830,0,1,16832,0.0,115,3162@TOP@human_GAPDH_TAA_len41_fa20_ta0_fm14_tm6,c
3162@TOP@human_GAPDH_TAA_len41_fa20_ta0_fm14_tm6*116*c,0,16778,0,0,16778,0.0,116,3162@TOP@human_GAPDH_TAA_len41_fa20_ta0_fm14_tm6,c
3162@TOP@human_GAPDH_TAA_len41_fa20_ta0_fm14_tm6*117*a,16715,0,35,0,16750,0.002,117,3162@TOP@human_GAPDH_TAA_len41_fa20_ta0_fm14_tm6,a
3162@TOP@human_GAPDH_TAA_len41_fa20_ta0_fm14_tm6*118*a,16472,1,197,1,16671,0.012,118,3162@TOP@human_GAPDH_TAA_len41_fa20_ta0_fm14_tm6,a
3162@TOP@human_GAPDH_TAA_len41_fa20_ta0_fm14_tm6*119*g,0,0,16637,0,16637,1.0,119,3162@TOP@human_GAPDH_TAA_len41_fa20_ta0_fm14_tm6,g
3162@TOP@human_GAPDH_TAA_len41_fa20_ta0_fm14_tm6*120*g,0,1,16535,0,16536,1.0,120,3162@TOP@human_GAPDH_TAA_len41_fa20_ta0_fm14_tm6,g
3162@TOP@human_GAPDH_TAA_len41_fa20_ta0_fm14_tm6*121*a,16753,0,3,0,16756,0.0,121,3162@TOP@human_GAPDH_TAA_len41_fa20_ta0_fm14_tm6,a
3162@TOP@human_GAPDH_TAA_len41_fa20_ta0_fm14_tm6*122*g,0,0,16756,1,16757,1.0,122,3162@TOP@human_GAPDH_TAA_len41_fa20_ta0_fm14_tm6,g
3162@TOP@human_GAPDH_TAA_len41_fa20_ta0_fm14_tm6*123*t,2,1,1,16545,16549,0.0,123,3162@TOP@human_GAPDH_TAA_len41_fa20_ta0_fm14_tm6,t
3162@TOP@human_GAPDH_TAA_len41_fa20_ta0_fm14_tm6*124*a,15927,0,570,0,16497,0.035,124,3162@TOP@human_GAPDH_TAA_len41_fa20_ta0_fm14_tm6,a
3162@TOP@human_GAPDH_TAA_len41_fa20_ta0_fm14_tm6*125*a,16166,0,295,0,16461,0.018,125,3162@TOP@human_GAPDH_TAA_len41_fa20_ta0_fm14_tm6,a
3162@TOP@human_GAPDH_TAA_len41_fa20_ta0_fm14_tm6*126*g,0,0,16538,0,16538,1.0,126,3162@TOP@human_GAPDH_TAA_len41_fa20_ta0_fm14_tm6,g
3162@TOP@human_GAPDH_TAA_len41_fa20_ta0_fm14_tm6*127*a,16696,0,5,0,16701,0.0,127,3162@TOP@human_GAPDH_TAA_len41_fa20_ta0_fm14_tm6,a
3162@TOP@human_GAPDH_TAA_len41_fa20_ta0_fm14_tm6*128*c,0,16796,1,1,16798,0.0,128,3162@TOP@human_GAPDH_TAA_len41_fa20_ta0_fm14_tm6,c
3162@TOP@human_GAPDH_TAA_len41_fa20_ta0_fm14_tm6*129*c,0,16689,0,5,16694,0.0,129,3162@TOP@human_GAPDH_TAA_len41_fa20_ta0_fm14_tm6,c
3162@TOP@human_GAPDH_TAA_len41_fa20_ta0_fm14_tm6*130*c,2,16760,0,1,16763,0.0,130,3162@TOP@human_GAPDH_TAA_len41_fa20_ta0_fm14_tm6,c
3162@TOP@human_GAPDH_TAA_len41_fa20_ta0_fm14_tm6*131*c,2,16807,0,2,16811,0.0,131,3162@TOP@human_GAPDH_TAA_len41_fa20_ta0_fm14_tm6,c
3162@TOP@human_GAPDH_TAA_len41_fa20_ta0_fm14_tm6*132*t,4,0,1,16569,16574,0.0,132,3162@TOP@human_GAPDH_TAA_len41_fa20_ta0_fm14_tm6,t
3162@TOP@human_GAPDH_TAA_len41_fa20_ta0_fm14_tm6*133*g,0,0,16554,0,16554,1.0,133,3162@TOP@human_GAPDH_TAA_len41_fa20_ta0_fm14_tm6,g
3162@TOP@human_GAPDH_TAA_len41_fa20_ta0_fm14_tm6*134*g,0,1,16630,1,16632,1.0,134,3162@TOP@human_GAPDH_TAA_len41_fa20_ta0_fm14_tm6,g
3163@TOP@human_GAPDH_TAA_len41_fa20_ta0_fm14_tm6*114*t,0,1,1,2985,2987,0.0,114,3163@TOP@human_GAPDH_TAA_len41_fa20_ta0_fm14_tm6,t
3163@TOP@human_GAPDH_TAA_len41_fa20_ta0_fm14_tm6*115*c,0,2998,0,0,2998,0.0,115,3163@TOP@human_GAPDH_TAA_len41_fa20_ta0_fm14_tm6,c
3163@TOP@human_GAPDH_TAA_len41_fa20_ta0_fm14_tm6*116*c,0,2985,0,0,2985,0.0,116,3163@TOP@human_GAPDH_TAA_len41_fa20_ta0_fm14_tm6,c
3163@TOP@human_GAPDH_TAA_len41_fa20_ta0_fm14_tm6*117*a,2984,0,7,0,2991,0.002,117,3163@TOP@human_GAPDH_TAA_len41_fa20_ta0_fm14_tm6,a
3163@TOP@human_GAPDH_TAA_len41_fa20_ta0_fm14_tm6*118*a,2900,0,69,0,2969,0.023,118,3163@TOP@human_GAPDH_TAA_len41_fa20_ta0_fm14_tm6,a
3163@TOP@human_GAPDH_TAA_len41_fa20_ta0_fm14_tm6*119*g,0,0,2958,0,2958,1.0,119,3163@TOP@human_GAPDH_TAA_len41_fa20_ta0_fm14_tm6,g
3163@TOP@human_GAPDH_TAA_len41_fa20_ta0_fm14_tm6*120*g,0,0,2956,0,2956,1.0,120,3163@TOP@human_GAPDH_TAA_len41_fa20_ta0_fm14_tm6,g
3163@TOP@human_GAPDH_TAA_len41_fa20_ta0_fm14_tm6*121*a,2982,0,1,0,2983,0.0,121,3163@TOP@human_GAPDH_TAA_len41_fa20_ta0_fm14_tm6,a
3163@TOP@human_GAPDH_TAA_len41_fa20_ta0_fm14_tm6*122*g,1,0,2987,0,2988,1.0,122,3163@TOP@human_GAPDH_TAA_len41_fa20_ta0_fm14_tm6,g
3163@TOP@human_GAPDH_TAA_len41_fa20_ta0_fm14_tm6*123*t,0,0,0,2947,2947,0.0,123,3163@TOP@human_GAPDH_TAA_len41_fa20_ta0_fm14_tm6,t
3163@TOP@human_GAPDH_TAA_len41_fa20_ta0_fm14_tm6*124*a,2783,0,160,0,2943,0.054,124,3163@TOP@human_GAPDH_TAA_len41_fa20_ta0_fm14_tm6,a
3163@TOP@human_GAPDH_TAA_len41_fa20_ta0_fm14_tm6*125*a,2817,0,111,0,2928,0.038,125,3163@TOP@human_GAPDH_TAA_len41_fa20_ta0_fm14_tm6,a
3163@TOP@human_GAPDH_TAA_len41_fa20_ta0_fm14_tm6*126*g,0,0,2937,0,2937,1.0,126,3163@TOP@human_GAPDH_TAA_len41_fa20_ta0_fm14_tm6,g
3163@TOP@human_GAPDH_TAA_len41_fa20_ta0_fm14_tm6*127*a,2976,0,3,0,2979,0.001,127,3163@TOP@human_GAPDH_TAA_len41_fa20_ta0_fm14_tm6,a
3163@TOP@human_GAPDH_TAA_len41_fa20_ta0_fm14_tm6*128*c,0,2993,2,0,2995,0.001,128,3163@TOP@human_GAPDH_TAA_len41_fa20_ta0_fm14_tm6,c
3163@TOP@human_GAPDH_TAA_len41_fa20_ta0_fm14_tm6*129*c,0,2975,0,0,2975,0.0,129,3163@TOP@human_GAPDH_TAA_len41_fa20_ta0_fm14_tm6,c
3163@TOP@human_GAPDH_TAA_len41_fa20_ta0_fm14_tm6*130*c,0,2988,0,0,2988,0.0,130,3163@TOP@human_GAPDH_TAA_len41_fa20_ta0_fm14_tm6,c
3163@TOP@human_GAPDH_TAA_len41_fa20_ta0_fm14_tm6*131*c,0,2997,0,0,2997,0.0,131,3163@TOP@human_GAPDH_TAA_len41_fa20_ta0_fm14_tm6,c
3163@TOP@human_GAPDH_TAA_len41_fa20_ta0_fm14_tm6*132*t,0,0,0,2956,2956,0.0,132,3163@TOP@human_GAPDH_TAA_len41_fa20_ta0_fm14_tm6,t
3163@TOP@human_GAPDH_TAA_len41_fa20_ta0_fm14_tm6*133*g,0,0,2953,0,2953,1.0,133,3163@TOP@human_GAPDH_TAA_len41_fa20_ta0_fm14_tm6,g
3163@TOP@human_GAPDH_TAA_len41_fa20_ta0_fm14_tm6*134*g,3,7,2945,0,2955,0.997,134,3163@TOP@human_GAPDH_TAA_len41_fa20_ta0_fm14_tm6,g
3164@TOP@human_GAPDH_TAA_len41_fa20_ta0_fm14_tm6*114*t,0,1,0,5284,5285,0.0,114,3164@TOP@human_GAPDH_TAA_len41_fa20_ta0_fm14_tm6,t
3164@TOP@human_GAPDH_TAA_len41_fa20_ta0_fm14_tm6*115*c,0,5311,0,0,5311,0.0,115,3164@TOP@human_GAPDH_TAA_len41_fa20_ta0_fm14_tm6,c
3164@TOP@human_GAPDH_TAA_len41_fa20_ta0_fm14_tm6*116*c,2,5289,0,0,5291,0.0,116,3164@TOP@human_GAPDH_TAA_len41_fa20_ta0_fm14_tm6,c
3164@TOP@human_GAPDH_TAA_len41_fa20_ta0_fm14_tm6*117*a,5270,0,12,1,5283,0.002,117,3164@TOP@human_GAPDH_TAA_len41_fa20_ta0_fm14_tm6,a
3164@TOP@human_GAPDH_TAA_len41_fa20_ta0_fm14_tm6*118*a,5168,0,77,1,5246,0.015,118,3164@TOP@human_GAPDH_TAA_len41_fa20_ta0_fm14_tm6,a
3164@TOP@human_GAPDH_TAA_len41_fa20_ta0_fm14_tm6*119*g,0,0,5246,0,5246,1.0,119,3164@TOP@human_GAPDH_TAA_len41_fa20_ta0_fm14_tm6,g
3164@TOP@human_GAPDH_TAA_len41_fa20_ta0_fm14_tm6*120*g,0,0,5237,0,5237,1.0,120,3164@TOP@human_GAPDH_TAA_len41_fa20_ta0_fm14_tm6,g
3164@TOP@human_GAPDH_TAA_len41_fa20_ta0_fm14_tm6*121*a,5273,0,4,0,5277,0.001,121,3164@TOP@human_GAPDH_TAA_len41_fa20_ta0_fm14_tm6,a
3164@TOP@human_GAPDH_TAA_len41_fa20_ta0_fm14_tm6*122*g,0,0,5294,0,5294,1.0,122,3164@TOP@human_GAPDH_TAA_len41_fa20_ta0_fm14_tm6,g
3164@TOP@human_GAPDH_TAA_len41_fa20_ta0_fm14_tm6*123*t,0,1,0,5211,5212,0.0,123,3164@TOP@human_GAPDH_TAA_len41_fa20_ta0_fm14_tm6,t
3164@TOP@human_GAPDH_TAA_len41_fa20_ta0_fm14_tm6*124*a,4878,0,307,0,5185,0.059,124,3164@TOP@human_GAPDH_TAA_len41_fa20_ta0_fm14_tm6,a
3164@TOP@human_GAPDH_TAA_len41_fa20_ta0_fm14_tm6*125*a,5060,1,112,1,5174,0.022,125,3164@TOP@human_GAPDH_TAA_len41_fa20_ta0_fm14_tm6,a
3164@TOP@human_GAPDH_TAA_len41_fa20_ta0_fm14_tm6*126*g,1,0,5229,0,5230,1.0,126,3164@TOP@human_GAPDH_TAA_len41_fa20_ta0_fm14_tm6,g
3164@TOP@human_GAPDH_TAA_len41_fa20_ta0_fm14_tm6*127*a,5264,2,9,0,5275,0.002,127,3164@TOP@human_GAPDH_TAA_len41_fa20_ta0_fm14_tm6,a
3164@TOP@human_GAPDH_TAA_len41_fa20_ta0_fm14_tm6*128*c,0,5302,0,0,5302,0.0,128,3164@TOP@human_GAPDH_TAA_len41_fa20_ta0_fm14_tm6,c
3164@TOP@human_GAPDH_TAA_len41_fa20_ta0_fm14_tm6*129*c,0,5269,0,0,5269,0.0,129,3164@TOP@human_GAPDH_TAA_len41_fa20_ta0_fm14_tm6,c
3164@TOP@human_GAPDH_TAA_len41_fa20_ta0_fm14_tm6*130*c,0,5289,0,0,5289,0.0,130,3164@TOP@human_GAPDH_TAA_len41_fa20_ta0_fm14_tm6,c
3164@TOP@human_GAPDH_TAA_len41_fa20_ta0_fm14_tm6*131*c,0,5300,0,0,5300,0.0,131,3164@TOP@human_GAPDH_TAA_len41_fa20_ta0_fm14_tm6,c
3164@TOP@human_GAPDH_TAA_len41_fa20_ta0_fm14_tm6*132*t,0,2,0,5228,5230,0.0,132,3164@TOP@human_GAPDH_TAA_len41_fa20_ta0_fm14_tm6,t
3164@TOP@human_GAPDH_TAA_len41_fa20_ta0_fm14_tm6*133*g,1,1,5218,0,5220,1.0,133,3164@TOP@human_GAPDH_TAA_len41_fa20_ta0_fm14_tm6,g
3164@TOP@human_GAPDH_TAA_len41_fa20_ta0_fm14_tm6*134*g,1,3,5255,0,5259,0.999,134,3164@TOP@human_GAPDH_TAA_len41_fa20_ta0_fm14_tm6,g
3165@TOP@human_GAPDH_TAA_len41_fa20_ta0_fm14_tm6*114*t,0,7,0,24444,24451,0.0,114,3165@TOP@human_GAPDH_TAA_len41_fa20_ta0_fm14_tm6,t
3165@TOP@human_GAPDH_TAA_len41_fa20_ta0_fm14_tm6*115*c,0,24601,0,0,24601,0.0,115,3165@TOP@human_GAPDH_TAA_len41_fa20_ta0_fm14_tm6,c
3165@TOP@human_GAPDH_TAA_len41_fa20_ta0_fm14_tm6*116*c,0,24511,0,0,24511,0.0,116,3165@TOP@human_GAPDH_TAA_len41_fa20_ta0_fm14_tm6,c
3165@TOP@human_GAPDH_TAA_len41_fa20_ta0_fm14_tm6*117*a,24448,0,36,0,24484,0.001,117,3165@TOP@human_GAPDH_TAA_len41_fa20_ta0_fm14_tm6,a
3165@TOP@human_GAPDH_TAA_len41_fa20_ta0_fm14_tm6*118*a,23956,2,394,0,24352,0.016,118,3165@TOP@human_GAPDH_TAA_len41_fa20_ta0_fm14_tm6,a
3165@TOP@human_GAPDH_TAA_len41_fa20_ta0_fm14_tm6*119*g,2,0,24286,2,24290,1.0,119,3165@TOP@human_GAPDH_TAA_len41_fa20_ta0_fm14_tm6,g
3165@TOP@human_GAPDH_TAA_len41_fa20_ta0_fm14_tm6*120*g,1,0,24239,1,24241,1.0,120,3165@TOP@human_GAPDH_TAA_len41_fa20_ta0_fm14_tm6,g
3165@TOP@human_GAPDH_TAA_len41_fa20_ta0_fm14_tm6*121*a,24456,0,7,1,24464,0.0,121,3165@TOP@human_GAPDH_TAA_len41_fa20_ta0_fm14_tm6,a
3165@TOP@human_GAPDH_TAA_len41_fa20_ta0_fm14_tm6*122*g,0,0,24506,0,24506,1.0,122,3165@TOP@human_GAPDH_TAA_len41_fa20_ta0_fm14_tm6,g
3165@TOP@human_GAPDH_TAA_len41_fa20_ta0_fm14_tm6*123*t,5,0,0,24140,24145,0.0,123,3165@TOP@human_GAPDH_TAA_len41_fa20_ta0_fm14_tm6,t
3165@TOP@human_GAPDH_TAA_len41_fa20_ta0_fm14_tm6*124*a,22679,0,1423,0,24102,0.059,124,3165@TOP@human_GAPDH_TAA_len41_fa20_ta0_fm14_tm6,a
3165@TOP@human_GAPDH_TAA_len41_fa20_ta0_fm14_tm6*125*a,23604,3,460,1,24068,0.019,125,3165@TOP@human_GAPDH_TAA_len41_fa20_ta0_fm14_tm6,a
3165@TOP@human_GAPDH_TAA_len41_fa20_ta0_fm14_tm6*126*g,2,0,24216,0,24218,1.0,126,3165@TOP@human_GAPDH_TAA_len41_fa20_ta0_fm14_tm6,g
3165@TOP@human_GAPDH_TAA_len41_fa20_ta0_fm14_tm6*127*a,24398,2,13,0,24413,0.001,127,3165@TOP@human_GAPDH_TAA_len41_fa20_ta0_fm14_tm6,a
3165@TOP@human_GAPDH_TAA_len41_fa20_ta0_fm14_tm6*128*c,0,24532,2,1,24535,0.0,128,3165@TOP@human_GAPDH_TAA_len41_fa20_ta0_fm14_tm6,c
3165@TOP@human_GAPDH_TAA_len41_fa20_ta0_fm14_tm6*129*c,2,24360,0,0,24362,0.0,129,3165@TOP@human_GAPDH_TAA_len41_fa20_ta0_fm14_tm6,c
3165@TOP@human_GAPDH_TAA_len41_fa20_ta0_fm14_tm6*130*c,6,24478,0,3,24487,0.0,130,3165@TOP@human_GAPDH_TAA_len41_fa20_ta0_fm14_tm6,c
3165@TOP@human_GAPDH_TAA_len41_fa20_ta0_fm14_tm6*131*c,2,24548,0,1,24551,0.0,131,3165@TOP@human_GAPDH_TAA_len41_fa20_ta0_fm14_tm6,c
3165@TOP@human_GAPDH_TAA_len41_fa20_ta0_fm14_tm6*132*t,4,4,1,24204,24213,0.0,132,3165@TOP@human_GAPDH_TAA_len41_fa20_ta0_fm14_tm6,t
3165@TOP@human_GAPDH_TAA_len41_fa20_ta0_fm14_tm6*133*g,0,0,24181,0,24181,1.0,133,3165@TOP@human_GAPDH_TAA_len41_fa20_ta0_fm14_tm6,g
3165@TOP@human_GAPDH_TAA_len41_fa20_ta0_fm14_tm6*134*g,0,2,24265,0,24267,1.0,134,3165@TOP@human_GAPDH_TAA_len41_fa20_ta0_fm14_tm6,g
3166@TOP@human_GAPDH_TAA_len41_fa20_ta0_fm14_tm6*114*t,0,7,0,15285,15292,0.0,114,3166@TOP@human_GAPDH_TAA_len41_fa20_ta0_fm14_tm6,t
3166@TOP@human_GAPDH_TAA_len41_fa20_ta0_fm14_tm6*115*c,2,15378,1,3,15384,0.0,115,3166@TOP@human_GAPDH_TAA_len41_fa20_ta0_fm14_tm6,c
3166@TOP@human_GAPDH_TAA_len41_fa20_ta0_fm14_tm6*116*c,1,15303,0,0,15304,0.0,116,3166@TOP@human_GAPDH_TAA_len41_fa20_ta0_fm14_tm6,c
3166@TOP@human_GAPDH_TAA_len41_fa20_ta0_fm14_tm6*117*a,15279,1,38,0,15318,0.002,117,3166@TOP@human_GAPDH_TAA_len41_fa20_ta0_fm14_tm6,a
3166@TOP@human_GAPDH_TAA_len41_fa20_ta0_fm14_tm6*118*a,15044,0,179,0,15223,0.012,118,3166@TOP@human_GAPDH_TAA_len41_fa20_ta0_fm14_tm6,a
3166@TOP@human_GAPDH_TAA_len41_fa20_ta0_fm14_tm6*119*g,1,0,15216,0,15217,1.0,119,3166@TOP@human_GAPDH_TAA_len41_fa20_ta0_fm14_tm6,g
3166@TOP@human_GAPDH_TAA_len41_fa20_ta0_fm14_tm6*120*g,2,0,15150,2,15154,1.0,120,3166@TOP@human_GAPDH_TAA_len41_fa20_ta0_fm14_tm6,g
3166@TOP@human_GAPDH_TAA_len41_fa20_ta0_fm14_tm6*121*a,15292,0,1,0,15293,0.0,121,3166@TOP@human_GAPDH_TAA_len41_fa20_ta0_fm14_tm6,a
3166@TOP@human_GAPDH_TAA_len41_fa20_ta0_fm14_tm6*122*g,3,0,15330,0,15333,1.0,122,3166@TOP@human_GAPDH_TAA_len41_fa20_ta0_fm14_tm6,g
3166@TOP@human_GAPDH_TAA_len41_fa20_ta0_fm14_tm6*123*t,0,6,0,15091,15097,0.0,123,3166@TOP@human_GAPDH_TAA_len41_fa20_ta0_fm14_tm6,t
3166@TOP@human_GAPDH_TAA_len41_fa20_ta0_fm14_tm6*124*a,14604,0,476,0,15080,0.032,124,3166@TOP@human_GAPDH_TAA_len41_fa20_ta0_fm14_tm6,a
3166@TOP@human_GAPDH_TAA_len41_fa20_ta0_fm14_tm6*125*a,14637,4,404,4,15049,0.027,125,3166@TOP@human_GAPDH_TAA_len41_fa20_ta0_fm14_tm6,a
3166@TOP@human_GAPDH_TAA_len41_fa20_ta0_fm14_tm6*126*g,0,0,15113,0,15113,1.0,126,3166@TOP@human_GAPDH_TAA_len41_fa20_ta0_fm14_tm6,g
3166@TOP@human_GAPDH_TAA_len41_fa20_ta0_fm14_tm6*127*a,15256,1,8,0,15265,0.001,127,3166@TOP@human_GAPDH_TAA_len41_fa20_ta0_fm14_tm6,a
3166@TOP@human_GAPDH_TAA_len41_fa20_ta0_fm14_tm6*128*c,0,15353,0,0,15353,0.0,128,3166@TOP@human_GAPDH_TAA_len41_fa20_ta0_fm14_tm6,c
3166@TOP@human_GAPDH_TAA_len41_fa20_ta0_fm14_tm6*129*c,1,15219,0,0,15220,0.0,129,3166@TOP@human_GAPDH_TAA_len41_fa20_ta0_fm14_tm6,c
3166@TOP@human_GAPDH_TAA_len41_fa20_ta0_fm14_tm6*130*c,0,15307,0,0,15307,0.0,130,3166@TOP@human_GAPDH_TAA_len41_fa20_ta0_fm14_tm6,c
3166@TOP@human_GAPDH_TAA_len41_fa20_ta0_fm14_tm6*131*c,2,15358,0,0,15360,0.0,131,3166@TOP@human_GAPDH_TAA_len41_fa20_ta0_fm14_tm6,c
3166@TOP@human_GAPDH_TAA_len41_fa20_ta0_fm14_tm6*132*t,4,5,5,15127,15141,0.0,132,3166@TOP@human_GAPDH_TAA_len41_fa20_ta0_fm14_tm6,t
3166@TOP@human_GAPDH_TAA_len41_fa20_ta0_fm14_tm6*133*g,2,1,15090,0,15093,1.0,133,3166@TOP@human_GAPDH_TAA_len41_fa20_ta0_fm14_tm6,g
3166@TOP@human_GAPDH_TAA_len41_fa20_ta0_fm14_tm6*134*g,0,3,15152,2,15157,1.0,134,3166@TOP@human_GAPDH_TAA_len41_fa20_ta0_fm14_tm6,g
3167@TOP@human_GAPDH_TAA_len41_fa20_ta0_fm14_tm6*114*t,1,5,0,18746,18752,0.0,114,3167@TOP@human_GAPDH_TAA_len41_fa20_ta0_fm14_tm6,t
3167@TOP@human_GAPDH_TAA_len41_fa20_ta0_fm14_tm6*115*c,2,18842,1,0,18845,0.0,115,3167@TOP@human_GAPDH_TAA_len41_fa20_ta0_fm14_tm6,c
3167@TOP@human_GAPDH_TAA_len41_fa20_ta0_fm14_tm6*116*c,1,18782,0,3,18786,0.0,116,3167@TOP@human_GAPDH_TAA_len41_fa20_ta0_fm14_tm6,c
3167@TOP@human_GAPDH_TAA_len41_fa20_ta0_fm14_tm6*117*a,18749,0,14,0,18763,0.001,117,3167@TOP@human_GAPDH_TAA_len41_fa20_ta0_fm14_tm6,a
3167@TOP@human_GAPDH_TAA_len41_fa20_ta0_fm14_tm6*118*a,18476,0,158,1,18635,0.008,118,3167@TOP@human_GAPDH_TAA_len41_fa20_ta0_fm14_tm6,a
3167@TOP@human_GAPDH_TAA_len41_fa20_ta0_fm14_tm6*119*g,1,0,18634,0,18635,1.0,119,3167@TOP@human_GAPDH_TAA_len41_fa20_ta0_fm14_tm6,g
3167@TOP@human_GAPDH_TAA_len41_fa20_ta0_fm14_tm6*120*g,3,1,18503,3,18510,1.0,120,3167@TOP@human_GAPDH_TAA_len41_fa20_ta0_fm14_tm6,g
3167@TOP@human_GAPDH_TAA_len41_fa20_ta0_fm14_tm6*121*a,18752,0,2,0,18754,0.0,121,3167@TOP@human_GAPDH_TAA_len41_fa20_ta0_fm14_tm6,a
3167@TOP@human_GAPDH_TAA_len41_fa20_ta0_fm14_tm6*122*g,1,0,18749,0,18750,1.0,122,3167@TOP@human_GAPDH_TAA_len41_fa20_ta0_fm14_tm6,g
3167@TOP@human_GAPDH_TAA_len41_fa20_ta0_fm14_tm6*123*t,3,4,1,18503,18511,0.0,123,3167@TOP@human_GAPDH_TAA_len41_fa20_ta0_fm14_tm6,t
3167@TOP@human_GAPDH_TAA_len41_fa20_ta0_fm14_tm6*124*a,17388,0,1048,2,18438,0.057,124,3167@TOP@human_GAPDH_TAA_len41_fa20_ta0_fm14_tm6,a
3167@TOP@human_GAPDH_TAA_len41_fa20_ta0_fm14_tm6*125*a,18126,0,304,0,18430,0.016,125,3167@TOP@human_GAPDH_TAA_len41_fa20_ta0_fm14_tm6,a
3167@TOP@human_GAPDH_TAA_len41_fa20_ta0_fm14_tm6*126*g,2,0,18499,3,18504,1.0,126,3167@TOP@human_GAPDH_TAA_len41_fa20_ta0_fm14_tm6,g
3167@TOP@human_GAPDH_TAA_len41_fa20_ta0_fm14_tm6*127*a,18721,0,4,0,18725,0.0,127,3167@TOP@human_GAPDH_TAA_len41_fa20_ta0_fm14_tm6,a
3167@TOP@human_GAPDH_TAA_len41_fa20_ta0_fm14_tm6*128*c,1,18787,2,3,18793,0.0,128,3167@TOP@human_GAPDH_TAA_len41_fa20_ta0_fm14_tm6,c
3167@TOP@human_GAPDH_TAA_len41_fa20_ta0_fm14_tm6*129*c,2,18670,1,0,18673,0.0,129,3167@TOP@human_GAPDH_TAA_len41_fa20_ta0_fm14_tm6,c
3167@TOP@human_GAPDH_TAA_len41_fa20_ta0_fm14_tm6*130*c,3,18746,0,0,18749,0.0,130,3167@TOP@human_GAPDH_TAA_len41_fa20_ta0_fm14_tm6,c
3167@TOP@human_GAPDH_TAA_len41_fa20_ta0_fm14_tm6*131*c,2,18800,0,1,18803,0.0,131,3167@TOP@human_GAPDH_TAA_len41_fa20_ta0_fm14_tm6,c
3167@TOP@human_GAPDH_TAA_len41_fa20_ta0_fm14_tm6*132*t,3,5,1,18565,18574,0.0,132,3167@TOP@human_GAPDH_TAA_len41_fa20_ta0_fm14_tm6,t
3167@TOP@human_GAPDH_TAA_len41_fa20_ta0_fm14_tm6*133*g,3,1,18480,1,18485,1.0,133,3167@TOP@human_GAPDH_TAA_len41_fa20_ta0_fm14_tm6,g
3167@TOP@human_GAPDH_TAA_len41_fa20_ta0_fm14_tm6*134*g,0,4,18562,0,18566,1.0,134,3167@TOP@human_GAPDH_TAA_len41_fa20_ta0_fm14_tm6,g
3168@TOP@human_GAPDH_TAA_len41_fa20_ta0_fm14_tm6*114*t,0,0,0,3512,3512,0.0,114,3168@TOP@human_GAPDH_TAA_len41_fa20_ta0_fm14_tm6,t
3168@TOP@human_GAPDH_TAA_len41_fa20_ta0_fm14_tm6*115*c,0,3543,0,0,3543,0.0,115,3168@TOP@human_GAPDH_TAA_len41_fa20_ta0_fm14_tm6,c
3168@TOP@human_GAPDH_TAA_len41_fa20_ta0_fm14_tm6*116*c,0,3531,0,0,3531,0.0,116,3168@TOP@human_GAPDH_TAA_len41_fa20_ta0_fm14_tm6,c
3168@TOP@human_GAPDH_TAA_len41_fa20_ta0_fm14_tm6*117*a,3518,0,6,0,3524,0.002,117,3168@TOP@human_GAPDH_TAA_len41_fa20_ta0_fm14_tm6,a
3168@TOP@human_GAPDH_TAA_len41_fa20_ta0_fm14_tm6*118*a,3468,0,42,0,3510,0.012,118,3168@TOP@human_GAPDH_TAA_len41_fa20_ta0_fm14_tm6,a
3168@TOP@human_GAPDH_TAA_len41_fa20_ta0_fm14_tm6*119*g,0,0,3494,3,3497,0.999,119,3168@TOP@human_GAPDH_TAA_len41_fa20_ta0_fm14_tm6,g
3168@TOP@human_GAPDH_TAA_len41_fa20_ta0_fm14_tm6*120*g,0,0,3484,1,3485,1.0,120,3168@TOP@human_GAPDH_TAA_len41_fa20_ta0_fm14_tm6,g
3168@TOP@human_GAPDH_TAA_len41_fa20_ta0_fm14_tm6*121*a,3530,0,0,0,3530,0.0,121,3168@TOP@human_GAPDH_TAA_len41_fa20_ta0_fm14_tm6,a
3168@TOP@human_GAPDH_TAA_len41_fa20_ta0_fm14_tm6*122*g,0,0,3515,0,3515,1.0,122,3168@TOP@human_GAPDH_TAA_len41_fa20_ta0_fm14_tm6,g
3168@TOP@human_GAPDH_TAA_len41_fa20_ta0_fm14_tm6*123*t,0,1,0,3480,3481,0.0,123,3168@TOP@human_GAPDH_TAA_len41_fa20_ta0_fm14_tm6,t
3168@TOP@human_GAPDH_TAA_len41_fa20_ta0_fm14_tm6*124*a,3217,0,250,0,3467,0.072,124,3168@TOP@human_GAPDH_TAA_len41_fa20_ta0_fm14_tm6,a
3168@TOP@human_GAPDH_TAA_len41_fa20_ta0_fm14_tm6*125*a,3331,0,142,0,3473,0.041,125,3168@TOP@human_GAPDH_TAA_len41_fa20_ta0_fm14_tm6,a
3168@TOP@human_GAPDH_TAA_len41_fa20_ta0_fm14_tm6*126*g,0,0,3465,0,3465,1.0,126,3168@TOP@human_GAPDH_TAA_len41_fa20_ta0_fm14_tm6,g
3168@TOP@human_GAPDH_TAA_len41_fa20_ta0_fm14_tm6*127*a,3513,0,5,0,3518,0.001,127,3168@TOP@human_GAPDH_TAA_len41_fa20_ta0_fm14_tm6,a
3168@TOP@human_GAPDH_TAA_len41_fa20_ta0_fm14_tm6*128*c,0,3531,2,1,3534,0.001,128,3168@TOP@human_GAPDH_TAA_len41_fa20_ta0_fm14_tm6,c
3168@TOP@human_GAPDH_TAA_len41_fa20_ta0_fm14_tm6*129*c,0,3499,0,0,3499,0.0,129,3168@TOP@human_GAPDH_TAA_len41_fa20_ta0_fm14_tm6,c
3168@TOP@human_GAPDH_TAA_len41_fa20_ta0_fm14_tm6*130*c,0,3529,0,0,3529,0.0,130,3168@TOP@human_GAPDH_TAA_len41_fa20_ta0_fm14_tm6,c
3168@TOP@human_GAPDH_TAA_len41_fa20_ta0_fm14_tm6*131*c,0,3532,0,4,3536,0.0,131,3168@TOP@human_GAPDH_TAA_len41_fa20_ta0_fm14_tm6,c
3168@TOP@human_GAPDH_TAA_len41_fa20_ta0_fm14_tm6*132*t,0,0,0,3493,3493,0.0,132,3168@TOP@human_GAPDH_TAA_len41_fa20_ta0_fm14_tm6,t
3168@TOP@human_GAPDH_TAA_len41_fa20_ta0_fm14_tm6*133*g,0,0,3485,0,3485,1.0,133,3168@TOP@human_GAPDH_TAA_len41_fa20_ta0_fm14_tm6,g
3168@TOP@human_GAPDH_TAA_len41_fa20_ta0_fm14_tm6*134*g,1,1,3485,1,3488,0.999,134,3168@TOP@human_GAPDH_TAA_len41_fa20_ta0_fm14_tm6,g
3169@TOP@human_GAPDH_TAA_len41_fa20_ta0_fm14_tm6*114*t,0,1,0,3157,3158,0.0,114,3169@TOP@human_GAPDH_TAA_len41_fa20_ta0_fm14_tm6,t
3169@TOP@human_GAPDH_TAA_len41_fa20_ta0_fm14_tm6*115*c,0,3183,0,0,3183,0.0,115,3169@TOP@human_GAPDH_TAA_len41_fa20_ta0_fm14_tm6,c
3169@TOP@human_GAPDH_TAA_len41_fa20_ta0_fm14_tm6*116*c,0,3175,0,0,3175,0.0,116,3169@TOP@human_GAPDH_TAA_len41_fa20_ta0_fm14_tm6,c
3169@TOP@human_GAPDH_TAA_len41_fa20_ta0_fm14_tm6*117*a,3170,0,0,0,3170,0.0,117,3169@TOP@human_GAPDH_TAA_len41_fa20_ta0_fm14_tm6,a
3169@TOP@human_GAPDH_TAA_len41_fa20_ta0_fm14_tm6*118*a,3115,0,39,0,3154,0.012,118,3169@TOP@human_GAPDH_TAA_len41_fa20_ta0_fm14_tm6,a
3169@TOP@human_GAPDH_TAA_len41_fa20_ta0_fm14_tm6*119*g,0,0,3141,1,3142,1.0,119,3169@TOP@human_GAPDH_TAA_len41_fa20_ta0_fm14_tm6,g
3169@TOP@human_GAPDH_TAA_len41_fa20_ta0_fm14_tm6*120*g,0,0,3130,0,3130,1.0,120,3169@TOP@human_GAPDH_TAA_len41_fa20_ta0_fm14_tm6,g
3169@TOP@human_GAPDH_TAA_len41_fa20_ta0_fm14_tm6*121*a,3168,0,0,0,3168,0.0,121,3169@TOP@human_GAPDH_TAA_len41_fa20_ta0_fm14_tm6,a
3169@TOP@human_GAPDH_TAA_len41_fa20_ta0_fm14_tm6*122*g,0,0,3169,0,3169,1.0,122,3169@TOP@human_GAPDH_TAA_len41_fa20_ta0_fm14_tm6,g
3169@TOP@human_GAPDH_TAA_len41_fa20_ta0_fm14_tm6*123*t,0,1,0,3136,3137,0.0,123,3169@TOP@human_GAPDH_TAA_len41_fa20_ta0_fm14_tm6,t
3169@TOP@human_GAPDH_TAA_len41_fa20_ta0_fm14_tm6*124*a,2851,0,248,1,3100,0.08,124,3169@TOP@human_GAPDH_TAA_len41_fa20_ta0_fm14_tm6,a
3169@TOP@human_GAPDH_TAA_len41_fa20_ta0_fm14_tm6*125*a,3040,0,76,0,3116,0.024,125,3169@TOP@human_GAPDH_TAA_len41_fa20_ta0_fm14_tm6,a
3169@TOP@human_GAPDH_TAA_len41_fa20_ta0_fm14_tm6*126*g,0,0,3125,1,3126,1.0,126,3169@TOP@human_GAPDH_TAA_len41_fa20_ta0_fm14_tm6,g
3169@TOP@human_GAPDH_TAA_len41_fa20_ta0_fm14_tm6*127*a,3158,0,0,0,3158,0.0,127,3169@TOP@human_GAPDH_TAA_len41_fa20_ta0_fm14_tm6,a
3169@TOP@human_GAPDH_TAA_len41_fa20_ta0_fm14_tm6*128*c,0,3174,1,0,3175,0.0,128,3169@TOP@human_GAPDH_TAA_len41_fa20_ta0_fm14_tm6,c
3169@TOP@human_GAPDH_TAA_len41_fa20_ta0_fm14_tm6*129*c,0,3136,0,0,3136,0.0,129,3169@TOP@human_GAPDH_TAA_len41_fa20_ta0_fm14_tm6,c
3169@TOP@human_GAPDH_TAA_len41_fa20_ta0_fm14_tm6*130*c,0,3170,0,0,3170,0.0,130,3169@TOP@human_GAPDH_TAA_len41_fa20_ta0_fm14_tm6,c
3169@TOP@human_GAPDH_TAA_len41_fa20_ta0_fm14_tm6*131*c,0,3177,0,0,3177,0.0,131,3169@TOP@human_GAPDH_TAA_len41_fa20_ta0_fm14_tm6,c
3169@TOP@human_GAPDH_TAA_len41_fa20_ta0_fm14_tm6*132*t,0,2,0,3119,3121,0.0,132,3169@TOP@human_GAPDH_TAA_len41_fa20_ta0_fm14_tm6,t
3169@TOP@human_GAPDH_TAA_len41_fa20_ta0_fm14_tm6*133*g,0,0,3134,0,3134,1.0,133,3169@TOP@human_GAPDH_TAA_len41_fa20_ta0_fm14_tm6,g
3169@TOP@human_GAPDH_TAA_len41_fa20_ta0_fm14_tm6*134*g,0,0,3134,0,3134,1.0,134,3169@TOP@human_GAPDH_TAA_len41_fa20_ta0_fm14_tm6,g
3170@TOP@human_GAPDH_TAA_len41_fa20_ta0_fm14_tm6*114*t,2,6,0,27589,27597,0.0,114,3170@TOP@human_GAPDH_TAA_len41_fa20_ta0_fm14_tm6,t
3170@TOP@human_GAPDH_TAA_len41_fa20_ta0_fm14_tm6*115*c,0,27739,0,4,27743,0.0,115,3170@TOP@human_GAPDH_TAA_len41_fa20_ta0_fm14_tm6,c
3170@TOP@human_GAPDH_TAA_len41_fa20_ta0_fm14_tm6*116*c,0,27627,3,0,27630,0.0,116,3170@TOP@human_GAPDH_TAA_len41_fa20_ta0_fm14_tm6,c
3170@TOP@human_GAPDH_TAA_len41_fa20_ta0_fm14_tm6*117*a,27611,0,28,0,27639,0.001,117,3170@TOP@human_GAPDH_TAA_len41_fa20_ta0_fm14_tm6,a
3170@TOP@human_GAPDH_TAA_len41_fa20_ta0_fm14_tm6*118*a,27199,0,277,0,27476,0.01,118,3170@TOP@human_GAPDH_TAA_len41_fa20_ta0_fm14_tm6,a
3170@TOP@human_GAPDH_TAA_len41_fa20_ta0_fm14_tm6*119*g,0,0,27414,1,27415,1.0,119,3170@TOP@human_GAPDH_TAA_len41_fa20_ta0_fm14_tm6,g
3170@TOP@human_GAPDH_TAA_len41_fa20_ta0_fm14_tm6*120*g,0,0,27321,3,27324,1.0,120,3170@TOP@human_GAPDH_TAA_len41_fa20_ta0_fm14_tm6,g
3170@TOP@human_GAPDH_TAA_len41_fa20_ta0_fm14_tm6*121*a,27590,0,8,1,27599,0.0,121,3170@TOP@human_GAPDH_TAA_len41_fa20_ta0_fm14_tm6,a
3170@TOP@human_GAPDH_TAA_len41_fa20_ta0_fm14_tm6*122*g,2,0,27626,0,27628,1.0,122,3170@TOP@human_GAPDH_TAA_len41_fa20_ta0_fm14_tm6,g
3170@TOP@human_GAPDH_TAA_len41_fa20_ta0_fm14_tm6*123*t,4,3,2,27261,27270,0.0,123,3170@TOP@human_GAPDH_TAA_len41_fa20_ta0_fm14_tm6,t
3170@TOP@human_GAPDH_TAA_len41_fa20_ta0_fm14_tm6*124*a,26418,2,714,0,27134,0.026,124,3170@TOP@human_GAPDH_TAA_len41_fa20_ta0_fm14_tm6,a
3170@TOP@human_GAPDH_TAA_len41_fa20_ta0_fm14_tm6*125*a,26679,5,446,0,27130,0.016,125,3170@TOP@human_GAPDH_TAA_len41_fa20_ta0_fm14_tm6,a
3170@TOP@human_GAPDH_TAA_len41_fa20_ta0_fm14_tm6*126*g,0,0,27256,2,27258,1.0,126,3170@TOP@human_GAPDH_TAA_len41_fa20_ta0_fm14_tm6,g
3170@TOP@human_GAPDH_TAA_len41_fa20_ta0_fm14_tm6*127*a,27521,0,9,1,27531,0.0,127,3170@TOP@human_GAPDH_TAA_len41_fa20_ta0_fm14_tm6,a
3170@TOP@human_GAPDH_TAA_len41_fa20_ta0_fm14_tm6*128*c,0,27674,4,0,27678,0.0,128,3170@TOP@human_GAPDH_TAA_len41_fa20_ta0_fm14_tm6,c
3170@TOP@human_GAPDH_TAA_len41_fa20_ta0_fm14_tm6*129*c,5,27480,0,5,27490,0.0,129,3170@TOP@human_GAPDH_TAA_len41_fa20_ta0_fm14_tm6,c
3170@TOP@human_GAPDH_TAA_len41_fa20_ta0_fm14_tm6*130*c,2,27621,0,0,27623,0.0,130,3170@TOP@human_GAPDH_TAA_len41_fa20_ta0_fm14_tm6,c
3170@TOP@human_GAPDH_TAA_len41_fa20_ta0_fm14_tm6*131*c,5,27691,0,1,27697,0.0,131,3170@TOP@human_GAPDH_TAA_len41_fa20_ta0_fm14_tm6,c
3170@TOP@human_GAPDH_TAA_len41_fa20_ta0_fm14_tm6*132*t,6,7,2,27281,27296,0.0,132,3170@TOP@human_GAPDH_TAA_len41_fa20_ta0_fm14_tm6,t
3170@TOP@human_GAPDH_TAA_len41_fa20_ta0_fm14_tm6*133*g,0,2,27251,1,27254,1.0,133,3170@TOP@human_GAPDH_TAA_len41_fa20_ta0_fm14_tm6,g
3170@TOP@human_GAPDH_TAA_len41_fa20_ta0_fm14_tm6*134*g,1,5,27345,0,27351,1.0,134,3170@TOP@human_GAPDH_TAA_len41_fa20_ta0_fm14_tm6,g
3171@TOP@human_GAPDH_TAA_len41_fa20_ta0_fm14_tm6*114*t,1,3,0,26306,26310,0.0,114,3171@TOP@human_GAPDH_TAA_len41_fa20_ta0_fm14_tm6,t
3171@TOP@human_GAPDH_TAA_len41_fa20_ta0_fm14_tm6*115*c,0,26454,0,0,26454,0.0,115,3171@TOP@human_GAPDH_TAA_len41_fa20_ta0_fm14_tm6,c
3171@TOP@human_GAPDH_TAA_len41_fa20_ta0_fm14_tm6*116*c,1,26346,0,1,26348,0.0,116,3171@TOP@human_GAPDH_TAA_len41_fa20_ta0_fm14_tm6,c
3171@TOP@human_GAPDH_TAA_len41_fa20_ta0_fm14_tm6*117*a,26288,0,31,0,26319,0.001,117,3171@TOP@human_GAPDH_TAA_len41_fa20_ta0_fm14_tm6,a
3171@TOP@human_GAPDH_TAA_len41_fa20_ta0_fm14_tm6*118*a,25816,1,321,2,26140,0.012,118,3171@TOP@human_GAPDH_TAA_len41_fa20_ta0_fm14_tm6,a
3171@TOP@human_GAPDH_TAA_len41_fa20_ta0_fm14_tm6*119*g,1,2,26145,1,26149,1.0,119,3171@TOP@human_GAPDH_TAA_len41_fa20_ta0_fm14_tm6,g
3171@TOP@human_GAPDH_TAA_len41_fa20_ta0_fm14_tm6*120*g,4,0,26037,1,26042,1.0,120,3171@TOP@human_GAPDH_TAA_len41_fa20_ta0_fm14_tm6,g
3171@TOP@human_GAPDH_TAA_len41_fa20_ta0_fm14_tm6*121*a,26297,0,5,1,26303,0.0,121,3171@TOP@human_GAPDH_TAA_len41_fa20_ta0_fm14_tm6,a
3171@TOP@human_GAPDH_TAA_len41_fa20_ta0_fm14_tm6*122*g,0,0,26377,0,26377,1.0,122,3171@TOP@human_GAPDH_TAA_len41_fa20_ta0_fm14_tm6,g
3171@TOP@human_GAPDH_TAA_len41_fa20_ta0_fm14_tm6*123*t,0,1,1,26001,26003,0.0,123,3171@TOP@human_GAPDH_TAA_len41_fa20_ta0_fm14_tm6,t
3171@TOP@human_GAPDH_TAA_len41_fa20_ta0_fm14_tm6*124*a,24853,1,1070,0,25924,0.041,124,3171@TOP@human_GAPDH_TAA_len41_fa20_ta0_fm14_tm6,a
3171@TOP@human_GAPDH_TAA_len41_fa20_ta0_fm14_tm6*125*a,25491,0,404,1,25896,0.016,125,3171@TOP@human_GAPDH_TAA_len41_fa20_ta0_fm14_tm6,a
3171@TOP@human_GAPDH_TAA_len41_fa20_ta0_fm14_tm6*126*g,3,0,25971,1,25975,1.0,126,3171@TOP@human_GAPDH_TAA_len41_fa20_ta0_fm14_tm6,g
3171@TOP@human_GAPDH_TAA_len41_fa20_ta0_fm14_tm6*127*a,26233,5,5,0,26243,0.0,127,3171@TOP@human_GAPDH_TAA_len41_fa20_ta0_fm14_tm6,a
3171@TOP@human_GAPDH_TAA_len41_fa20_ta0_fm14_tm6*128*c,0,26401,1,2,26404,0.0,128,3171@TOP@human_GAPDH_TAA_len41_fa20_ta0_fm14_tm6,c
3171@TOP@human_GAPDH_TAA_len41_fa20_ta0_fm14_tm6*129*c,1,26201,0,0,26202,0.0,129,3171@TOP@human_GAPDH_TAA_len41_fa20_ta0_fm14_tm6,c
3171@TOP@human_GAPDH_TAA_len41_fa20_ta0_fm14_tm6*130*c,5,26325,0,0,26330,0.0,130,3171@TOP@human_GAPDH_TAA_len41_fa20_ta0_fm14_tm6,c
3171@TOP@human_GAPDH_TAA_len41_fa20_ta0_fm14_tm6*131*c,3,26422,0,0,26425,0.0,131,3171@TOP@human_GAPDH_TAA_len41_fa20_ta0_fm14_tm6,c
3171@TOP@human_GAPDH_TAA_len41_fa20_ta0_fm14_tm6*132*t,4,2,7,26034,26047,0.0,132,3171@TOP@human_GAPDH_TAA_len41_fa20_ta0_fm14_tm6,t
3171@TOP@human_GAPDH_TAA_len41_fa20_ta0_fm14_tm6*133*g,1,1,25951,3,25956,1.0,133,3171@TOP@human_GAPDH_TAA_len41_fa20_ta0_fm14_tm6,g
3171@TOP@human_GAPDH_TAA_len41_fa20_ta0_fm14_tm6*134*g,1,6,26123,3,26133,1.0,134,3171@TOP@human_GAPDH_TAA_len41_fa20_ta0_fm14_tm6,g
3172@TOP@human_GAPDH_TAA_len41_fa20_ta0_fm14_tm6*114*t,1,0,0,808,809,0.0,114,3172@TOP@human_GAPDH_TAA_len41_fa20_ta0_fm14_tm6,t
3172@TOP@human_GAPDH_TAA_len41_fa20_ta0_fm14_tm6*115*c,0,819,0,0,819,0.0,115,3172@TOP@human_GAPDH_TAA_len41_fa20_ta0_fm14_tm6,c
3172@TOP@human_GAPDH_TAA_len41_fa20_ta0_fm14_tm6*116*c,0,818,0,0,818,0.0,116,3172@TOP@human_GAPDH_TAA_len41_fa20_ta0_fm14_tm6,c
3172@TOP@human_GAPDH_TAA_len41_fa20_ta0_fm14_tm6*117*a,811,0,4,0,815,0.005,117,3172@TOP@human_GAPDH_TAA_len41_fa20_ta0_fm14_tm6,a
3172@TOP@human_GAPDH_TAA_len41_fa20_ta0_fm14_tm6*118*a,775,0,38,1,814,0.047,118,3172@TOP@human_GAPDH_TAA_len41_fa20_ta0_fm14_tm6,a
3172@TOP@human_GAPDH_TAA_len41_fa20_ta0_fm14_tm6*119*g,0,0,806,0,806,1.0,119,3172@TOP@human_GAPDH_TAA_len41_fa20_ta0_fm14_tm6,g
3172@TOP@human_GAPDH_TAA_len41_fa20_ta0_fm14_tm6*120*g,0,0,807,0,807,1.0,120,3172@TOP@human_GAPDH_TAA_len41_fa20_ta0_fm14_tm6,g
3172@TOP@human_GAPDH_TAA_len41_fa20_ta0_fm14_tm6*121*a,812,0,3,0,815,0.004,121,3172@TOP@human_GAPDH_TAA_len41_fa20_ta0_fm14_tm6,a
3172@TOP@human_GAPDH_TAA_len41_fa20_ta0_fm14_tm6*122*g,0,0,815,0,815,1.0,122,3172@TOP@human_GAPDH_TAA_len41_fa20_ta0_fm14_tm6,g
3172@TOP@human_GAPDH_TAA_len41_fa20_ta0_fm14_tm6*123*t,1,0,0,803,804,0.0,123,3172@TOP@human_GAPDH_TAA_len41_fa20_ta0_fm14_tm6,t
3172@TOP@human_GAPDH_TAA_len41_fa20_ta0_fm14_tm6*124*a,726,0,74,0,800,0.092,124,3172@TOP@human_GAPDH_TAA_len41_fa20_ta0_fm14_tm6,a
3172@TOP@human_GAPDH_TAA_len41_fa20_ta0_fm14_tm6*125*a,745,0,51,1,797,0.064,125,3172@TOP@human_GAPDH_TAA_len41_fa20_ta0_fm14_tm6,a
3172@TOP@human_GAPDH_TAA_len41_fa20_ta0_fm14_tm6*126*g,0,0,803,0,803,1.0,126,3172@TOP@human_GAPDH_TAA_len41_fa20_ta0_fm14_tm6,g
3172@TOP@human_GAPDH_TAA_len41_fa20_ta0_fm14_tm6*127*a,812,0,1,0,813,0.001,127,3172@TOP@human_GAPDH_TAA_len41_fa20_ta0_fm14_tm6,a
3172@TOP@human_GAPDH_TAA_len41_fa20_ta0_fm14_tm6*128*c,0,816,0,0,816,0.0,128,3172@TOP@human_GAPDH_TAA_len41_fa20_ta0_fm14_tm6,c
3172@TOP@human_GAPDH_TAA_len41_fa20_ta0_fm14_tm6*129*c,0,810,0,0,810,0.0,129,3172@TOP@human_GAPDH_TAA_len41_fa20_ta0_fm14_tm6,c
3172@TOP@human_GAPDH_TAA_len41_fa20_ta0_fm14_tm6*130*c,0,809,0,0,809,0.0,130,3172@TOP@human_GAPDH_TAA_len41_fa20_ta0_fm14_tm6,c
3172@TOP@human_GAPDH_TAA_len41_fa20_ta0_fm14_tm6*131*c,0,815,0,0,815,0.0,131,3172@TOP@human_GAPDH_TAA_len41_fa20_ta0_fm14_tm6,c
3172@TOP@human_GAPDH_TAA_len41_fa20_ta0_fm14_tm6*132*t,0,0,0,799,799,0.0,132,3172@TOP@human_GAPDH_TAA_len41_fa20_ta0_fm14_tm6,t
3172@TOP@human_GAPDH_TAA_len41_fa20_ta0_fm14_tm6*133*g,0,0,804,0,804,1.0,133,3172@TOP@human_GAPDH_TAA_len41_fa20_ta0_fm14_tm6,g
3172@TOP@human_GAPDH_TAA_len41_fa20_ta0_fm14_tm6*134*g,0,2,812,0,814,0.998,134,3172@TOP@human_GAPDH_TAA_len41_fa20_ta0_fm14_tm6,g
3173@TOP@human_GAPDH_TAA_len41_fa20_ta0_fm14_tm6*114*t,0,0,0,1546,1546,0.0,114,3173@TOP@human_GAPDH_TAA_len41_fa20_ta0_fm14_tm6,t
3173@TOP@human_GAPDH_TAA_len41_fa20_ta0_fm14_tm6*115*c,0,1558,0,0,1558,0.0,115,3173@TOP@human_GAPDH_TAA_len41_fa20_ta0_fm14_tm6,c
3173@TOP@human_GAPDH_TAA_len41_fa20_ta0_fm14_tm6*116*c,0,1547,0,0,1547,0.0,116,3173@TOP@human_GAPDH_TAA_len41_fa20_ta0_fm14_tm6,c
3173@TOP@human_GAPDH_TAA_len41_fa20_ta0_fm14_tm6*117*a,1547,0,2,0,1549,0.001,117,3173@TOP@human_GAPDH_TAA_len41_fa20_ta0_fm14_tm6,a
3173@TOP@human_GAPDH_TAA_len41_fa20_ta0_fm14_tm6*118*a,1509,0,32,0,1541,0.021,118,3173@TOP@human_GAPDH_TAA_len41_fa20_ta0_fm14_tm6,a
3173@TOP@human_GAPDH_TAA_len41_fa20_ta0_fm14_tm6*119*g,0,0,1533,0,1533,1.0,119,3173@TOP@human_GAPDH_TAA_len41_fa20_ta0_fm14_tm6,g
3173@TOP@human_GAPDH_TAA_len41_fa20_ta0_fm14_tm6*120*g,0,0,1532,0,1532,1.0,120,3173@TOP@human_GAPDH_TAA_len41_fa20_ta0_fm14_tm6,g
3173@TOP@human_GAPDH_TAA_len41_fa20_ta0_fm14_tm6*121*a,1552,0,0,0,1552,0.0,121,3173@TOP@human_GAPDH_TAA_len41_fa20_ta0_fm14_tm6,a
3173@TOP@human_GAPDH_TAA_len41_fa20_ta0_fm14_tm6*122*g,0,0,1548,0,1548,1.0,122,3173@TOP@human_GAPDH_TAA_len41_fa20_ta0_fm14_tm6,g
3173@TOP@human_GAPDH_TAA_len41_fa20_ta0_fm14_tm6*123*t,0,0,1,1523,1524,0.001,123,3173@TOP@human_GAPDH_TAA_len41_fa20_ta0_fm14_tm6,t
3173@TOP@human_GAPDH_TAA_len41_fa20_ta0_fm14_tm6*124*a,1465,0,56,0,1521,0.037,124,3173@TOP@human_GAPDH_TAA_len41_fa20_ta0_fm14_tm6,a
3173@TOP@human_GAPDH_TAA_len41_fa20_ta0_fm14_tm6*125*a,1455,1,57,0,1513,0.038,125,3173@TOP@human_GAPDH_TAA_len41_fa20_ta0_fm14_tm6,a
3173@TOP@human_GAPDH_TAA_len41_fa20_ta0_fm14_tm6*126*g,0,0,1538,0,1538,1.0,126,3173@TOP@human_GAPDH_TAA_len41_fa20_ta0_fm14_tm6,g
3173@TOP@human_GAPDH_TAA_len41_fa20_ta0_fm14_tm6*127*a,1543,0,4,0,1547,0.003,127,3173@TOP@human_GAPDH_TAA_len41_fa20_ta0_fm14_tm6,a
3173@TOP@human_GAPDH_TAA_len41_fa20_ta0_fm14_tm6*128*c,0,1553,0,0,1553,0.0,128,3173@TOP@human_GAPDH_TAA_len41_fa20_ta0_fm14_tm6,c
3173@TOP@human_GAPDH_TAA_len41_fa20_ta0_fm14_tm6*129*c,1,1539,0,0,1540,0.0,129,3173@TOP@human_GAPDH_TAA_len41_fa20_ta0_fm14_tm6,c
3173@TOP@human_GAPDH_TAA_len41_fa20_ta0_fm14_tm6*130*c,0,1548,0,0,1548,0.0,130,3173@TOP@human_GAPDH_TAA_len41_fa20_ta0_fm14_tm6,c
3173@TOP@human_GAPDH_TAA_len41_fa20_ta0_fm14_tm6*131*c,0,1553,0,0,1553,0.0,131,3173@TOP@human_GAPDH_TAA_len41_fa20_ta0_fm14_tm6,c
3173@TOP@human_GAPDH_TAA_len41_fa20_ta0_fm14_tm6*132*t,0,1,0,1522,1523,0.0,132,3173@TOP@human_GAPDH_TAA_len41_fa20_ta0_fm14_tm6,t
3173@TOP@human_GAPDH_TAA_len41_fa20_ta0_fm14_tm6*133*g,0,0,1524,0,1524,1.0,133,3173@TOP@human_GAPDH_TAA_len41_fa20_ta0_fm14_tm6,g
3173@TOP@human_GAPDH_TAA_len41_fa20_ta0_fm14_tm6*134*g,0,1,1532,0,1533,0.999,134,3173@TOP@human_GAPDH_TAA_len41_fa20_ta0_fm14_tm6,g
3174@TOP@human_GAPDH_TAA_len41_fa20_ta0_fm14_tm6*114*t,0,0,0,1408,1408,0.0,114,3174@TOP@human_GAPDH_TAA_len41_fa20_ta0_fm14_tm6,t
3174@TOP@human_GAPDH_TAA_len41_fa20_ta0_fm14_tm6*115*c,0,1421,0,1,1422,0.0,115,3174@TOP@human_GAPDH_TAA_len41_fa20_ta0_fm14_tm6,c
3174@TOP@human_GAPDH_TAA_len41_fa20_ta0_fm14_tm6*116*c,0,1413,0,0,1413,0.0,116,3174@TOP@human_GAPDH_TAA_len41_fa20_ta0_fm14_tm6,c
3174@TOP@human_GAPDH_TAA_len41_fa20_ta0_fm14_tm6*117*a,1405,0,7,0,1412,0.005,117,3174@TOP@human_GAPDH_TAA_len41_fa20_ta0_fm14_tm6,a
3174@TOP@human_GAPDH_TAA_len41_fa20_ta0_fm14_tm6*118*a,1363,0,38,0,1401,0.027,118,3174@TOP@human_GAPDH_TAA_len41_fa20_ta0_fm14_tm6,a
3174@TOP@human_GAPDH_TAA_len41_fa20_ta0_fm14_tm6*119*g,0,0,1407,0,1407,1.0,119,3174@TOP@human_GAPDH_TAA_len41_fa20_ta0_fm14_tm6,g
3174@TOP@human_GAPDH_TAA_len41_fa20_ta0_fm14_tm6*120*g,0,0,1396,0,1396,1.0,120,3174@TOP@human_GAPDH_TAA_len41_fa20_ta0_fm14_tm6,g
3174@TOP@human_GAPDH_TAA_len41_fa20_ta0_fm14_tm6*121*a,1408,0,2,0,1410,0.001,121,3174@TOP@human_GAPDH_TAA_len41_fa20_ta0_fm14_tm6,a
3174@TOP@human_GAPDH_TAA_len41_fa20_ta0_fm14_tm6*122*g,1,0,1416,0,1417,0.999,122,3174@TOP@human_GAPDH_TAA_len41_fa20_ta0_fm14_tm6,g
3174@TOP@human_GAPDH_TAA_len41_fa20_ta0_fm14_tm6*123*t,0,0,0,1392,1392,0.0,123,3174@TOP@human_GAPDH_TAA_len41_fa20_ta0_fm14_tm6,t
3174@TOP@human_GAPDH_TAA_len41_fa20_ta0_fm14_tm6*124*a,1311,0,73,0,1384,0.053,124,3174@TOP@human_GAPDH_TAA_len41_fa20_ta0_fm14_tm6,a
3174@TOP@human_GAPDH_TAA_len41_fa20_ta0_fm14_tm6*125*a,1340,0,37,0,1377,0.027,125,3174@TOP@human_GAPDH_TAA_len41_fa20_ta0_fm14_tm6,a
3174@TOP@human_GAPDH_TAA_len41_fa20_ta0_fm14_tm6*126*g,0,0,1405,0,1405,1.0,126,3174@TOP@human_GAPDH_TAA_len41_fa20_ta0_fm14_tm6,g
3174@TOP@human_GAPDH_TAA_len41_fa20_ta0_fm14_tm6*127*a,1403,0,0,0,1403,0.0,127,3174@TOP@human_GAPDH_TAA_len41_fa20_ta0_fm14_tm6,a
3174@TOP@human_GAPDH_TAA_len41_fa20_ta0_fm14_tm6*128*c,0,1419,0,0,1419,0.0,128,3174@TOP@human_GAPDH_TAA_len41_fa20_ta0_fm14_tm6,c
3174@TOP@human_GAPDH_TAA_len41_fa20_ta0_fm14_tm6*129*c,0,1402,0,0,1402,0.0,129,3174@TOP@human_GAPDH_TAA_len41_fa20_ta0_fm14_tm6,c
3174@TOP@human_GAPDH_TAA_len41_fa20_ta0_fm14_tm6*130*c,0,1411,0,0,1411,0.0,130,3174@TOP@human_GAPDH_TAA_len41_fa20_ta0_fm14_tm6,c
3174@TOP@human_GAPDH_TAA_len41_fa20_ta0_fm14_tm6*131*c,0,1415,0,0,1415,0.0,131,3174@TOP@human_GAPDH_TAA_len41_fa20_ta0_fm14_tm6,c
3174@TOP@human_GAPDH_TAA_len41_fa20_ta0_fm14_tm6*132*t,1,0,0,1390,1391,0.0,132,3174@TOP@human_GAPDH_TAA_len41_fa20_ta0_fm14_tm6,t
3174@TOP@human_GAPDH_TAA_len41_fa20_ta0_fm14_tm6*133*g,0,0,1388,0,1388,1.0,133,3174@TOP@human_GAPDH_TAA_len41_fa20_ta0_fm14_tm6,g
3174@TOP@human_GAPDH_TAA_len41_fa20_ta0_fm14_tm6*134*g,0,0,1406,0,1406,1.0,134,3174@TOP@human_GAPDH_TAA_len41_fa20_ta0_fm14_tm6,g
3175@TOP@human_GAPDH_TAA_len41_fa20_ta0_fm14_tm6*114*t,2,2,0,23832,23836,0.0,114,3175@TOP@human_GAPDH_TAA_len41_fa20_ta0_fm14_tm6,t
3175@TOP@human_GAPDH_TAA_len41_fa20_ta0_fm14_tm6*115*c,0,23973,0,1,23974,0.0,115,3175@TOP@human_GAPDH_TAA_len41_fa20_ta0_fm14_tm6,c
3175@TOP@human_GAPDH_TAA_len41_fa20_ta0_fm14_tm6*116*c,1,23890,1,0,23892,0.0,116,3175@TOP@human_GAPDH_TAA_len41_fa20_ta0_fm14_tm6,c
3175@TOP@human_GAPDH_TAA_len41_fa20_ta0_fm14_tm6*117*a,23797,0,67,0,23864,0.003,117,3175@TOP@human_GAPDH_TAA_len41_fa20_ta0_fm14_tm6,a
3175@TOP@human_GAPDH_TAA_len41_fa20_ta0_fm14_tm6*118*a,23289,1,465,1,23756,0.02,118,3175@TOP@human_GAPDH_TAA_len41_fa20_ta0_fm14_tm6,a
3175@TOP@human_GAPDH_TAA_len41_fa20_ta0_fm14_tm6*119*g,1,0,23716,2,23719,1.0,119,3175@TOP@human_GAPDH_TAA_len41_fa20_ta0_fm14_tm6,g
3175@TOP@human_GAPDH_TAA_len41_fa20_ta0_fm14_tm6*120*g,1,0,23606,0,23607,1.0,120,3175@TOP@human_GAPDH_TAA_len41_fa20_ta0_fm14_tm6,g
3175@TOP@human_GAPDH_TAA_len41_fa20_ta0_fm14_tm6*121*a,23827,0,14,0,23841,0.001,121,3175@TOP@human_GAPDH_TAA_len41_fa20_ta0_fm14_tm6,a
3175@TOP@human_GAPDH_TAA_len41_fa20_ta0_fm14_tm6*122*g,0,0,23868,0,23868,1.0,122,3175@TOP@human_GAPDH_TAA_len41_fa20_ta0_fm14_tm6,g
3175@TOP@human_GAPDH_TAA_len41_fa20_ta0_fm14_tm6*123*t,2,7,1,23594,23604,0.0,123,3175@TOP@human_GAPDH_TAA_len41_fa20_ta0_fm14_tm6,t
3175@TOP@human_GAPDH_TAA_len41_fa20_ta0_fm14_tm6*124*a,22322,1,1200,0,23523,0.051,124,3175@TOP@human_GAPDH_TAA_len41_fa20_ta0_fm14_tm6,a
3175@TOP@human_GAPDH_TAA_len41_fa20_ta0_fm14_tm6*125*a,23048,1,435,0,23484,0.019,125,3175@TOP@human_GAPDH_TAA_len41_fa20_ta0_fm14_tm6,a
3175@TOP@human_GAPDH_TAA_len41_fa20_ta0_fm14_tm6*126*g,0,0,23584,1,23585,1.0,126,3175@TOP@human_GAPDH_TAA_len41_fa20_ta0_fm14_tm6,g
3175@TOP@human_GAPDH_TAA_len41_fa20_ta0_fm14_tm6*127*a,23793,1,12,0,23806,0.001,127,3175@TOP@human_GAPDH_TAA_len41_fa20_ta0_fm14_tm6,a
3175@TOP@human_GAPDH_TAA_len41_fa20_ta0_fm14_tm6*128*c,2,23903,0,1,23906,0.0,128,3175@TOP@human_GAPDH_TAA_len41_fa20_ta0_fm14_tm6,c
3175@TOP@human_GAPDH_TAA_len41_fa20_ta0_fm14_tm6*129*c,1,23741,0,4,23746,0.0,129,3175@TOP@human_GAPDH_TAA_len41_fa20_ta0_fm14_tm6,c
3175@TOP@human_GAPDH_TAA_len41_fa20_ta0_fm14_tm6*130*c,0,23881,0,6,23887,0.0,130,3175@TOP@human_GAPDH_TAA_len41_fa20_ta0_fm14_tm6,c
3175@TOP@human_GAPDH_TAA_len41_fa20_ta0_fm14_tm6*131*c,2,23923,0,5,23930,0.0,131,3175@TOP@human_GAPDH_TAA_len41_fa20_ta0_fm14_tm6,c
3175@TOP@human_GAPDH_TAA_len41_fa20_ta0_fm14_tm6*132*t,3,8,2,23550,23563,0.0,132,3175@TOP@human_GAPDH_TAA_len41_fa20_ta0_fm14_tm6,t
3175@TOP@human_GAPDH_TAA_len41_fa20_ta0_fm14_tm6*133*g,2,1,23573,0,23576,1.0,133,3175@TOP@human_GAPDH_TAA_len41_fa20_ta0_fm14_tm6,g
3175@TOP@human_GAPDH_TAA_len41_fa20_ta0_fm14_tm6*134*g,0,2,23664,1,23667,1.0,134,3175@TOP@human_GAPDH_TAA_len41_fa20_ta0_fm14_tm6,g
3176@TOP@human_GAPDH_TAA_len41_fa20_ta0_fm14_tm6*114*t,1,3,0,24096,24100,0.0,114,3176@TOP@human_GAPDH_TAA_len41_fa20_ta0_fm14_tm6,t
3176@TOP@human_GAPDH_TAA_len41_fa20_ta0_fm14_tm6*115*c,1,24206,0,0,24207,0.0,115,3176@TOP@human_GAPDH_TAA_len41_fa20_ta0_fm14_tm6,c
3176@TOP@human_GAPDH_TAA_len41_fa20_ta0_fm14_tm6*116*c,0,24117,0,1,24118,0.0,116,3176@TOP@human_GAPDH_TAA_len41_fa20_ta0_fm14_tm6,c
3176@TOP@human_GAPDH_TAA_len41_fa20_ta0_fm14_tm6*117*a,24075,0,35,0,24110,0.001,117,3176@TOP@human_GAPDH_TAA_len41_fa20_ta0_fm14_tm6,a
3176@TOP@human_GAPDH_TAA_len41_fa20_ta0_fm14_tm6*118*a,23708,1,290,0,23999,0.012,118,3176@TOP@human_GAPDH_TAA_len41_fa20_ta0_fm14_tm6,a
3176@TOP@human_GAPDH_TAA_len41_fa20_ta0_fm14_tm6*119*g,5,1,23928,2,23936,1.0,119,3176@TOP@human_GAPDH_TAA_len41_fa20_ta0_fm14_tm6,g
3176@TOP@human_GAPDH_TAA_len41_fa20_ta0_fm14_tm6*120*g,1,2,23861,1,23865,1.0,120,3176@TOP@human_GAPDH_TAA_len41_fa20_ta0_fm14_tm6,g
3176@TOP@human_GAPDH_TAA_len41_fa20_ta0_fm14_tm6*121*a,24086,0,8,0,24094,0.0,121,3176@TOP@human_GAPDH_TAA_len41_fa20_ta0_fm14_tm6,a
3176@TOP@human_GAPDH_TAA_len41_fa20_ta0_fm14_tm6*122*g,2,0,24121,0,24123,1.0,122,3176@TOP@human_GAPDH_TAA_len41_fa20_ta0_fm14_tm6,g
3176@TOP@human_GAPDH_TAA_len41_fa20_ta0_fm14_tm6*123*t,4,1,3,23780,23788,0.0,123,3176@TOP@human_GAPDH_TAA_len41_fa20_ta0_fm14_tm6,t
3176@TOP@human_GAPDH_TAA_len41_fa20_ta0_fm14_tm6*124*a,22274,0,1471,0,23745,0.062,124,3176@TOP@human_GAPDH_TAA_len41_fa20_ta0_fm14_tm6,a
3176@TOP@human_GAPDH_TAA_len41_fa20_ta0_fm14_tm6*125*a,23265,0,447,1,23713,0.019,125,3176@TOP@human_GAPDH_TAA_len41_fa20_ta0_fm14_tm6,a
3176@TOP@human_GAPDH_TAA_len41_fa20_ta0_fm14_tm6*126*g,0,0,23817,0,23817,1.0,126,3176@TOP@human_GAPDH_TAA_len41_fa20_ta0_fm14_tm6,g
3176@TOP@human_GAPDH_TAA_len41_fa20_ta0_fm14_tm6*127*a,24004,0,12,0,24016,0.0,127,3176@TOP@human_GAPDH_TAA_len41_fa20_ta0_fm14_tm6,a
3176@TOP@human_GAPDH_TAA_len41_fa20_ta0_fm14_tm6*128*c,0,24144,2,0,24146,0.0,128,3176@TOP@human_GAPDH_TAA_len41_fa20_ta0_fm14_tm6,c
3176@TOP@human_GAPDH_TAA_len41_fa20_ta0_fm14_tm6*129*c,0,23982,1,2,23985,0.0,129,3176@TOP@human_GAPDH_TAA_len41_fa20_ta0_fm14_tm6,c
3176@TOP@human_GAPDH_TAA_len41_fa20_ta0_fm14_tm6*130*c,0,24089,0,2,24091,0.0,130,3176@TOP@human_GAPDH_TAA_len41_fa20_ta0_fm14_tm6,c
3176@TOP@human_GAPDH_TAA_len41_fa20_ta0_fm14_tm6*131*c,0,24160,1,2,24163,0.0,131,3176@TOP@human_GAPDH_TAA_len41_fa20_ta0_fm14_tm6,c
3176@TOP@human_GAPDH_TAA_len41_fa20_ta0_fm14_tm6*132*t,6,3,0,23809,23818,0.0,132,3176@TOP@human_GAPDH_TAA_len41_fa20_ta0_fm14_tm6,t
3176@TOP@human_GAPDH_TAA_len41_fa20_ta0_fm14_tm6*133*g,1,2,23741,3,23747,1.0,133,3176@TOP@human_GAPDH_TAA_len41_fa20_ta0_fm14_tm6,g
3176@TOP@human_GAPDH_TAA_len41_fa20_ta0_fm14_tm6*134*g,0,4,23934,1,23939,1.0,134,3176@TOP@human_GAPDH_TAA_len41_fa20_ta0_fm14_tm6,g
3177@TOP@human_GAPDH_TAA_len41_fa20_ta0_fm14_tm6*114*t,0,0,1,2487,2488,0.0,114,3177@TOP@human_GAPDH_TAA_len41_fa20_ta0_fm14_tm6,t
3177@TOP@human_GAPDH_TAA_len41_fa20_ta0_fm14_tm6*115*c,0,2508,0,0,2508,0.0,115,3177@TOP@human_GAPDH_TAA_len41_fa20_ta0_fm14_tm6,c
3177@TOP@human_GAPDH_TAA_len41_fa20_ta0_fm14_tm6*116*c,0,2495,0,0,2495,0.0,116,3177@TOP@human_GAPDH_TAA_len41_fa20_ta0_fm14_tm6,c
3177@TOP@human_GAPDH_TAA_len41_fa20_ta0_fm14_tm6*117*a,2492,0,4,0,2496,0.002,117,3177@TOP@human_GAPDH_TAA_len41_fa20_ta0_fm14_tm6,a
3177@TOP@human_GAPDH_TAA_len41_fa20_ta0_fm14_tm6*118*a,2447,0,38,0,2485,0.015,118,3177@TOP@human_GAPDH_TAA_len41_fa20_ta0_fm14_tm6,a
3177@TOP@human_GAPDH_TAA_len41_fa20_ta0_fm14_tm6*119*g,0,0,2475,0,2475,1.0,119,3177@TOP@human_GAPDH_TAA_len41_fa20_ta0_fm14_tm6,g
3177@TOP@human_GAPDH_TAA_len41_fa20_ta0_fm14_tm6*120*g,0,0,2458,0,2458,1.0,120,3177@TOP@human_GAPDH_TAA_len41_fa20_ta0_fm14_tm6,g
3177@TOP@human_GAPDH_TAA_len41_fa20_ta0_fm14_tm6*121*a,2498,0,0,0,2498,0.0,121,3177@TOP@human_GAPDH_TAA_len41_fa20_ta0_fm14_tm6,a
3177@TOP@human_GAPDH_TAA_len41_fa20_ta0_fm14_tm6*122*g,0,0,2495,0,2495,1.0,122,3177@TOP@human_GAPDH_TAA_len41_fa20_ta0_fm14_tm6,g
3177@TOP@human_GAPDH_TAA_len41_fa20_ta0_fm14_tm6*123*t,1,0,0,2463,2464,0.0,123,3177@TOP@human_GAPDH_TAA_len41_fa20_ta0_fm14_tm6,t
3177@TOP@human_GAPDH_TAA_len41_fa20_ta0_fm14_tm6*124*a,2366,0,85,0,2451,0.035,124,3177@TOP@human_GAPDH_TAA_len41_fa20_ta0_fm14_tm6,a
3177@TOP@human_GAPDH_TAA_len41_fa20_ta0_fm14_tm6*125*a,2410,0,46,0,2456,0.019,125,3177@TOP@human_GAPDH_TAA_len41_fa20_ta0_fm14_tm6,a
3177@TOP@human_GAPDH_TAA_len41_fa20_ta0_fm14_tm6*126*g,1,0,2449,0,2450,1.0,126,3177@TOP@human_GAPDH_TAA_len41_fa20_ta0_fm14_tm6,g
3177@TOP@human_GAPDH_TAA_len41_fa20_ta0_fm14_tm6*127*a,2485,0,0,0,2485,0.0,127,3177@TOP@human_GAPDH_TAA_len41_fa20_ta0_fm14_tm6,a
3177@TOP@human_GAPDH_TAA_len41_fa20_ta0_fm14_tm6*128*c,1,2504,0,0,2505,0.0,128,3177@TOP@human_GAPDH_TAA_len41_fa20_ta0_fm14_tm6,c
3177@TOP@human_GAPDH_TAA_len41_fa20_ta0_fm14_tm6*129*c,0,2482,0,0,2482,0.0,129,3177@TOP@human_GAPDH_TAA_len41_fa20_ta0_fm14_tm6,c
3177@TOP@human_GAPDH_TAA_len41_fa20_ta0_fm14_tm6*130*c,0,2497,0,1,2498,0.0,130,3177@TOP@human_GAPDH_TAA_len41_fa20_ta0_fm14_tm6,c
3177@TOP@human_GAPDH_TAA_len41_fa20_ta0_fm14_tm6*131*c,0,2507,0,0,2507,0.0,131,3177@TOP@human_GAPDH_TAA_len41_fa20_ta0_fm14_tm6,c
3177@TOP@human_GAPDH_TAA_len41_fa20_ta0_fm14_tm6*132*t,0,2,0,2462,2464,0.0,132,3177@TOP@human_GAPDH_TAA_len41_fa20_ta0_fm14_tm6,t
3177@TOP@human_GAPDH_TAA_len41_fa20_ta0_fm14_tm6*133*g,0,0,2458,0,2458,1.0,133,3177@TOP@human_GAPDH_TAA_len41_fa20_ta0_fm14_tm6,g
3177@TOP@human_GAPDH_TAA_len41_fa20_ta0_fm14_tm6*134*g,0,7,2465,0,2472,0.997,134,3177@TOP@human_GAPDH_TAA_len41_fa20_ta0_fm14_tm6,g
3178@TOP@human_GAPDH_TAA_len41_fa20_ta0_fm14_tm6*114*t,1,0,0,2837,2838,0.0,114,3178@TOP@human_GAPDH_TAA_len41_fa20_ta0_fm14_tm6,t
3178@TOP@human_GAPDH_TAA_len41_fa20_ta0_fm14_tm6*115*c,0,2855,0,0,2855,0.0,115,3178@TOP@human_GAPDH_TAA_len41_fa20_ta0_fm14_tm6,c
3178@TOP@human_GAPDH_TAA_len41_fa20_ta0_fm14_tm6*116*c,0,2837,0,0,2837,0.0,116,3178@TOP@human_GAPDH_TAA_len41_fa20_ta0_fm14_tm6,c
3178@TOP@human_GAPDH_TAA_len41_fa20_ta0_fm14_tm6*117*a,2836,0,5,0,2841,0.002,117,3178@TOP@human_GAPDH_TAA_len41_fa20_ta0_fm14_tm6,a
3178@TOP@human_GAPDH_TAA_len41_fa20_ta0_fm14_tm6*118*a,2775,0,45,0,2820,0.016,118,3178@TOP@human_GAPDH_TAA_len41_fa20_ta0_fm14_tm6,a
3178@TOP@human_GAPDH_TAA_len41_fa20_ta0_fm14_tm6*119*g,1,0,2809,0,2810,1.0,119,3178@TOP@human_GAPDH_TAA_len41_fa20_ta0_fm14_tm6,g
3178@TOP@human_GAPDH_TAA_len41_fa20_ta0_fm14_tm6*120*g,0,0,2801,0,2801,1.0,120,3178@TOP@human_GAPDH_TAA_len41_fa20_ta0_fm14_tm6,g
3178@TOP@human_GAPDH_TAA_len41_fa20_ta0_fm14_tm6*121*a,2840,0,0,0,2840,0.0,121,3178@TOP@human_GAPDH_TAA_len41_fa20_ta0_fm14_tm6,a
3178@TOP@human_GAPDH_TAA_len41_fa20_ta0_fm14_tm6*122*g,0,0,2839,0,2839,1.0,122,3178@TOP@human_GAPDH_TAA_len41_fa20_ta0_fm14_tm6,g
3178@TOP@human_GAPDH_TAA_len41_fa20_ta0_fm14_tm6*123*t,0,0,2,2797,2799,0.001,123,3178@TOP@human_GAPDH_TAA_len41_fa20_ta0_fm14_tm6,t
3178@TOP@human_GAPDH_TAA_len41_fa20_ta0_fm14_tm6*124*a,2702,0,96,0,2798,0.034,124,3178@TOP@human_GAPDH_TAA_len41_fa20_ta0_fm14_tm6,a
3178@TOP@human_GAPDH_TAA_len41_fa20_ta0_fm14_tm6*125*a,2727,0,53,0,2780,0.019,125,3178@TOP@human_GAPDH_TAA_len41_fa20_ta0_fm14_tm6,a
3178@TOP@human_GAPDH_TAA_len41_fa20_ta0_fm14_tm6*126*g,1,0,2805,0,2806,1.0,126,3178@TOP@human_GAPDH_TAA_len41_fa20_ta0_fm14_tm6,g
3178@TOP@human_GAPDH_TAA_len41_fa20_ta0_fm14_tm6*127*a,2823,0,7,0,2830,0.002,127,3178@TOP@human_GAPDH_TAA_len41_fa20_ta0_fm14_tm6,a
3178@TOP@human_GAPDH_TAA_len41_fa20_ta0_fm14_tm6*128*c,0,2848,0,0,2848,0.0,128,3178@TOP@human_GAPDH_TAA_len41_fa20_ta0_fm14_tm6,c
3178@TOP@human_GAPDH_TAA_len41_fa20_ta0_fm14_tm6*129*c,0,2830,0,0,2830,0.0,129,3178@TOP@human_GAPDH_TAA_len41_fa20_ta0_fm14_tm6,c
3178@TOP@human_GAPDH_TAA_len41_fa20_ta0_fm14_tm6*130*c,0,2837,0,2,2839,0.0,130,3178@TOP@human_GAPDH_TAA_len41_fa20_ta0_fm14_tm6,c
3178@TOP@human_GAPDH_TAA_len41_fa20_ta0_fm14_tm6*131*c,0,2849,0,0,2849,0.0,131,3178@TOP@human_GAPDH_TAA_len41_fa20_ta0_fm14_tm6,c
3178@TOP@human_GAPDH_TAA_len41_fa20_ta0_fm14_tm6*132*t,0,4,1,2801,2806,0.0,132,3178@TOP@human_GAPDH_TAA_len41_fa20_ta0_fm14_tm6,t
3178@TOP@human_GAPDH_TAA_len41_fa20_ta0_fm14_tm6*133*g,0,0,2808,0,2808,1.0,133,3178@TOP@human_GAPDH_TAA_len41_fa20_ta0_fm14_tm6,g
3178@TOP@human_GAPDH_TAA_len41_fa20_ta0_fm14_tm6*134*g,0,1,2819,0,2820,1.0,134,3178@TOP@human_GAPDH_TAA_len41_fa20_ta0_fm14_tm6,g
3179@TOP@human_GAPDH_TAA_len41_fa20_ta0_fm14_tm6*114*t,0,0,0,1138,1138,0.0,114,3179@TOP@human_GAPDH_TAA_len41_fa20_ta0_fm14_tm6,t
3179@TOP@human_GAPDH_TAA_len41_fa20_ta0_fm14_tm6*115*c,0,1146,0,0,1146,0.0,115,3179@TOP@human_GAPDH_TAA_len41_fa20_ta0_fm14_tm6,c
3179@TOP@human_GAPDH_TAA_len41_fa20_ta0_fm14_tm6*116*c,0,1135,0,0,1135,0.0,116,3179@TOP@human_GAPDH_TAA_len41_fa20_ta0_fm14_tm6,c
3179@TOP@human_GAPDH_TAA_len41_fa20_ta0_fm14_tm6*117*a,1140,0,1,0,1141,0.001,117,3179@TOP@human_GAPDH_TAA_len41_fa20_ta0_fm14_tm6,a
3179@TOP@human_GAPDH_TAA_len41_fa20_ta0_fm14_tm6*118*a,1125,0,11,0,1136,0.01,118,3179@TOP@human_GAPDH_TAA_len41_fa20_ta0_fm14_tm6,a
3179@TOP@human_GAPDH_TAA_len41_fa20_ta0_fm14_tm6*119*g,0,0,1132,1,1133,0.999,119,3179@TOP@human_GAPDH_TAA_len41_fa20_ta0_fm14_tm6,g
3179@TOP@human_GAPDH_TAA_len41_fa20_ta0_fm14_tm6*120*g,0,0,1120,0,1120,1.0,120,3179@TOP@human_GAPDH_TAA_len41_fa20_ta0_fm14_tm6,g
3179@TOP@human_GAPDH_TAA_len41_fa20_ta0_fm14_tm6*121*a,1140,0,1,0,1141,0.001,121,3179@TOP@human_GAPDH_TAA_len41_fa20_ta0_fm14_tm6,a
3179@TOP@human_GAPDH_TAA_len41_fa20_ta0_fm14_tm6*122*g,0,0,1143,0,1143,1.0,122,3179@TOP@human_GAPDH_TAA_len41_fa20_ta0_fm14_tm6,g
3179@TOP@human_GAPDH_TAA_len41_fa20_ta0_fm14_tm6*123*t,0,0,0,1123,1123,0.0,123,3179@TOP@human_GAPDH_TAA_len41_fa20_ta0_fm14_tm6,t
3179@TOP@human_GAPDH_TAA_len41_fa20_ta0_fm14_tm6*124*a,988,0,132,0,1120,0.118,124,3179@TOP@human_GAPDH_TAA_len41_fa20_ta0_fm14_tm6,a
3179@TOP@human_GAPDH_TAA_len41_fa20_ta0_fm14_tm6*125*a,1080,0,43,1,1124,0.038,125,3179@TOP@human_GAPDH_TAA_len41_fa20_ta0_fm14_tm6,a
3179@TOP@human_GAPDH_TAA_len41_fa20_ta0_fm14_tm6*126*g,0,0,1122,0,1122,1.0,126,3179@TOP@human_GAPDH_TAA_len41_fa20_ta0_fm14_tm6,g
3179@TOP@human_GAPDH_TAA_len41_fa20_ta0_fm14_tm6*127*a,1133,0,2,0,1135,0.002,127,3179@TOP@human_GAPDH_TAA_len41_fa20_ta0_fm14_tm6,a
3179@TOP@human_GAPDH_TAA_len41_fa20_ta0_fm14_tm6*128*c,0,1141,0,0,1141,0.0,128,3179@TOP@human_GAPDH_TAA_len41_fa20_ta0_fm14_tm6,c
3179@TOP@human_GAPDH_TAA_len41_fa20_ta0_fm14_tm6*129*c,0,1130,0,0,1130,0.0,129,3179@TOP@human_GAPDH_TAA_len41_fa20_ta0_fm14_tm6,c
3179@TOP@human_GAPDH_TAA_len41_fa20_ta0_fm14_tm6*130*c,0,1142,0,0,1142,0.0,130,3179@TOP@human_GAPDH_TAA_len41_fa20_ta0_fm14_tm6,c
3179@TOP@human_GAPDH_TAA_len41_fa20_ta0_fm14_tm6*131*c,0,1145,0,0,1145,0.0,131,3179@TOP@human_GAPDH_TAA_len41_fa20_ta0_fm14_tm6,c
3179@TOP@human_GAPDH_TAA_len41_fa20_ta0_fm14_tm6*132*t,0,0,0,1120,1120,0.0,132,3179@TOP@human_GAPDH_TAA_len41_fa20_ta0_fm14_tm6,t
3179@TOP@human_GAPDH_TAA_len41_fa20_ta0_fm14_tm6*133*g,0,0,1124,0,1124,1.0,133,3179@TOP@human_GAPDH_TAA_len41_fa20_ta0_fm14_tm6,g
3179@TOP@human_GAPDH_TAA_len41_fa20_ta0_fm14_tm6*134*g,0,0,1127,0,1127,1.0,134,3179@TOP@human_GAPDH_TAA_len41_fa20_ta0_fm14_tm6,g
3180@TOP@human_GAPDH_TAA_len41_fa20_ta0_fm14_tm6*114*t,0,0,0,1577,1577,0.0,114,3180@TOP@human_GAPDH_TAA_len41_fa20_ta0_fm14_tm6,t
3180@TOP@human_GAPDH_TAA_len41_fa20_ta0_fm14_tm6*115*c,0,1583,0,0,1583,0.0,115,3180@TOP@human_GAPDH_TAA_len41_fa20_ta0_fm14_tm6,c
3180@TOP@human_GAPDH_TAA_len41_fa20_ta0_fm14_tm6*116*c,0,1576,0,0,1576,0.0,116,3180@TOP@human_GAPDH_TAA_len41_fa20_ta0_fm14_tm6,c
3180@TOP@human_GAPDH_TAA_len41_fa20_ta0_fm14_tm6*117*a,1571,0,5,0,1576,0.003,117,3180@TOP@human_GAPDH_TAA_len41_fa20_ta0_fm14_tm6,a
3180@TOP@human_GAPDH_TAA_len41_fa20_ta0_fm14_tm6*118*a,1549,0,18,0,1567,0.011,118,3180@TOP@human_GAPDH_TAA_len41_fa20_ta0_fm14_tm6,a
3180@TOP@human_GAPDH_TAA_len41_fa20_ta0_fm14_tm6*119*g,0,0,1557,0,1557,1.0,119,3180@TOP@human_GAPDH_TAA_len41_fa20_ta0_fm14_tm6,g
3180@TOP@human_GAPDH_TAA_len41_fa20_ta0_fm14_tm6*120*g,0,0,1558,0,1558,1.0,120,3180@TOP@human_GAPDH_TAA_len41_fa20_ta0_fm14_tm6,g
3180@TOP@human_GAPDH_TAA_len41_fa20_ta0_fm14_tm6*121*a,1575,0,0,0,1575,0.0,121,3180@TOP@human_GAPDH_TAA_len41_fa20_ta0_fm14_tm6,a
3180@TOP@human_GAPDH_TAA_len41_fa20_ta0_fm14_tm6*122*g,0,0,1575,0,1575,1.0,122,3180@TOP@human_GAPDH_TAA_len41_fa20_ta0_fm14_tm6,g
3180@TOP@human_GAPDH_TAA_len41_fa20_ta0_fm14_tm6*123*t,0,0,0,1562,1562,0.0,123,3180@TOP@human_GAPDH_TAA_len41_fa20_ta0_fm14_tm6,t
3180@TOP@human_GAPDH_TAA_len41_fa20_ta0_fm14_tm6*124*a,1511,0,48,0,1559,0.031,124,3180@TOP@human_GAPDH_TAA_len41_fa20_ta0_fm14_tm6,a
3180@TOP@human_GAPDH_TAA_len41_fa20_ta0_fm14_tm6*125*a,1518,0,33,0,1551,0.021,125,3180@TOP@human_GAPDH_TAA_len41_fa20_ta0_fm14_tm6,a
3180@TOP@human_GAPDH_TAA_len41_fa20_ta0_fm14_tm6*126*g,0,0,1552,0,1552,1.0,126,3180@TOP@human_GAPDH_TAA_len41_fa20_ta0_fm14_tm6,g
3180@TOP@human_GAPDH_TAA_len41_fa20_ta0_fm14_tm6*127*a,1576,0,0,0,1576,0.0,127,3180@TOP@human_GAPDH_TAA_len41_fa20_ta0_fm14_tm6,a
3180@TOP@human_GAPDH_TAA_len41_fa20_ta0_fm14_tm6*128*c,0,1575,0,0,1575,0.0,128,3180@TOP@human_GAPDH_TAA_len41_fa20_ta0_fm14_tm6,c
3180@TOP@human_GAPDH_TAA_len41_fa20_ta0_fm14_tm6*129*c,0,1567,0,0,1567,0.0,129,3180@TOP@human_GAPDH_TAA_len41_fa20_ta0_fm14_tm6,c
3180@TOP@human_GAPDH_TAA_len41_fa20_ta0_fm14_tm6*130*c,0,1572,0,0,1572,0.0,130,3180@TOP@human_GAPDH_TAA_len41_fa20_ta0_fm14_tm6,c
3180@TOP@human_GAPDH_TAA_len41_fa20_ta0_fm14_tm6*131*c,0,1580,0,0,1580,0.0,131,3180@TOP@human_GAPDH_TAA_len41_fa20_ta0_fm14_tm6,c
3180@TOP@human_GAPDH_TAA_len41_fa20_ta0_fm14_tm6*132*t,0,0,2,1559,1561,0.001,132,3180@TOP@human_GAPDH_TAA_len41_fa20_ta0_fm14_tm6,t
3180@TOP@human_GAPDH_TAA_len41_fa20_ta0_fm14_tm6*133*g,0,0,1552,1,1553,0.999,133,3180@TOP@human_GAPDH_TAA_len41_fa20_ta0_fm14_tm6,g
3180@TOP@human_GAPDH_TAA_len41_fa20_ta0_fm14_tm6*134*g,1,0,1561,0,1562,0.999,134,3180@TOP@human_GAPDH_TAA_len41_fa20_ta0_fm14_tm6,g
3181@TOP@human_GAPDH_TAA_len41_fa20_ta0_fm14_tm6*114*t,0,0,0,5745,5745,0.0,114,3181@TOP@human_GAPDH_TAA_len41_fa20_ta0_fm14_tm6,t
3181@TOP@human_GAPDH_TAA_len41_fa20_ta0_fm14_tm6*115*c,0,5777,1,1,5779,0.0,115,3181@TOP@human_GAPDH_TAA_len41_fa20_ta0_fm14_tm6,c
3181@TOP@human_GAPDH_TAA_len41_fa20_ta0_fm14_tm6*116*c,0,5764,0,0,5764,0.0,116,3181@TOP@human_GAPDH_TAA_len41_fa20_ta0_fm14_tm6,c
3181@TOP@human_GAPDH_TAA_len41_fa20_ta0_fm14_tm6*117*a,5744,2,15,0,5761,0.003,117,3181@TOP@human_GAPDH_TAA_len41_fa20_ta0_fm14_tm6,a
3181@TOP@human_GAPDH_TAA_len41_fa20_ta0_fm14_tm6*118*a,5593,0,130,0,5723,0.023,118,3181@TOP@human_GAPDH_TAA_len41_fa20_ta0_fm14_tm6,a
3181@TOP@human_GAPDH_TAA_len41_fa20_ta0_fm14_tm6*119*g,5,0,5720,0,5725,0.999,119,3181@TOP@human_GAPDH_TAA_len41_fa20_ta0_fm14_tm6,g
3181@TOP@human_GAPDH_TAA_len41_fa20_ta0_fm14_tm6*120*g,0,0,5701,1,5702,1.0,120,3181@TOP@human_GAPDH_TAA_len41_fa20_ta0_fm14_tm6,g
3181@TOP@human_GAPDH_TAA_len41_fa20_ta0_fm14_tm6*121*a,5761,0,0,0,5761,0.0,121,3181@TOP@human_GAPDH_TAA_len41_fa20_ta0_fm14_tm6,a
3181@TOP@human_GAPDH_TAA_len41_fa20_ta0_fm14_tm6*122*g,1,0,5755,0,5756,1.0,122,3181@TOP@human_GAPDH_TAA_len41_fa20_ta0_fm14_tm6,g
3181@TOP@human_GAPDH_TAA_len41_fa20_ta0_fm14_tm6*123*t,0,0,2,5690,5692,0.0,123,3181@TOP@human_GAPDH_TAA_len41_fa20_ta0_fm14_tm6,t
3181@TOP@human_GAPDH_TAA_len41_fa20_ta0_fm14_tm6*124*a,5384,0,288,0,5672,0.051,124,3181@TOP@human_GAPDH_TAA_len41_fa20_ta0_fm14_tm6,a
3181@TOP@human_GAPDH_TAA_len41_fa20_ta0_fm14_tm6*125*a,5526,0,145,3,5674,0.026,125,3181@TOP@human_GAPDH_TAA_len41_fa20_ta0_fm14_tm6,a
3181@TOP@human_GAPDH_TAA_len41_fa20_ta0_fm14_tm6*126*g,0,0,5699,0,5699,1.0,126,3181@TOP@human_GAPDH_TAA_len41_fa20_ta0_fm14_tm6,g
3181@TOP@human_GAPDH_TAA_len41_fa20_ta0_fm14_tm6*127*a,5725,0,7,0,5732,0.001,127,3181@TOP@human_GAPDH_TAA_len41_fa20_ta0_fm14_tm6,a
3181@TOP@human_GAPDH_TAA_len41_fa20_ta0_fm14_tm6*128*c,0,5770,0,0,5770,0.0,128,3181@TOP@human_GAPDH_TAA_len41_fa20_ta0_fm14_tm6,c
3181@TOP@human_GAPDH_TAA_len41_fa20_ta0_fm14_tm6*129*c,0,5732,0,0,5732,0.0,129,3181@TOP@human_GAPDH_TAA_len41_fa20_ta0_fm14_tm6,c
3181@TOP@human_GAPDH_TAA_len41_fa20_ta0_fm14_tm6*130*c,3,5753,0,0,5756,0.0,130,3181@TOP@human_GAPDH_TAA_len41_fa20_ta0_fm14_tm6,c
3181@TOP@human_GAPDH_TAA_len41_fa20_ta0_fm14_tm6*131*c,0,5774,0,1,5775,0.0,131,3181@TOP@human_GAPDH_TAA_len41_fa20_ta0_fm14_tm6,c
3181@TOP@human_GAPDH_TAA_len41_fa20_ta0_fm14_tm6*132*t,1,1,0,5701,5703,0.0,132,3181@TOP@human_GAPDH_TAA_len41_fa20_ta0_fm14_tm6,t
3181@TOP@human_GAPDH_TAA_len41_fa20_ta0_fm14_tm6*133*g,0,0,5689,0,5689,1.0,133,3181@TOP@human_GAPDH_TAA_len41_fa20_ta0_fm14_tm6,g
3181@TOP@human_GAPDH_TAA_len41_fa20_ta0_fm14_tm6*134*g,0,0,5718,0,5718,1.0,134,3181@TOP@human_GAPDH_TAA_len41_fa20_ta0_fm14_tm6,g
3182@TOP@human_GAPDH_TAA_len41_fa20_ta0_fm14_tm6*114*t,0,4,0,3168,3172,0.0,114,3182@TOP@human_GAPDH_TAA_len41_fa20_ta0_fm14_tm6,t
3182@TOP@human_GAPDH_TAA_len41_fa20_ta0_fm14_tm6*115*c,0,3197,0,0,3197,0.0,115,3182@TOP@human_GAPDH_TAA_len41_fa20_ta0_fm14_tm6,c
3182@TOP@human_GAPDH_TAA_len41_fa20_ta0_fm14_tm6*116*c,0,3182,0,0,3182,0.0,116,3182@TOP@human_GAPDH_TAA_len41_fa20_ta0_fm14_tm6,c
3182@TOP@human_GAPDH_TAA_len41_fa20_ta0_fm14_tm6*117*a,3172,0,11,0,3183,0.003,117,3182@TOP@human_GAPDH_TAA_len41_fa20_ta0_fm14_tm6,a
3182@TOP@human_GAPDH_TAA_len41_fa20_ta0_fm14_tm6*118*a,3127,0,42,0,3169,0.013,118,3182@TOP@human_GAPDH_TAA_len41_fa20_ta0_fm14_tm6,a
3182@TOP@human_GAPDH_TAA_len41_fa20_ta0_fm14_tm6*119*g,0,0,3169,0,3169,1.0,119,3182@TOP@human_GAPDH_TAA_len41_fa20_ta0_fm14_tm6,g
3182@TOP@human_GAPDH_TAA_len41_fa20_ta0_fm14_tm6*120*g,0,0,3141,0,3141,1.0,120,3182@TOP@human_GAPDH_TAA_len41_fa20_ta0_fm14_tm6,g
3182@TOP@human_GAPDH_TAA_len41_fa20_ta0_fm14_tm6*121*a,3179,0,0,0,3179,0.0,121,3182@TOP@human_GAPDH_TAA_len41_fa20_ta0_fm14_tm6,a
3182@TOP@human_GAPDH_TAA_len41_fa20_ta0_fm14_tm6*122*g,0,0,3182,0,3182,1.0,122,3182@TOP@human_GAPDH_TAA_len41_fa20_ta0_fm14_tm6,g
3182@TOP@human_GAPDH_TAA_len41_fa20_ta0_fm14_tm6*123*t,0,0,1,3126,3127,0.0,123,3182@TOP@human_GAPDH_TAA_len41_fa20_ta0_fm14_tm6,t
3182@TOP@human_GAPDH_TAA_len41_fa20_ta0_fm14_tm6*124*a,2959,1,172,0,3132,0.055,124,3182@TOP@human_GAPDH_TAA_len41_fa20_ta0_fm14_tm6,a
3182@TOP@human_GAPDH_TAA_len41_fa20_ta0_fm14_tm6*125*a,3059,0,54,0,3113,0.017,125,3182@TOP@human_GAPDH_TAA_len41_fa20_ta0_fm14_tm6,a
3182@TOP@human_GAPDH_TAA_len41_fa20_ta0_fm14_tm6*126*g,0,0,3137,0,3137,1.0,126,3182@TOP@human_GAPDH_TAA_len41_fa20_ta0_fm14_tm6,g
3182@TOP@human_GAPDH_TAA_len41_fa20_ta0_fm14_tm6*127*a,3174,0,3,0,3177,0.001,127,3182@TOP@human_GAPDH_TAA_len41_fa20_ta0_fm14_tm6,a
3182@TOP@human_GAPDH_TAA_len41_fa20_ta0_fm14_tm6*128*c,0,3190,0,0,3190,0.0,128,3182@TOP@human_GAPDH_TAA_len41_fa20_ta0_fm14_tm6,c
3182@TOP@human_GAPDH_TAA_len41_fa20_ta0_fm14_tm6*129*c,0,3161,0,0,3161,0.0,129,3182@TOP@human_GAPDH_TAA_len41_fa20_ta0_fm14_tm6,c
3182@TOP@human_GAPDH_TAA_len41_fa20_ta0_fm14_tm6*130*c,0,3185,0,0,3185,0.0,130,3182@TOP@human_GAPDH_TAA_len41_fa20_ta0_fm14_tm6,c
3182@TOP@human_GAPDH_TAA_len41_fa20_ta0_fm14_tm6*131*c,0,3189,0,0,3189,0.0,131,3182@TOP@human_GAPDH_TAA_len41_fa20_ta0_fm14_tm6,c
3182@TOP@human_GAPDH_TAA_len41_fa20_ta0_fm14_tm6*132*t,0,0,0,3132,3132,0.0,132,3182@TOP@human_GAPDH_TAA_len41_fa20_ta0_fm14_tm6,t
3182@TOP@human_GAPDH_TAA_len41_fa20_ta0_fm14_tm6*133*g,1,0,3132,0,3133,1.0,133,3182@TOP@human_GAPDH_TAA_len41_fa20_ta0_fm14_tm6,g
3182@TOP@human_GAPDH_TAA_len41_fa20_ta0_fm14_tm6*134*g,0,0,3151,0,3151,1.0,134,3182@TOP@human_GAPDH_TAA_len41_fa20_ta0_fm14_tm6,g
3183@TOP@human_GAPDH_TAA_len41_fa20_ta0_fm14_tm6*114*t,1,1,0,3120,3122,0.0,114,3183@TOP@human_GAPDH_TAA_len41_fa20_ta0_fm14_tm6,t
3183@TOP@human_GAPDH_TAA_len41_fa20_ta0_fm14_tm6*115*c,0,3131,0,2,3133,0.0,115,3183@TOP@human_GAPDH_TAA_len41_fa20_ta0_fm14_tm6,c
3183@TOP@human_GAPDH_TAA_len41_fa20_ta0_fm14_tm6*116*c,1,3123,0,0,3124,0.0,116,3183@TOP@human_GAPDH_TAA_len41_fa20_ta0_fm14_tm6,c
3183@TOP@human_GAPDH_TAA_len41_fa20_ta0_fm14_tm6*117*a,3106,0,9,0,3115,0.003,117,3183@TOP@human_GAPDH_TAA_len41_fa20_ta0_fm14_tm6,a
3183@TOP@human_GAPDH_TAA_len41_fa20_ta0_fm14_tm6*118*a,3035,0,58,0,3093,0.019,118,3183@TOP@human_GAPDH_TAA_len41_fa20_ta0_fm14_tm6,a
3183@TOP@human_GAPDH_TAA_len41_fa20_ta0_fm14_tm6*119*g,0,2,3100,0,3102,0.999,119,3183@TOP@human_GAPDH_TAA_len41_fa20_ta0_fm14_tm6,g
3183@TOP@human_GAPDH_TAA_len41_fa20_ta0_fm14_tm6*120*g,0,0,3090,0,3090,1.0,120,3183@TOP@human_GAPDH_TAA_len41_fa20_ta0_fm14_tm6,g
3183@TOP@human_GAPDH_TAA_len41_fa20_ta0_fm14_tm6*121*a,3106,0,3,0,3109,0.001,121,3183@TOP@human_GAPDH_TAA_len41_fa20_ta0_fm14_tm6,a
3183@TOP@human_GAPDH_TAA_len41_fa20_ta0_fm14_tm6*122*g,0,0,3121,0,3121,1.0,122,3183@TOP@human_GAPDH_TAA_len41_fa20_ta0_fm14_tm6,g
3183@TOP@human_GAPDH_TAA_len41_fa20_ta0_fm14_tm6*123*t,1,1,0,3071,3073,0.0,123,3183@TOP@human_GAPDH_TAA_len41_fa20_ta0_fm14_tm6,t
3183@TOP@human_GAPDH_TAA_len41_fa20_ta0_fm14_tm6*124*a,2946,0,121,0,3067,0.039,124,3183@TOP@human_GAPDH_TAA_len41_fa20_ta0_fm14_tm6,a
3183@TOP@human_GAPDH_TAA_len41_fa20_ta0_fm14_tm6*125*a,2992,0,86,0,3078,0.028,125,3183@TOP@human_GAPDH_TAA_len41_fa20_ta0_fm14_tm6,a
3183@TOP@human_GAPDH_TAA_len41_fa20_ta0_fm14_tm6*126*g,0,1,3089,0,3090,1.0,126,3183@TOP@human_GAPDH_TAA_len41_fa20_ta0_fm14_tm6,g
3183@TOP@human_GAPDH_TAA_len41_fa20_ta0_fm14_tm6*127*a,3097,2,0,0,3099,0.0,127,3183@TOP@human_GAPDH_TAA_len41_fa20_ta0_fm14_tm6,a
3183@TOP@human_GAPDH_TAA_len41_fa20_ta0_fm14_tm6*128*c,0,3132,0,0,3132,0.0,128,3183@TOP@human_GAPDH_TAA_len41_fa20_ta0_fm14_tm6,c
3183@TOP@human_GAPDH_TAA_len41_fa20_ta0_fm14_tm6*129*c,0,3108,0,0,3108,0.0,129,3183@TOP@human_GAPDH_TAA_len41_fa20_ta0_fm14_tm6,c
3183@TOP@human_GAPDH_TAA_len41_fa20_ta0_fm14_tm6*130*c,0,3126,0,0,3126,0.0,130,3183@TOP@human_GAPDH_TAA_len41_fa20_ta0_fm14_tm6,c
3183@TOP@human_GAPDH_TAA_len41_fa20_ta0_fm14_tm6*131*c,0,3132,0,0,3132,0.0,131,3183@TOP@human_GAPDH_TAA_len41_fa20_ta0_fm14_tm6,c
3183@TOP@human_GAPDH_TAA_len41_fa20_ta0_fm14_tm6*132*t,2,1,0,3081,3084,0.0,132,3183@TOP@human_GAPDH_TAA_len41_fa20_ta0_fm14_tm6,t
3183@TOP@human_GAPDH_TAA_len41_fa20_ta0_fm14_tm6*133*g,0,0,3075,0,3075,1.0,133,3183@TOP@human_GAPDH_TAA_len41_fa20_ta0_fm14_tm6,g
3183@TOP@human_GAPDH_TAA_len41_fa20_ta0_fm14_tm6*134*g,1,0,3105,0,3106,1.0,134,3183@TOP@human_GAPDH_TAA_len41_fa20_ta0_fm14_tm6,g
3184@TOP@human_GAPDH_TAA_len41_fa20_ta0_fm14_tm6*114*t,0,1,1,1540,1542,0.001,114,3184@TOP@human_GAPDH_TAA_len41_fa20_ta0_fm14_tm6,t
3184@TOP@human_GAPDH_TAA_len41_fa20_ta0_fm14_tm6*115*c,0,1550,0,0,1550,0.0,115,3184@TOP@human_GAPDH_TAA_len41_fa20_ta0_fm14_tm6,c
3184@TOP@human_GAPDH_TAA_len41_fa20_ta0_fm14_tm6*116*c,0,1546,0,0,1546,0.0,116,3184@TOP@human_GAPDH_TAA_len41_fa20_ta0_fm14_tm6,c
3184@TOP@human_GAPDH_TAA_len41_fa20_ta0_fm14_tm6*117*a,1540,0,5,0,1545,0.003,117,3184@TOP@human_GAPDH_TAA_len41_fa20_ta0_fm14_tm6,a
3184@TOP@human_GAPDH_TAA_len41_fa20_ta0_fm14_tm6*118*a,1509,0,23,0,1532,0.015,118,3184@TOP@human_GAPDH_TAA_len41_fa20_ta0_fm14_tm6,a
3184@TOP@human_GAPDH_TAA_len41_fa20_ta0_fm14_tm6*119*g,0,0,1536,0,1536,1.0,119,3184@TOP@human_GAPDH_TAA_len41_fa20_ta0_fm14_tm6,g
3184@TOP@human_GAPDH_TAA_len41_fa20_ta0_fm14_tm6*120*g,1,0,1518,0,1519,0.999,120,3184@TOP@human_GAPDH_TAA_len41_fa20_ta0_fm14_tm6,g
3184@TOP@human_GAPDH_TAA_len41_fa20_ta0_fm14_tm6*121*a,1540,0,1,0,1541,0.001,121,3184@TOP@human_GAPDH_TAA_len41_fa20_ta0_fm14_tm6,a
3184@TOP@human_GAPDH_TAA_len41_fa20_ta0_fm14_tm6*122*g,0,0,1547,0,1547,1.0,122,3184@TOP@human_GAPDH_TAA_len41_fa20_ta0_fm14_tm6,g
3184@TOP@human_GAPDH_TAA_len41_fa20_ta0_fm14_tm6*123*t,0,0,1,1521,1522,0.001,123,3184@TOP@human_GAPDH_TAA_len41_fa20_ta0_fm14_tm6,t
3184@TOP@human_GAPDH_TAA_len41_fa20_ta0_fm14_tm6*124*a,1413,0,104,0,1517,0.069,124,3184@TOP@human_GAPDH_TAA_len41_fa20_ta0_fm14_tm6,a
3184@TOP@human_GAPDH_TAA_len41_fa20_ta0_fm14_tm6*125*a,1483,0,35,0,1518,0.023,125,3184@TOP@human_GAPDH_TAA_len41_fa20_ta0_fm14_tm6,a
3184@TOP@human_GAPDH_TAA_len41_fa20_ta0_fm14_tm6*126*g,0,0,1527,0,1527,1.0,126,3184@TOP@human_GAPDH_TAA_len41_fa20_ta0_fm14_tm6,g
3184@TOP@human_GAPDH_TAA_len41_fa20_ta0_fm14_tm6*127*a,1538,0,3,0,1541,0.002,127,3184@TOP@human_GAPDH_TAA_len41_fa20_ta0_fm14_tm6,a
3184@TOP@human_GAPDH_TAA_len41_fa20_ta0_fm14_tm6*128*c,0,1547,0,0,1547,0.0,128,3184@TOP@human_GAPDH_TAA_len41_fa20_ta0_fm14_tm6,c
3184@TOP@human_GAPDH_TAA_len41_fa20_ta0_fm14_tm6*129*c,0,1531,0,0,1531,0.0,129,3184@TOP@human_GAPDH_TAA_len41_fa20_ta0_fm14_tm6,c
3184@TOP@human_GAPDH_TAA_len41_fa20_ta0_fm14_tm6*130*c,0,1543,0,0,1543,0.0,130,3184@TOP@human_GAPDH_TAA_len41_fa20_ta0_fm14_tm6,c
3184@TOP@human_GAPDH_TAA_len41_fa20_ta0_fm14_tm6*131*c,0,1542,0,0,1542,0.0,131,3184@TOP@human_GAPDH_TAA_len41_fa20_ta0_fm14_tm6,c
3184@TOP@human_GAPDH_TAA_len41_fa20_ta0_fm14_tm6*132*t,0,0,0,1519,1519,0.0,132,3184@TOP@human_GAPDH_TAA_len41_fa20_ta0_fm14_tm6,t
3184@TOP@human_GAPDH_TAA_len41_fa20_ta0_fm14_tm6*133*g,0,0,1524,0,1524,1.0,133,3184@TOP@human_GAPDH_TAA_len41_fa20_ta0_fm14_tm6,g
3184@TOP@human_GAPDH_TAA_len41_fa20_ta0_fm14_tm6*134*g,0,0,1533,0,1533,1.0,134,3184@TOP@human_GAPDH_TAA_len41_fa20_ta0_fm14_tm6,g
3185@TOP@human_GAPDH_TAA_len41_fa20_ta0_fm14_tm6*114*t,3,8,0,22844,22855,0.0,114,3185@TOP@human_GAPDH_TAA_len41_fa20_ta0_fm14_tm6,t
3185@TOP@human_GAPDH_TAA_len41_fa20_ta0_fm14_tm6*115*c,1,22987,0,0,22988,0.0,115,3185@TOP@human_GAPDH_TAA_len41_fa20_ta0_fm14_tm6,c
3185@TOP@human_GAPDH_TAA_len41_fa20_ta0_fm14_tm6*116*c,0,22897,0,0,22897,0.0,116,3185@TOP@human_GAPDH_TAA_len41_fa20_ta0_fm14_tm6,c
3185@TOP@human_GAPDH_TAA_len41_fa20_ta0_fm14_tm6*117*a,22864,1,24,0,22889,0.001,117,3185@TOP@human_GAPDH_TAA_len41_fa20_ta0_fm14_tm6,a
3185@TOP@human_GAPDH_TAA_len41_fa20_ta0_fm14_tm6*118*a,22430,0,310,2,22742,0.014,118,3185@TOP@human_GAPDH_TAA_len41_fa20_ta0_fm14_tm6,a
3185@TOP@human_GAPDH_TAA_len41_fa20_ta0_fm14_tm6*119*g,1,1,22723,0,22725,1.0,119,3185@TOP@human_GAPDH_TAA_len41_fa20_ta0_fm14_tm6,g
3185@TOP@human_GAPDH_TAA_len41_fa20_ta0_fm14_tm6*120*g,0,0,22629,0,22629,1.0,120,3185@TOP@human_GAPDH_TAA_len41_fa20_ta0_fm14_tm6,g
3185@TOP@human_GAPDH_TAA_len41_fa20_ta0_fm14_tm6*121*a,22852,0,15,0,22867,0.001,121,3185@TOP@human_GAPDH_TAA_len41_fa20_ta0_fm14_tm6,a
3185@TOP@human_GAPDH_TAA_len41_fa20_ta0_fm14_tm6*122*g,1,0,22901,0,22902,1.0,122,3185@TOP@human_GAPDH_TAA_len41_fa20_ta0_fm14_tm6,g
3185@TOP@human_GAPDH_TAA_len41_fa20_ta0_fm14_tm6*123*t,5,1,4,22569,22579,0.0,123,3185@TOP@human_GAPDH_TAA_len41_fa20_ta0_fm14_tm6,t
3185@TOP@human_GAPDH_TAA_len41_fa20_ta0_fm14_tm6*124*a,21842,0,689,0,22531,0.031,124,3185@TOP@human_GAPDH_TAA_len41_fa20_ta0_fm14_tm6,a
3185@TOP@human_GAPDH_TAA_len41_fa20_ta0_fm14_tm6*125*a,22072,1,407,2,22482,0.018,125,3185@TOP@human_GAPDH_TAA_len41_fa20_ta0_fm14_tm6,a
3185@TOP@human_GAPDH_TAA_len41_fa20_ta0_fm14_tm6*126*g,4,0,22590,0,22594,1.0,126,3185@TOP@human_GAPDH_TAA_len41_fa20_ta0_fm14_tm6,g
3185@TOP@human_GAPDH_TAA_len41_fa20_ta0_fm14_tm6*127*a,22792,3,15,0,22810,0.001,127,3185@TOP@human_GAPDH_TAA_len41_fa20_ta0_fm14_tm6,a
3185@TOP@human_GAPDH_TAA_len41_fa20_ta0_fm14_tm6*128*c,2,22940,4,0,22946,0.0,128,3185@TOP@human_GAPDH_TAA_len41_fa20_ta0_fm14_tm6,c
3185@TOP@human_GAPDH_TAA_len41_fa20_ta0_fm14_tm6*129*c,1,22765,0,0,22766,0.0,129,3185@TOP@human_GAPDH_TAA_len41_fa20_ta0_fm14_tm6,c
3185@TOP@human_GAPDH_TAA_len41_fa20_ta0_fm14_tm6*130*c,3,22894,0,0,22897,0.0,130,3185@TOP@human_GAPDH_TAA_len41_fa20_ta0_fm14_tm6,c
3185@TOP@human_GAPDH_TAA_len41_fa20_ta0_fm14_tm6*131*c,1,22946,0,0,22947,0.0,131,3185@TOP@human_GAPDH_TAA_len41_fa20_ta0_fm14_tm6,c
3185@TOP@human_GAPDH_TAA_len41_fa20_ta0_fm14_tm6*132*t,3,3,2,22617,22625,0.0,132,3185@TOP@human_GAPDH_TAA_len41_fa20_ta0_fm14_tm6,t
3185@TOP@human_GAPDH_TAA_len41_fa20_ta0_fm14_tm6*133*g,3,1,22548,0,22552,1.0,133,3185@TOP@human_GAPDH_TAA_len41_fa20_ta0_fm14_tm6,g
3185@TOP@human_GAPDH_TAA_len41_fa20_ta0_fm14_tm6*134*g,1,9,22679,0,22689,1.0,134,3185@TOP@human_GAPDH_TAA_len41_fa20_ta0_fm14_tm6,g
3186@TOP@human_GAPDH_TAA_len41_fa20_ta0_fm14_tm6*114*t,0,7,0,34017,34024,0.0,114,3186@TOP@human_GAPDH_TAA_len41_fa20_ta0_fm14_tm6,t
3186@TOP@human_GAPDH_TAA_len41_fa20_ta0_fm14_tm6*115*c,0,34203,0,0,34203,0.0,115,3186@TOP@human_GAPDH_TAA_len41_fa20_ta0_fm14_tm6,c
3186@TOP@human_GAPDH_TAA_len41_fa20_ta0_fm14_tm6*116*c,0,34063,0,2,34065,0.0,116,3186@TOP@human_GAPDH_TAA_len41_fa20_ta0_fm14_tm6,c
3186@TOP@human_GAPDH_TAA_len41_fa20_ta0_fm14_tm6*117*a,34023,1,39,0,34063,0.001,117,3186@TOP@human_GAPDH_TAA_len41_fa20_ta0_fm14_tm6,a
3186@TOP@human_GAPDH_TAA_len41_fa20_ta0_fm14_tm6*118*a,33319,1,573,0,33893,0.017,118,3186@TOP@human_GAPDH_TAA_len41_fa20_ta0_fm14_tm6,a
3186@TOP@human_GAPDH_TAA_len41_fa20_ta0_fm14_tm6*119*g,1,0,33802,4,33807,1.0,119,3186@TOP@human_GAPDH_TAA_len41_fa20_ta0_fm14_tm6,g
3186@TOP@human_GAPDH_TAA_len41_fa20_ta0_fm14_tm6*120*g,2,1,33651,1,33655,1.0,120,3186@TOP@human_GAPDH_TAA_len41_fa20_ta0_fm14_tm6,g
3186@TOP@human_GAPDH_TAA_len41_fa20_ta0_fm14_tm6*121*a,34036,0,17,0,34053,0.0,121,3186@TOP@human_GAPDH_TAA_len41_fa20_ta0_fm14_tm6,a
3186@TOP@human_GAPDH_TAA_len41_fa20_ta0_fm14_tm6*122*g,2,0,34077,1,34080,1.0,122,3186@TOP@human_GAPDH_TAA_len41_fa20_ta0_fm14_tm6,g
3186@TOP@human_GAPDH_TAA_len41_fa20_ta0_fm14_tm6*123*t,7,2,2,33638,33649,0.0,123,3186@TOP@human_GAPDH_TAA_len41_fa20_ta0_fm14_tm6,t
3186@TOP@human_GAPDH_TAA_len41_fa20_ta0_fm14_tm6*124*a,32031,0,1663,0,33694,0.049,124,3186@TOP@human_GAPDH_TAA_len41_fa20_ta0_fm14_tm6,a
3186@TOP@human_GAPDH_TAA_len41_fa20_ta0_fm14_tm6*125*a,32993,1,627,0,33621,0.019,125,3186@TOP@human_GAPDH_TAA_len41_fa20_ta0_fm14_tm6,a
3186@TOP@human_GAPDH_TAA_len41_fa20_ta0_fm14_tm6*126*g,1,0,33569,2,33572,1.0,126,3186@TOP@human_GAPDH_TAA_len41_fa20_ta0_fm14_tm6,g
3186@TOP@human_GAPDH_TAA_len41_fa20_ta0_fm14_tm6*127*a,33866,1,20,2,33889,0.001,127,3186@TOP@human_GAPDH_TAA_len41_fa20_ta0_fm14_tm6,a
3186@TOP@human_GAPDH_TAA_len41_fa20_ta0_fm14_tm6*128*c,1,34120,2,2,34125,0.0,128,3186@TOP@human_GAPDH_TAA_len41_fa20_ta0_fm14_tm6,c
3186@TOP@human_GAPDH_TAA_len41_fa20_ta0_fm14_tm6*129*c,1,33841,0,3,33845,0.0,129,3186@TOP@human_GAPDH_TAA_len41_fa20_ta0_fm14_tm6,c
3186@TOP@human_GAPDH_TAA_len41_fa20_ta0_fm14_tm6*130*c,4,34071,0,2,34077,0.0,130,3186@TOP@human_GAPDH_TAA_len41_fa20_ta0_fm14_tm6,c
3186@TOP@human_GAPDH_TAA_len41_fa20_ta0_fm14_tm6*131*c,2,34135,0,0,34137,0.0,131,3186@TOP@human_GAPDH_TAA_len41_fa20_ta0_fm14_tm6,c
3186@TOP@human_GAPDH_TAA_len41_fa20_ta0_fm14_tm6*132*t,9,8,3,33672,33692,0.0,132,3186@TOP@human_GAPDH_TAA_len41_fa20_ta0_fm14_tm6,t
3186@TOP@human_GAPDH_TAA_len41_fa20_ta0_fm14_tm6*133*g,4,1,33611,2,33618,1.0,133,3186@TOP@human_GAPDH_TAA_len41_fa20_ta0_fm14_tm6,g
3186@TOP@human_GAPDH_TAA_len41_fa20_ta0_fm14_tm6*134*g,2,3,33764,0,33769,1.0,134,3186@TOP@human_GAPDH_TAA_len41_fa20_ta0_fm14_tm6,g
3187@TOP@human_GAPDH_TAA_len41_fa20_ta0_fm14_tm6*114*t,1,1,0,8308,8310,0.0,114,3187@TOP@human_GAPDH_TAA_len41_fa20_ta0_fm14_tm6,t
3187@TOP@human_GAPDH_TAA_len41_fa20_ta0_fm14_tm6*115*c,0,8366,0,1,8367,0.0,115,3187@TOP@human_GAPDH_TAA_len41_fa20_ta0_fm14_tm6,c
3187@TOP@human_GAPDH_TAA_len41_fa20_ta0_fm14_tm6*116*c,0,8337,0,0,8337,0.0,116,3187@TOP@human_GAPDH_TAA_len41_fa20_ta0_fm14_tm6,c
3187@TOP@human_GAPDH_TAA_len41_fa20_ta0_fm14_tm6*117*a,8305,0,15,0,8320,0.002,117,3187@TOP@human_GAPDH_TAA_len41_fa20_ta0_fm14_tm6,a
3187@TOP@human_GAPDH_TAA_len41_fa20_ta0_fm14_tm6*118*a,8180,1,107,0,8288,0.013,118,3187@TOP@human_GAPDH_TAA_len41_fa20_ta0_fm14_tm6,a
3187@TOP@human_GAPDH_TAA_len41_fa20_ta0_fm14_tm6*119*g,0,0,8271,0,8271,1.0,119,3187@TOP@human_GAPDH_TAA_len41_fa20_ta0_fm14_tm6,g
3187@TOP@human_GAPDH_TAA_len41_fa20_ta0_fm14_tm6*120*g,1,0,8233,0,8234,1.0,120,3187@TOP@human_GAPDH_TAA_len41_fa20_ta0_fm14_tm6,g
3187@TOP@human_GAPDH_TAA_len41_fa20_ta0_fm14_tm6*121*a,8308,0,0,0,8308,0.0,121,3187@TOP@human_GAPDH_TAA_len41_fa20_ta0_fm14_tm6,a
3187@TOP@human_GAPDH_TAA_len41_fa20_ta0_fm14_tm6*122*g,0,0,8340,1,8341,1.0,122,3187@TOP@human_GAPDH_TAA_len41_fa20_ta0_fm14_tm6,g
3187@TOP@human_GAPDH_TAA_len41_fa20_ta0_fm14_tm6*123*t,3,2,0,8212,8217,0.0,123,3187@TOP@human_GAPDH_TAA_len41_fa20_ta0_fm14_tm6,t
3187@TOP@human_GAPDH_TAA_len41_fa20_ta0_fm14_tm6*124*a,7863,1,327,0,8191,0.04,124,3187@TOP@human_GAPDH_TAA_len41_fa20_ta0_fm14_tm6,a
3187@TOP@human_GAPDH_TAA_len41_fa20_ta0_fm14_tm6*125*a,7778,1,399,0,8178,0.049,125,3187@TOP@human_GAPDH_TAA_len41_fa20_ta0_fm14_tm6,a
3187@TOP@human_GAPDH_TAA_len41_fa20_ta0_fm14_tm6*126*g,0,0,8199,1,8200,1.0,126,3187@TOP@human_GAPDH_TAA_len41_fa20_ta0_fm14_tm6,g
3187@TOP@human_GAPDH_TAA_len41_fa20_ta0_fm14_tm6*127*a,8299,0,3,0,8302,0.0,127,3187@TOP@human_GAPDH_TAA_len41_fa20_ta0_fm14_tm6,a
3187@TOP@human_GAPDH_TAA_len41_fa20_ta0_fm14_tm6*128*c,0,8351,0,1,8352,0.0,128,3187@TOP@human_GAPDH_TAA_len41_fa20_ta0_fm14_tm6,c
3187@TOP@human_GAPDH_TAA_len41_fa20_ta0_fm14_tm6*129*c,0,8287,0,1,8288,0.0,129,3187@TOP@human_GAPDH_TAA_len41_fa20_ta0_fm14_tm6,c
3187@TOP@human_GAPDH_TAA_len41_fa20_ta0_fm14_tm6*130*c,0,8331,0,0,8331,0.0,130,3187@TOP@human_GAPDH_TAA_len41_fa20_ta0_fm14_tm6,c
3187@TOP@human_GAPDH_TAA_len41_fa20_ta0_fm14_tm6*131*c,0,8359,0,0,8359,0.0,131,3187@TOP@human_GAPDH_TAA_len41_fa20_ta0_fm14_tm6,c
3187@TOP@human_GAPDH_TAA_len41_fa20_ta0_fm14_tm6*132*t,1,0,0,8220,8221,0.0,132,3187@TOP@human_GAPDH_TAA_len41_fa20_ta0_fm14_tm6,t
3187@TOP@human_GAPDH_TAA_len41_fa20_ta0_fm14_tm6*133*g,1,2,8205,1,8209,1.0,133,3187@TOP@human_GAPDH_TAA_len41_fa20_ta0_fm14_tm6,g
3187@TOP@human_GAPDH_TAA_len41_fa20_ta0_fm14_tm6*134*g,0,0,8252,0,8252,1.0,134,3187@TOP@human_GAPDH_TAA_len41_fa20_ta0_fm14_tm6,g
3188@TOP@human_GAPDH_TAA_len41_fa20_ta0_fm14_tm6*114*t,0,2,0,10268,10270,0.0,114,3188@TOP@human_GAPDH_TAA_len41_fa20_ta0_fm14_tm6,t
3188@TOP@human_GAPDH_TAA_len41_fa20_ta0_fm14_tm6*115*c,0,10317,0,1,10318,0.0,115,3188@TOP@human_GAPDH_TAA_len41_fa20_ta0_fm14_tm6,c
3188@TOP@human_GAPDH_TAA_len41_fa20_ta0_fm14_tm6*116*c,0,10283,0,2,10285,0.0,116,3188@TOP@human_GAPDH_TAA_len41_fa20_ta0_fm14_tm6,c
3188@TOP@human_GAPDH_TAA_len41_fa20_ta0_fm14_tm6*117*a,10262,0,4,0,10266,0.0,117,3188@TOP@human_GAPDH_TAA_len41_fa20_ta0_fm14_tm6,a
3188@TOP@human_GAPDH_TAA_len41_fa20_ta0_fm14_tm6*118*a,10100,0,139,0,10239,0.014,118,3188@TOP@human_GAPDH_TAA_len41_fa20_ta0_fm14_tm6,a
3188@TOP@human_GAPDH_TAA_len41_fa20_ta0_fm14_tm6*119*g,0,0,10209,0,10209,1.0,119,3188@TOP@human_GAPDH_TAA_len41_fa20_ta0_fm14_tm6,g
3188@TOP@human_GAPDH_TAA_len41_fa20_ta0_fm14_tm6*120*g,6,0,10154,0,10160,0.999,120,3188@TOP@human_GAPDH_TAA_len41_fa20_ta0_fm14_tm6,g
3188@TOP@human_GAPDH_TAA_len41_fa20_ta0_fm14_tm6*121*a,10269,0,0,0,10269,0.0,121,3188@TOP@human_GAPDH_TAA_len41_fa20_ta0_fm14_tm6,a
3188@TOP@human_GAPDH_TAA_len41_fa20_ta0_fm14_tm6*122*g,2,0,10279,0,10281,1.0,122,3188@TOP@human_GAPDH_TAA_len41_fa20_ta0_fm14_tm6,g
3188@TOP@human_GAPDH_TAA_len41_fa20_ta0_fm14_tm6*123*t,0,1,0,10151,10152,0.0,123,3188@TOP@human_GAPDH_TAA_len41_fa20_ta0_fm14_tm6,t
3188@TOP@human_GAPDH_TAA_len41_fa20_ta0_fm14_tm6*124*a,9188,0,964,0,10152,0.095,124,3188@TOP@human_GAPDH_TAA_len41_fa20_ta0_fm14_tm6,a
3188@TOP@human_GAPDH_TAA_len41_fa20_ta0_fm14_tm6*125*a,9798,1,275,0,10074,0.027,125,3188@TOP@human_GAPDH_TAA_len41_fa20_ta0_fm14_tm6,a
3188@TOP@human_GAPDH_TAA_len41_fa20_ta0_fm14_tm6*126*g,0,0,10131,0,10131,1.0,126,3188@TOP@human_GAPDH_TAA_len41_fa20_ta0_fm14_tm6,g
3188@TOP@human_GAPDH_TAA_len41_fa20_ta0_fm14_tm6*127*a,10259,1,4,1,10265,0.0,127,3188@TOP@human_GAPDH_TAA_len41_fa20_ta0_fm14_tm6,a
3188@TOP@human_GAPDH_TAA_len41_fa20_ta0_fm14_tm6*128*c,0,10287,1,0,10288,0.0,128,3188@TOP@human_GAPDH_TAA_len41_fa20_ta0_fm14_tm6,c
3188@TOP@human_GAPDH_TAA_len41_fa20_ta0_fm14_tm6*129*c,0,10231,0,0,10231,0.0,129,3188@TOP@human_GAPDH_TAA_len41_fa20_ta0_fm14_tm6,c
3188@TOP@human_GAPDH_TAA_len41_fa20_ta0_fm14_tm6*130*c,1,10288,0,0,10289,0.0,130,3188@TOP@human_GAPDH_TAA_len41_fa20_ta0_fm14_tm6,c
3188@TOP@human_GAPDH_TAA_len41_fa20_ta0_fm14_tm6*131*c,1,10301,0,0,10302,0.0,131,3188@TOP@human_GAPDH_TAA_len41_fa20_ta0_fm14_tm6,c
3188@TOP@human_GAPDH_TAA_len41_fa20_ta0_fm14_tm6*132*t,6,2,1,10150,10159,0.0,132,3188@TOP@human_GAPDH_TAA_len41_fa20_ta0_fm14_tm6,t
3188@TOP@human_GAPDH_TAA_len41_fa20_ta0_fm14_tm6*133*g,2,0,10135,0,10137,1.0,133,3188@TOP@human_GAPDH_TAA_len41_fa20_ta0_fm14_tm6,g
3188@TOP@human_GAPDH_TAA_len41_fa20_ta0_fm14_tm6*134*g,0,2,10198,0,10200,1.0,134,3188@TOP@human_GAPDH_TAA_len41_fa20_ta0_fm14_tm6,g
3189@TOP@human_GAPDH_TAA_len41_fa20_ta0_fm14_tm6*114*t,0,1,0,1301,1302,0.0,114,3189@TOP@human_GAPDH_TAA_len41_fa20_ta0_fm14_tm6,t
3189@TOP@human_GAPDH_TAA_len41_fa20_ta0_fm14_tm6*115*c,0,1311,0,0,1311,0.0,115,3189@TOP@human_GAPDH_TAA_len41_fa20_ta0_fm14_tm6,c
3189@TOP@human_GAPDH_TAA_len41_fa20_ta0_fm14_tm6*116*c,0,1306,0,0,1306,0.0,116,3189@TOP@human_GAPDH_TAA_len41_fa20_ta0_fm14_tm6,c
3189@TOP@human_GAPDH_TAA_len41_fa20_ta0_fm14_tm6*117*a,1300,0,2,0,1302,0.002,117,3189@TOP@human_GAPDH_TAA_len41_fa20_ta0_fm14_tm6,a
3189@TOP@human_GAPDH_TAA_len41_fa20_ta0_fm14_tm6*118*a,1294,0,12,0,1306,0.009,118,3189@TOP@human_GAPDH_TAA_len41_fa20_ta0_fm14_tm6,a
3189@TOP@human_GAPDH_TAA_len41_fa20_ta0_fm14_tm6*119*g,0,0,1297,0,1297,1.0,119,3189@TOP@human_GAPDH_TAA_len41_fa20_ta0_fm14_tm6,g
3189@TOP@human_GAPDH_TAA_len41_fa20_ta0_fm14_tm6*120*g,0,0,1301,0,1301,1.0,120,3189@TOP@human_GAPDH_TAA_len41_fa20_ta0_fm14_tm6,g
3189@TOP@human_GAPDH_TAA_len41_fa20_ta0_fm14_tm6*121*a,1304,0,2,0,1306,0.002,121,3189@TOP@human_GAPDH_TAA_len41_fa20_ta0_fm14_tm6,a
3189@TOP@human_GAPDH_TAA_len41_fa20_ta0_fm14_tm6*122*g,0,0,1313,0,1313,1.0,122,3189@TOP@human_GAPDH_TAA_len41_fa20_ta0_fm14_tm6,g
3189@TOP@human_GAPDH_TAA_len41_fa20_ta0_fm14_tm6*123*t,0,0,1,1284,1285,0.001,123,3189@TOP@human_GAPDH_TAA_len41_fa20_ta0_fm14_tm6,t
3189@TOP@human_GAPDH_TAA_len41_fa20_ta0_fm14_tm6*124*a,1242,0,44,0,1286,0.034,124,3189@TOP@human_GAPDH_TAA_len41_fa20_ta0_fm14_tm6,a
3189@TOP@human_GAPDH_TAA_len41_fa20_ta0_fm14_tm6*125*a,1228,1,50,0,1279,0.039,125,3189@TOP@human_GAPDH_TAA_len41_fa20_ta0_fm14_tm6,a
3189@TOP@human_GAPDH_TAA_len41_fa20_ta0_fm14_tm6*126*g,0,0,1291,0,1291,1.0,126,3189@TOP@human_GAPDH_TAA_len41_fa20_ta0_fm14_tm6,g
3189@TOP@human_GAPDH_TAA_len41_fa20_ta0_fm14_tm6*127*a,1294,0,3,0,1297,0.002,127,3189@TOP@human_GAPDH_TAA_len41_fa20_ta0_fm14_tm6,a
3189@TOP@human_GAPDH_TAA_len41_fa20_ta0_fm14_tm6*128*c,0,1310,0,0,1310,0.0,128,3189@TOP@human_GAPDH_TAA_len41_fa20_ta0_fm14_tm6,c
3189@TOP@human_GAPDH_TAA_len41_fa20_ta0_fm14_tm6*129*c,0,1304,0,1,1305,0.0,129,3189@TOP@human_GAPDH_TAA_len41_fa20_ta0_fm14_tm6,c
3189@TOP@human_GAPDH_TAA_len41_fa20_ta0_fm14_tm6*130*c,0,1309,0,0,1309,0.0,130,3189@TOP@human_GAPDH_TAA_len41_fa20_ta0_fm14_tm6,c
3189@TOP@human_GAPDH_TAA_len41_fa20_ta0_fm14_tm6*131*c,0,1308,0,0,1308,0.0,131,3189@TOP@human_GAPDH_TAA_len41_fa20_ta0_fm14_tm6,c
3189@TOP@human_GAPDH_TAA_len41_fa20_ta0_fm14_tm6*132*t,0,0,4,1286,1290,0.003,132,3189@TOP@human_GAPDH_TAA_len41_fa20_ta0_fm14_tm6,t
3189@TOP@human_GAPDH_TAA_len41_fa20_ta0_fm14_tm6*133*g,0,0,1287,0,1287,1.0,133,3189@TOP@human_GAPDH_TAA_len41_fa20_ta0_fm14_tm6,g
3189@TOP@human_GAPDH_TAA_len41_fa20_ta0_fm14_tm6*134*g,0,0,1298,0,1298,1.0,134,3189@TOP@human_GAPDH_TAA_len41_fa20_ta0_fm14_tm6,g
3190@TOP@human_GAPDH_TAA_len41_fa20_ta0_fm14_tm6*114*t,4,10,0,16367,16381,0.0,114,3190@TOP@human_GAPDH_TAA_len41_fa20_ta0_fm14_tm6,t
3190@TOP@human_GAPDH_TAA_len41_fa20_ta0_fm14_tm6*115*c,0,16472,0,0,16472,0.0,115,3190@TOP@human_GAPDH_TAA_len41_fa20_ta0_fm14_tm6,c
3190@TOP@human_GAPDH_TAA_len41_fa20_ta0_fm14_tm6*116*c,1,16407,1,2,16411,0.0,116,3190@TOP@human_GAPDH_TAA_len41_fa20_ta0_fm14_tm6,c
3190@TOP@human_GAPDH_TAA_len41_fa20_ta0_fm14_tm6*117*a,16377,0,19,1,16397,0.001,117,3190@TOP@human_GAPDH_TAA_len41_fa20_ta0_fm14_tm6,a
3190@TOP@human_GAPDH_TAA_len41_fa20_ta0_fm14_tm6*118*a,15953,1,352,1,16307,0.022,118,3190@TOP@human_GAPDH_TAA_len41_fa20_ta0_fm14_tm6,a
3190@TOP@human_GAPDH_TAA_len41_fa20_ta0_fm14_tm6*119*g,0,0,16298,1,16299,1.0,119,3190@TOP@human_GAPDH_TAA_len41_fa20_ta0_fm14_tm6,g
3190@TOP@human_GAPDH_TAA_len41_fa20_ta0_fm14_tm6*120*g,0,0,16238,0,16238,1.0,120,3190@TOP@human_GAPDH_TAA_len41_fa20_ta0_fm14_tm6,g
3190@TOP@human_GAPDH_TAA_len41_fa20_ta0_fm14_tm6*121*a,16393,0,6,0,16399,0.0,121,3190@TOP@human_GAPDH_TAA_len41_fa20_ta0_fm14_tm6,a
3190@TOP@human_GAPDH_TAA_len41_fa20_ta0_fm14_tm6*122*g,1,0,16409,0,16410,1.0,122,3190@TOP@human_GAPDH_TAA_len41_fa20_ta0_fm14_tm6,g
3190@TOP@human_GAPDH_TAA_len41_fa20_ta0_fm14_tm6*123*t,0,1,1,16213,16215,0.0,123,3190@TOP@human_GAPDH_TAA_len41_fa20_ta0_fm14_tm6,t
3190@TOP@human_GAPDH_TAA_len41_fa20_ta0_fm14_tm6*124*a,15391,0,762,0,16153,0.047,124,3190@TOP@human_GAPDH_TAA_len41_fa20_ta0_fm14_tm6,a
3190@TOP@human_GAPDH_TAA_len41_fa20_ta0_fm14_tm6*125*a,15853,1,272,0,16126,0.017,125,3190@TOP@human_GAPDH_TAA_len41_fa20_ta0_fm14_tm6,a
3190@TOP@human_GAPDH_TAA_len41_fa20_ta0_fm14_tm6*126*g,1,0,16243,1,16245,1.0,126,3190@TOP@human_GAPDH_TAA_len41_fa20_ta0_fm14_tm6,g
3190@TOP@human_GAPDH_TAA_len41_fa20_ta0_fm14_tm6*127*a,16345,0,16,0,16361,0.001,127,3190@TOP@human_GAPDH_TAA_len41_fa20_ta0_fm14_tm6,a
3190@TOP@human_GAPDH_TAA_len41_fa20_ta0_fm14_tm6*128*c,0,16440,1,0,16441,0.0,128,3190@TOP@human_GAPDH_TAA_len41_fa20_ta0_fm14_tm6,c
3190@TOP@human_GAPDH_TAA_len41_fa20_ta0_fm14_tm6*129*c,3,16334,0,0,16337,0.0,129,3190@TOP@human_GAPDH_TAA_len41_fa20_ta0_fm14_tm6,c
3190@TOP@human_GAPDH_TAA_len41_fa20_ta0_fm14_tm6*130*c,1,16409,0,0,16410,0.0,130,3190@TOP@human_GAPDH_TAA_len41_fa20_ta0_fm14_tm6,c
3190@TOP@human_GAPDH_TAA_len41_fa20_ta0_fm14_tm6*131*c,5,16440,0,1,16446,0.0,131,3190@TOP@human_GAPDH_TAA_len41_fa20_ta0_fm14_tm6,c
3190@TOP@human_GAPDH_TAA_len41_fa20_ta0_fm14_tm6*132*t,2,8,0,16165,16175,0.0,132,3190@TOP@human_GAPDH_TAA_len41_fa20_ta0_fm14_tm6,t
3190@TOP@human_GAPDH_TAA_len41_fa20_ta0_fm14_tm6*133*g,0,0,16196,0,16196,1.0,133,3190@TOP@human_GAPDH_TAA_len41_fa20_ta0_fm14_tm6,g
3190@TOP@human_GAPDH_TAA_len41_fa20_ta0_fm14_tm6*134*g,0,0,16270,0,16270,1.0,134,3190@TOP@human_GAPDH_TAA_len41_fa20_ta0_fm14_tm6,g
3191@TOP@human_GAPDH_TAA_len41_fa20_ta0_fm14_tm6*114*t,0,1,0,1987,1988,0.0,114,3191@TOP@human_GAPDH_TAA_len41_fa20_ta0_fm14_tm6,t
3191@TOP@human_GAPDH_TAA_len41_fa20_ta0_fm14_tm6*115*c,0,2006,0,0,2006,0.0,115,3191@TOP@human_GAPDH_TAA_len41_fa20_ta0_fm14_tm6,c
3191@TOP@human_GAPDH_TAA_len41_fa20_ta0_fm14_tm6*116*c,0,1995,0,0,1995,0.0,116,3191@TOP@human_GAPDH_TAA_len41_fa20_ta0_fm14_tm6,c
3191@TOP@human_GAPDH_TAA_len41_fa20_ta0_fm14_tm6*117*a,1994,0,1,0,1995,0.001,117,3191@TOP@human_GAPDH_TAA_len41_fa20_ta0_fm14_tm6,a
3191@TOP@human_GAPDH_TAA_len41_fa20_ta0_fm14_tm6*118*a,1937,0,31,0,1968,0.016,118,3191@TOP@human_GAPDH_TAA_len41_fa20_ta0_fm14_tm6,a
3191@TOP@human_GAPDH_TAA_len41_fa20_ta0_fm14_tm6*119*g,0,0,1979,0,1979,1.0,119,3191@TOP@human_GAPDH_TAA_len41_fa20_ta0_fm14_tm6,g
3191@TOP@human_GAPDH_TAA_len41_fa20_ta0_fm14_tm6*120*g,0,0,1964,0,1964,1.0,120,3191@TOP@human_GAPDH_TAA_len41_fa20_ta0_fm14_tm6,g
3191@TOP@human_GAPDH_TAA_len41_fa20_ta0_fm14_tm6*121*a,1985,1,0,0,1986,0.0,121,3191@TOP@human_GAPDH_TAA_len41_fa20_ta0_fm14_tm6,a
3191@TOP@human_GAPDH_TAA_len41_fa20_ta0_fm14_tm6*122*g,0,0,1996,0,1996,1.0,122,3191@TOP@human_GAPDH_TAA_len41_fa20_ta0_fm14_tm6,g
3191@TOP@human_GAPDH_TAA_len41_fa20_ta0_fm14_tm6*123*t,0,0,0,1966,1966,0.0,123,3191@TOP@human_GAPDH_TAA_len41_fa20_ta0_fm14_tm6,t
3191@TOP@human_GAPDH_TAA_len41_fa20_ta0_fm14_tm6*124*a,1813,0,146,0,1959,0.075,124,3191@TOP@human_GAPDH_TAA_len41_fa20_ta0_fm14_tm6,a
3191@TOP@human_GAPDH_TAA_len41_fa20_ta0_fm14_tm6*125*a,1931,0,33,0,1964,0.017,125,3191@TOP@human_GAPDH_TAA_len41_fa20_ta0_fm14_tm6,a
3191@TOP@human_GAPDH_TAA_len41_fa20_ta0_fm14_tm6*126*g,1,0,1972,0,1973,0.999,126,3191@TOP@human_GAPDH_TAA_len41_fa20_ta0_fm14_tm6,g
3191@TOP@human_GAPDH_TAA_len41_fa20_ta0_fm14_tm6*127*a,1981,0,0,0,1981,0.0,127,3191@TOP@human_GAPDH_TAA_len41_fa20_ta0_fm14_tm6,a
3191@TOP@human_GAPDH_TAA_len41_fa20_ta0_fm14_tm6*128*c,0,2002,1,0,2003,0.0,128,3191@TOP@human_GAPDH_TAA_len41_fa20_ta0_fm14_tm6,c
3191@TOP@human_GAPDH_TAA_len41_fa20_ta0_fm14_tm6*129*c,0,1981,0,0,1981,0.0,129,3191@TOP@human_GAPDH_TAA_len41_fa20_ta0_fm14_tm6,c
3191@TOP@human_GAPDH_TAA_len41_fa20_ta0_fm14_tm6*130*c,0,1999,0,0,1999,0.0,130,3191@TOP@human_GAPDH_TAA_len41_fa20_ta0_fm14_tm6,c
3191@TOP@human_GAPDH_TAA_len41_fa20_ta0_fm14_tm6*131*c,0,2003,0,0,2003,0.0,131,3191@TOP@human_GAPDH_TAA_len41_fa20_ta0_fm14_tm6,c
3191@TOP@human_GAPDH_TAA_len41_fa20_ta0_fm14_tm6*132*t,1,0,0,1975,1976,0.0,132,3191@TOP@human_GAPDH_TAA_len41_fa20_ta0_fm14_tm6,t
3191@TOP@human_GAPDH_TAA_len41_fa20_ta0_fm14_tm6*133*g,0,0,1975,0,1975,1.0,133,3191@TOP@human_GAPDH_TAA_len41_fa20_ta0_fm14_tm6,g
3191@TOP@human_GAPDH_TAA_len41_fa20_ta0_fm14_tm6*134*g,0,0,1974,0,1974,1.0,134,3191@TOP@human_GAPDH_TAA_len41_fa20_ta0_fm14_tm6,g
3192@TOP@human_GAPDH_TAA_len41_fa20_ta0_fm14_tm6*114*t,0,1,0,5465,5466,0.0,114,3192@TOP@human_GAPDH_TAA_len41_fa20_ta0_fm14_tm6,t
3192@TOP@human_GAPDH_TAA_len41_fa20_ta0_fm14_tm6*115*c,0,5500,0,0,5500,0.0,115,3192@TOP@human_GAPDH_TAA_len41_fa20_ta0_fm14_tm6,c
3192@TOP@human_GAPDH_TAA_len41_fa20_ta0_fm14_tm6*116*c,0,5473,0,2,5475,0.0,116,3192@TOP@human_GAPDH_TAA_len41_fa20_ta0_fm14_tm6,c
3192@TOP@human_GAPDH_TAA_len41_fa20_ta0_fm14_tm6*117*a,5471,0,8,0,5479,0.001,117,3192@TOP@human_GAPDH_TAA_len41_fa20_ta0_fm14_tm6,a
3192@TOP@human_GAPDH_TAA_len41_fa20_ta0_fm14_tm6*118*a,5340,1,101,0,5442,0.019,118,3192@TOP@human_GAPDH_TAA_len41_fa20_ta0_fm14_tm6,a
3192@TOP@human_GAPDH_TAA_len41_fa20_ta0_fm14_tm6*119*g,0,1,5429,0,5430,1.0,119,3192@TOP@human_GAPDH_TAA_len41_fa20_ta0_fm14_tm6,g
3192@TOP@human_GAPDH_TAA_len41_fa20_ta0_fm14_tm6*120*g,0,1,5413,0,5414,1.0,120,3192@TOP@human_GAPDH_TAA_len41_fa20_ta0_fm14_tm6,g
3192@TOP@human_GAPDH_TAA_len41_fa20_ta0_fm14_tm6*121*a,5457,0,1,0,5458,0.0,121,3192@TOP@human_GAPDH_TAA_len41_fa20_ta0_fm14_tm6,a
3192@TOP@human_GAPDH_TAA_len41_fa20_ta0_fm14_tm6*122*g,0,0,5481,1,5482,1.0,122,3192@TOP@human_GAPDH_TAA_len41_fa20_ta0_fm14_tm6,g
3192@TOP@human_GAPDH_TAA_len41_fa20_ta0_fm14_tm6*123*t,0,0,1,5414,5415,0.0,123,3192@TOP@human_GAPDH_TAA_len41_fa20_ta0_fm14_tm6,t
3192@TOP@human_GAPDH_TAA_len41_fa20_ta0_fm14_tm6*124*a,4932,0,458,0,5390,0.085,124,3192@TOP@human_GAPDH_TAA_len41_fa20_ta0_fm14_tm6,a
3192@TOP@human_GAPDH_TAA_len41_fa20_ta0_fm14_tm6*125*a,5250,0,121,0,5371,0.023,125,3192@TOP@human_GAPDH_TAA_len41_fa20_ta0_fm14_tm6,a
3192@TOP@human_GAPDH_TAA_len41_fa20_ta0_fm14_tm6*126*g,0,0,5408,0,5408,1.0,126,3192@TOP@human_GAPDH_TAA_len41_fa20_ta0_fm14_tm6,g
3192@TOP@human_GAPDH_TAA_len41_fa20_ta0_fm14_tm6*127*a,5439,0,11,0,5450,0.002,127,3192@TOP@human_GAPDH_TAA_len41_fa20_ta0_fm14_tm6,a
3192@TOP@human_GAPDH_TAA_len41_fa20_ta0_fm14_tm6*128*c,0,5492,0,0,5492,0.0,128,3192@TOP@human_GAPDH_TAA_len41_fa20_ta0_fm14_tm6,c
3192@TOP@human_GAPDH_TAA_len41_fa20_ta0_fm14_tm6*129*c,0,5453,0,0,5453,0.0,129,3192@TOP@human_GAPDH_TAA_len41_fa20_ta0_fm14_tm6,c
3192@TOP@human_GAPDH_TAA_len41_fa20_ta0_fm14_tm6*130*c,0,5478,0,0,5478,0.0,130,3192@TOP@human_GAPDH_TAA_len41_fa20_ta0_fm14_tm6,c
3192@TOP@human_GAPDH_TAA_len41_fa20_ta0_fm14_tm6*131*c,2,5495,0,0,5497,0.0,131,3192@TOP@human_GAPDH_TAA_len41_fa20_ta0_fm14_tm6,c
3192@TOP@human_GAPDH_TAA_len41_fa20_ta0_fm14_tm6*132*t,0,1,0,5405,5406,0.0,132,3192@TOP@human_GAPDH_TAA_len41_fa20_ta0_fm14_tm6,t
3192@TOP@human_GAPDH_TAA_len41_fa20_ta0_fm14_tm6*133*g,0,1,5409,0,5410,1.0,133,3192@TOP@human_GAPDH_TAA_len41_fa20_ta0_fm14_tm6,g
3192@TOP@human_GAPDH_TAA_len41_fa20_ta0_fm14_tm6*134*g,0,1,5424,0,5425,1.0,134,3192@TOP@human_GAPDH_TAA_len41_fa20_ta0_fm14_tm6,g
3193@TOP@human_GAPDH_TAA_len41_fa20_ta0_fm14_tm6*114*t,0,1,0,4954,4955,0.0,114,3193@TOP@human_GAPDH_TAA_len41_fa20_ta0_fm14_tm6,t
3193@TOP@human_GAPDH_TAA_len41_fa20_ta0_fm14_tm6*115*c,1,4983,0,0,4984,0.0,115,3193@TOP@human_GAPDH_TAA_len41_fa20_ta0_fm14_tm6,c
3193@TOP@human_GAPDH_TAA_len41_fa20_ta0_fm14_tm6*116*c,0,4958,0,0,4958,0.0,116,3193@TOP@human_GAPDH_TAA_len41_fa20_ta0_fm14_tm6,c
3193@TOP@human_GAPDH_TAA_len41_fa20_ta0_fm14_tm6*117*a,4952,0,9,0,4961,0.002,117,3193@TOP@human_GAPDH_TAA_len41_fa20_ta0_fm14_tm6,a
3193@TOP@human_GAPDH_TAA_len41_fa20_ta0_fm14_tm6*118*a,4865,0,65,0,4930,0.013,118,3193@TOP@human_GAPDH_TAA_len41_fa20_ta0_fm14_tm6,a
3193@TOP@human_GAPDH_TAA_len41_fa20_ta0_fm14_tm6*119*g,0,0,4928,0,4928,1.0,119,3193@TOP@human_GAPDH_TAA_len41_fa20_ta0_fm14_tm6,g
3193@TOP@human_GAPDH_TAA_len41_fa20_ta0_fm14_tm6*120*g,0,1,4912,0,4913,1.0,120,3193@TOP@human_GAPDH_TAA_len41_fa20_ta0_fm14_tm6,g
3193@TOP@human_GAPDH_TAA_len41_fa20_ta0_fm14_tm6*121*a,4949,0,2,0,4951,0.0,121,3193@TOP@human_GAPDH_TAA_len41_fa20_ta0_fm14_tm6,a
3193@TOP@human_GAPDH_TAA_len41_fa20_ta0_fm14_tm6*122*g,0,0,4962,0,4962,1.0,122,3193@TOP@human_GAPDH_TAA_len41_fa20_ta0_fm14_tm6,g
3193@TOP@human_GAPDH_TAA_len41_fa20_ta0_fm14_tm6*123*t,1,1,1,4886,4889,0.0,123,3193@TOP@human_GAPDH_TAA_len41_fa20_ta0_fm14_tm6,t
3193@TOP@human_GAPDH_TAA_len41_fa20_ta0_fm14_tm6*124*a,4706,0,176,0,4882,0.036,124,3193@TOP@human_GAPDH_TAA_len41_fa20_ta0_fm14_tm6,a
3193@TOP@human_GAPDH_TAA_len41_fa20_ta0_fm14_tm6*125*a,4788,0,82,0,4870,0.017,125,3193@TOP@human_GAPDH_TAA_len41_fa20_ta0_fm14_tm6,a
3193@TOP@human_GAPDH_TAA_len41_fa20_ta0_fm14_tm6*126*g,0,0,4896,0,4896,1.0,126,3193@TOP@human_GAPDH_TAA_len41_fa20_ta0_fm14_tm6,g
3193@TOP@human_GAPDH_TAA_len41_fa20_ta0_fm14_tm6*127*a,4944,0,0,0,4944,0.0,127,3193@TOP@human_GAPDH_TAA_len41_fa20_ta0_fm14_tm6,a
3193@TOP@human_GAPDH_TAA_len41_fa20_ta0_fm14_tm6*128*c,0,4969,0,0,4969,0.0,128,3193@TOP@human_GAPDH_TAA_len41_fa20_ta0_fm14_tm6,c
3193@TOP@human_GAPDH_TAA_len41_fa20_ta0_fm14_tm6*129*c,0,4933,0,0,4933,0.0,129,3193@TOP@human_GAPDH_TAA_len41_fa20_ta0_fm14_tm6,c
3193@TOP@human_GAPDH_TAA_len41_fa20_ta0_fm14_tm6*130*c,2,4964,0,0,4966,0.0,130,3193@TOP@human_GAPDH_TAA_len41_fa20_ta0_fm14_tm6,c
3193@TOP@human_GAPDH_TAA_len41_fa20_ta0_fm14_tm6*131*c,0,4969,0,0,4969,0.0,131,3193@TOP@human_GAPDH_TAA_len41_fa20_ta0_fm14_tm6,c
3193@TOP@human_GAPDH_TAA_len41_fa20_ta0_fm14_tm6*132*t,1,2,0,4894,4897,0.0,132,3193@TOP@human_GAPDH_TAA_len41_fa20_ta0_fm14_tm6,t
3193@TOP@human_GAPDH_TAA_len41_fa20_ta0_fm14_tm6*133*g,0,0,4895,1,4896,1.0,133,3193@TOP@human_GAPDH_TAA_len41_fa20_ta0_fm14_tm6,g
3193@TOP@human_GAPDH_TAA_len41_fa20_ta0_fm14_tm6*134*g,1,0,4929,0,4930,1.0,134,3193@TOP@human_GAPDH_TAA_len41_fa20_ta0_fm14_tm6,g
3194@TOP@human_GAPDH_TAA_len41_fa20_ta0_fm14_tm6*114*t,2,2,0,20654,20658,0.0,114,3194@TOP@human_GAPDH_TAA_len41_fa20_ta0_fm14_tm6,t
3194@TOP@human_GAPDH_TAA_len41_fa20_ta0_fm14_tm6*115*c,0,20756,0,2,20758,0.0,115,3194@TOP@human_GAPDH_TAA_len41_fa20_ta0_fm14_tm6,c
3194@TOP@human_GAPDH_TAA_len41_fa20_ta0_fm14_tm6*116*c,0,20676,0,0,20676,0.0,116,3194@TOP@human_GAPDH_TAA_len41_fa20_ta0_fm14_tm6,c
3194@TOP@human_GAPDH_TAA_len41_fa20_ta0_fm14_tm6*117*a,20635,0,25,1,20661,0.001,117,3194@TOP@human_GAPDH_TAA_len41_fa20_ta0_fm14_tm6,a
3194@TOP@human_GAPDH_TAA_len41_fa20_ta0_fm14_tm6*118*a,20319,1,214,1,20535,0.01,118,3194@TOP@human_GAPDH_TAA_len41_fa20_ta0_fm14_tm6,a
3194@TOP@human_GAPDH_TAA_len41_fa20_ta0_fm14_tm6*119*g,2,0,20517,1,20520,1.0,119,3194@TOP@human_GAPDH_TAA_len41_fa20_ta0_fm14_tm6,g
3194@TOP@human_GAPDH_TAA_len41_fa20_ta0_fm14_tm6*120*g,1,0,20437,1,20439,1.0,120,3194@TOP@human_GAPDH_TAA_len41_fa20_ta0_fm14_tm6,g
3194@TOP@human_GAPDH_TAA_len41_fa20_ta0_fm14_tm6*121*a,20651,0,3,0,20654,0.0,121,3194@TOP@human_GAPDH_TAA_len41_fa20_ta0_fm14_tm6,a
3194@TOP@human_GAPDH_TAA_len41_fa20_ta0_fm14_tm6*122*g,0,2,20657,2,20661,1.0,122,3194@TOP@human_GAPDH_TAA_len41_fa20_ta0_fm14_tm6,g
3194@TOP@human_GAPDH_TAA_len41_fa20_ta0_fm14_tm6*123*t,0,1,3,20383,20387,0.0,123,3194@TOP@human_GAPDH_TAA_len41_fa20_ta0_fm14_tm6,t
3194@TOP@human_GAPDH_TAA_len41_fa20_ta0_fm14_tm6*124*a,19719,0,586,0,20305,0.029,124,3194@TOP@human_GAPDH_TAA_len41_fa20_ta0_fm14_tm6,a
3194@TOP@human_GAPDH_TAA_len41_fa20_ta0_fm14_tm6*125*a,19985,3,312,2,20302,0.015,125,3194@TOP@human_GAPDH_TAA_len41_fa20_ta0_fm14_tm6,a
3194@TOP@human_GAPDH_TAA_len41_fa20_ta0_fm14_tm6*126*g,0,0,20413,0,20413,1.0,126,3194@TOP@human_GAPDH_TAA_len41_fa20_ta0_fm14_tm6,g
3194@TOP@human_GAPDH_TAA_len41_fa20_ta0_fm14_tm6*127*a,20593,0,9,1,20603,0.0,127,3194@TOP@human_GAPDH_TAA_len41_fa20_ta0_fm14_tm6,a
3194@TOP@human_GAPDH_TAA_len41_fa20_ta0_fm14_tm6*128*c,1,20711,1,1,20714,0.0,128,3194@TOP@human_GAPDH_TAA_len41_fa20_ta0_fm14_tm6,c
3194@TOP@human_GAPDH_TAA_len41_fa20_ta0_fm14_tm6*129*c,1,20547,0,4,20552,0.0,129,3194@TOP@human_GAPDH_TAA_len41_fa20_ta0_fm14_tm6,c
3194@TOP@human_GAPDH_TAA_len41_fa20_ta0_fm14_tm6*130*c,0,20671,0,2,20673,0.0,130,3194@TOP@human_GAPDH_TAA_len41_fa20_ta0_fm14_tm6,c
3194@TOP@human_GAPDH_TAA_len41_fa20_ta0_fm14_tm6*131*c,0,20716,0,4,20720,0.0,131,3194@TOP@human_GAPDH_TAA_len41_fa20_ta0_fm14_tm6,c
3194@TOP@human_GAPDH_TAA_len41_fa20_ta0_fm14_tm6*132*t,2,1,2,20404,20409,0.0,132,3194@TOP@human_GAPDH_TAA_len41_fa20_ta0_fm14_tm6,t
3194@TOP@human_GAPDH_TAA_len41_fa20_ta0_fm14_tm6*133*g,1,1,20410,2,20414,1.0,133,3194@TOP@human_GAPDH_TAA_len41_fa20_ta0_fm14_tm6,g
3194@TOP@human_GAPDH_TAA_len41_fa20_ta0_fm14_tm6*134*g,0,8,20484,1,20493,1.0,134,3194@TOP@human_GAPDH_TAA_len41_fa20_ta0_fm14_tm6,g
3195@TOP@human_GAPDH_TAA_len41_fa20_ta0_fm14_tm6*114*t,2,3,0,23452,23457,0.0,114,3195@TOP@human_GAPDH_TAA_len41_fa20_ta0_fm14_tm6,t
3195@TOP@human_GAPDH_TAA_len41_fa20_ta0_fm14_tm6*115*c,0,23565,0,0,23565,0.0,115,3195@TOP@human_GAPDH_TAA_len41_fa20_ta0_fm14_tm6,c
3195@TOP@human_GAPDH_TAA_len41_fa20_ta0_fm14_tm6*116*c,1,23471,0,0,23472,0.0,116,3195@TOP@human_GAPDH_TAA_len41_fa20_ta0_fm14_tm6,c
3195@TOP@human_GAPDH_TAA_len41_fa20_ta0_fm14_tm6*117*a,23433,0,25,0,23458,0.001,117,3195@TOP@human_GAPDH_TAA_len41_fa20_ta0_fm14_tm6,a
3195@TOP@human_GAPDH_TAA_len41_fa20_ta0_fm14_tm6*118*a,23150,0,212,2,23364,0.009,118,3195@TOP@human_GAPDH_TAA_len41_fa20_ta0_fm14_tm6,a
3195@TOP@human_GAPDH_TAA_len41_fa20_ta0_fm14_tm6*119*g,0,0,23316,3,23319,1.0,119,3195@TOP@human_GAPDH_TAA_len41_fa20_ta0_fm14_tm6,g
3195@TOP@human_GAPDH_TAA_len41_fa20_ta0_fm14_tm6*120*g,0,0,23217,2,23219,1.0,120,3195@TOP@human_GAPDH_TAA_len41_fa20_ta0_fm14_tm6,g
3195@TOP@human_GAPDH_TAA_len41_fa20_ta0_fm14_tm6*121*a,23444,0,2,0,23446,0.0,121,3195@TOP@human_GAPDH_TAA_len41_fa20_ta0_fm14_tm6,a
3195@TOP@human_GAPDH_TAA_len41_fa20_ta0_fm14_tm6*122*g,0,0,23480,3,23483,1.0,122,3195@TOP@human_GAPDH_TAA_len41_fa20_ta0_fm14_tm6,g
3195@TOP@human_GAPDH_TAA_len41_fa20_ta0_fm14_tm6*123*t,2,0,1,23182,23185,0.0,123,3195@TOP@human_GAPDH_TAA_len41_fa20_ta0_fm14_tm6,t
3195@TOP@human_GAPDH_TAA_len41_fa20_ta0_fm14_tm6*124*a,22393,1,694,0,23088,0.03,124,3195@TOP@human_GAPDH_TAA_len41_fa20_ta0_fm14_tm6,a
3195@TOP@human_GAPDH_TAA_len41_fa20_ta0_fm14_tm6*125*a,22694,3,340,2,23039,0.015,125,3195@TOP@human_GAPDH_TAA_len41_fa20_ta0_fm14_tm6,a
3195@TOP@human_GAPDH_TAA_len41_fa20_ta0_fm14_tm6*126*g,2,0,23191,0,23193,1.0,126,3195@TOP@human_GAPDH_TAA_len41_fa20_ta0_fm14_tm6,g
3195@TOP@human_GAPDH_TAA_len41_fa20_ta0_fm14_tm6*127*a,23389,0,17,3,23409,0.001,127,3195@TOP@human_GAPDH_TAA_len41_fa20_ta0_fm14_tm6,a
3195@TOP@human_GAPDH_TAA_len41_fa20_ta0_fm14_tm6*128*c,1,23514,9,0,23524,0.0,128,3195@TOP@human_GAPDH_TAA_len41_fa20_ta0_fm14_tm6,c
3195@TOP@human_GAPDH_TAA_len41_fa20_ta0_fm14_tm6*129*c,0,23360,0,0,23360,0.0,129,3195@TOP@human_GAPDH_TAA_len41_fa20_ta0_fm14_tm6,c
3195@TOP@human_GAPDH_TAA_len41_fa20_ta0_fm14_tm6*130*c,3,23474,0,3,23480,0.0,130,3195@TOP@human_GAPDH_TAA_len41_fa20_ta0_fm14_tm6,c
3195@TOP@human_GAPDH_TAA_len41_fa20_ta0_fm14_tm6*131*c,3,23532,0,4,23539,0.0,131,3195@TOP@human_GAPDH_TAA_len41_fa20_ta0_fm14_tm6,c
3195@TOP@human_GAPDH_TAA_len41_fa20_ta0_fm14_tm6*132*t,8,6,0,23157,23171,0.0,132,3195@TOP@human_GAPDH_TAA_len41_fa20_ta0_fm14_tm6,t
3195@TOP@human_GAPDH_TAA_len41_fa20_ta0_fm14_tm6*133*g,3,1,23130,4,23138,1.0,133,3195@TOP@human_GAPDH_TAA_len41_fa20_ta0_fm14_tm6,g
3195@TOP@human_GAPDH_TAA_len41_fa20_ta0_fm14_tm6*134*g,2,11,23256,0,23269,0.999,134,3195@TOP@human_GAPDH_TAA_len41_fa20_ta0_fm14_tm6,g
3196@TOP@human_GAPDH_TAA_len41_fa20_ta0_fm14_tm6*114*t,1,3,0,27933,27937,0.0,114,3196@TOP@human_GAPDH_TAA_len41_fa20_ta0_fm14_tm6,t
3196@TOP@human_GAPDH_TAA_len41_fa20_ta0_fm14_tm6*115*c,1,28084,0,0,28085,0.0,115,3196@TOP@human_GAPDH_TAA_len41_fa20_ta0_fm14_tm6,c
3196@TOP@human_GAPDH_TAA_len41_fa20_ta0_fm14_tm6*116*c,0,27998,0,0,27998,0.0,116,3196@TOP@human_GAPDH_TAA_len41_fa20_ta0_fm14_tm6,c
3196@TOP@human_GAPDH_TAA_len41_fa20_ta0_fm14_tm6*117*a,27937,0,35,1,27973,0.001,117,3196@TOP@human_GAPDH_TAA_len41_fa20_ta0_fm14_tm6,a
3196@TOP@human_GAPDH_TAA_len41_fa20_ta0_fm14_tm6*118*a,27500,1,303,0,27804,0.011,118,3196@TOP@human_GAPDH_TAA_len41_fa20_ta0_fm14_tm6,a
3196@TOP@human_GAPDH_TAA_len41_fa20_ta0_fm14_tm6*119*g,2,0,27769,0,27771,1.0,119,3196@TOP@human_GAPDH_TAA_len41_fa20_ta0_fm14_tm6,g
3196@TOP@human_GAPDH_TAA_len41_fa20_ta0_fm14_tm6*120*g,1,0,27677,2,27680,1.0,120,3196@TOP@human_GAPDH_TAA_len41_fa20_ta0_fm14_tm6,g
3196@TOP@human_GAPDH_TAA_len41_fa20_ta0_fm14_tm6*121*a,27922,1,9,0,27932,0.0,121,3196@TOP@human_GAPDH_TAA_len41_fa20_ta0_fm14_tm6,a
3196@TOP@human_GAPDH_TAA_len41_fa20_ta0_fm14_tm6*122*g,0,0,27985,0,27985,1.0,122,3196@TOP@human_GAPDH_TAA_len41_fa20_ta0_fm14_tm6,g
3196@TOP@human_GAPDH_TAA_len41_fa20_ta0_fm14_tm6*123*t,3,0,5,27591,27599,0.0,123,3196@TOP@human_GAPDH_TAA_len41_fa20_ta0_fm14_tm6,t
3196@TOP@human_GAPDH_TAA_len41_fa20_ta0_fm14_tm6*124*a,26731,2,767,2,27502,0.028,124,3196@TOP@human_GAPDH_TAA_len41_fa20_ta0_fm14_tm6,a
3196@TOP@human_GAPDH_TAA_len41_fa20_ta0_fm14_tm6*125*a,26992,0,442,0,27434,0.016,125,3196@TOP@human_GAPDH_TAA_len41_fa20_ta0_fm14_tm6,a
3196@TOP@human_GAPDH_TAA_len41_fa20_ta0_fm14_tm6*126*g,2,0,27610,5,27617,1.0,126,3196@TOP@human_GAPDH_TAA_len41_fa20_ta0_fm14_tm6,g
3196@TOP@human_GAPDH_TAA_len41_fa20_ta0_fm14_tm6*127*a,27866,0,24,1,27891,0.001,127,3196@TOP@human_GAPDH_TAA_len41_fa20_ta0_fm14_tm6,a
3196@TOP@human_GAPDH_TAA_len41_fa20_ta0_fm14_tm6*128*c,0,28006,4,1,28011,0.0,128,3196@TOP@human_GAPDH_TAA_len41_fa20_ta0_fm14_tm6,c
3196@TOP@human_GAPDH_TAA_len41_fa20_ta0_fm14_tm6*129*c,0,27825,0,1,27826,0.0,129,3196@TOP@human_GAPDH_TAA_len41_fa20_ta0_fm14_tm6,c
3196@TOP@human_GAPDH_TAA_len41_fa20_ta0_fm14_tm6*130*c,2,27974,0,0,27976,0.0,130,3196@TOP@human_GAPDH_TAA_len41_fa20_ta0_fm14_tm6,c
3196@TOP@human_GAPDH_TAA_len41_fa20_ta0_fm14_tm6*131*c,5,28015,0,3,28023,0.0,131,3196@TOP@human_GAPDH_TAA_len41_fa20_ta0_fm14_tm6,c
3196@TOP@human_GAPDH_TAA_len41_fa20_ta0_fm14_tm6*132*t,3,4,2,27660,27669,0.0,132,3196@TOP@human_GAPDH_TAA_len41_fa20_ta0_fm14_tm6,t
3196@TOP@human_GAPDH_TAA_len41_fa20_ta0_fm14_tm6*133*g,2,0,27577,1,27580,1.0,133,3196@TOP@human_GAPDH_TAA_len41_fa20_ta0_fm14_tm6,g
3196@TOP@human_GAPDH_TAA_len41_fa20_ta0_fm14_tm6*134*g,0,5,27720,5,27730,1.0,134,3196@TOP@human_GAPDH_TAA_len41_fa20_ta0_fm14_tm6,g
3197@TOP@human_GAPDH_TAA_len41_fa20_ta0_fm14_tm6*114*t,1,4,0,27375,27380,0.0,114,3197@TOP@human_GAPDH_TAA_len41_fa20_ta0_fm14_tm6,t
3197@TOP@human_GAPDH_TAA_len41_fa20_ta0_fm14_tm6*115*c,1,27498,0,0,27499,0.0,115,3197@TOP@human_GAPDH_TAA_len41_fa20_ta0_fm14_tm6,c
3197@TOP@human_GAPDH_TAA_len41_fa20_ta0_fm14_tm6*116*c,1,27384,0,3,27388,0.0,116,3197@TOP@human_GAPDH_TAA_len41_fa20_ta0_fm14_tm6,c
3197@TOP@human_GAPDH_TAA_len41_fa20_ta0_fm14_tm6*117*a,27322,1,43,1,27367,0.002,117,3197@TOP@human_GAPDH_TAA_len41_fa20_ta0_fm14_tm6,a
3197@TOP@human_GAPDH_TAA_len41_fa20_ta0_fm14_tm6*118*a,26926,0,300,0,27226,0.011,118,3197@TOP@human_GAPDH_TAA_len41_fa20_ta0_fm14_tm6,a
3197@TOP@human_GAPDH_TAA_len41_fa20_ta0_fm14_tm6*119*g,1,0,27133,1,27135,1.0,119,3197@TOP@human_GAPDH_TAA_len41_fa20_ta0_fm14_tm6,g
3197@TOP@human_GAPDH_TAA_len41_fa20_ta0_fm14_tm6*120*g,0,0,27086,2,27088,1.0,120,3197@TOP@human_GAPDH_TAA_len41_fa20_ta0_fm14_tm6,g
3197@TOP@human_GAPDH_TAA_len41_fa20_ta0_fm14_tm6*121*a,27336,0,14,0,27350,0.001,121,3197@TOP@human_GAPDH_TAA_len41_fa20_ta0_fm14_tm6,a
3197@TOP@human_GAPDH_TAA_len41_fa20_ta0_fm14_tm6*122*g,4,0,27384,0,27388,1.0,122,3197@TOP@human_GAPDH_TAA_len41_fa20_ta0_fm14_tm6,g
3197@TOP@human_GAPDH_TAA_len41_fa20_ta0_fm14_tm6*123*t,5,5,3,26978,26991,0.0,123,3197@TOP@human_GAPDH_TAA_len41_fa20_ta0_fm14_tm6,t
3197@TOP@human_GAPDH_TAA_len41_fa20_ta0_fm14_tm6*124*a,25933,0,1039,0,26972,0.039,124,3197@TOP@human_GAPDH_TAA_len41_fa20_ta0_fm14_tm6,a
3197@TOP@human_GAPDH_TAA_len41_fa20_ta0_fm14_tm6*125*a,26573,3,387,0,26963,0.014,125,3197@TOP@human_GAPDH_TAA_len41_fa20_ta0_fm14_tm6,a
3197@TOP@human_GAPDH_TAA_len41_fa20_ta0_fm14_tm6*126*g,0,0,26998,0,26998,1.0,126,3197@TOP@human_GAPDH_TAA_len41_fa20_ta0_fm14_tm6,g
3197@TOP@human_GAPDH_TAA_len41_fa20_ta0_fm14_tm6*127*a,27278,2,10,0,27290,0.0,127,3197@TOP@human_GAPDH_TAA_len41_fa20_ta0_fm14_tm6,a
3197@TOP@human_GAPDH_TAA_len41_fa20_ta0_fm14_tm6*128*c,0,27428,2,1,27431,0.0,128,3197@TOP@human_GAPDH_TAA_len41_fa20_ta0_fm14_tm6,c
3197@TOP@human_GAPDH_TAA_len41_fa20_ta0_fm14_tm6*129*c,2,27245,0,3,27250,0.0,129,3197@TOP@human_GAPDH_TAA_len41_fa20_ta0_fm14_tm6,c
3197@TOP@human_GAPDH_TAA_len41_fa20_ta0_fm14_tm6*130*c,1,27407,0,1,27409,0.0,130,3197@TOP@human_GAPDH_TAA_len41_fa20_ta0_fm14_tm6,c
3197@TOP@human_GAPDH_TAA_len41_fa20_ta0_fm14_tm6*131*c,3,27456,0,1,27460,0.0,131,3197@TOP@human_GAPDH_TAA_len41_fa20_ta0_fm14_tm6,c
3197@TOP@human_GAPDH_TAA_len41_fa20_ta0_fm14_tm6*132*t,6,9,3,27059,27077,0.0,132,3197@TOP@human_GAPDH_TAA_len41_fa20_ta0_fm14_tm6,t
3197@TOP@human_GAPDH_TAA_len41_fa20_ta0_fm14_tm6*133*g,1,3,26969,2,26975,1.0,133,3197@TOP@human_GAPDH_TAA_len41_fa20_ta0_fm14_tm6,g
3197@TOP@human_GAPDH_TAA_len41_fa20_ta0_fm14_tm6*134*g,1,4,27120,0,27125,1.0,134,3197@TOP@human_GAPDH_TAA_len41_fa20_ta0_fm14_tm6,g
3198@TOP@human_GAPDH_TAA_len41_fa20_ta0_fm14_tm6*114*t,2,4,0,26943,26949,0.0,114,3198@TOP@human_GAPDH_TAA_len41_fa20_ta0_fm14_tm6,t
3198@TOP@human_GAPDH_TAA_len41_fa20_ta0_fm14_tm6*115*c,0,27103,0,0,27103,0.0,115,3198@TOP@human_GAPDH_TAA_len41_fa20_ta0_fm14_tm6,c
3198@TOP@human_GAPDH_TAA_len41_fa20_ta0_fm14_tm6*116*c,0,27016,0,0,27016,0.0,116,3198@TOP@human_GAPDH_TAA_len41_fa20_ta0_fm14_tm6,c
3198@TOP@human_GAPDH_TAA_len41_fa20_ta0_fm14_tm6*117*a,26958,0,30,0,26988,0.001,117,3198@TOP@human_GAPDH_TAA_len41_fa20_ta0_fm14_tm6,a
3198@TOP@human_GAPDH_TAA_len41_fa20_ta0_fm14_tm6*118*a,26561,1,284,0,26846,0.011,118,3198@TOP@human_GAPDH_TAA_len41_fa20_ta0_fm14_tm6,a
3198@TOP@human_GAPDH_TAA_len41_fa20_ta0_fm14_tm6*119*g,1,1,26818,0,26820,1.0,119,3198@TOP@human_GAPDH_TAA_len41_fa20_ta0_fm14_tm6,g
3198@TOP@human_GAPDH_TAA_len41_fa20_ta0_fm14_tm6*120*g,0,2,26680,1,26683,1.0,120,3198@TOP@human_GAPDH_TAA_len41_fa20_ta0_fm14_tm6,g
3198@TOP@human_GAPDH_TAA_len41_fa20_ta0_fm14_tm6*121*a,26969,0,1,0,26970,0.0,121,3198@TOP@human_GAPDH_TAA_len41_fa20_ta0_fm14_tm6,a
3198@TOP@human_GAPDH_TAA_len41_fa20_ta0_fm14_tm6*122*g,1,1,27016,0,27018,1.0,122,3198@TOP@human_GAPDH_TAA_len41_fa20_ta0_fm14_tm6,g
3198@TOP@human_GAPDH_TAA_len41_fa20_ta0_fm14_tm6*123*t,4,2,3,26645,26654,0.0,123,3198@TOP@human_GAPDH_TAA_len41_fa20_ta0_fm14_tm6,t
3198@TOP@human_GAPDH_TAA_len41_fa20_ta0_fm14_tm6*124*a,25093,1,1474,0,26568,0.055,124,3198@TOP@human_GAPDH_TAA_len41_fa20_ta0_fm14_tm6,a
3198@TOP@human_GAPDH_TAA_len41_fa20_ta0_fm14_tm6*125*a,26068,3,429,1,26501,0.016,125,3198@TOP@human_GAPDH_TAA_len41_fa20_ta0_fm14_tm6,a
3198@TOP@human_GAPDH_TAA_len41_fa20_ta0_fm14_tm6*126*g,2,0,26679,0,26681,1.0,126,3198@TOP@human_GAPDH_TAA_len41_fa20_ta0_fm14_tm6,g
3198@TOP@human_GAPDH_TAA_len41_fa20_ta0_fm14_tm6*127*a,26899,1,16,0,26916,0.001,127,3198@TOP@human_GAPDH_TAA_len41_fa20_ta0_fm14_tm6,a
3198@TOP@human_GAPDH_TAA_len41_fa20_ta0_fm14_tm6*128*c,0,27030,1,5,27036,0.0,128,3198@TOP@human_GAPDH_TAA_len41_fa20_ta0_fm14_tm6,c
3198@TOP@human_GAPDH_TAA_len41_fa20_ta0_fm14_tm6*129*c,1,26835,0,1,26837,0.0,129,3198@TOP@human_GAPDH_TAA_len41_fa20_ta0_fm14_tm6,c
3198@TOP@human_GAPDH_TAA_len41_fa20_ta0_fm14_tm6*130*c,3,27005,1,2,27011,0.0,130,3198@TOP@human_GAPDH_TAA_len41_fa20_ta0_fm14_tm6,c
3198@TOP@human_GAPDH_TAA_len41_fa20_ta0_fm14_tm6*131*c,4,27050,0,2,27056,0.0,131,3198@TOP@human_GAPDH_TAA_len41_fa20_ta0_fm14_tm6,c
3198@TOP@human_GAPDH_TAA_len41_fa20_ta0_fm14_tm6*132*t,1,4,5,26688,26698,0.0,132,3198@TOP@human_GAPDH_TAA_len41_fa20_ta0_fm14_tm6,t
3198@TOP@human_GAPDH_TAA_len41_fa20_ta0_fm14_tm6*133*g,1,0,26650,0,26651,1.0,133,3198@TOP@human_GAPDH_TAA_len41_fa20_ta0_fm14_tm6,g
3198@TOP@human_GAPDH_TAA_len41_fa20_ta0_fm14_tm6*134*g,3,1,26716,0,26720,1.0,134,3198@TOP@human_GAPDH_TAA_len41_fa20_ta0_fm14_tm6,g
3199@TOP@human_GAPDH_TAA_len41_fa20_ta0_fm14_tm6*114*t,3,6,0,28008,28017,0.0,114,3199@TOP@human_GAPDH_TAA_len41_fa20_ta0_fm14_tm6,t
3199@TOP@human_GAPDH_TAA_len41_fa20_ta0_fm14_tm6*115*c,0,28174,0,2,28176,0.0,115,3199@TOP@human_GAPDH_TAA_len41_fa20_ta0_fm14_tm6,c
3199@TOP@human_GAPDH_TAA_len41_fa20_ta0_fm14_tm6*116*c,1,28069,0,3,28073,0.0,116,3199@TOP@human_GAPDH_TAA_len41_fa20_ta0_fm14_tm6,c
3199@TOP@human_GAPDH_TAA_len41_fa20_ta0_fm14_tm6*117*a,28042,1,27,0,28070,0.001,117,3199@TOP@human_GAPDH_TAA_len41_fa20_ta0_fm14_tm6,a
3199@TOP@human_GAPDH_TAA_len41_fa20_ta0_fm14_tm6*118*a,27656,1,252,2,27911,0.009,118,3199@TOP@human_GAPDH_TAA_len41_fa20_ta0_fm14_tm6,a
3199@TOP@human_GAPDH_TAA_len41_fa20_ta0_fm14_tm6*119*g,0,0,27839,1,27840,1.0,119,3199@TOP@human_GAPDH_TAA_len41_fa20_ta0_fm14_tm6,g
3199@TOP@human_GAPDH_TAA_len41_fa20_ta0_fm14_tm6*120*g,7,1,27746,0,27754,1.0,120,3199@TOP@human_GAPDH_TAA_len41_fa20_ta0_fm14_tm6,g
3199@TOP@human_GAPDH_TAA_len41_fa20_ta0_fm14_tm6*121*a,28036,0,9,1,28046,0.0,121,3199@TOP@human_GAPDH_TAA_len41_fa20_ta0_fm14_tm6,a
3199@TOP@human_GAPDH_TAA_len41_fa20_ta0_fm14_tm6*122*g,1,0,28040,0,28041,1.0,122,3199@TOP@human_GAPDH_TAA_len41_fa20_ta0_fm14_tm6,g
3199@TOP@human_GAPDH_TAA_len41_fa20_ta0_fm14_tm6*123*t,2,2,6,27680,27690,0.0,123,3199@TOP@human_GAPDH_TAA_len41_fa20_ta0_fm14_tm6,t
3199@TOP@human_GAPDH_TAA_len41_fa20_ta0_fm14_tm6*124*a,26562,0,1057,0,27619,0.038,124,3199@TOP@human_GAPDH_TAA_len41_fa20_ta0_fm14_tm6,a
3199@TOP@human_GAPDH_TAA_len41_fa20_ta0_fm14_tm6*125*a,27165,2,369,2,27538,0.013,125,3199@TOP@human_GAPDH_TAA_len41_fa20_ta0_fm14_tm6,a
3199@TOP@human_GAPDH_TAA_len41_fa20_ta0_fm14_tm6*126*g,0,1,27733,1,27735,1.0,126,3199@TOP@human_GAPDH_TAA_len41_fa20_ta0_fm14_tm6,g
3199@TOP@human_GAPDH_TAA_len41_fa20_ta0_fm14_tm6*127*a,27945,0,10,2,27957,0.0,127,3199@TOP@human_GAPDH_TAA_len41_fa20_ta0_fm14_tm6,a
3199@TOP@human_GAPDH_TAA_len41_fa20_ta0_fm14_tm6*128*c,0,28098,3,3,28104,0.0,128,3199@TOP@human_GAPDH_TAA_len41_fa20_ta0_fm14_tm6,c
3199@TOP@human_GAPDH_TAA_len41_fa20_ta0_fm14_tm6*129*c,2,27922,0,0,27924,0.0,129,3199@TOP@human_GAPDH_TAA_len41_fa20_ta0_fm14_tm6,c
3199@TOP@human_GAPDH_TAA_len41_fa20_ta0_fm14_tm6*130*c,2,28048,0,6,28056,0.0,130,3199@TOP@human_GAPDH_TAA_len41_fa20_ta0_fm14_tm6,c
3199@TOP@human_GAPDH_TAA_len41_fa20_ta0_fm14_tm6*131*c,6,28122,0,6,28134,0.0,131,3199@TOP@human_GAPDH_TAA_len41_fa20_ta0_fm14_tm6,c
3199@TOP@human_GAPDH_TAA_len41_fa20_ta0_fm14_tm6*132*t,4,4,1,27737,27746,0.0,132,3199@TOP@human_GAPDH_TAA_len41_fa20_ta0_fm14_tm6,t
3199@TOP@human_GAPDH_TAA_len41_fa20_ta0_fm14_tm6*133*g,1,0,27669,1,27671,1.0,133,3199@TOP@human_GAPDH_TAA_len41_fa20_ta0_fm14_tm6,g
3199@TOP@human_GAPDH_TAA_len41_fa20_ta0_fm14_tm6*134*g,2,4,27804,0,27810,1.0,134,3199@TOP@human_GAPDH_TAA_len41_fa20_ta0_fm14_tm6,g
3200@TOP@human_GAPDH_TAA_len41_fa20_ta0_fm14_tm6*114*t,1,8,0,27858,27867,0.0,114,3200@TOP@human_GAPDH_TAA_len41_fa20_ta0_fm14_tm6,t
3200@TOP@human_GAPDH_TAA_len41_fa20_ta0_fm14_tm6*115*c,2,28020,0,1,28023,0.0,115,3200@TOP@human_GAPDH_TAA_len41_fa20_ta0_fm14_tm6,c
3200@TOP@human_GAPDH_TAA_len41_fa20_ta0_fm14_tm6*116*c,4,27905,0,3,27912,0.0,116,3200@TOP@human_GAPDH_TAA_len41_fa20_ta0_fm14_tm6,c
3200@TOP@human_GAPDH_TAA_len41_fa20_ta0_fm14_tm6*117*a,27852,0,41,0,27893,0.001,117,3200@TOP@human_GAPDH_TAA_len41_fa20_ta0_fm14_tm6,a
3200@TOP@human_GAPDH_TAA_len41_fa20_ta0_fm14_tm6*118*a,27480,1,285,0,27766,0.01,118,3200@TOP@human_GAPDH_TAA_len41_fa20_ta0_fm14_tm6,a
3200@TOP@human_GAPDH_TAA_len41_fa20_ta0_fm14_tm6*119*g,4,0,27722,0,27726,1.0,119,3200@TOP@human_GAPDH_TAA_len41_fa20_ta0_fm14_tm6,g
3200@TOP@human_GAPDH_TAA_len41_fa20_ta0_fm14_tm6*120*g,4,0,27606,3,27613,1.0,120,3200@TOP@human_GAPDH_TAA_len41_fa20_ta0_fm14_tm6,g
3200@TOP@human_GAPDH_TAA_len41_fa20_ta0_fm14_tm6*121*a,27866,0,9,1,27876,0.0,121,3200@TOP@human_GAPDH_TAA_len41_fa20_ta0_fm14_tm6,a
3200@TOP@human_GAPDH_TAA_len41_fa20_ta0_fm14_tm6*122*g,2,1,27906,0,27909,1.0,122,3200@TOP@human_GAPDH_TAA_len41_fa20_ta0_fm14_tm6,g
3200@TOP@human_GAPDH_TAA_len41_fa20_ta0_fm14_tm6*123*t,2,1,5,27542,27550,0.0,123,3200@TOP@human_GAPDH_TAA_len41_fa20_ta0_fm14_tm6,t
3200@TOP@human_GAPDH_TAA_len41_fa20_ta0_fm14_tm6*124*a,26571,0,865,2,27438,0.032,124,3200@TOP@human_GAPDH_TAA_len41_fa20_ta0_fm14_tm6,a
3200@TOP@human_GAPDH_TAA_len41_fa20_ta0_fm14_tm6*125*a,26926,2,434,3,27365,0.016,125,3200@TOP@human_GAPDH_TAA_len41_fa20_ta0_fm14_tm6,a
3200@TOP@human_GAPDH_TAA_len41_fa20_ta0_fm14_tm6*126*g,1,0,27579,1,27581,1.0,126,3200@TOP@human_GAPDH_TAA_len41_fa20_ta0_fm14_tm6,g
3200@TOP@human_GAPDH_TAA_len41_fa20_ta0_fm14_tm6*127*a,27765,8,12,0,27785,0.0,127,3200@TOP@human_GAPDH_TAA_len41_fa20_ta0_fm14_tm6,a
3200@TOP@human_GAPDH_TAA_len41_fa20_ta0_fm14_tm6*128*c,1,27966,2,3,27972,0.0,128,3200@TOP@human_GAPDH_TAA_len41_fa20_ta0_fm14_tm6,c
3200@TOP@human_GAPDH_TAA_len41_fa20_ta0_fm14_tm6*129*c,3,27778,2,0,27783,0.0,129,3200@TOP@human_GAPDH_TAA_len41_fa20_ta0_fm14_tm6,c
3200@TOP@human_GAPDH_TAA_len41_fa20_ta0_fm14_tm6*130*c,1,27905,0,0,27906,0.0,130,3200@TOP@human_GAPDH_TAA_len41_fa20_ta0_fm14_tm6,c
3200@TOP@human_GAPDH_TAA_len41_fa20_ta0_fm14_tm6*131*c,2,27971,0,4,27977,0.0,131,3200@TOP@human_GAPDH_TAA_len41_fa20_ta0_fm14_tm6,c
3200@TOP@human_GAPDH_TAA_len41_fa20_ta0_fm14_tm6*132*t,2,11,5,27600,27618,0.0,132,3200@TOP@human_GAPDH_TAA_len41_fa20_ta0_fm14_tm6,t
3200@TOP@human_GAPDH_TAA_len41_fa20_ta0_fm14_tm6*133*g,1,0,27513,0,27514,1.0,133,3200@TOP@human_GAPDH_TAA_len41_fa20_ta0_fm14_tm6,g
3200@TOP@human_GAPDH_TAA_len41_fa20_ta0_fm14_tm6*134*g,3,3,27664,2,27672,1.0,134,3200@TOP@human_GAPDH_TAA_len41_fa20_ta0_fm14_tm6,g
3201@TOP@human_GAPDH_TAA_len41_fa20_ta0_fm14_tm6*114*t,4,11,0,17456,17471,0.0,114,3201@TOP@human_GAPDH_TAA_len41_fa20_ta0_fm14_tm6,t
3201@TOP@human_GAPDH_TAA_len41_fa20_ta0_fm14_tm6*115*c,0,17568,0,0,17568,0.0,115,3201@TOP@human_GAPDH_TAA_len41_fa20_ta0_fm14_tm6,c
3201@TOP@human_GAPDH_TAA_len41_fa20_ta0_fm14_tm6*116*c,1,17506,0,0,17507,0.0,116,3201@TOP@human_GAPDH_TAA_len41_fa20_ta0_fm14_tm6,c
3201@TOP@human_GAPDH_TAA_len41_fa20_ta0_fm14_tm6*117*a,17462,0,21,0,17483,0.001,117,3201@TOP@human_GAPDH_TAA_len41_fa20_ta0_fm14_tm6,a
3201@TOP@human_GAPDH_TAA_len41_fa20_ta0_fm14_tm6*118*a,17201,0,188,0,17389,0.011,118,3201@TOP@human_GAPDH_TAA_len41_fa20_ta0_fm14_tm6,a
3201@TOP@human_GAPDH_TAA_len41_fa20_ta0_fm14_tm6*119*g,0,0,17356,0,17356,1.0,119,3201@TOP@human_GAPDH_TAA_len41_fa20_ta0_fm14_tm6,g
3201@TOP@human_GAPDH_TAA_len41_fa20_ta0_fm14_tm6*120*g,1,1,17301,1,17304,1.0,120,3201@TOP@human_GAPDH_TAA_len41_fa20_ta0_fm14_tm6,g
3201@TOP@human_GAPDH_TAA_len41_fa20_ta0_fm14_tm6*121*a,17456,0,12,0,17468,0.001,121,3201@TOP@human_GAPDH_TAA_len41_fa20_ta0_fm14_tm6,a
3201@TOP@human_GAPDH_TAA_len41_fa20_ta0_fm14_tm6*122*g,0,0,17493,0,17493,1.0,122,3201@TOP@human_GAPDH_TAA_len41_fa20_ta0_fm14_tm6,g
3201@TOP@human_GAPDH_TAA_len41_fa20_ta0_fm14_tm6*123*t,2,2,1,17231,17236,0.0,123,3201@TOP@human_GAPDH_TAA_len41_fa20_ta0_fm14_tm6,t
3201@TOP@human_GAPDH_TAA_len41_fa20_ta0_fm14_tm6*124*a,16658,1,516,0,17175,0.03,124,3201@TOP@human_GAPDH_TAA_len41_fa20_ta0_fm14_tm6,a
3201@TOP@human_GAPDH_TAA_len41_fa20_ta0_fm14_tm6*125*a,16887,2,252,0,17141,0.015,125,3201@TOP@human_GAPDH_TAA_len41_fa20_ta0_fm14_tm6,a
3201@TOP@human_GAPDH_TAA_len41_fa20_ta0_fm14_tm6*126*g,1,0,17241,0,17242,1.0,126,3201@TOP@human_GAPDH_TAA_len41_fa20_ta0_fm14_tm6,g
3201@TOP@human_GAPDH_TAA_len41_fa20_ta0_fm14_tm6*127*a,17438,0,15,0,17453,0.001,127,3201@TOP@human_GAPDH_TAA_len41_fa20_ta0_fm14_tm6,a
3201@TOP@human_GAPDH_TAA_len41_fa20_ta0_fm14_tm6*128*c,0,17516,3,0,17519,0.0,128,3201@TOP@human_GAPDH_TAA_len41_fa20_ta0_fm14_tm6,c
3201@TOP@human_GAPDH_TAA_len41_fa20_ta0_fm14_tm6*129*c,1,17393,0,0,17394,0.0,129,3201@TOP@human_GAPDH_TAA_len41_fa20_ta0_fm14_tm6,c
3201@TOP@human_GAPDH_TAA_len41_fa20_ta0_fm14_tm6*130*c,1,17504,0,3,17508,0.0,130,3201@TOP@human_GAPDH_TAA_len41_fa20_ta0_fm14_tm6,c
3201@TOP@human_GAPDH_TAA_len41_fa20_ta0_fm14_tm6*131*c,0,17523,0,0,17523,0.0,131,3201@TOP@human_GAPDH_TAA_len41_fa20_ta0_fm14_tm6,c
3201@TOP@human_GAPDH_TAA_len41_fa20_ta0_fm14_tm6*132*t,5,2,4,17271,17282,0.0,132,3201@TOP@human_GAPDH_TAA_len41_fa20_ta0_fm14_tm6,t
3201@TOP@human_GAPDH_TAA_len41_fa20_ta0_fm14_tm6*133*g,2,2,17229,1,17234,1.0,133,3201@TOP@human_GAPDH_TAA_len41_fa20_ta0_fm14_tm6,g
3201@TOP@human_GAPDH_TAA_len41_fa20_ta0_fm14_tm6*134*g,0,3,17324,1,17328,1.0,134,3201@TOP@human_GAPDH_TAA_len41_fa20_ta0_fm14_tm6,g
3202@TOP@human_GAPDH_TAA_len41_fa20_ta0_fm14_tm6*114*t,0,5,0,3100,3105,0.0,114,3202@TOP@human_GAPDH_TAA_len41_fa20_ta0_fm14_tm6,t
3202@TOP@human_GAPDH_TAA_len41_fa20_ta0_fm14_tm6*115*c,0,3119,0,0,3119,0.0,115,3202@TOP@human_GAPDH_TAA_len41_fa20_ta0_fm14_tm6,c
3202@TOP@human_GAPDH_TAA_len41_fa20_ta0_fm14_tm6*116*c,0,3107,0,0,3107,0.0,116,3202@TOP@human_GAPDH_TAA_len41_fa20_ta0_fm14_tm6,c
3202@TOP@human_GAPDH_TAA_len41_fa20_ta0_fm14_tm6*117*a,3092,0,7,0,3099,0.002,117,3202@TOP@human_GAPDH_TAA_len41_fa20_ta0_fm14_tm6,a
3202@TOP@human_GAPDH_TAA_len41_fa20_ta0_fm14_tm6*118*a,3042,0,30,0,3072,0.01,118,3202@TOP@human_GAPDH_TAA_len41_fa20_ta0_fm14_tm6,a
3202@TOP@human_GAPDH_TAA_len41_fa20_ta0_fm14_tm6*119*g,0,0,3082,0,3082,1.0,119,3202@TOP@human_GAPDH_TAA_len41_fa20_ta0_fm14_tm6,g
3202@TOP@human_GAPDH_TAA_len41_fa20_ta0_fm14_tm6*120*g,0,0,3069,0,3069,1.0,120,3202@TOP@human_GAPDH_TAA_len41_fa20_ta0_fm14_tm6,g
3202@TOP@human_GAPDH_TAA_len41_fa20_ta0_fm14_tm6*121*a,3106,0,0,0,3106,0.0,121,3202@TOP@human_GAPDH_TAA_len41_fa20_ta0_fm14_tm6,a
3202@TOP@human_GAPDH_TAA_len41_fa20_ta0_fm14_tm6*122*g,0,0,3110,0,3110,1.0,122,3202@TOP@human_GAPDH_TAA_len41_fa20_ta0_fm14_tm6,g
3202@TOP@human_GAPDH_TAA_len41_fa20_ta0_fm14_tm6*123*t,0,0,0,3071,3071,0.0,123,3202@TOP@human_GAPDH_TAA_len41_fa20_ta0_fm14_tm6,t
3202@TOP@human_GAPDH_TAA_len41_fa20_ta0_fm14_tm6*124*a,2831,0,215,0,3046,0.071,124,3202@TOP@human_GAPDH_TAA_len41_fa20_ta0_fm14_tm6,a
3202@TOP@human_GAPDH_TAA_len41_fa20_ta0_fm14_tm6*125*a,2994,0,57,0,3051,0.019,125,3202@TOP@human_GAPDH_TAA_len41_fa20_ta0_fm14_tm6,a
3202@TOP@human_GAPDH_TAA_len41_fa20_ta0_fm14_tm6*126*g,0,0,3059,0,3059,1.0,126,3202@TOP@human_GAPDH_TAA_len41_fa20_ta0_fm14_tm6,g
3202@TOP@human_GAPDH_TAA_len41_fa20_ta0_fm14_tm6*127*a,3097,0,1,0,3098,0.0,127,3202@TOP@human_GAPDH_TAA_len41_fa20_ta0_fm14_tm6,a
3202@TOP@human_GAPDH_TAA_len41_fa20_ta0_fm14_tm6*128*c,0,3115,0,0,3115,0.0,128,3202@TOP@human_GAPDH_TAA_len41_fa20_ta0_fm14_tm6,c
3202@TOP@human_GAPDH_TAA_len41_fa20_ta0_fm14_tm6*129*c,0,3098,0,0,3098,0.0,129,3202@TOP@human_GAPDH_TAA_len41_fa20_ta0_fm14_tm6,c
3202@TOP@human_GAPDH_TAA_len41_fa20_ta0_fm14_tm6*130*c,0,3104,0,0,3104,0.0,130,3202@TOP@human_GAPDH_TAA_len41_fa20_ta0_fm14_tm6,c
3202@TOP@human_GAPDH_TAA_len41_fa20_ta0_fm14_tm6*131*c,0,3112,0,0,3112,0.0,131,3202@TOP@human_GAPDH_TAA_len41_fa20_ta0_fm14_tm6,c
3202@TOP@human_GAPDH_TAA_len41_fa20_ta0_fm14_tm6*132*t,1,1,0,3055,3057,0.0,132,3202@TOP@human_GAPDH_TAA_len41_fa20_ta0_fm14_tm6,t
3202@TOP@human_GAPDH_TAA_len41_fa20_ta0_fm14_tm6*133*g,3,0,3076,0,3079,0.999,133,3202@TOP@human_GAPDH_TAA_len41_fa20_ta0_fm14_tm6,g
3202@TOP@human_GAPDH_TAA_len41_fa20_ta0_fm14_tm6*134*g,0,2,3086,0,3088,0.999,134,3202@TOP@human_GAPDH_TAA_len41_fa20_ta0_fm14_tm6,g
3203@TOP@human_GAPDH_TAA_len41_fa20_ta0_fm14_tm6*114*t,1,2,0,9083,9086,0.0,114,3203@TOP@human_GAPDH_TAA_len41_fa20_ta0_fm14_tm6,t
3203@TOP@human_GAPDH_TAA_len41_fa20_ta0_fm14_tm6*115*c,0,9143,0,0,9143,0.0,115,3203@TOP@human_GAPDH_TAA_len41_fa20_ta0_fm14_tm6,c
3203@TOP@human_GAPDH_TAA_len41_fa20_ta0_fm14_tm6*116*c,1,9088,0,1,9090,0.0,116,3203@TOP@human_GAPDH_TAA_len41_fa20_ta0_fm14_tm6,c
3203@TOP@human_GAPDH_TAA_len41_fa20_ta0_fm14_tm6*117*a,9040,1,42,0,9083,0.005,117,3203@TOP@human_GAPDH_TAA_len41_fa20_ta0_fm14_tm6,a
3203@TOP@human_GAPDH_TAA_len41_fa20_ta0_fm14_tm6*118*a,8896,1,165,1,9063,0.018,118,3203@TOP@human_GAPDH_TAA_len41_fa20_ta0_fm14_tm6,a
3203@TOP@human_GAPDH_TAA_len41_fa20_ta0_fm14_tm6*119*g,0,0,9020,1,9021,1.0,119,3203@TOP@human_GAPDH_TAA_len41_fa20_ta0_fm14_tm6,g
3203@TOP@human_GAPDH_TAA_len41_fa20_ta0_fm14_tm6*120*g,0,0,8978,0,8978,1.0,120,3203@TOP@human_GAPDH_TAA_len41_fa20_ta0_fm14_tm6,g
3203@TOP@human_GAPDH_TAA_len41_fa20_ta0_fm14_tm6*121*a,9086,0,2,0,9088,0.0,121,3203@TOP@human_GAPDH_TAA_len41_fa20_ta0_fm14_tm6,a
3203@TOP@human_GAPDH_TAA_len41_fa20_ta0_fm14_tm6*122*g,0,0,9087,0,9087,1.0,122,3203@TOP@human_GAPDH_TAA_len41_fa20_ta0_fm14_tm6,g
3203@TOP@human_GAPDH_TAA_len41_fa20_ta0_fm14_tm6*123*t,0,0,0,8953,8953,0.0,123,3203@TOP@human_GAPDH_TAA_len41_fa20_ta0_fm14_tm6,t
3203@TOP@human_GAPDH_TAA_len41_fa20_ta0_fm14_tm6*124*a,8665,1,282,1,8949,0.032,124,3203@TOP@human_GAPDH_TAA_len41_fa20_ta0_fm14_tm6,a
3203@TOP@human_GAPDH_TAA_len41_fa20_ta0_fm14_tm6*125*a,8807,1,126,1,8935,0.014,125,3203@TOP@human_GAPDH_TAA_len41_fa20_ta0_fm14_tm6,a
3203@TOP@human_GAPDH_TAA_len41_fa20_ta0_fm14_tm6*126*g,1,0,8971,0,8972,1.0,126,3203@TOP@human_GAPDH_TAA_len41_fa20_ta0_fm14_tm6,g
3203@TOP@human_GAPDH_TAA_len41_fa20_ta0_fm14_tm6*127*a,9067,0,1,0,9068,0.0,127,3203@TOP@human_GAPDH_TAA_len41_fa20_ta0_fm14_tm6,a
3203@TOP@human_GAPDH_TAA_len41_fa20_ta0_fm14_tm6*128*c,0,9109,0,0,9109,0.0,128,3203@TOP@human_GAPDH_TAA_len41_fa20_ta0_fm14_tm6,c
3203@TOP@human_GAPDH_TAA_len41_fa20_ta0_fm14_tm6*129*c,1,9015,0,1,9017,0.0,129,3203@TOP@human_GAPDH_TAA_len41_fa20_ta0_fm14_tm6,c
3203@TOP@human_GAPDH_TAA_len41_fa20_ta0_fm14_tm6*130*c,0,9089,0,1,9090,0.0,130,3203@TOP@human_GAPDH_TAA_len41_fa20_ta0_fm14_tm6,c
3203@TOP@human_GAPDH_TAA_len41_fa20_ta0_fm14_tm6*131*c,3,9116,0,0,9119,0.0,131,3203@TOP@human_GAPDH_TAA_len41_fa20_ta0_fm14_tm6,c
3203@TOP@human_GAPDH_TAA_len41_fa20_ta0_fm14_tm6*132*t,1,0,0,8999,9000,0.0,132,3203@TOP@human_GAPDH_TAA_len41_fa20_ta0_fm14_tm6,t
3203@TOP@human_GAPDH_TAA_len41_fa20_ta0_fm14_tm6*133*g,0,0,8953,0,8953,1.0,133,3203@TOP@human_GAPDH_TAA_len41_fa20_ta0_fm14_tm6,g
3203@TOP@human_GAPDH_TAA_len41_fa20_ta0_fm14_tm6*134*g,0,2,8998,0,9000,1.0,134,3203@TOP@human_GAPDH_TAA_len41_fa20_ta0_fm14_tm6,g
3204@TOP@human_GAPDH_TAA_len41_fa20_ta0_fm14_tm6*114*t,0,0,0,4490,4490,0.0,114,3204@TOP@human_GAPDH_TAA_len41_fa20_ta0_fm14_tm6,t
3204@TOP@human_GAPDH_TAA_len41_fa20_ta0_fm14_tm6*115*c,1,4507,0,1,4509,0.0,115,3204@TOP@human_GAPDH_TAA_len41_fa20_ta0_fm14_tm6,c
3204@TOP@human_GAPDH_TAA_len41_fa20_ta0_fm14_tm6*116*c,0,4489,0,1,4490,0.0,116,3204@TOP@human_GAPDH_TAA_len41_fa20_ta0_fm14_tm6,c
3204@TOP@human_GAPDH_TAA_len41_fa20_ta0_fm14_tm6*117*a,4478,0,8,0,4486,0.002,117,3204@TOP@human_GAPDH_TAA_len41_fa20_ta0_fm14_tm6,a
3204@TOP@human_GAPDH_TAA_len41_fa20_ta0_fm14_tm6*118*a,4413,0,60,0,4473,0.013,118,3204@TOP@human_GAPDH_TAA_len41_fa20_ta0_fm14_tm6,a
3204@TOP@human_GAPDH_TAA_len41_fa20_ta0_fm14_tm6*119*g,0,0,4463,0,4463,1.0,119,3204@TOP@human_GAPDH_TAA_len41_fa20_ta0_fm14_tm6,g
3204@TOP@human_GAPDH_TAA_len41_fa20_ta0_fm14_tm6*120*g,0,0,4437,0,4437,1.0,120,3204@TOP@human_GAPDH_TAA_len41_fa20_ta0_fm14_tm6,g
3204@TOP@human_GAPDH_TAA_len41_fa20_ta0_fm14_tm6*121*a,4475,0,6,0,4481,0.001,121,3204@TOP@human_GAPDH_TAA_len41_fa20_ta0_fm14_tm6,a
3204@TOP@human_GAPDH_TAA_len41_fa20_ta0_fm14_tm6*122*g,0,0,4492,0,4492,1.0,122,3204@TOP@human_GAPDH_TAA_len41_fa20_ta0_fm14_tm6,g
3204@TOP@human_GAPDH_TAA_len41_fa20_ta0_fm14_tm6*123*t,0,0,1,4419,4420,0.0,123,3204@TOP@human_GAPDH_TAA_len41_fa20_ta0_fm14_tm6,t
3204@TOP@human_GAPDH_TAA_len41_fa20_ta0_fm14_tm6*124*a,4138,0,278,1,4417,0.063,124,3204@TOP@human_GAPDH_TAA_len41_fa20_ta0_fm14_tm6,a
3204@TOP@human_GAPDH_TAA_len41_fa20_ta0_fm14_tm6*125*a,4320,1,100,0,4421,0.023,125,3204@TOP@human_GAPDH_TAA_len41_fa20_ta0_fm14_tm6,a
3204@TOP@human_GAPDH_TAA_len41_fa20_ta0_fm14_tm6*126*g,0,0,4430,0,4430,1.0,126,3204@TOP@human_GAPDH_TAA_len41_fa20_ta0_fm14_tm6,g
3204@TOP@human_GAPDH_TAA_len41_fa20_ta0_fm14_tm6*127*a,4471,0,2,0,4473,0.0,127,3204@TOP@human_GAPDH_TAA_len41_fa20_ta0_fm14_tm6,a
3204@TOP@human_GAPDH_TAA_len41_fa20_ta0_fm14_tm6*128*c,0,4500,0,2,4502,0.0,128,3204@TOP@human_GAPDH_TAA_len41_fa20_ta0_fm14_tm6,c
3204@TOP@human_GAPDH_TAA_len41_fa20_ta0_fm14_tm6*129*c,0,4455,0,0,4455,0.0,129,3204@TOP@human_GAPDH_TAA_len41_fa20_ta0_fm14_tm6,c
3204@TOP@human_GAPDH_TAA_len41_fa20_ta0_fm14_tm6*130*c,0,4489,0,0,4489,0.0,130,3204@TOP@human_GAPDH_TAA_len41_fa20_ta0_fm14_tm6,c
3204@TOP@human_GAPDH_TAA_len41_fa20_ta0_fm14_tm6*131*c,0,4499,0,0,4499,0.0,131,3204@TOP@human_GAPDH_TAA_len41_fa20_ta0_fm14_tm6,c
3204@TOP@human_GAPDH_TAA_len41_fa20_ta0_fm14_tm6*132*t,2,0,0,4426,4428,0.0,132,3204@TOP@human_GAPDH_TAA_len41_fa20_ta0_fm14_tm6,t
3204@TOP@human_GAPDH_TAA_len41_fa20_ta0_fm14_tm6*133*g,0,0,4441,0,4441,1.0,133,3204@TOP@human_GAPDH_TAA_len41_fa20_ta0_fm14_tm6,g
3204@TOP@human_GAPDH_TAA_len41_fa20_ta0_fm14_tm6*134*g,0,1,4460,0,4461,1.0,134,3204@TOP@human_GAPDH_TAA_len41_fa20_ta0_fm14_tm6,g
3205@TOP@human_GAPDH_TAA_len41_fa20_ta0_fm14_tm6*114*t,1,1,0,1807,1809,0.0,114,3205@TOP@human_GAPDH_TAA_len41_fa20_ta0_fm14_tm6,t
3205@TOP@human_GAPDH_TAA_len41_fa20_ta0_fm14_tm6*115*c,0,1826,0,0,1826,0.0,115,3205@TOP@human_GAPDH_TAA_len41_fa20_ta0_fm14_tm6,c
3205@TOP@human_GAPDH_TAA_len41_fa20_ta0_fm14_tm6*116*c,0,1819,0,0,1819,0.0,116,3205@TOP@human_GAPDH_TAA_len41_fa20_ta0_fm14_tm6,c
3205@TOP@human_GAPDH_TAA_len41_fa20_ta0_fm14_tm6*117*a,1802,0,10,0,1812,0.006,117,3205@TOP@human_GAPDH_TAA_len41_fa20_ta0_fm14_tm6,a
3205@TOP@human_GAPDH_TAA_len41_fa20_ta0_fm14_tm6*118*a,1735,0,73,0,1808,0.04,118,3205@TOP@human_GAPDH_TAA_len41_fa20_ta0_fm14_tm6,a
3205@TOP@human_GAPDH_TAA_len41_fa20_ta0_fm14_tm6*119*g,0,0,1806,0,1806,1.0,119,3205@TOP@human_GAPDH_TAA_len41_fa20_ta0_fm14_tm6,g
3205@TOP@human_GAPDH_TAA_len41_fa20_ta0_fm14_tm6*120*g,0,0,1804,1,1805,0.999,120,3205@TOP@human_GAPDH_TAA_len41_fa20_ta0_fm14_tm6,g
3205@TOP@human_GAPDH_TAA_len41_fa20_ta0_fm14_tm6*121*a,1816,0,2,0,1818,0.001,121,3205@TOP@human_GAPDH_TAA_len41_fa20_ta0_fm14_tm6,a
3205@TOP@human_GAPDH_TAA_len41_fa20_ta0_fm14_tm6*122*g,1,1,1817,0,1819,0.999,122,3205@TOP@human_GAPDH_TAA_len41_fa20_ta0_fm14_tm6,g
3205@TOP@human_GAPDH_TAA_len41_fa20_ta0_fm14_tm6*123*t,0,0,0,1788,1788,0.0,123,3205@TOP@human_GAPDH_TAA_len41_fa20_ta0_fm14_tm6,t
3205@TOP@human_GAPDH_TAA_len41_fa20_ta0_fm14_tm6*124*a,1695,0,93,0,1788,0.052,124,3205@TOP@human_GAPDH_TAA_len41_fa20_ta0_fm14_tm6,a
3205@TOP@human_GAPDH_TAA_len41_fa20_ta0_fm14_tm6*125*a,1720,0,63,0,1783,0.035,125,3205@TOP@human_GAPDH_TAA_len41_fa20_ta0_fm14_tm6,a
3205@TOP@human_GAPDH_TAA_len41_fa20_ta0_fm14_tm6*126*g,0,0,1782,0,1782,1.0,126,3205@TOP@human_GAPDH_TAA_len41_fa20_ta0_fm14_tm6,g
3205@TOP@human_GAPDH_TAA_len41_fa20_ta0_fm14_tm6*127*a,1813,0,2,0,1815,0.001,127,3205@TOP@human_GAPDH_TAA_len41_fa20_ta0_fm14_tm6,a
3205@TOP@human_GAPDH_TAA_len41_fa20_ta0_fm14_tm6*128*c,0,1822,0,0,1822,0.0,128,3205@TOP@human_GAPDH_TAA_len41_fa20_ta0_fm14_tm6,c
3205@TOP@human_GAPDH_TAA_len41_fa20_ta0_fm14_tm6*129*c,0,1805,0,0,1805,0.0,129,3205@TOP@human_GAPDH_TAA_len41_fa20_ta0_fm14_tm6,c
3205@TOP@human_GAPDH_TAA_len41_fa20_ta0_fm14_tm6*130*c,0,1821,0,0,1821,0.0,130,3205@TOP@human_GAPDH_TAA_len41_fa20_ta0_fm14_tm6,c
3205@TOP@human_GAPDH_TAA_len41_fa20_ta0_fm14_tm6*131*c,0,1822,0,0,1822,0.0,131,3205@TOP@human_GAPDH_TAA_len41_fa20_ta0_fm14_tm6,c
3205@TOP@human_GAPDH_TAA_len41_fa20_ta0_fm14_tm6*132*t,0,0,1,1792,1793,0.001,132,3205@TOP@human_GAPDH_TAA_len41_fa20_ta0_fm14_tm6,t
3205@TOP@human_GAPDH_TAA_len41_fa20_ta0_fm14_tm6*133*g,0,0,1779,0,1779,1.0,133,3205@TOP@human_GAPDH_TAA_len41_fa20_ta0_fm14_tm6,g
3205@TOP@human_GAPDH_TAA_len41_fa20_ta0_fm14_tm6*134*g,0,0,1803,1,1804,0.999,134,3205@TOP@human_GAPDH_TAA_len41_fa20_ta0_fm14_tm6,g
3206@TOP@human_GAPDH_TAA_len41_fa20_ta0_fm14_tm6*114*t,0,2,0,2855,2857,0.0,114,3206@TOP@human_GAPDH_TAA_len41_fa20_ta0_fm14_tm6,t
3206@TOP@human_GAPDH_TAA_len41_fa20_ta0_fm14_tm6*115*c,0,2875,0,0,2875,0.0,115,3206@TOP@human_GAPDH_TAA_len41_fa20_ta0_fm14_tm6,c
3206@TOP@human_GAPDH_TAA_len41_fa20_ta0_fm14_tm6*116*c,0,2854,0,0,2854,0.0,116,3206@TOP@human_GAPDH_TAA_len41_fa20_ta0_fm14_tm6,c
3206@TOP@human_GAPDH_TAA_len41_fa20_ta0_fm14_tm6*117*a,2853,0,4,0,2857,0.001,117,3206@TOP@human_GAPDH_TAA_len41_fa20_ta0_fm14_tm6,a
3206@TOP@human_GAPDH_TAA_len41_fa20_ta0_fm14_tm6*118*a,2771,0,59,0,2830,0.021,118,3206@TOP@human_GAPDH_TAA_len41_fa20_ta0_fm14_tm6,a
3206@TOP@human_GAPDH_TAA_len41_fa20_ta0_fm14_tm6*119*g,0,0,2827,0,2827,1.0,119,3206@TOP@human_GAPDH_TAA_len41_fa20_ta0_fm14_tm6,g
3206@TOP@human_GAPDH_TAA_len41_fa20_ta0_fm14_tm6*120*g,0,0,2819,0,2819,1.0,120,3206@TOP@human_GAPDH_TAA_len41_fa20_ta0_fm14_tm6,g
3206@TOP@human_GAPDH_TAA_len41_fa20_ta0_fm14_tm6*121*a,2861,1,0,0,2862,0.0,121,3206@TOP@human_GAPDH_TAA_len41_fa20_ta0_fm14_tm6,a
3206@TOP@human_GAPDH_TAA_len41_fa20_ta0_fm14_tm6*122*g,0,0,2857,0,2857,1.0,122,3206@TOP@human_GAPDH_TAA_len41_fa20_ta0_fm14_tm6,g
3206@TOP@human_GAPDH_TAA_len41_fa20_ta0_fm14_tm6*123*t,0,0,1,2809,2810,0.0,123,3206@TOP@human_GAPDH_TAA_len41_fa20_ta0_fm14_tm6,t
3206@TOP@human_GAPDH_TAA_len41_fa20_ta0_fm14_tm6*124*a,2601,0,212,0,2813,0.075,124,3206@TOP@human_GAPDH_TAA_len41_fa20_ta0_fm14_tm6,a
3206@TOP@human_GAPDH_TAA_len41_fa20_ta0_fm14_tm6*125*a,2715,0,88,0,2803,0.031,125,3206@TOP@human_GAPDH_TAA_len41_fa20_ta0_fm14_tm6,a
3206@TOP@human_GAPDH_TAA_len41_fa20_ta0_fm14_tm6*126*g,0,0,2800,0,2800,1.0,126,3206@TOP@human_GAPDH_TAA_len41_fa20_ta0_fm14_tm6,g
3206@TOP@human_GAPDH_TAA_len41_fa20_ta0_fm14_tm6*127*a,2849,0,0,0,2849,0.0,127,3206@TOP@human_GAPDH_TAA_len41_fa20_ta0_fm14_tm6,a
3206@TOP@human_GAPDH_TAA_len41_fa20_ta0_fm14_tm6*128*c,0,2864,0,0,2864,0.0,128,3206@TOP@human_GAPDH_TAA_len41_fa20_ta0_fm14_tm6,c
3206@TOP@human_GAPDH_TAA_len41_fa20_ta0_fm14_tm6*129*c,1,2829,0,0,2830,0.0,129,3206@TOP@human_GAPDH_TAA_len41_fa20_ta0_fm14_tm6,c
3206@TOP@human_GAPDH_TAA_len41_fa20_ta0_fm14_tm6*130*c,1,2856,0,0,2857,0.0,130,3206@TOP@human_GAPDH_TAA_len41_fa20_ta0_fm14_tm6,c
3206@TOP@human_GAPDH_TAA_len41_fa20_ta0_fm14_tm6*131*c,0,2865,0,0,2865,0.0,131,3206@TOP@human_GAPDH_TAA_len41_fa20_ta0_fm14_tm6,c
3206@TOP@human_GAPDH_TAA_len41_fa20_ta0_fm14_tm6*132*t,1,1,0,2824,2826,0.0,132,3206@TOP@human_GAPDH_TAA_len41_fa20_ta0_fm14_tm6,t
3206@TOP@human_GAPDH_TAA_len41_fa20_ta0_fm14_tm6*133*g,0,1,2806,0,2807,1.0,133,3206@TOP@human_GAPDH_TAA_len41_fa20_ta0_fm14_tm6,g
3206@TOP@human_GAPDH_TAA_len41_fa20_ta0_fm14_tm6*134*g,1,0,2828,0,2829,1.0,134,3206@TOP@human_GAPDH_TAA_len41_fa20_ta0_fm14_tm6,g
3207@TOP@human_GAPDH_TAA_len41_fa20_ta0_fm14_tm6*114*t,0,0,1,1755,1756,0.001,114,3207@TOP@human_GAPDH_TAA_len41_fa20_ta0_fm14_tm6,t
3207@TOP@human_GAPDH_TAA_len41_fa20_ta0_fm14_tm6*115*c,0,1764,0,0,1764,0.0,115,3207@TOP@human_GAPDH_TAA_len41_fa20_ta0_fm14_tm6,c
3207@TOP@human_GAPDH_TAA_len41_fa20_ta0_fm14_tm6*116*c,0,1755,0,0,1755,0.0,116,3207@TOP@human_GAPDH_TAA_len41_fa20_ta0_fm14_tm6,c
3207@TOP@human_GAPDH_TAA_len41_fa20_ta0_fm14_tm6*117*a,1749,0,5,0,1754,0.003,117,3207@TOP@human_GAPDH_TAA_len41_fa20_ta0_fm14_tm6,a
3207@TOP@human_GAPDH_TAA_len41_fa20_ta0_fm14_tm6*118*a,1708,0,32,0,1740,0.018,118,3207@TOP@human_GAPDH_TAA_len41_fa20_ta0_fm14_tm6,a
3207@TOP@human_GAPDH_TAA_len41_fa20_ta0_fm14_tm6*119*g,0,0,1735,0,1735,1.0,119,3207@TOP@human_GAPDH_TAA_len41_fa20_ta0_fm14_tm6,g
3207@TOP@human_GAPDH_TAA_len41_fa20_ta0_fm14_tm6*120*g,0,0,1723,0,1723,1.0,120,3207@TOP@human_GAPDH_TAA_len41_fa20_ta0_fm14_tm6,g
3207@TOP@human_GAPDH_TAA_len41_fa20_ta0_fm14_tm6*121*a,1750,0,1,0,1751,0.001,121,3207@TOP@human_GAPDH_TAA_len41_fa20_ta0_fm14_tm6,a
3207@TOP@human_GAPDH_TAA_len41_fa20_ta0_fm14_tm6*122*g,0,0,1757,0,1757,1.0,122,3207@TOP@human_GAPDH_TAA_len41_fa20_ta0_fm14_tm6,g
3207@TOP@human_GAPDH_TAA_len41_fa20_ta0_fm14_tm6*123*t,1,0,0,1732,1733,0.0,123,3207@TOP@human_GAPDH_TAA_len41_fa20_ta0_fm14_tm6,t
3207@TOP@human_GAPDH_TAA_len41_fa20_ta0_fm14_tm6*124*a,1577,0,164,0,1741,0.094,124,3207@TOP@human_GAPDH_TAA_len41_fa20_ta0_fm14_tm6,a
3207@TOP@human_GAPDH_TAA_len41_fa20_ta0_fm14_tm6*125*a,1617,0,108,0,1725,0.063,125,3207@TOP@human_GAPDH_TAA_len41_fa20_ta0_fm14_tm6,a
3207@TOP@human_GAPDH_TAA_len41_fa20_ta0_fm14_tm6*126*g,0,0,1732,0,1732,1.0,126,3207@TOP@human_GAPDH_TAA_len41_fa20_ta0_fm14_tm6,g
3207@TOP@human_GAPDH_TAA_len41_fa20_ta0_fm14_tm6*127*a,1750,0,4,0,1754,0.002,127,3207@TOP@human_GAPDH_TAA_len41_fa20_ta0_fm14_tm6,a
3207@TOP@human_GAPDH_TAA_len41_fa20_ta0_fm14_tm6*128*c,1,1757,1,0,1759,0.001,128,3207@TOP@human_GAPDH_TAA_len41_fa20_ta0_fm14_tm6,c
3207@TOP@human_GAPDH_TAA_len41_fa20_ta0_fm14_tm6*129*c,0,1743,0,0,1743,0.0,129,3207@TOP@human_GAPDH_TAA_len41_fa20_ta0_fm14_tm6,c
3207@TOP@human_GAPDH_TAA_len41_fa20_ta0_fm14_tm6*130*c,0,1754,0,0,1754,0.0,130,3207@TOP@human_GAPDH_TAA_len41_fa20_ta0_fm14_tm6,c
3207@TOP@human_GAPDH_TAA_len41_fa20_ta0_fm14_tm6*131*c,0,1757,0,0,1757,0.0,131,3207@TOP@human_GAPDH_TAA_len41_fa20_ta0_fm14_tm6,c
3207@TOP@human_GAPDH_TAA_len41_fa20_ta0_fm14_tm6*132*t,0,1,0,1731,1732,0.0,132,3207@TOP@human_GAPDH_TAA_len41_fa20_ta0_fm14_tm6,t
3207@TOP@human_GAPDH_TAA_len41_fa20_ta0_fm14_tm6*133*g,0,0,1733,0,1733,1.0,133,3207@TOP@human_GAPDH_TAA_len41_fa20_ta0_fm14_tm6,g
3207@TOP@human_GAPDH_TAA_len41_fa20_ta0_fm14_tm6*134*g,1,2,1733,2,1738,0.997,134,3207@TOP@human_GAPDH_TAA_len41_fa20_ta0_fm14_tm6,g
3208@TOP@human_GAPDH_TAA_len41_fa20_ta0_fm14_tm6*114*t,1,0,0,1120,1121,0.0,114,3208@TOP@human_GAPDH_TAA_len41_fa20_ta0_fm14_tm6,t
3208@TOP@human_GAPDH_TAA_len41_fa20_ta0_fm14_tm6*115*c,0,1133,0,0,1133,0.0,115,3208@TOP@human_GAPDH_TAA_len41_fa20_ta0_fm14_tm6,c
3208@TOP@human_GAPDH_TAA_len41_fa20_ta0_fm14_tm6*116*c,0,1126,0,1,1127,0.0,116,3208@TOP@human_GAPDH_TAA_len41_fa20_ta0_fm14_tm6,c
3208@TOP@human_GAPDH_TAA_len41_fa20_ta0_fm14_tm6*117*a,1126,0,1,0,1127,0.001,117,3208@TOP@human_GAPDH_TAA_len41_fa20_ta0_fm14_tm6,a
3208@TOP@human_GAPDH_TAA_len41_fa20_ta0_fm14_tm6*118*a,1090,0,25,0,1115,0.022,118,3208@TOP@human_GAPDH_TAA_len41_fa20_ta0_fm14_tm6,a
3208@TOP@human_GAPDH_TAA_len41_fa20_ta0_fm14_tm6*119*g,0,0,1114,0,1114,1.0,119,3208@TOP@human_GAPDH_TAA_len41_fa20_ta0_fm14_tm6,g
3208@TOP@human_GAPDH_TAA_len41_fa20_ta0_fm14_tm6*120*g,0,0,1109,0,1109,1.0,120,3208@TOP@human_GAPDH_TAA_len41_fa20_ta0_fm14_tm6,g
3208@TOP@human_GAPDH_TAA_len41_fa20_ta0_fm14_tm6*121*a,1133,0,0,0,1133,0.0,121,3208@TOP@human_GAPDH_TAA_len41_fa20_ta0_fm14_tm6,a
3208@TOP@human_GAPDH_TAA_len41_fa20_ta0_fm14_tm6*122*g,0,0,1128,0,1128,1.0,122,3208@TOP@human_GAPDH_TAA_len41_fa20_ta0_fm14_tm6,g
3208@TOP@human_GAPDH_TAA_len41_fa20_ta0_fm14_tm6*123*t,1,0,0,1111,1112,0.0,123,3208@TOP@human_GAPDH_TAA_len41_fa20_ta0_fm14_tm6,t
3208@TOP@human_GAPDH_TAA_len41_fa20_ta0_fm14_tm6*124*a,1039,0,67,0,1106,0.061,124,3208@TOP@human_GAPDH_TAA_len41_fa20_ta0_fm14_tm6,a
3208@TOP@human_GAPDH_TAA_len41_fa20_ta0_fm14_tm6*125*a,1077,0,25,0,1102,0.023,125,3208@TOP@human_GAPDH_TAA_len41_fa20_ta0_fm14_tm6,a
3208@TOP@human_GAPDH_TAA_len41_fa20_ta0_fm14_tm6*126*g,0,0,1112,2,1114,0.998,126,3208@TOP@human_GAPDH_TAA_len41_fa20_ta0_fm14_tm6,g
3208@TOP@human_GAPDH_TAA_len41_fa20_ta0_fm14_tm6*127*a,1121,0,4,0,1125,0.004,127,3208@TOP@human_GAPDH_TAA_len41_fa20_ta0_fm14_tm6,a
3208@TOP@human_GAPDH_TAA_len41_fa20_ta0_fm14_tm6*128*c,0,1133,0,0,1133,0.0,128,3208@TOP@human_GAPDH_TAA_len41_fa20_ta0_fm14_tm6,c
3208@TOP@human_GAPDH_TAA_len41_fa20_ta0_fm14_tm6*129*c,0,1124,0,0,1124,0.0,129,3208@TOP@human_GAPDH_TAA_len41_fa20_ta0_fm14_tm6,c
3208@TOP@human_GAPDH_TAA_len41_fa20_ta0_fm14_tm6*130*c,0,1128,0,0,1128,0.0,130,3208@TOP@human_GAPDH_TAA_len41_fa20_ta0_fm14_tm6,c
3208@TOP@human_GAPDH_TAA_len41_fa20_ta0_fm14_tm6*131*c,0,1130,0,1,1131,0.0,131,3208@TOP@human_GAPDH_TAA_len41_fa20_ta0_fm14_tm6,c
3208@TOP@human_GAPDH_TAA_len41_fa20_ta0_fm14_tm6*132*t,0,1,0,1115,1116,0.0,132,3208@TOP@human_GAPDH_TAA_len41_fa20_ta0_fm14_tm6,t
3208@TOP@human_GAPDH_TAA_len41_fa20_ta0_fm14_tm6*133*g,0,0,1116,0,1116,1.0,133,3208@TOP@human_GAPDH_TAA_len41_fa20_ta0_fm14_tm6,g
3208@TOP@human_GAPDH_TAA_len41_fa20_ta0_fm14_tm6*134*g,0,0,1117,0,1117,1.0,134,3208@TOP@human_GAPDH_TAA_len41_fa20_ta0_fm14_tm6,g
3209@TOP@human_GAPDH_TAA_len41_fa20_ta0_fm14_tm6*114*t,0,8,0,10704,10712,0.0,114,3209@TOP@human_GAPDH_TAA_len41_fa20_ta0_fm14_tm6,t
3209@TOP@human_GAPDH_TAA_len41_fa20_ta0_fm14_tm6*115*c,0,10768,0,2,10770,0.0,115,3209@TOP@human_GAPDH_TAA_len41_fa20_ta0_fm14_tm6,c
3209@TOP@human_GAPDH_TAA_len41_fa20_ta0_fm14_tm6*116*c,0,10728,0,0,10728,0.0,116,3209@TOP@human_GAPDH_TAA_len41_fa20_ta0_fm14_tm6,c
3209@TOP@human_GAPDH_TAA_len41_fa20_ta0_fm14_tm6*117*a,10710,0,25,0,10735,0.002,117,3209@TOP@human_GAPDH_TAA_len41_fa20_ta0_fm14_tm6,a
3209@TOP@human_GAPDH_TAA_len41_fa20_ta0_fm14_tm6*118*a,10497,1,157,0,10655,0.015,118,3209@TOP@human_GAPDH_TAA_len41_fa20_ta0_fm14_tm6,a
3209@TOP@human_GAPDH_TAA_len41_fa20_ta0_fm14_tm6*119*g,0,1,10616,2,10619,1.0,119,3209@TOP@human_GAPDH_TAA_len41_fa20_ta0_fm14_tm6,g
3209@TOP@human_GAPDH_TAA_len41_fa20_ta0_fm14_tm6*120*g,0,0,10627,0,10627,1.0,120,3209@TOP@human_GAPDH_TAA_len41_fa20_ta0_fm14_tm6,g
3209@TOP@human_GAPDH_TAA_len41_fa20_ta0_fm14_tm6*121*a,10709,0,7,1,10717,0.001,121,3209@TOP@human_GAPDH_TAA_len41_fa20_ta0_fm14_tm6,a
3209@TOP@human_GAPDH_TAA_len41_fa20_ta0_fm14_tm6*122*g,2,0,10723,1,10726,1.0,122,3209@TOP@human_GAPDH_TAA_len41_fa20_ta0_fm14_tm6,g
3209@TOP@human_GAPDH_TAA_len41_fa20_ta0_fm14_tm6*123*t,0,1,2,10582,10585,0.0,123,3209@TOP@human_GAPDH_TAA_len41_fa20_ta0_fm14_tm6,t
3209@TOP@human_GAPDH_TAA_len41_fa20_ta0_fm14_tm6*124*a,10175,0,430,0,10605,0.041,124,3209@TOP@human_GAPDH_TAA_len41_fa20_ta0_fm14_tm6,a
3209@TOP@human_GAPDH_TAA_len41_fa20_ta0_fm14_tm6*125*a,10203,1,352,0,10556,0.033,125,3209@TOP@human_GAPDH_TAA_len41_fa20_ta0_fm14_tm6,a
3209@TOP@human_GAPDH_TAA_len41_fa20_ta0_fm14_tm6*126*g,0,0,10582,0,10582,1.0,126,3209@TOP@human_GAPDH_TAA_len41_fa20_ta0_fm14_tm6,g
3209@TOP@human_GAPDH_TAA_len41_fa20_ta0_fm14_tm6*127*a,10682,3,4,1,10690,0.0,127,3209@TOP@human_GAPDH_TAA_len41_fa20_ta0_fm14_tm6,a
3209@TOP@human_GAPDH_TAA_len41_fa20_ta0_fm14_tm6*128*c,0,10739,1,0,10740,0.0,128,3209@TOP@human_GAPDH_TAA_len41_fa20_ta0_fm14_tm6,c
3209@TOP@human_GAPDH_TAA_len41_fa20_ta0_fm14_tm6*129*c,0,10660,0,0,10660,0.0,129,3209@TOP@human_GAPDH_TAA_len41_fa20_ta0_fm14_tm6,c
3209@TOP@human_GAPDH_TAA_len41_fa20_ta0_fm14_tm6*130*c,1,10726,0,1,10728,0.0,130,3209@TOP@human_GAPDH_TAA_len41_fa20_ta0_fm14_tm6,c
3209@TOP@human_GAPDH_TAA_len41_fa20_ta0_fm14_tm6*131*c,5,10748,0,0,10753,0.0,131,3209@TOP@human_GAPDH_TAA_len41_fa20_ta0_fm14_tm6,c
3209@TOP@human_GAPDH_TAA_len41_fa20_ta0_fm14_tm6*132*t,1,3,0,10615,10619,0.0,132,3209@TOP@human_GAPDH_TAA_len41_fa20_ta0_fm14_tm6,t
3209@TOP@human_GAPDH_TAA_len41_fa20_ta0_fm14_tm6*133*g,1,2,10580,0,10583,1.0,133,3209@TOP@human_GAPDH_TAA_len41_fa20_ta0_fm14_tm6,g
3209@TOP@human_GAPDH_TAA_len41_fa20_ta0_fm14_tm6*134*g,0,1,10613,1,10615,1.0,134,3209@TOP@human_GAPDH_TAA_len41_fa20_ta0_fm14_tm6,g
3210@TOP@human_GAPDH_TAA_len41_fa20_ta0_fm14_tm6*114*t,2,1,0,10414,10417,0.0,114,3210@TOP@human_GAPDH_TAA_len41_fa20_ta0_fm14_tm6,t
3210@TOP@human_GAPDH_TAA_len41_fa20_ta0_fm14_tm6*115*c,0,10462,0,0,10462,0.0,115,3210@TOP@human_GAPDH_TAA_len41_fa20_ta0_fm14_tm6,c
3210@TOP@human_GAPDH_TAA_len41_fa20_ta0_fm14_tm6*116*c,1,10425,0,0,10426,0.0,116,3210@TOP@human_GAPDH_TAA_len41_fa20_ta0_fm14_tm6,c
3210@TOP@human_GAPDH_TAA_len41_fa20_ta0_fm14_tm6*117*a,10409,0,12,0,10421,0.001,117,3210@TOP@human_GAPDH_TAA_len41_fa20_ta0_fm14_tm6,a
3210@TOP@human_GAPDH_TAA_len41_fa20_ta0_fm14_tm6*118*a,10244,1,129,0,10374,0.012,118,3210@TOP@human_GAPDH_TAA_len41_fa20_ta0_fm14_tm6,a
3210@TOP@human_GAPDH_TAA_len41_fa20_ta0_fm14_tm6*119*g,0,0,10324,4,10328,1.0,119,3210@TOP@human_GAPDH_TAA_len41_fa20_ta0_fm14_tm6,g
3210@TOP@human_GAPDH_TAA_len41_fa20_ta0_fm14_tm6*120*g,0,0,10291,0,10291,1.0,120,3210@TOP@human_GAPDH_TAA_len41_fa20_ta0_fm14_tm6,g
3210@TOP@human_GAPDH_TAA_len41_fa20_ta0_fm14_tm6*121*a,10406,0,2,0,10408,0.0,121,3210@TOP@human_GAPDH_TAA_len41_fa20_ta0_fm14_tm6,a
3210@TOP@human_GAPDH_TAA_len41_fa20_ta0_fm14_tm6*122*g,1,0,10424,0,10425,1.0,122,3210@TOP@human_GAPDH_TAA_len41_fa20_ta0_fm14_tm6,g
3210@TOP@human_GAPDH_TAA_len41_fa20_ta0_fm14_tm6*123*t,2,3,1,10253,10259,0.0,123,3210@TOP@human_GAPDH_TAA_len41_fa20_ta0_fm14_tm6,t
3210@TOP@human_GAPDH_TAA_len41_fa20_ta0_fm14_tm6*124*a,9392,1,850,1,10244,0.083,124,3210@TOP@human_GAPDH_TAA_len41_fa20_ta0_fm14_tm6,a
3210@TOP@human_GAPDH_TAA_len41_fa20_ta0_fm14_tm6*125*a,10063,2,181,0,10246,0.018,125,3210@TOP@human_GAPDH_TAA_len41_fa20_ta0_fm14_tm6,a
3210@TOP@human_GAPDH_TAA_len41_fa20_ta0_fm14_tm6*126*g,0,0,10301,0,10301,1.0,126,3210@TOP@human_GAPDH_TAA_len41_fa20_ta0_fm14_tm6,g
3210@TOP@human_GAPDH_TAA_len41_fa20_ta0_fm14_tm6*127*a,10388,0,6,3,10397,0.001,127,3210@TOP@human_GAPDH_TAA_len41_fa20_ta0_fm14_tm6,a
3210@TOP@human_GAPDH_TAA_len41_fa20_ta0_fm14_tm6*128*c,0,10437,0,2,10439,0.0,128,3210@TOP@human_GAPDH_TAA_len41_fa20_ta0_fm14_tm6,c
3210@TOP@human_GAPDH_TAA_len41_fa20_ta0_fm14_tm6*129*c,0,10340,0,1,10341,0.0,129,3210@TOP@human_GAPDH_TAA_len41_fa20_ta0_fm14_tm6,c
3210@TOP@human_GAPDH_TAA_len41_fa20_ta0_fm14_tm6*130*c,0,10414,0,0,10414,0.0,130,3210@TOP@human_GAPDH_TAA_len41_fa20_ta0_fm14_tm6,c
3210@TOP@human_GAPDH_TAA_len41_fa20_ta0_fm14_tm6*131*c,1,10438,0,3,10442,0.0,131,3210@TOP@human_GAPDH_TAA_len41_fa20_ta0_fm14_tm6,c
3210@TOP@human_GAPDH_TAA_len41_fa20_ta0_fm14_tm6*132*t,4,1,0,10286,10291,0.0,132,3210@TOP@human_GAPDH_TAA_len41_fa20_ta0_fm14_tm6,t
3210@TOP@human_GAPDH_TAA_len41_fa20_ta0_fm14_tm6*133*g,1,0,10299,1,10301,1.0,133,3210@TOP@human_GAPDH_TAA_len41_fa20_ta0_fm14_tm6,g
3210@TOP@human_GAPDH_TAA_len41_fa20_ta0_fm14_tm6*134*g,1,2,10334,1,10338,1.0,134,3210@TOP@human_GAPDH_TAA_len41_fa20_ta0_fm14_tm6,g
3211@TOP@human_GAPDH_TAA_len41_fa20_ta0_fm14_tm6*114*t,0,0,0,1208,1208,0.0,114,3211@TOP@human_GAPDH_TAA_len41_fa20_ta0_fm14_tm6,t
3211@TOP@human_GAPDH_TAA_len41_fa20_ta0_fm14_tm6*115*c,0,1212,0,0,1212,0.0,115,3211@TOP@human_GAPDH_TAA_len41_fa20_ta0_fm14_tm6,c
3211@TOP@human_GAPDH_TAA_len41_fa20_ta0_fm14_tm6*116*c,0,1205,0,0,1205,0.0,116,3211@TOP@human_GAPDH_TAA_len41_fa20_ta0_fm14_tm6,c
3211@TOP@human_GAPDH_TAA_len41_fa20_ta0_fm14_tm6*117*a,1201,0,4,0,1205,0.003,117,3211@TOP@human_GAPDH_TAA_len41_fa20_ta0_fm14_tm6,a
3211@TOP@human_GAPDH_TAA_len41_fa20_ta0_fm14_tm6*118*a,1173,0,20,0,1193,0.017,118,3211@TOP@human_GAPDH_TAA_len41_fa20_ta0_fm14_tm6,a
3211@TOP@human_GAPDH_TAA_len41_fa20_ta0_fm14_tm6*119*g,0,0,1197,0,1197,1.0,119,3211@TOP@human_GAPDH_TAA_len41_fa20_ta0_fm14_tm6,g
3211@TOP@human_GAPDH_TAA_len41_fa20_ta0_fm14_tm6*120*g,0,0,1195,0,1195,1.0,120,3211@TOP@human_GAPDH_TAA_len41_fa20_ta0_fm14_tm6,g
3211@TOP@human_GAPDH_TAA_len41_fa20_ta0_fm14_tm6*121*a,1201,0,0,0,1201,0.0,121,3211@TOP@human_GAPDH_TAA_len41_fa20_ta0_fm14_tm6,a
3211@TOP@human_GAPDH_TAA_len41_fa20_ta0_fm14_tm6*122*g,0,0,1205,0,1205,1.0,122,3211@TOP@human_GAPDH_TAA_len41_fa20_ta0_fm14_tm6,g
3211@TOP@human_GAPDH_TAA_len41_fa20_ta0_fm14_tm6*123*t,0,0,0,1191,1191,0.0,123,3211@TOP@human_GAPDH_TAA_len41_fa20_ta0_fm14_tm6,t
3211@TOP@human_GAPDH_TAA_len41_fa20_ta0_fm14_tm6*124*a,1136,0,46,0,1182,0.039,124,3211@TOP@human_GAPDH_TAA_len41_fa20_ta0_fm14_tm6,a
3211@TOP@human_GAPDH_TAA_len41_fa20_ta0_fm14_tm6*125*a,1158,0,28,0,1186,0.024,125,3211@TOP@human_GAPDH_TAA_len41_fa20_ta0_fm14_tm6,a
3211@TOP@human_GAPDH_TAA_len41_fa20_ta0_fm14_tm6*126*g,0,0,1191,0,1191,1.0,126,3211@TOP@human_GAPDH_TAA_len41_fa20_ta0_fm14_tm6,g
3211@TOP@human_GAPDH_TAA_len41_fa20_ta0_fm14_tm6*127*a,1203,0,1,0,1204,0.001,127,3211@TOP@human_GAPDH_TAA_len41_fa20_ta0_fm14_tm6,a
3211@TOP@human_GAPDH_TAA_len41_fa20_ta0_fm14_tm6*128*c,0,1211,0,0,1211,0.0,128,3211@TOP@human_GAPDH_TAA_len41_fa20_ta0_fm14_tm6,c
3211@TOP@human_GAPDH_TAA_len41_fa20_ta0_fm14_tm6*129*c,0,1199,0,0,1199,0.0,129,3211@TOP@human_GAPDH_TAA_len41_fa20_ta0_fm14_tm6,c
3211@TOP@human_GAPDH_TAA_len41_fa20_ta0_fm14_tm6*130*c,0,1208,0,0,1208,0.0,130,3211@TOP@human_GAPDH_TAA_len41_fa20_ta0_fm14_tm6,c
3211@TOP@human_GAPDH_TAA_len41_fa20_ta0_fm14_tm6*131*c,0,1212,0,0,1212,0.0,131,3211@TOP@human_GAPDH_TAA_len41_fa20_ta0_fm14_tm6,c
3211@TOP@human_GAPDH_TAA_len41_fa20_ta0_fm14_tm6*132*t,1,0,0,1195,1196,0.0,132,3211@TOP@human_GAPDH_TAA_len41_fa20_ta0_fm14_tm6,t
3211@TOP@human_GAPDH_TAA_len41_fa20_ta0_fm14_tm6*133*g,0,0,1187,0,1187,1.0,133,3211@TOP@human_GAPDH_TAA_len41_fa20_ta0_fm14_tm6,g
3211@TOP@human_GAPDH_TAA_len41_fa20_ta0_fm14_tm6*134*g,0,0,1200,0,1200,1.0,134,3211@TOP@human_GAPDH_TAA_len41_fa20_ta0_fm14_tm6,g
3212@TOP@human_GAPDH_TAA_len41_fa20_ta0_fm14_tm6*114*t,0,0,0,1082,1082,0.0,114,3212@TOP@human_GAPDH_TAA_len41_fa20_ta0_fm14_tm6,t
3212@TOP@human_GAPDH_TAA_len41_fa20_ta0_fm14_tm6*115*c,0,1090,0,0,1090,0.0,115,3212@TOP@human_GAPDH_TAA_len41_fa20_ta0_fm14_tm6,c
3212@TOP@human_GAPDH_TAA_len41_fa20_ta0_fm14_tm6*116*c,0,1083,0,0,1083,0.0,116,3212@TOP@human_GAPDH_TAA_len41_fa20_ta0_fm14_tm6,c
3212@TOP@human_GAPDH_TAA_len41_fa20_ta0_fm14_tm6*117*a,1080,0,1,0,1081,0.001,117,3212@TOP@human_GAPDH_TAA_len41_fa20_ta0_fm14_tm6,a
3212@TOP@human_GAPDH_TAA_len41_fa20_ta0_fm14_tm6*118*a,1041,0,31,0,1072,0.029,118,3212@TOP@human_GAPDH_TAA_len41_fa20_ta0_fm14_tm6,a
3212@TOP@human_GAPDH_TAA_len41_fa20_ta0_fm14_tm6*119*g,0,0,1075,0,1075,1.0,119,3212@TOP@human_GAPDH_TAA_len41_fa20_ta0_fm14_tm6,g
3212@TOP@human_GAPDH_TAA_len41_fa20_ta0_fm14_tm6*120*g,0,0,1077,0,1077,1.0,120,3212@TOP@human_GAPDH_TAA_len41_fa20_ta0_fm14_tm6,g
3212@TOP@human_GAPDH_TAA_len41_fa20_ta0_fm14_tm6*121*a,1082,0,0,0,1082,0.0,121,3212@TOP@human_GAPDH_TAA_len41_fa20_ta0_fm14_tm6,a
3212@TOP@human_GAPDH_TAA_len41_fa20_ta0_fm14_tm6*122*g,0,0,1086,0,1086,1.0,122,3212@TOP@human_GAPDH_TAA_len41_fa20_ta0_fm14_tm6,g
3212@TOP@human_GAPDH_TAA_len41_fa20_ta0_fm14_tm6*123*t,0,0,0,1075,1075,0.0,123,3212@TOP@human_GAPDH_TAA_len41_fa20_ta0_fm14_tm6,t
3212@TOP@human_GAPDH_TAA_len41_fa20_ta0_fm14_tm6*124*a,1009,0,61,0,1070,0.057,124,3212@TOP@human_GAPDH_TAA_len41_fa20_ta0_fm14_tm6,a
3212@TOP@human_GAPDH_TAA_len41_fa20_ta0_fm14_tm6*125*a,1034,0,25,0,1059,0.024,125,3212@TOP@human_GAPDH_TAA_len41_fa20_ta0_fm14_tm6,a
3212@TOP@human_GAPDH_TAA_len41_fa20_ta0_fm14_tm6*126*g,0,0,1071,0,1071,1.0,126,3212@TOP@human_GAPDH_TAA_len41_fa20_ta0_fm14_tm6,g
3212@TOP@human_GAPDH_TAA_len41_fa20_ta0_fm14_tm6*127*a,1081,0,0,0,1081,0.0,127,3212@TOP@human_GAPDH_TAA_len41_fa20_ta0_fm14_tm6,a
3212@TOP@human_GAPDH_TAA_len41_fa20_ta0_fm14_tm6*128*c,0,1091,0,0,1091,0.0,128,3212@TOP@human_GAPDH_TAA_len41_fa20_ta0_fm14_tm6,c
3212@TOP@human_GAPDH_TAA_len41_fa20_ta0_fm14_tm6*129*c,1,1083,0,0,1084,0.0,129,3212@TOP@human_GAPDH_TAA_len41_fa20_ta0_fm14_tm6,c
3212@TOP@human_GAPDH_TAA_len41_fa20_ta0_fm14_tm6*130*c,1,1083,0,0,1084,0.0,130,3212@TOP@human_GAPDH_TAA_len41_fa20_ta0_fm14_tm6,c
3212@TOP@human_GAPDH_TAA_len41_fa20_ta0_fm14_tm6*131*c,0,1087,0,0,1087,0.0,131,3212@TOP@human_GAPDH_TAA_len41_fa20_ta0_fm14_tm6,c
3212@TOP@human_GAPDH_TAA_len41_fa20_ta0_fm14_tm6*132*t,0,0,0,1077,1077,0.0,132,3212@TOP@human_GAPDH_TAA_len41_fa20_ta0_fm14_tm6,t
3212@TOP@human_GAPDH_TAA_len41_fa20_ta0_fm14_tm6*133*g,0,0,1067,0,1067,1.0,133,3212@TOP@human_GAPDH_TAA_len41_fa20_ta0_fm14_tm6,g
3212@TOP@human_GAPDH_TAA_len41_fa20_ta0_fm14_tm6*134*g,0,0,1074,0,1074,1.0,134,3212@TOP@human_GAPDH_TAA_len41_fa20_ta0_fm14_tm6,g
3213@TOP@human_GAPDH_TAA_len41_fa20_ta0_fm14_tm6*114*t,0,1,0,1006,1007,0.0,114,3213@TOP@human_GAPDH_TAA_len41_fa20_ta0_fm14_tm6,t
3213@TOP@human_GAPDH_TAA_len41_fa20_ta0_fm14_tm6*115*c,0,1016,0,0,1016,0.0,115,3213@TOP@human_GAPDH_TAA_len41_fa20_ta0_fm14_tm6,c
3213@TOP@human_GAPDH_TAA_len41_fa20_ta0_fm14_tm6*116*c,0,1010,0,0,1010,0.0,116,3213@TOP@human_GAPDH_TAA_len41_fa20_ta0_fm14_tm6,c
3213@TOP@human_GAPDH_TAA_len41_fa20_ta0_fm14_tm6*117*a,1010,0,3,0,1013,0.003,117,3213@TOP@human_GAPDH_TAA_len41_fa20_ta0_fm14_tm6,a
3213@TOP@human_GAPDH_TAA_len41_fa20_ta0_fm14_tm6*118*a,950,0,53,0,1003,0.053,118,3213@TOP@human_GAPDH_TAA_len41_fa20_ta0_fm14_tm6,a
3213@TOP@human_GAPDH_TAA_len41_fa20_ta0_fm14_tm6*119*g,0,0,1002,0,1002,1.0,119,3213@TOP@human_GAPDH_TAA_len41_fa20_ta0_fm14_tm6,g
3213@TOP@human_GAPDH_TAA_len41_fa20_ta0_fm14_tm6*120*g,0,0,993,0,993,1.0,120,3213@TOP@human_GAPDH_TAA_len41_fa20_ta0_fm14_tm6,g
3213@TOP@human_GAPDH_TAA_len41_fa20_ta0_fm14_tm6*121*a,1005,0,1,0,1006,0.001,121,3213@TOP@human_GAPDH_TAA_len41_fa20_ta0_fm14_tm6,a
3213@TOP@human_GAPDH_TAA_len41_fa20_ta0_fm14_tm6*122*g,0,0,1012,0,1012,1.0,122,3213@TOP@human_GAPDH_TAA_len41_fa20_ta0_fm14_tm6,g
3213@TOP@human_GAPDH_TAA_len41_fa20_ta0_fm14_tm6*123*t,0,0,0,1005,1005,0.0,123,3213@TOP@human_GAPDH_TAA_len41_fa20_ta0_fm14_tm6,t
3213@TOP@human_GAPDH_TAA_len41_fa20_ta0_fm14_tm6*124*a,962,0,39,0,1001,0.039,124,3213@TOP@human_GAPDH_TAA_len41_fa20_ta0_fm14_tm6,a
3213@TOP@human_GAPDH_TAA_len41_fa20_ta0_fm14_tm6*125*a,982,0,13,2,997,0.013,125,3213@TOP@human_GAPDH_TAA_len41_fa20_ta0_fm14_tm6,a
3213@TOP@human_GAPDH_TAA_len41_fa20_ta0_fm14_tm6*126*g,2,0,990,1,993,0.997,126,3213@TOP@human_GAPDH_TAA_len41_fa20_ta0_fm14_tm6,g
3213@TOP@human_GAPDH_TAA_len41_fa20_ta0_fm14_tm6*127*a,1005,0,4,0,1009,0.004,127,3213@TOP@human_GAPDH_TAA_len41_fa20_ta0_fm14_tm6,a
3213@TOP@human_GAPDH_TAA_len41_fa20_ta0_fm14_tm6*128*c,0,1013,1,0,1014,0.001,128,3213@TOP@human_GAPDH_TAA_len41_fa20_ta0_fm14_tm6,c
3213@TOP@human_GAPDH_TAA_len41_fa20_ta0_fm14_tm6*129*c,0,1005,0,0,1005,0.0,129,3213@TOP@human_GAPDH_TAA_len41_fa20_ta0_fm14_tm6,c
3213@TOP@human_GAPDH_TAA_len41_fa20_ta0_fm14_tm6*130*c,1,1012,1,0,1014,0.001,130,3213@TOP@human_GAPDH_TAA_len41_fa20_ta0_fm14_tm6,c
3213@TOP@human_GAPDH_TAA_len41_fa20_ta0_fm14_tm6*131*c,0,1012,0,0,1012,0.0,131,3213@TOP@human_GAPDH_TAA_len41_fa20_ta0_fm14_tm6,c
3213@TOP@human_GAPDH_TAA_len41_fa20_ta0_fm14_tm6*132*t,0,0,0,992,992,0.0,132,3213@TOP@human_GAPDH_TAA_len41_fa20_ta0_fm14_tm6,t
3213@TOP@human_GAPDH_TAA_len41_fa20_ta0_fm14_tm6*133*g,0,0,984,0,984,1.0,133,3213@TOP@human_GAPDH_TAA_len41_fa20_ta0_fm14_tm6,g
3213@TOP@human_GAPDH_TAA_len41_fa20_ta0_fm14_tm6*134*g,0,1,1003,0,1004,0.999,134,3213@TOP@human_GAPDH_TAA_len41_fa20_ta0_fm14_tm6,g
3214@TOP@human_GAPDH_TAA_len41_fa20_ta0_fm14_tm6*114*t,0,1,0,981,982,0.0,114,3214@TOP@human_GAPDH_TAA_len41_fa20_ta0_fm14_tm6,t
3214@TOP@human_GAPDH_TAA_len41_fa20_ta0_fm14_tm6*115*c,0,994,0,0,994,0.0,115,3214@TOP@human_GAPDH_TAA_len41_fa20_ta0_fm14_tm6,c
3214@TOP@human_GAPDH_TAA_len41_fa20_ta0_fm14_tm6*116*c,0,988,0,0,988,0.0,116,3214@TOP@human_GAPDH_TAA_len41_fa20_ta0_fm14_tm6,c
3214@TOP@human_GAPDH_TAA_len41_fa20_ta0_fm14_tm6*117*a,985,0,3,0,988,0.003,117,3214@TOP@human_GAPDH_TAA_len41_fa20_ta0_fm14_tm6,a
3214@TOP@human_GAPDH_TAA_len41_fa20_ta0_fm14_tm6*118*a,958,0,23,0,981,0.023,118,3214@TOP@human_GAPDH_TAA_len41_fa20_ta0_fm14_tm6,a
3214@TOP@human_GAPDH_TAA_len41_fa20_ta0_fm14_tm6*119*g,1,0,981,0,982,0.999,119,3214@TOP@human_GAPDH_TAA_len41_fa20_ta0_fm14_tm6,g
3214@TOP@human_GAPDH_TAA_len41_fa20_ta0_fm14_tm6*120*g,0,0,983,0,983,1.0,120,3214@TOP@human_GAPDH_TAA_len41_fa20_ta0_fm14_tm6,g
3214@TOP@human_GAPDH_TAA_len41_fa20_ta0_fm14_tm6*121*a,985,0,0,0,985,0.0,121,3214@TOP@human_GAPDH_TAA_len41_fa20_ta0_fm14_tm6,a
3214@TOP@human_GAPDH_TAA_len41_fa20_ta0_fm14_tm6*122*g,0,0,993,0,993,1.0,122,3214@TOP@human_GAPDH_TAA_len41_fa20_ta0_fm14_tm6,g
3214@TOP@human_GAPDH_TAA_len41_fa20_ta0_fm14_tm6*123*t,0,0,0,967,967,0.0,123,3214@TOP@human_GAPDH_TAA_len41_fa20_ta0_fm14_tm6,t
3214@TOP@human_GAPDH_TAA_len41_fa20_ta0_fm14_tm6*124*a,889,0,89,0,978,0.091,124,3214@TOP@human_GAPDH_TAA_len41_fa20_ta0_fm14_tm6,a
3214@TOP@human_GAPDH_TAA_len41_fa20_ta0_fm14_tm6*125*a,935,1,29,0,965,0.03,125,3214@TOP@human_GAPDH_TAA_len41_fa20_ta0_fm14_tm6,a
3214@TOP@human_GAPDH_TAA_len41_fa20_ta0_fm14_tm6*126*g,0,0,974,0,974,1.0,126,3214@TOP@human_GAPDH_TAA_len41_fa20_ta0_fm14_tm6,g
3214@TOP@human_GAPDH_TAA_len41_fa20_ta0_fm14_tm6*127*a,987,0,0,0,987,0.0,127,3214@TOP@human_GAPDH_TAA_len41_fa20_ta0_fm14_tm6,a
3214@TOP@human_GAPDH_TAA_len41_fa20_ta0_fm14_tm6*128*c,0,992,1,0,993,0.001,128,3214@TOP@human_GAPDH_TAA_len41_fa20_ta0_fm14_tm6,c
3214@TOP@human_GAPDH_TAA_len41_fa20_ta0_fm14_tm6*129*c,0,983,0,0,983,0.0,129,3214@TOP@human_GAPDH_TAA_len41_fa20_ta0_fm14_tm6,c
3214@TOP@human_GAPDH_TAA_len41_fa20_ta0_fm14_tm6*130*c,0,988,0,0,988,0.0,130,3214@TOP@human_GAPDH_TAA_len41_fa20_ta0_fm14_tm6,c
3214@TOP@human_GAPDH_TAA_len41_fa20_ta0_fm14_tm6*131*c,0,994,0,0,994,0.0,131,3214@TOP@human_GAPDH_TAA_len41_fa20_ta0_fm14_tm6,c
3214@TOP@human_GAPDH_TAA_len41_fa20_ta0_fm14_tm6*132*t,0,0,0,971,971,0.0,132,3214@TOP@human_GAPDH_TAA_len41_fa20_ta0_fm14_tm6,t
3214@TOP@human_GAPDH_TAA_len41_fa20_ta0_fm14_tm6*133*g,0,0,976,0,976,1.0,133,3214@TOP@human_GAPDH_TAA_len41_fa20_ta0_fm14_tm6,g
3214@TOP@human_GAPDH_TAA_len41_fa20_ta0_fm14_tm6*134*g,0,0,976,0,976,1.0,134,3214@TOP@human_GAPDH_TAA_len41_fa20_ta0_fm14_tm6,g
3215@TOP@human_GAPDH_TAA_len41_fa20_ta0_fm14_tm6*114*t,1,1,0,8849,8851,0.0,114,3215@TOP@human_GAPDH_TAA_len41_fa20_ta0_fm14_tm6,t
3215@TOP@human_GAPDH_TAA_len41_fa20_ta0_fm14_tm6*115*c,0,8896,0,1,8897,0.0,115,3215@TOP@human_GAPDH_TAA_len41_fa20_ta0_fm14_tm6,c
3215@TOP@human_GAPDH_TAA_len41_fa20_ta0_fm14_tm6*116*c,0,8866,0,1,8867,0.0,116,3215@TOP@human_GAPDH_TAA_len41_fa20_ta0_fm14_tm6,c
3215@TOP@human_GAPDH_TAA_len41_fa20_ta0_fm14_tm6*117*a,8846,1,12,0,8859,0.001,117,3215@TOP@human_GAPDH_TAA_len41_fa20_ta0_fm14_tm6,a
3215@TOP@human_GAPDH_TAA_len41_fa20_ta0_fm14_tm6*118*a,8680,0,132,0,8812,0.015,118,3215@TOP@human_GAPDH_TAA_len41_fa20_ta0_fm14_tm6,a
3215@TOP@human_GAPDH_TAA_len41_fa20_ta0_fm14_tm6*119*g,2,0,8794,0,8796,1.0,119,3215@TOP@human_GAPDH_TAA_len41_fa20_ta0_fm14_tm6,g
3215@TOP@human_GAPDH_TAA_len41_fa20_ta0_fm14_tm6*120*g,0,0,8745,0,8745,1.0,120,3215@TOP@human_GAPDH_TAA_len41_fa20_ta0_fm14_tm6,g
3215@TOP@human_GAPDH_TAA_len41_fa20_ta0_fm14_tm6*121*a,8845,0,4,0,8849,0.0,121,3215@TOP@human_GAPDH_TAA_len41_fa20_ta0_fm14_tm6,a
3215@TOP@human_GAPDH_TAA_len41_fa20_ta0_fm14_tm6*122*g,0,0,8864,0,8864,1.0,122,3215@TOP@human_GAPDH_TAA_len41_fa20_ta0_fm14_tm6,g
3215@TOP@human_GAPDH_TAA_len41_fa20_ta0_fm14_tm6*123*t,1,1,0,8738,8740,0.0,123,3215@TOP@human_GAPDH_TAA_len41_fa20_ta0_fm14_tm6,t
3215@TOP@human_GAPDH_TAA_len41_fa20_ta0_fm14_tm6*124*a,8403,1,295,0,8699,0.034,124,3215@TOP@human_GAPDH_TAA_len41_fa20_ta0_fm14_tm6,a
3215@TOP@human_GAPDH_TAA_len41_fa20_ta0_fm14_tm6*125*a,8163,0,539,0,8702,0.062,125,3215@TOP@human_GAPDH_TAA_len41_fa20_ta0_fm14_tm6,a
3215@TOP@human_GAPDH_TAA_len41_fa20_ta0_fm14_tm6*126*g,0,0,8742,1,8743,1.0,126,3215@TOP@human_GAPDH_TAA_len41_fa20_ta0_fm14_tm6,g
3215@TOP@human_GAPDH_TAA_len41_fa20_ta0_fm14_tm6*127*a,8834,0,4,0,8838,0.0,127,3215@TOP@human_GAPDH_TAA_len41_fa20_ta0_fm14_tm6,a
3215@TOP@human_GAPDH_TAA_len41_fa20_ta0_fm14_tm6*128*c,0,8872,1,0,8873,0.0,128,3215@TOP@human_GAPDH_TAA_len41_fa20_ta0_fm14_tm6,c
3215@TOP@human_GAPDH_TAA_len41_fa20_ta0_fm14_tm6*129*c,0,8804,0,0,8804,0.0,129,3215@TOP@human_GAPDH_TAA_len41_fa20_ta0_fm14_tm6,c
3215@TOP@human_GAPDH_TAA_len41_fa20_ta0_fm14_tm6*130*c,0,8873,0,0,8873,0.0,130,3215@TOP@human_GAPDH_TAA_len41_fa20_ta0_fm14_tm6,c
3215@TOP@human_GAPDH_TAA_len41_fa20_ta0_fm14_tm6*131*c,0,8883,0,0,8883,0.0,131,3215@TOP@human_GAPDH_TAA_len41_fa20_ta0_fm14_tm6,c
3215@TOP@human_GAPDH_TAA_len41_fa20_ta0_fm14_tm6*132*t,1,0,1,8753,8755,0.0,132,3215@TOP@human_GAPDH_TAA_len41_fa20_ta0_fm14_tm6,t
3215@TOP@human_GAPDH_TAA_len41_fa20_ta0_fm14_tm6*133*g,0,0,8752,0,8752,1.0,133,3215@TOP@human_GAPDH_TAA_len41_fa20_ta0_fm14_tm6,g
3215@TOP@human_GAPDH_TAA_len41_fa20_ta0_fm14_tm6*134*g,0,1,8788,0,8789,1.0,134,3215@TOP@human_GAPDH_TAA_len41_fa20_ta0_fm14_tm6,g
3216@TOP@human_GAPDH_TAA_len41_fa20_ta0_fm14_tm6*114*t,3,5,0,17906,17914,0.0,114,3216@TOP@human_GAPDH_TAA_len41_fa20_ta0_fm14_tm6,t
3216@TOP@human_GAPDH_TAA_len41_fa20_ta0_fm14_tm6*115*c,2,18012,0,1,18015,0.0,115,3216@TOP@human_GAPDH_TAA_len41_fa20_ta0_fm14_tm6,c
3216@TOP@human_GAPDH_TAA_len41_fa20_ta0_fm14_tm6*116*c,0,17936,0,0,17936,0.0,116,3216@TOP@human_GAPDH_TAA_len41_fa20_ta0_fm14_tm6,c
3216@TOP@human_GAPDH_TAA_len41_fa20_ta0_fm14_tm6*117*a,17915,0,25,0,17940,0.001,117,3216@TOP@human_GAPDH_TAA_len41_fa20_ta0_fm14_tm6,a
3216@TOP@human_GAPDH_TAA_len41_fa20_ta0_fm14_tm6*118*a,17561,0,248,3,17812,0.014,118,3216@TOP@human_GAPDH_TAA_len41_fa20_ta0_fm14_tm6,a
3216@TOP@human_GAPDH_TAA_len41_fa20_ta0_fm14_tm6*119*g,0,0,17799,0,17799,1.0,119,3216@TOP@human_GAPDH_TAA_len41_fa20_ta0_fm14_tm6,g
3216@TOP@human_GAPDH_TAA_len41_fa20_ta0_fm14_tm6*120*g,0,0,17752,0,17752,1.0,120,3216@TOP@human_GAPDH_TAA_len41_fa20_ta0_fm14_tm6,g
3216@TOP@human_GAPDH_TAA_len41_fa20_ta0_fm14_tm6*121*a,17921,0,0,1,17922,0.0,121,3216@TOP@human_GAPDH_TAA_len41_fa20_ta0_fm14_tm6,a
3216@TOP@human_GAPDH_TAA_len41_fa20_ta0_fm14_tm6*122*g,0,1,17932,0,17933,1.0,122,3216@TOP@human_GAPDH_TAA_len41_fa20_ta0_fm14_tm6,g
3216@TOP@human_GAPDH_TAA_len41_fa20_ta0_fm14_tm6*123*t,0,3,1,17701,17705,0.0,123,3216@TOP@human_GAPDH_TAA_len41_fa20_ta0_fm14_tm6,t
3216@TOP@human_GAPDH_TAA_len41_fa20_ta0_fm14_tm6*124*a,16485,2,1149,0,17636,0.065,124,3216@TOP@human_GAPDH_TAA_len41_fa20_ta0_fm14_tm6,a
3216@TOP@human_GAPDH_TAA_len41_fa20_ta0_fm14_tm6*125*a,17137,0,467,3,17607,0.027,125,3216@TOP@human_GAPDH_TAA_len41_fa20_ta0_fm14_tm6,a
3216@TOP@human_GAPDH_TAA_len41_fa20_ta0_fm14_tm6*126*g,1,4,17716,1,17722,1.0,126,3216@TOP@human_GAPDH_TAA_len41_fa20_ta0_fm14_tm6,g
3216@TOP@human_GAPDH_TAA_len41_fa20_ta0_fm14_tm6*127*a,17871,1,12,0,17884,0.001,127,3216@TOP@human_GAPDH_TAA_len41_fa20_ta0_fm14_tm6,a
3216@TOP@human_GAPDH_TAA_len41_fa20_ta0_fm14_tm6*128*c,0,17963,4,0,17967,0.0,128,3216@TOP@human_GAPDH_TAA_len41_fa20_ta0_fm14_tm6,c
3216@TOP@human_GAPDH_TAA_len41_fa20_ta0_fm14_tm6*129*c,1,17829,0,0,17830,0.0,129,3216@TOP@human_GAPDH_TAA_len41_fa20_ta0_fm14_tm6,c
3216@TOP@human_GAPDH_TAA_len41_fa20_ta0_fm14_tm6*130*c,3,17942,1,0,17946,0.0,130,3216@TOP@human_GAPDH_TAA_len41_fa20_ta0_fm14_tm6,c
3216@TOP@human_GAPDH_TAA_len41_fa20_ta0_fm14_tm6*131*c,0,17978,0,0,17978,0.0,131,3216@TOP@human_GAPDH_TAA_len41_fa20_ta0_fm14_tm6,c
3216@TOP@human_GAPDH_TAA_len41_fa20_ta0_fm14_tm6*132*t,5,3,0,17694,17702,0.0,132,3216@TOP@human_GAPDH_TAA_len41_fa20_ta0_fm14_tm6,t
3216@TOP@human_GAPDH_TAA_len41_fa20_ta0_fm14_tm6*133*g,1,0,17665,2,17668,1.0,133,3216@TOP@human_GAPDH_TAA_len41_fa20_ta0_fm14_tm6,g
3216@TOP@human_GAPDH_TAA_len41_fa20_ta0_fm14_tm6*134*g,0,6,17765,1,17772,1.0,134,3216@TOP@human_GAPDH_TAA_len41_fa20_ta0_fm14_tm6,g
3217@TOP@human_GAPDH_TAA_len41_fa20_ta0_fm14_tm6*114*t,2,7,0,33960,33969,0.0,114,3217@TOP@human_GAPDH_TAA_len41_fa20_ta0_fm14_tm6,t
3217@TOP@human_GAPDH_TAA_len41_fa20_ta0_fm14_tm6*115*c,0,34134,0,6,34140,0.0,115,3217@TOP@human_GAPDH_TAA_len41_fa20_ta0_fm14_tm6,c
3217@TOP@human_GAPDH_TAA_len41_fa20_ta0_fm14_tm6*116*c,3,34011,0,0,34014,0.0,116,3217@TOP@human_GAPDH_TAA_len41_fa20_ta0_fm14_tm6,c
3217@TOP@human_GAPDH_TAA_len41_fa20_ta0_fm14_tm6*117*a,33948,0,52,1,34001,0.002,117,3217@TOP@human_GAPDH_TAA_len41_fa20_ta0_fm14_tm6,a
3217@TOP@human_GAPDH_TAA_len41_fa20_ta0_fm14_tm6*118*a,33310,0,446,1,33757,0.013,118,3217@TOP@human_GAPDH_TAA_len41_fa20_ta0_fm14_tm6,a
3217@TOP@human_GAPDH_TAA_len41_fa20_ta0_fm14_tm6*119*g,3,0,33723,1,33727,1.0,119,3217@TOP@human_GAPDH_TAA_len41_fa20_ta0_fm14_tm6,g
3217@TOP@human_GAPDH_TAA_len41_fa20_ta0_fm14_tm6*120*g,2,0,33626,3,33631,1.0,120,3217@TOP@human_GAPDH_TAA_len41_fa20_ta0_fm14_tm6,g
3217@TOP@human_GAPDH_TAA_len41_fa20_ta0_fm14_tm6*121*a,33945,0,4,1,33950,0.0,121,3217@TOP@human_GAPDH_TAA_len41_fa20_ta0_fm14_tm6,a
3217@TOP@human_GAPDH_TAA_len41_fa20_ta0_fm14_tm6*122*g,0,0,33999,1,34000,1.0,122,3217@TOP@human_GAPDH_TAA_len41_fa20_ta0_fm14_tm6,g
3217@TOP@human_GAPDH_TAA_len41_fa20_ta0_fm14_tm6*123*t,5,2,5,33529,33541,0.0,123,3217@TOP@human_GAPDH_TAA_len41_fa20_ta0_fm14_tm6,t
3217@TOP@human_GAPDH_TAA_len41_fa20_ta0_fm14_tm6*124*a,32395,2,1023,1,33421,0.031,124,3217@TOP@human_GAPDH_TAA_len41_fa20_ta0_fm14_tm6,a
3217@TOP@human_GAPDH_TAA_len41_fa20_ta0_fm14_tm6*125*a,32476,1,948,3,33428,0.028,125,3217@TOP@human_GAPDH_TAA_len41_fa20_ta0_fm14_tm6,a
3217@TOP@human_GAPDH_TAA_len41_fa20_ta0_fm14_tm6*126*g,8,3,33476,2,33489,1.0,126,3217@TOP@human_GAPDH_TAA_len41_fa20_ta0_fm14_tm6,g
3217@TOP@human_GAPDH_TAA_len41_fa20_ta0_fm14_tm6*127*a,33873,0,24,0,33897,0.001,127,3217@TOP@human_GAPDH_TAA_len41_fa20_ta0_fm14_tm6,a
3217@TOP@human_GAPDH_TAA_len41_fa20_ta0_fm14_tm6*128*c,2,34074,2,3,34081,0.0,128,3217@TOP@human_GAPDH_TAA_len41_fa20_ta0_fm14_tm6,c
3217@TOP@human_GAPDH_TAA_len41_fa20_ta0_fm14_tm6*129*c,3,33761,0,2,33766,0.0,129,3217@TOP@human_GAPDH_TAA_len41_fa20_ta0_fm14_tm6,c
3217@TOP@human_GAPDH_TAA_len41_fa20_ta0_fm14_tm6*130*c,2,34018,0,0,34020,0.0,130,3217@TOP@human_GAPDH_TAA_len41_fa20_ta0_fm14_tm6,c
3217@TOP@human_GAPDH_TAA_len41_fa20_ta0_fm14_tm6*131*c,5,34070,0,1,34076,0.0,131,3217@TOP@human_GAPDH_TAA_len41_fa20_ta0_fm14_tm6,c
3217@TOP@human_GAPDH_TAA_len41_fa20_ta0_fm14_tm6*132*t,5,14,5,33574,33598,0.0,132,3217@TOP@human_GAPDH_TAA_len41_fa20_ta0_fm14_tm6,t
3217@TOP@human_GAPDH_TAA_len41_fa20_ta0_fm14_tm6*133*g,2,1,33532,3,33538,1.0,133,3217@TOP@human_GAPDH_TAA_len41_fa20_ta0_fm14_tm6,g
3217@TOP@human_GAPDH_TAA_len41_fa20_ta0_fm14_tm6*134*g,8,4,33703,2,33717,1.0,134,3217@TOP@human_GAPDH_TAA_len41_fa20_ta0_fm14_tm6,g
3218@TOP@human_GAPDH_TAA_len41_fa20_ta0_fm14_tm6*114*t,4,20,0,32645,32669,0.0,114,3218@TOP@human_GAPDH_TAA_len41_fa20_ta0_fm14_tm6,t
3218@TOP@human_GAPDH_TAA_len41_fa20_ta0_fm14_tm6*115*c,0,32827,0,2,32829,0.0,115,3218@TOP@human_GAPDH_TAA_len41_fa20_ta0_fm14_tm6,c
3218@TOP@human_GAPDH_TAA_len41_fa20_ta0_fm14_tm6*116*c,0,32690,0,3,32693,0.0,116,3218@TOP@human_GAPDH_TAA_len41_fa20_ta0_fm14_tm6,c
3218@TOP@human_GAPDH_TAA_len41_fa20_ta0_fm14_tm6*117*a,32644,0,44,0,32688,0.001,117,3218@TOP@human_GAPDH_TAA_len41_fa20_ta0_fm14_tm6,a
3218@TOP@human_GAPDH_TAA_len41_fa20_ta0_fm14_tm6*118*a,32090,0,419,0,32509,0.013,118,3218@TOP@human_GAPDH_TAA_len41_fa20_ta0_fm14_tm6,a
3218@TOP@human_GAPDH_TAA_len41_fa20_ta0_fm14_tm6*119*g,1,2,32466,5,32474,1.0,119,3218@TOP@human_GAPDH_TAA_len41_fa20_ta0_fm14_tm6,g
3218@TOP@human_GAPDH_TAA_len41_fa20_ta0_fm14_tm6*120*g,5,1,32344,5,32355,1.0,120,3218@TOP@human_GAPDH_TAA_len41_fa20_ta0_fm14_tm6,g
3218@TOP@human_GAPDH_TAA_len41_fa20_ta0_fm14_tm6*121*a,32670,0,9,1,32680,0.0,121,3218@TOP@human_GAPDH_TAA_len41_fa20_ta0_fm14_tm6,a
3218@TOP@human_GAPDH_TAA_len41_fa20_ta0_fm14_tm6*122*g,2,0,32691,0,32693,1.0,122,3218@TOP@human_GAPDH_TAA_len41_fa20_ta0_fm14_tm6,g
3218@TOP@human_GAPDH_TAA_len41_fa20_ta0_fm14_tm6*123*t,2,3,5,32256,32266,0.0,123,3218@TOP@human_GAPDH_TAA_len41_fa20_ta0_fm14_tm6,t
3218@TOP@human_GAPDH_TAA_len41_fa20_ta0_fm14_tm6*124*a,31232,1,917,1,32151,0.029,124,3218@TOP@human_GAPDH_TAA_len41_fa20_ta0_fm14_tm6,a
3218@TOP@human_GAPDH_TAA_len41_fa20_ta0_fm14_tm6*125*a,31549,0,573,3,32125,0.018,125,3218@TOP@human_GAPDH_TAA_len41_fa20_ta0_fm14_tm6,a
3218@TOP@human_GAPDH_TAA_len41_fa20_ta0_fm14_tm6*126*g,2,4,32243,0,32249,1.0,126,3218@TOP@human_GAPDH_TAA_len41_fa20_ta0_fm14_tm6,g
3218@TOP@human_GAPDH_TAA_len41_fa20_ta0_fm14_tm6*127*a,32543,1,20,0,32564,0.001,127,3218@TOP@human_GAPDH_TAA_len41_fa20_ta0_fm14_tm6,a
3218@TOP@human_GAPDH_TAA_len41_fa20_ta0_fm14_tm6*128*c,0,32742,2,2,32746,0.0,128,3218@TOP@human_GAPDH_TAA_len41_fa20_ta0_fm14_tm6,c
3218@TOP@human_GAPDH_TAA_len41_fa20_ta0_fm14_tm6*129*c,2,32516,0,1,32519,0.0,129,3218@TOP@human_GAPDH_TAA_len41_fa20_ta0_fm14_tm6,c
3218@TOP@human_GAPDH_TAA_len41_fa20_ta0_fm14_tm6*130*c,7,32699,0,3,32709,0.0,130,3218@TOP@human_GAPDH_TAA_len41_fa20_ta0_fm14_tm6,c
3218@TOP@human_GAPDH_TAA_len41_fa20_ta0_fm14_tm6*131*c,2,32760,0,5,32767,0.0,131,3218@TOP@human_GAPDH_TAA_len41_fa20_ta0_fm14_tm6,c
3218@TOP@human_GAPDH_TAA_len41_fa20_ta0_fm14_tm6*132*t,4,8,6,32277,32295,0.0,132,3218@TOP@human_GAPDH_TAA_len41_fa20_ta0_fm14_tm6,t
3218@TOP@human_GAPDH_TAA_len41_fa20_ta0_fm14_tm6*133*g,1,0,32267,0,32268,1.0,133,3218@TOP@human_GAPDH_TAA_len41_fa20_ta0_fm14_tm6,g
3218@TOP@human_GAPDH_TAA_len41_fa20_ta0_fm14_tm6*134*g,4,2,32397,3,32406,1.0,134,3218@TOP@human_GAPDH_TAA_len41_fa20_ta0_fm14_tm6,g
3219@TOP@human_GAPDH_TAA_len41_fa20_ta0_fm14_tm6*114*t,0,0,0,8320,8320,0.0,114,3219@TOP@human_GAPDH_TAA_len41_fa20_ta0_fm14_tm6,t
3219@TOP@human_GAPDH_TAA_len41_fa20_ta0_fm14_tm6*115*c,0,8379,1,0,8380,0.0,115,3219@TOP@human_GAPDH_TAA_len41_fa20_ta0_fm14_tm6,c
3219@TOP@human_GAPDH_TAA_len41_fa20_ta0_fm14_tm6*116*c,0,8357,0,0,8357,0.0,116,3219@TOP@human_GAPDH_TAA_len41_fa20_ta0_fm14_tm6,c
3219@TOP@human_GAPDH_TAA_len41_fa20_ta0_fm14_tm6*117*a,8343,1,7,0,8351,0.001,117,3219@TOP@human_GAPDH_TAA_len41_fa20_ta0_fm14_tm6,a
3219@TOP@human_GAPDH_TAA_len41_fa20_ta0_fm14_tm6*118*a,8213,0,84,0,8297,0.01,118,3219@TOP@human_GAPDH_TAA_len41_fa20_ta0_fm14_tm6,a
3219@TOP@human_GAPDH_TAA_len41_fa20_ta0_fm14_tm6*119*g,0,0,8297,0,8297,1.0,119,3219@TOP@human_GAPDH_TAA_len41_fa20_ta0_fm14_tm6,g
3219@TOP@human_GAPDH_TAA_len41_fa20_ta0_fm14_tm6*120*g,3,0,8232,0,8235,1.0,120,3219@TOP@human_GAPDH_TAA_len41_fa20_ta0_fm14_tm6,g
3219@TOP@human_GAPDH_TAA_len41_fa20_ta0_fm14_tm6*121*a,8332,0,3,0,8335,0.0,121,3219@TOP@human_GAPDH_TAA_len41_fa20_ta0_fm14_tm6,a
3219@TOP@human_GAPDH_TAA_len41_fa20_ta0_fm14_tm6*122*g,0,0,8347,0,8347,1.0,122,3219@TOP@human_GAPDH_TAA_len41_fa20_ta0_fm14_tm6,g
3219@TOP@human_GAPDH_TAA_len41_fa20_ta0_fm14_tm6*123*t,1,2,0,8219,8222,0.0,123,3219@TOP@human_GAPDH_TAA_len41_fa20_ta0_fm14_tm6,t
3219@TOP@human_GAPDH_TAA_len41_fa20_ta0_fm14_tm6*124*a,7645,0,588,0,8233,0.071,124,3219@TOP@human_GAPDH_TAA_len41_fa20_ta0_fm14_tm6,a
3219@TOP@human_GAPDH_TAA_len41_fa20_ta0_fm14_tm6*125*a,8059,3,145,1,8208,0.018,125,3219@TOP@human_GAPDH_TAA_len41_fa20_ta0_fm14_tm6,a
3219@TOP@human_GAPDH_TAA_len41_fa20_ta0_fm14_tm6*126*g,2,0,8247,0,8249,1.0,126,3219@TOP@human_GAPDH_TAA_len41_fa20_ta0_fm14_tm6,g
3219@TOP@human_GAPDH_TAA_len41_fa20_ta0_fm14_tm6*127*a,8294,0,4,0,8298,0.0,127,3219@TOP@human_GAPDH_TAA_len41_fa20_ta0_fm14_tm6,a
3219@TOP@human_GAPDH_TAA_len41_fa20_ta0_fm14_tm6*128*c,1,8356,1,0,8358,0.0,128,3219@TOP@human_GAPDH_TAA_len41_fa20_ta0_fm14_tm6,c
3219@TOP@human_GAPDH_TAA_len41_fa20_ta0_fm14_tm6*129*c,0,8301,0,0,8301,0.0,129,3219@TOP@human_GAPDH_TAA_len41_fa20_ta0_fm14_tm6,c
3219@TOP@human_GAPDH_TAA_len41_fa20_ta0_fm14_tm6*130*c,0,8349,0,4,8353,0.0,130,3219@TOP@human_GAPDH_TAA_len41_fa20_ta0_fm14_tm6,c
3219@TOP@human_GAPDH_TAA_len41_fa20_ta0_fm14_tm6*131*c,1,8373,0,0,8374,0.0,131,3219@TOP@human_GAPDH_TAA_len41_fa20_ta0_fm14_tm6,c
3219@TOP@human_GAPDH_TAA_len41_fa20_ta0_fm14_tm6*132*t,1,0,3,8215,8219,0.0,132,3219@TOP@human_GAPDH_TAA_len41_fa20_ta0_fm14_tm6,t
3219@TOP@human_GAPDH_TAA_len41_fa20_ta0_fm14_tm6*133*g,0,2,8232,0,8234,1.0,133,3219@TOP@human_GAPDH_TAA_len41_fa20_ta0_fm14_tm6,g
3219@TOP@human_GAPDH_TAA_len41_fa20_ta0_fm14_tm6*134*g,0,1,8271,1,8273,1.0,134,3219@TOP@human_GAPDH_TAA_len41_fa20_ta0_fm14_tm6,g
3220@TOP@human_GAPDH_TAA_len41_fa20_ta0_fm14_tm6*114*t,1,0,0,2615,2616,0.0,114,3220@TOP@human_GAPDH_TAA_len41_fa20_ta0_fm14_tm6,t
3220@TOP@human_GAPDH_TAA_len41_fa20_ta0_fm14_tm6*115*c,0,2633,0,3,2636,0.0,115,3220@TOP@human_GAPDH_TAA_len41_fa20_ta0_fm14_tm6,c
3220@TOP@human_GAPDH_TAA_len41_fa20_ta0_fm14_tm6*116*c,0,2615,0,0,2615,0.0,116,3220@TOP@human_GAPDH_TAA_len41_fa20_ta0_fm14_tm6,c
3220@TOP@human_GAPDH_TAA_len41_fa20_ta0_fm14_tm6*117*a,2612,0,12,0,2624,0.005,117,3220@TOP@human_GAPDH_TAA_len41_fa20_ta0_fm14_tm6,a
3220@TOP@human_GAPDH_TAA_len41_fa20_ta0_fm14_tm6*118*a,2532,0,74,0,2606,0.028,118,3220@TOP@human_GAPDH_TAA_len41_fa20_ta0_fm14_tm6,a
3220@TOP@human_GAPDH_TAA_len41_fa20_ta0_fm14_tm6*119*g,0,0,2609,0,2609,1.0,119,3220@TOP@human_GAPDH_TAA_len41_fa20_ta0_fm14_tm6,g
3220@TOP@human_GAPDH_TAA_len41_fa20_ta0_fm14_tm6*120*g,0,0,2594,1,2595,1.0,120,3220@TOP@human_GAPDH_TAA_len41_fa20_ta0_fm14_tm6,g
3220@TOP@human_GAPDH_TAA_len41_fa20_ta0_fm14_tm6*121*a,2622,0,4,0,2626,0.002,121,3220@TOP@human_GAPDH_TAA_len41_fa20_ta0_fm14_tm6,a
3220@TOP@human_GAPDH_TAA_len41_fa20_ta0_fm14_tm6*122*g,0,2,2624,0,2626,0.999,122,3220@TOP@human_GAPDH_TAA_len41_fa20_ta0_fm14_tm6,g
3220@TOP@human_GAPDH_TAA_len41_fa20_ta0_fm14_tm6*123*t,0,1,1,2595,2597,0.0,123,3220@TOP@human_GAPDH_TAA_len41_fa20_ta0_fm14_tm6,t
3220@TOP@human_GAPDH_TAA_len41_fa20_ta0_fm14_tm6*124*a,2419,0,158,0,2577,0.061,124,3220@TOP@human_GAPDH_TAA_len41_fa20_ta0_fm14_tm6,a
3220@TOP@human_GAPDH_TAA_len41_fa20_ta0_fm14_tm6*125*a,2462,0,107,0,2569,0.042,125,3220@TOP@human_GAPDH_TAA_len41_fa20_ta0_fm14_tm6,a
3220@TOP@human_GAPDH_TAA_len41_fa20_ta0_fm14_tm6*126*g,0,0,2587,1,2588,1.0,126,3220@TOP@human_GAPDH_TAA_len41_fa20_ta0_fm14_tm6,g
3220@TOP@human_GAPDH_TAA_len41_fa20_ta0_fm14_tm6*127*a,2610,0,5,0,2615,0.002,127,3220@TOP@human_GAPDH_TAA_len41_fa20_ta0_fm14_tm6,a
3220@TOP@human_GAPDH_TAA_len41_fa20_ta0_fm14_tm6*128*c,0,2633,0,0,2633,0.0,128,3220@TOP@human_GAPDH_TAA_len41_fa20_ta0_fm14_tm6,c
3220@TOP@human_GAPDH_TAA_len41_fa20_ta0_fm14_tm6*129*c,0,2602,0,0,2602,0.0,129,3220@TOP@human_GAPDH_TAA_len41_fa20_ta0_fm14_tm6,c
3220@TOP@human_GAPDH_TAA_len41_fa20_ta0_fm14_tm6*130*c,0,2626,1,0,2627,0.0,130,3220@TOP@human_GAPDH_TAA_len41_fa20_ta0_fm14_tm6,c
3220@TOP@human_GAPDH_TAA_len41_fa20_ta0_fm14_tm6*131*c,0,2632,0,0,2632,0.0,131,3220@TOP@human_GAPDH_TAA_len41_fa20_ta0_fm14_tm6,c
3220@TOP@human_GAPDH_TAA_len41_fa20_ta0_fm14_tm6*132*t,0,0,0,2591,2591,0.0,132,3220@TOP@human_GAPDH_TAA_len41_fa20_ta0_fm14_tm6,t
3220@TOP@human_GAPDH_TAA_len41_fa20_ta0_fm14_tm6*133*g,1,0,2588,0,2589,1.0,133,3220@TOP@human_GAPDH_TAA_len41_fa20_ta0_fm14_tm6,g
3220@TOP@human_GAPDH_TAA_len41_fa20_ta0_fm14_tm6*134*g,0,0,2582,0,2582,1.0,134,3220@TOP@human_GAPDH_TAA_len41_fa20_ta0_fm14_tm6,g
3221@TOP@human_GAPDH_TAA_len41_fa20_ta0_fm14_tm6*114*t,0,1,0,1905,1906,0.0,114,3221@TOP@human_GAPDH_TAA_len41_fa20_ta0_fm14_tm6,t
3221@TOP@human_GAPDH_TAA_len41_fa20_ta0_fm14_tm6*115*c,0,1921,0,0,1921,0.0,115,3221@TOP@human_GAPDH_TAA_len41_fa20_ta0_fm14_tm6,c
3221@TOP@human_GAPDH_TAA_len41_fa20_ta0_fm14_tm6*116*c,0,1916,0,0,1916,0.0,116,3221@TOP@human_GAPDH_TAA_len41_fa20_ta0_fm14_tm6,c
3221@TOP@human_GAPDH_TAA_len41_fa20_ta0_fm14_tm6*117*a,1910,0,4,0,1914,0.002,117,3221@TOP@human_GAPDH_TAA_len41_fa20_ta0_fm14_tm6,a
3221@TOP@human_GAPDH_TAA_len41_fa20_ta0_fm14_tm6*118*a,1871,0,35,0,1906,0.018,118,3221@TOP@human_GAPDH_TAA_len41_fa20_ta0_fm14_tm6,a
3221@TOP@human_GAPDH_TAA_len41_fa20_ta0_fm14_tm6*119*g,0,0,1898,0,1898,1.0,119,3221@TOP@human_GAPDH_TAA_len41_fa20_ta0_fm14_tm6,g
3221@TOP@human_GAPDH_TAA_len41_fa20_ta0_fm14_tm6*120*g,0,0,1887,1,1888,0.999,120,3221@TOP@human_GAPDH_TAA_len41_fa20_ta0_fm14_tm6,g
3221@TOP@human_GAPDH_TAA_len41_fa20_ta0_fm14_tm6*121*a,1907,0,0,2,1909,0.0,121,3221@TOP@human_GAPDH_TAA_len41_fa20_ta0_fm14_tm6,a
3221@TOP@human_GAPDH_TAA_len41_fa20_ta0_fm14_tm6*122*g,0,0,1912,0,1912,1.0,122,3221@TOP@human_GAPDH_TAA_len41_fa20_ta0_fm14_tm6,g
3221@TOP@human_GAPDH_TAA_len41_fa20_ta0_fm14_tm6*123*t,0,0,0,1893,1893,0.0,123,3221@TOP@human_GAPDH_TAA_len41_fa20_ta0_fm14_tm6,t
3221@TOP@human_GAPDH_TAA_len41_fa20_ta0_fm14_tm6*124*a,1730,0,143,0,1873,0.076,124,3221@TOP@human_GAPDH_TAA_len41_fa20_ta0_fm14_tm6,a
3221@TOP@human_GAPDH_TAA_len41_fa20_ta0_fm14_tm6*125*a,1831,0,52,0,1883,0.028,125,3221@TOP@human_GAPDH_TAA_len41_fa20_ta0_fm14_tm6,a
3221@TOP@human_GAPDH_TAA_len41_fa20_ta0_fm14_tm6*126*g,0,0,1887,0,1887,1.0,126,3221@TOP@human_GAPDH_TAA_len41_fa20_ta0_fm14_tm6,g
3221@TOP@human_GAPDH_TAA_len41_fa20_ta0_fm14_tm6*127*a,1903,0,0,0,1903,0.0,127,3221@TOP@human_GAPDH_TAA_len41_fa20_ta0_fm14_tm6,a
3221@TOP@human_GAPDH_TAA_len41_fa20_ta0_fm14_tm6*128*c,0,1916,0,0,1916,0.0,128,3221@TOP@human_GAPDH_TAA_len41_fa20_ta0_fm14_tm6,c
3221@TOP@human_GAPDH_TAA_len41_fa20_ta0_fm14_tm6*129*c,0,1909,0,0,1909,0.0,129,3221@TOP@human_GAPDH_TAA_len41_fa20_ta0_fm14_tm6,c
3221@TOP@human_GAPDH_TAA_len41_fa20_ta0_fm14_tm6*130*c,0,1914,0,0,1914,0.0,130,3221@TOP@human_GAPDH_TAA_len41_fa20_ta0_fm14_tm6,c
3221@TOP@human_GAPDH_TAA_len41_fa20_ta0_fm14_tm6*131*c,0,1916,0,0,1916,0.0,131,3221@TOP@human_GAPDH_TAA_len41_fa20_ta0_fm14_tm6,c
3221@TOP@human_GAPDH_TAA_len41_fa20_ta0_fm14_tm6*132*t,0,0,0,1890,1890,0.0,132,3221@TOP@human_GAPDH_TAA_len41_fa20_ta0_fm14_tm6,t
3221@TOP@human_GAPDH_TAA_len41_fa20_ta0_fm14_tm6*133*g,0,0,1883,0,1883,1.0,133,3221@TOP@human_GAPDH_TAA_len41_fa20_ta0_fm14_tm6,g
3221@TOP@human_GAPDH_TAA_len41_fa20_ta0_fm14_tm6*134*g,0,0,1894,0,1894,1.0,134,3221@TOP@human_GAPDH_TAA_len41_fa20_ta0_fm14_tm6,g
3222@TOP@human_GAPDH_TAA_len41_fa20_ta0_fm14_tm6*114*t,0,0,1,6664,6665,0.0,114,3222@TOP@human_GAPDH_TAA_len41_fa20_ta0_fm14_tm6,t
3222@TOP@human_GAPDH_TAA_len41_fa20_ta0_fm14_tm6*115*c,0,6707,0,1,6708,0.0,115,3222@TOP@human_GAPDH_TAA_len41_fa20_ta0_fm14_tm6,c
3222@TOP@human_GAPDH_TAA_len41_fa20_ta0_fm14_tm6*116*c,1,6669,0,0,6670,0.0,116,3222@TOP@human_GAPDH_TAA_len41_fa20_ta0_fm14_tm6,c
3222@TOP@human_GAPDH_TAA_len41_fa20_ta0_fm14_tm6*117*a,6659,0,12,0,6671,0.002,117,3222@TOP@human_GAPDH_TAA_len41_fa20_ta0_fm14_tm6,a
3222@TOP@human_GAPDH_TAA_len41_fa20_ta0_fm14_tm6*118*a,6538,0,92,0,6630,0.014,118,3222@TOP@human_GAPDH_TAA_len41_fa20_ta0_fm14_tm6,a
3222@TOP@human_GAPDH_TAA_len41_fa20_ta0_fm14_tm6*119*g,2,1,6620,0,6623,1.0,119,3222@TOP@human_GAPDH_TAA_len41_fa20_ta0_fm14_tm6,g
3222@TOP@human_GAPDH_TAA_len41_fa20_ta0_fm14_tm6*120*g,0,1,6595,0,6596,1.0,120,3222@TOP@human_GAPDH_TAA_len41_fa20_ta0_fm14_tm6,g
3222@TOP@human_GAPDH_TAA_len41_fa20_ta0_fm14_tm6*121*a,6662,0,2,0,6664,0.0,121,3222@TOP@human_GAPDH_TAA_len41_fa20_ta0_fm14_tm6,a
3222@TOP@human_GAPDH_TAA_len41_fa20_ta0_fm14_tm6*122*g,0,0,6685,1,6686,1.0,122,3222@TOP@human_GAPDH_TAA_len41_fa20_ta0_fm14_tm6,g
3222@TOP@human_GAPDH_TAA_len41_fa20_ta0_fm14_tm6*123*t,1,1,0,6568,6570,0.0,123,3222@TOP@human_GAPDH_TAA_len41_fa20_ta0_fm14_tm6,t
3222@TOP@human_GAPDH_TAA_len41_fa20_ta0_fm14_tm6*124*a,6240,0,308,0,6548,0.047,124,3222@TOP@human_GAPDH_TAA_len41_fa20_ta0_fm14_tm6,a
3222@TOP@human_GAPDH_TAA_len41_fa20_ta0_fm14_tm6*125*a,6373,0,157,0,6530,0.024,125,3222@TOP@human_GAPDH_TAA_len41_fa20_ta0_fm14_tm6,a
3222@TOP@human_GAPDH_TAA_len41_fa20_ta0_fm14_tm6*126*g,0,0,6570,0,6570,1.0,126,3222@TOP@human_GAPDH_TAA_len41_fa20_ta0_fm14_tm6,g
3222@TOP@human_GAPDH_TAA_len41_fa20_ta0_fm14_tm6*127*a,6645,0,0,0,6645,0.0,127,3222@TOP@human_GAPDH_TAA_len41_fa20_ta0_fm14_tm6,a
3222@TOP@human_GAPDH_TAA_len41_fa20_ta0_fm14_tm6*128*c,0,6690,0,0,6690,0.0,128,3222@TOP@human_GAPDH_TAA_len41_fa20_ta0_fm14_tm6,c
3222@TOP@human_GAPDH_TAA_len41_fa20_ta0_fm14_tm6*129*c,0,6618,0,4,6622,0.0,129,3222@TOP@human_GAPDH_TAA_len41_fa20_ta0_fm14_tm6,c
3222@TOP@human_GAPDH_TAA_len41_fa20_ta0_fm14_tm6*130*c,0,6682,1,0,6683,0.0,130,3222@TOP@human_GAPDH_TAA_len41_fa20_ta0_fm14_tm6,c
3222@TOP@human_GAPDH_TAA_len41_fa20_ta0_fm14_tm6*131*c,0,6692,0,0,6692,0.0,131,3222@TOP@human_GAPDH_TAA_len41_fa20_ta0_fm14_tm6,c
3222@TOP@human_GAPDH_TAA_len41_fa20_ta0_fm14_tm6*132*t,0,4,0,6598,6602,0.0,132,3222@TOP@human_GAPDH_TAA_len41_fa20_ta0_fm14_tm6,t
3222@TOP@human_GAPDH_TAA_len41_fa20_ta0_fm14_tm6*133*g,1,0,6572,0,6573,1.0,133,3222@TOP@human_GAPDH_TAA_len41_fa20_ta0_fm14_tm6,g
3222@TOP@human_GAPDH_TAA_len41_fa20_ta0_fm14_tm6*134*g,0,10,6606,0,6616,0.998,134,3222@TOP@human_GAPDH_TAA_len41_fa20_ta0_fm14_tm6,g
3223@TOP@human_GAPDH_TAA_len41_fa20_ta0_fm14_tm6*114*t,0,0,0,2793,2793,0.0,114,3223@TOP@human_GAPDH_TAA_len41_fa20_ta0_fm14_tm6,t
3223@TOP@human_GAPDH_TAA_len41_fa20_ta0_fm14_tm6*115*c,0,2810,0,0,2810,0.0,115,3223@TOP@human_GAPDH_TAA_len41_fa20_ta0_fm14_tm6,c
3223@TOP@human_GAPDH_TAA_len41_fa20_ta0_fm14_tm6*116*c,0,2788,0,0,2788,0.0,116,3223@TOP@human_GAPDH_TAA_len41_fa20_ta0_fm14_tm6,c
3223@TOP@human_GAPDH_TAA_len41_fa20_ta0_fm14_tm6*117*a,2791,0,6,0,2797,0.002,117,3223@TOP@human_GAPDH_TAA_len41_fa20_ta0_fm14_tm6,a
3223@TOP@human_GAPDH_TAA_len41_fa20_ta0_fm14_tm6*118*a,2735,0,35,0,2770,0.013,118,3223@TOP@human_GAPDH_TAA_len41_fa20_ta0_fm14_tm6,a
3223@TOP@human_GAPDH_TAA_len41_fa20_ta0_fm14_tm6*119*g,0,0,2762,0,2762,1.0,119,3223@TOP@human_GAPDH_TAA_len41_fa20_ta0_fm14_tm6,g
3223@TOP@human_GAPDH_TAA_len41_fa20_ta0_fm14_tm6*120*g,0,0,2748,0,2748,1.0,120,3223@TOP@human_GAPDH_TAA_len41_fa20_ta0_fm14_tm6,g
3223@TOP@human_GAPDH_TAA_len41_fa20_ta0_fm14_tm6*121*a,2791,0,3,0,2794,0.001,121,3223@TOP@human_GAPDH_TAA_len41_fa20_ta0_fm14_tm6,a
3223@TOP@human_GAPDH_TAA_len41_fa20_ta0_fm14_tm6*122*g,0,0,2795,0,2795,1.0,122,3223@TOP@human_GAPDH_TAA_len41_fa20_ta0_fm14_tm6,g
3223@TOP@human_GAPDH_TAA_len41_fa20_ta0_fm14_tm6*123*t,0,0,0,2744,2744,0.0,123,3223@TOP@human_GAPDH_TAA_len41_fa20_ta0_fm14_tm6,t
3223@TOP@human_GAPDH_TAA_len41_fa20_ta0_fm14_tm6*124*a,2587,0,147,0,2734,0.054,124,3223@TOP@human_GAPDH_TAA_len41_fa20_ta0_fm14_tm6,a
3223@TOP@human_GAPDH_TAA_len41_fa20_ta0_fm14_tm6*125*a,2670,0,67,0,2737,0.024,125,3223@TOP@human_GAPDH_TAA_len41_fa20_ta0_fm14_tm6,a
3223@TOP@human_GAPDH_TAA_len41_fa20_ta0_fm14_tm6*126*g,0,0,2758,0,2758,1.0,126,3223@TOP@human_GAPDH_TAA_len41_fa20_ta0_fm14_tm6,g
3223@TOP@human_GAPDH_TAA_len41_fa20_ta0_fm14_tm6*127*a,2762,0,0,0,2762,0.0,127,3223@TOP@human_GAPDH_TAA_len41_fa20_ta0_fm14_tm6,a
3223@TOP@human_GAPDH_TAA_len41_fa20_ta0_fm14_tm6*128*c,0,2802,0,0,2802,0.0,128,3223@TOP@human_GAPDH_TAA_len41_fa20_ta0_fm14_tm6,c
3223@TOP@human_GAPDH_TAA_len41_fa20_ta0_fm14_tm6*129*c,0,2782,0,0,2782,0.0,129,3223@TOP@human_GAPDH_TAA_len41_fa20_ta0_fm14_tm6,c
3223@TOP@human_GAPDH_TAA_len41_fa20_ta0_fm14_tm6*130*c,0,2787,0,0,2787,0.0,130,3223@TOP@human_GAPDH_TAA_len41_fa20_ta0_fm14_tm6,c
3223@TOP@human_GAPDH_TAA_len41_fa20_ta0_fm14_tm6*131*c,1,2800,0,1,2802,0.0,131,3223@TOP@human_GAPDH_TAA_len41_fa20_ta0_fm14_tm6,c
3223@TOP@human_GAPDH_TAA_len41_fa20_ta0_fm14_tm6*132*t,0,0,0,2774,2774,0.0,132,3223@TOP@human_GAPDH_TAA_len41_fa20_ta0_fm14_tm6,t
3223@TOP@human_GAPDH_TAA_len41_fa20_ta0_fm14_tm6*133*g,0,0,2740,0,2740,1.0,133,3223@TOP@human_GAPDH_TAA_len41_fa20_ta0_fm14_tm6,g
3223@TOP@human_GAPDH_TAA_len41_fa20_ta0_fm14_tm6*134*g,0,0,2764,0,2764,1.0,134,3223@TOP@human_GAPDH_TAA_len41_fa20_ta0_fm14_tm6,g
3224@TOP@human_GAPDH_TAA_len41_fa20_ta0_fm14_tm6*114*t,2,2,0,10021,10025,0.0,114,3224@TOP@human_GAPDH_TAA_len41_fa20_ta0_fm14_tm6,t
3224@TOP@human_GAPDH_TAA_len41_fa20_ta0_fm14_tm6*115*c,0,10087,0,0,10087,0.0,115,3224@TOP@human_GAPDH_TAA_len41_fa20_ta0_fm14_tm6,c
3224@TOP@human_GAPDH_TAA_len41_fa20_ta0_fm14_tm6*116*c,0,10039,0,1,10040,0.0,116,3224@TOP@human_GAPDH_TAA_len41_fa20_ta0_fm14_tm6,c
3224@TOP@human_GAPDH_TAA_len41_fa20_ta0_fm14_tm6*117*a,10020,0,17,0,10037,0.002,117,3224@TOP@human_GAPDH_TAA_len41_fa20_ta0_fm14_tm6,a
3224@TOP@human_GAPDH_TAA_len41_fa20_ta0_fm14_tm6*118*a,9825,0,120,0,9945,0.012,118,3224@TOP@human_GAPDH_TAA_len41_fa20_ta0_fm14_tm6,a
3224@TOP@human_GAPDH_TAA_len41_fa20_ta0_fm14_tm6*119*g,0,0,9964,4,9968,1.0,119,3224@TOP@human_GAPDH_TAA_len41_fa20_ta0_fm14_tm6,g
3224@TOP@human_GAPDH_TAA_len41_fa20_ta0_fm14_tm6*120*g,2,0,9922,0,9924,1.0,120,3224@TOP@human_GAPDH_TAA_len41_fa20_ta0_fm14_tm6,g
3224@TOP@human_GAPDH_TAA_len41_fa20_ta0_fm14_tm6*121*a,10009,0,0,1,10010,0.0,121,3224@TOP@human_GAPDH_TAA_len41_fa20_ta0_fm14_tm6,a
3224@TOP@human_GAPDH_TAA_len41_fa20_ta0_fm14_tm6*122*g,1,1,10040,0,10042,1.0,122,3224@TOP@human_GAPDH_TAA_len41_fa20_ta0_fm14_tm6,g
3224@TOP@human_GAPDH_TAA_len41_fa20_ta0_fm14_tm6*123*t,1,0,3,9887,9891,0.0,123,3224@TOP@human_GAPDH_TAA_len41_fa20_ta0_fm14_tm6,t
3224@TOP@human_GAPDH_TAA_len41_fa20_ta0_fm14_tm6*124*a,9507,0,337,1,9845,0.034,124,3224@TOP@human_GAPDH_TAA_len41_fa20_ta0_fm14_tm6,a
3224@TOP@human_GAPDH_TAA_len41_fa20_ta0_fm14_tm6*125*a,9653,0,200,1,9854,0.02,125,3224@TOP@human_GAPDH_TAA_len41_fa20_ta0_fm14_tm6,a
3224@TOP@human_GAPDH_TAA_len41_fa20_ta0_fm14_tm6*126*g,1,0,9910,0,9911,1.0,126,3224@TOP@human_GAPDH_TAA_len41_fa20_ta0_fm14_tm6,g
3224@TOP@human_GAPDH_TAA_len41_fa20_ta0_fm14_tm6*127*a,9978,0,7,0,9985,0.001,127,3224@TOP@human_GAPDH_TAA_len41_fa20_ta0_fm14_tm6,a
3224@TOP@human_GAPDH_TAA_len41_fa20_ta0_fm14_tm6*128*c,0,10056,0,0,10056,0.0,128,3224@TOP@human_GAPDH_TAA_len41_fa20_ta0_fm14_tm6,c
3224@TOP@human_GAPDH_TAA_len41_fa20_ta0_fm14_tm6*129*c,1,9984,0,0,9985,0.0,129,3224@TOP@human_GAPDH_TAA_len41_fa20_ta0_fm14_tm6,c
3224@TOP@human_GAPDH_TAA_len41_fa20_ta0_fm14_tm6*130*c,0,10044,0,1,10045,0.0,130,3224@TOP@human_GAPDH_TAA_len41_fa20_ta0_fm14_tm6,c
3224@TOP@human_GAPDH_TAA_len41_fa20_ta0_fm14_tm6*131*c,3,10058,0,0,10061,0.0,131,3224@TOP@human_GAPDH_TAA_len41_fa20_ta0_fm14_tm6,c
3224@TOP@human_GAPDH_TAA_len41_fa20_ta0_fm14_tm6*132*t,2,7,0,9914,9923,0.0,132,3224@TOP@human_GAPDH_TAA_len41_fa20_ta0_fm14_tm6,t
3224@TOP@human_GAPDH_TAA_len41_fa20_ta0_fm14_tm6*133*g,1,0,9884,0,9885,1.0,133,3224@TOP@human_GAPDH_TAA_len41_fa20_ta0_fm14_tm6,g
3224@TOP@human_GAPDH_TAA_len41_fa20_ta0_fm14_tm6*134*g,1,1,9945,0,9947,1.0,134,3224@TOP@human_GAPDH_TAA_len41_fa20_ta0_fm14_tm6,g
3225@TOP@human_GAPDH_TAA_len41_fa20_ta0_fm14_tm6*114*t,0,1,0,9195,9196,0.0,114,3225@TOP@human_GAPDH_TAA_len41_fa20_ta0_fm14_tm6,t
3225@TOP@human_GAPDH_TAA_len41_fa20_ta0_fm14_tm6*115*c,1,9254,0,0,9255,0.0,115,3225@TOP@human_GAPDH_TAA_len41_fa20_ta0_fm14_tm6,c
3225@TOP@human_GAPDH_TAA_len41_fa20_ta0_fm14_tm6*116*c,0,9216,0,0,9216,0.0,116,3225@TOP@human_GAPDH_TAA_len41_fa20_ta0_fm14_tm6,c
3225@TOP@human_GAPDH_TAA_len41_fa20_ta0_fm14_tm6*117*a,9192,0,21,0,9213,0.002,117,3225@TOP@human_GAPDH_TAA_len41_fa20_ta0_fm14_tm6,a
3225@TOP@human_GAPDH_TAA_len41_fa20_ta0_fm14_tm6*118*a,9076,0,91,0,9167,0.01,118,3225@TOP@human_GAPDH_TAA_len41_fa20_ta0_fm14_tm6,a
3225@TOP@human_GAPDH_TAA_len41_fa20_ta0_fm14_tm6*119*g,0,0,9137,0,9137,1.0,119,3225@TOP@human_GAPDH_TAA_len41_fa20_ta0_fm14_tm6,g
3225@TOP@human_GAPDH_TAA_len41_fa20_ta0_fm14_tm6*120*g,0,0,9122,0,9122,1.0,120,3225@TOP@human_GAPDH_TAA_len41_fa20_ta0_fm14_tm6,g
3225@TOP@human_GAPDH_TAA_len41_fa20_ta0_fm14_tm6*121*a,9191,0,0,0,9191,0.0,121,3225@TOP@human_GAPDH_TAA_len41_fa20_ta0_fm14_tm6,a
3225@TOP@human_GAPDH_TAA_len41_fa20_ta0_fm14_tm6*122*g,0,0,9221,0,9221,1.0,122,3225@TOP@human_GAPDH_TAA_len41_fa20_ta0_fm14_tm6,g
3225@TOP@human_GAPDH_TAA_len41_fa20_ta0_fm14_tm6*123*t,0,2,3,9083,9088,0.0,123,3225@TOP@human_GAPDH_TAA_len41_fa20_ta0_fm14_tm6,t
3225@TOP@human_GAPDH_TAA_len41_fa20_ta0_fm14_tm6*124*a,8744,1,346,0,9091,0.038,124,3225@TOP@human_GAPDH_TAA_len41_fa20_ta0_fm14_tm6,a
3225@TOP@human_GAPDH_TAA_len41_fa20_ta0_fm14_tm6*125*a,8860,1,187,0,9048,0.021,125,3225@TOP@human_GAPDH_TAA_len41_fa20_ta0_fm14_tm6,a
3225@TOP@human_GAPDH_TAA_len41_fa20_ta0_fm14_tm6*126*g,2,0,9084,1,9087,1.0,126,3225@TOP@human_GAPDH_TAA_len41_fa20_ta0_fm14_tm6,g
3225@TOP@human_GAPDH_TAA_len41_fa20_ta0_fm14_tm6*127*a,9179,0,2,0,9181,0.0,127,3225@TOP@human_GAPDH_TAA_len41_fa20_ta0_fm14_tm6,a
3225@TOP@human_GAPDH_TAA_len41_fa20_ta0_fm14_tm6*128*c,0,9235,0,0,9235,0.0,128,3225@TOP@human_GAPDH_TAA_len41_fa20_ta0_fm14_tm6,c
3225@TOP@human_GAPDH_TAA_len41_fa20_ta0_fm14_tm6*129*c,1,9151,0,4,9156,0.0,129,3225@TOP@human_GAPDH_TAA_len41_fa20_ta0_fm14_tm6,c
3225@TOP@human_GAPDH_TAA_len41_fa20_ta0_fm14_tm6*130*c,1,9209,0,0,9210,0.0,130,3225@TOP@human_GAPDH_TAA_len41_fa20_ta0_fm14_tm6,c
3225@TOP@human_GAPDH_TAA_len41_fa20_ta0_fm14_tm6*131*c,1,9243,0,0,9244,0.0,131,3225@TOP@human_GAPDH_TAA_len41_fa20_ta0_fm14_tm6,c
3225@TOP@human_GAPDH_TAA_len41_fa20_ta0_fm14_tm6*132*t,1,2,1,9108,9112,0.0,132,3225@TOP@human_GAPDH_TAA_len41_fa20_ta0_fm14_tm6,t
3225@TOP@human_GAPDH_TAA_len41_fa20_ta0_fm14_tm6*133*g,0,0,9085,0,9085,1.0,133,3225@TOP@human_GAPDH_TAA_len41_fa20_ta0_fm14_tm6,g
3225@TOP@human_GAPDH_TAA_len41_fa20_ta0_fm14_tm6*134*g,0,7,9132,0,9139,0.999,134,3225@TOP@human_GAPDH_TAA_len41_fa20_ta0_fm14_tm6,g
3226@TOP@human_GAPDH_TAA_len41_fa20_ta0_fm14_tm6*114*t,0,5,0,21569,21574,0.0,114,3226@TOP@human_GAPDH_TAA_len41_fa20_ta0_fm14_tm6,t
3226@TOP@human_GAPDH_TAA_len41_fa20_ta0_fm14_tm6*115*c,0,21708,0,0,21708,0.0,115,3226@TOP@human_GAPDH_TAA_len41_fa20_ta0_fm14_tm6,c
3226@TOP@human_GAPDH_TAA_len41_fa20_ta0_fm14_tm6*116*c,0,21604,0,1,21605,0.0,116,3226@TOP@human_GAPDH_TAA_len41_fa20_ta0_fm14_tm6,c
3226@TOP@human_GAPDH_TAA_len41_fa20_ta0_fm14_tm6*117*a,21586,1,29,0,21616,0.001,117,3226@TOP@human_GAPDH_TAA_len41_fa20_ta0_fm14_tm6,a
3226@TOP@human_GAPDH_TAA_len41_fa20_ta0_fm14_tm6*118*a,21189,0,284,0,21473,0.013,118,3226@TOP@human_GAPDH_TAA_len41_fa20_ta0_fm14_tm6,a
3226@TOP@human_GAPDH_TAA_len41_fa20_ta0_fm14_tm6*119*g,2,0,21434,0,21436,1.0,119,3226@TOP@human_GAPDH_TAA_len41_fa20_ta0_fm14_tm6,g
3226@TOP@human_GAPDH_TAA_len41_fa20_ta0_fm14_tm6*120*g,0,0,21350,2,21352,1.0,120,3226@TOP@human_GAPDH_TAA_len41_fa20_ta0_fm14_tm6,g
3226@TOP@human_GAPDH_TAA_len41_fa20_ta0_fm14_tm6*121*a,21564,1,4,0,21569,0.0,121,3226@TOP@human_GAPDH_TAA_len41_fa20_ta0_fm14_tm6,a
3226@TOP@human_GAPDH_TAA_len41_fa20_ta0_fm14_tm6*122*g,0,0,21595,0,21595,1.0,122,3226@TOP@human_GAPDH_TAA_len41_fa20_ta0_fm14_tm6,g
3226@TOP@human_GAPDH_TAA_len41_fa20_ta0_fm14_tm6*123*t,3,4,0,21303,21310,0.0,123,3226@TOP@human_GAPDH_TAA_len41_fa20_ta0_fm14_tm6,t
3226@TOP@human_GAPDH_TAA_len41_fa20_ta0_fm14_tm6*124*a,20592,2,636,0,21230,0.03,124,3226@TOP@human_GAPDH_TAA_len41_fa20_ta0_fm14_tm6,a
3226@TOP@human_GAPDH_TAA_len41_fa20_ta0_fm14_tm6*125*a,20835,2,388,1,21226,0.018,125,3226@TOP@human_GAPDH_TAA_len41_fa20_ta0_fm14_tm6,a
3226@TOP@human_GAPDH_TAA_len41_fa20_ta0_fm14_tm6*126*g,2,0,21358,2,21362,1.0,126,3226@TOP@human_GAPDH_TAA_len41_fa20_ta0_fm14_tm6,g
3226@TOP@human_GAPDH_TAA_len41_fa20_ta0_fm14_tm6*127*a,21487,2,13,0,21502,0.001,127,3226@TOP@human_GAPDH_TAA_len41_fa20_ta0_fm14_tm6,a
3226@TOP@human_GAPDH_TAA_len41_fa20_ta0_fm14_tm6*128*c,0,21645,2,3,21650,0.0,128,3226@TOP@human_GAPDH_TAA_len41_fa20_ta0_fm14_tm6,c
3226@TOP@human_GAPDH_TAA_len41_fa20_ta0_fm14_tm6*129*c,0,21480,0,2,21482,0.0,129,3226@TOP@human_GAPDH_TAA_len41_fa20_ta0_fm14_tm6,c
3226@TOP@human_GAPDH_TAA_len41_fa20_ta0_fm14_tm6*130*c,1,21612,0,2,21615,0.0,130,3226@TOP@human_GAPDH_TAA_len41_fa20_ta0_fm14_tm6,c
3226@TOP@human_GAPDH_TAA_len41_fa20_ta0_fm14_tm6*131*c,1,21660,0,0,21661,0.0,131,3226@TOP@human_GAPDH_TAA_len41_fa20_ta0_fm14_tm6,c
3226@TOP@human_GAPDH_TAA_len41_fa20_ta0_fm14_tm6*132*t,4,3,3,21362,21372,0.0,132,3226@TOP@human_GAPDH_TAA_len41_fa20_ta0_fm14_tm6,t
3226@TOP@human_GAPDH_TAA_len41_fa20_ta0_fm14_tm6*133*g,2,0,21290,1,21293,1.0,133,3226@TOP@human_GAPDH_TAA_len41_fa20_ta0_fm14_tm6,g
3226@TOP@human_GAPDH_TAA_len41_fa20_ta0_fm14_tm6*134*g,0,2,21412,0,21414,1.0,134,3226@TOP@human_GAPDH_TAA_len41_fa20_ta0_fm14_tm6,g
3227@TOP@human_GAPDH_TAA_len41_fa20_ta0_fm14_tm6*114*t,8,7,0,33888,33903,0.0,114,3227@TOP@human_GAPDH_TAA_len41_fa20_ta0_fm14_tm6,t
3227@TOP@human_GAPDH_TAA_len41_fa20_ta0_fm14_tm6*115*c,0,34131,0,0,34131,0.0,115,3227@TOP@human_GAPDH_TAA_len41_fa20_ta0_fm14_tm6,c
3227@TOP@human_GAPDH_TAA_len41_fa20_ta0_fm14_tm6*116*c,1,33985,0,0,33986,0.0,116,3227@TOP@human_GAPDH_TAA_len41_fa20_ta0_fm14_tm6,c
3227@TOP@human_GAPDH_TAA_len41_fa20_ta0_fm14_tm6*117*a,33948,1,39,0,33988,0.001,117,3227@TOP@human_GAPDH_TAA_len41_fa20_ta0_fm14_tm6,a
3227@TOP@human_GAPDH_TAA_len41_fa20_ta0_fm14_tm6*118*a,33363,3,415,1,33782,0.012,118,3227@TOP@human_GAPDH_TAA_len41_fa20_ta0_fm14_tm6,a
3227@TOP@human_GAPDH_TAA_len41_fa20_ta0_fm14_tm6*119*g,0,0,33696,1,33697,1.0,119,3227@TOP@human_GAPDH_TAA_len41_fa20_ta0_fm14_tm6,g
3227@TOP@human_GAPDH_TAA_len41_fa20_ta0_fm14_tm6*120*g,4,0,33553,1,33558,1.0,120,3227@TOP@human_GAPDH_TAA_len41_fa20_ta0_fm14_tm6,g
3227@TOP@human_GAPDH_TAA_len41_fa20_ta0_fm14_tm6*121*a,33934,0,6,1,33941,0.0,121,3227@TOP@human_GAPDH_TAA_len41_fa20_ta0_fm14_tm6,a
3227@TOP@human_GAPDH_TAA_len41_fa20_ta0_fm14_tm6*122*g,2,0,33960,2,33964,1.0,122,3227@TOP@human_GAPDH_TAA_len41_fa20_ta0_fm14_tm6,g
3227@TOP@human_GAPDH_TAA_len41_fa20_ta0_fm14_tm6*123*t,2,3,4,33464,33473,0.0,123,3227@TOP@human_GAPDH_TAA_len41_fa20_ta0_fm14_tm6,t
3227@TOP@human_GAPDH_TAA_len41_fa20_ta0_fm14_tm6*124*a,31794,0,1568,1,33363,0.047,124,3227@TOP@human_GAPDH_TAA_len41_fa20_ta0_fm14_tm6,a
3227@TOP@human_GAPDH_TAA_len41_fa20_ta0_fm14_tm6*125*a,32843,2,515,1,33361,0.015,125,3227@TOP@human_GAPDH_TAA_len41_fa20_ta0_fm14_tm6,a
3227@TOP@human_GAPDH_TAA_len41_fa20_ta0_fm14_tm6*126*g,1,0,33541,0,33542,1.0,126,3227@TOP@human_GAPDH_TAA_len41_fa20_ta0_fm14_tm6,g
3227@TOP@human_GAPDH_TAA_len41_fa20_ta0_fm14_tm6*127*a,33815,0,28,1,33844,0.001,127,3227@TOP@human_GAPDH_TAA_len41_fa20_ta0_fm14_tm6,a
3227@TOP@human_GAPDH_TAA_len41_fa20_ta0_fm14_tm6*128*c,0,34053,1,2,34056,0.0,128,3227@TOP@human_GAPDH_TAA_len41_fa20_ta0_fm14_tm6,c
3227@TOP@human_GAPDH_TAA_len41_fa20_ta0_fm14_tm6*129*c,0,33796,0,1,33797,0.0,129,3227@TOP@human_GAPDH_TAA_len41_fa20_ta0_fm14_tm6,c
3227@TOP@human_GAPDH_TAA_len41_fa20_ta0_fm14_tm6*130*c,2,33981,0,2,33985,0.0,130,3227@TOP@human_GAPDH_TAA_len41_fa20_ta0_fm14_tm6,c
3227@TOP@human_GAPDH_TAA_len41_fa20_ta0_fm14_tm6*131*c,6,34069,0,3,34078,0.0,131,3227@TOP@human_GAPDH_TAA_len41_fa20_ta0_fm14_tm6,c
3227@TOP@human_GAPDH_TAA_len41_fa20_ta0_fm14_tm6*132*t,6,10,1,33588,33605,0.0,132,3227@TOP@human_GAPDH_TAA_len41_fa20_ta0_fm14_tm6,t
3227@TOP@human_GAPDH_TAA_len41_fa20_ta0_fm14_tm6*133*g,4,1,33515,1,33521,1.0,133,3227@TOP@human_GAPDH_TAA_len41_fa20_ta0_fm14_tm6,g
3227@TOP@human_GAPDH_TAA_len41_fa20_ta0_fm14_tm6*134*g,3,6,33735,1,33745,1.0,134,3227@TOP@human_GAPDH_TAA_len41_fa20_ta0_fm14_tm6,g
3228@TOP@human_GAPDH_TAA_len41_fa20_ta0_fm14_tm6*114*t,1,3,0,14724,14728,0.0,114,3228@TOP@human_GAPDH_TAA_len41_fa20_ta0_fm14_tm6,t
3228@TOP@human_GAPDH_TAA_len41_fa20_ta0_fm14_tm6*115*c,0,14830,0,0,14830,0.0,115,3228@TOP@human_GAPDH_TAA_len41_fa20_ta0_fm14_tm6,c
3228@TOP@human_GAPDH_TAA_len41_fa20_ta0_fm14_tm6*116*c,1,14771,0,0,14772,0.0,116,3228@TOP@human_GAPDH_TAA_len41_fa20_ta0_fm14_tm6,c
3228@TOP@human_GAPDH_TAA_len41_fa20_ta0_fm14_tm6*117*a,14751,0,16,0,14767,0.001,117,3228@TOP@human_GAPDH_TAA_len41_fa20_ta0_fm14_tm6,a
3228@TOP@human_GAPDH_TAA_len41_fa20_ta0_fm14_tm6*118*a,14483,0,188,1,14672,0.013,118,3228@TOP@human_GAPDH_TAA_len41_fa20_ta0_fm14_tm6,a
3228@TOP@human_GAPDH_TAA_len41_fa20_ta0_fm14_tm6*119*g,0,1,14657,0,14658,1.0,119,3228@TOP@human_GAPDH_TAA_len41_fa20_ta0_fm14_tm6,g
3228@TOP@human_GAPDH_TAA_len41_fa20_ta0_fm14_tm6*120*g,0,0,14598,2,14600,1.0,120,3228@TOP@human_GAPDH_TAA_len41_fa20_ta0_fm14_tm6,g
3228@TOP@human_GAPDH_TAA_len41_fa20_ta0_fm14_tm6*121*a,14729,0,1,0,14730,0.0,121,3228@TOP@human_GAPDH_TAA_len41_fa20_ta0_fm14_tm6,a
3228@TOP@human_GAPDH_TAA_len41_fa20_ta0_fm14_tm6*122*g,3,0,14773,0,14776,1.0,122,3228@TOP@human_GAPDH_TAA_len41_fa20_ta0_fm14_tm6,g
3228@TOP@human_GAPDH_TAA_len41_fa20_ta0_fm14_tm6*123*t,0,1,6,14563,14570,0.0,123,3228@TOP@human_GAPDH_TAA_len41_fa20_ta0_fm14_tm6,t
3228@TOP@human_GAPDH_TAA_len41_fa20_ta0_fm14_tm6*124*a,13705,1,840,1,14547,0.058,124,3228@TOP@human_GAPDH_TAA_len41_fa20_ta0_fm14_tm6,a
3228@TOP@human_GAPDH_TAA_len41_fa20_ta0_fm14_tm6*125*a,14143,0,350,0,14493,0.024,125,3228@TOP@human_GAPDH_TAA_len41_fa20_ta0_fm14_tm6,a
3228@TOP@human_GAPDH_TAA_len41_fa20_ta0_fm14_tm6*126*g,0,0,14602,1,14603,1.0,126,3228@TOP@human_GAPDH_TAA_len41_fa20_ta0_fm14_tm6,g
3228@TOP@human_GAPDH_TAA_len41_fa20_ta0_fm14_tm6*127*a,14702,1,7,0,14710,0.0,127,3228@TOP@human_GAPDH_TAA_len41_fa20_ta0_fm14_tm6,a
3228@TOP@human_GAPDH_TAA_len41_fa20_ta0_fm14_tm6*128*c,0,14790,1,0,14791,0.0,128,3228@TOP@human_GAPDH_TAA_len41_fa20_ta0_fm14_tm6,c
3228@TOP@human_GAPDH_TAA_len41_fa20_ta0_fm14_tm6*129*c,0,14687,0,0,14687,0.0,129,3228@TOP@human_GAPDH_TAA_len41_fa20_ta0_fm14_tm6,c
3228@TOP@human_GAPDH_TAA_len41_fa20_ta0_fm14_tm6*130*c,3,14783,0,1,14787,0.0,130,3228@TOP@human_GAPDH_TAA_len41_fa20_ta0_fm14_tm6,c
3228@TOP@human_GAPDH_TAA_len41_fa20_ta0_fm14_tm6*131*c,1,14806,0,0,14807,0.0,131,3228@TOP@human_GAPDH_TAA_len41_fa20_ta0_fm14_tm6,c
3228@TOP@human_GAPDH_TAA_len41_fa20_ta0_fm14_tm6*132*t,0,3,1,14590,14594,0.0,132,3228@TOP@human_GAPDH_TAA_len41_fa20_ta0_fm14_tm6,t
3228@TOP@human_GAPDH_TAA_len41_fa20_ta0_fm14_tm6*133*g,0,0,14554,0,14554,1.0,133,3228@TOP@human_GAPDH_TAA_len41_fa20_ta0_fm14_tm6,g
3228@TOP@human_GAPDH_TAA_len41_fa20_ta0_fm14_tm6*134*g,0,1,14645,0,14646,1.0,134,3228@TOP@human_GAPDH_TAA_len41_fa20_ta0_fm14_tm6,g
3229@TOP@human_GAPDH_TAA_len41_fa20_ta0_fm14_tm6*114*t,3,5,0,19767,19775,0.0,114,3229@TOP@human_GAPDH_TAA_len41_fa20_ta0_fm14_tm6,t
3229@TOP@human_GAPDH_TAA_len41_fa20_ta0_fm14_tm6*115*c,0,19897,0,0,19897,0.0,115,3229@TOP@human_GAPDH_TAA_len41_fa20_ta0_fm14_tm6,c
3229@TOP@human_GAPDH_TAA_len41_fa20_ta0_fm14_tm6*116*c,0,19817,0,1,19818,0.0,116,3229@TOP@human_GAPDH_TAA_len41_fa20_ta0_fm14_tm6,c
3229@TOP@human_GAPDH_TAA_len41_fa20_ta0_fm14_tm6*117*a,19787,1,30,0,19818,0.002,117,3229@TOP@human_GAPDH_TAA_len41_fa20_ta0_fm14_tm6,a
3229@TOP@human_GAPDH_TAA_len41_fa20_ta0_fm14_tm6*118*a,19433,0,256,1,19690,0.013,118,3229@TOP@human_GAPDH_TAA_len41_fa20_ta0_fm14_tm6,a
3229@TOP@human_GAPDH_TAA_len41_fa20_ta0_fm14_tm6*119*g,0,0,19671,1,19672,1.0,119,3229@TOP@human_GAPDH_TAA_len41_fa20_ta0_fm14_tm6,g
3229@TOP@human_GAPDH_TAA_len41_fa20_ta0_fm14_tm6*120*g,2,0,19601,0,19603,1.0,120,3229@TOP@human_GAPDH_TAA_len41_fa20_ta0_fm14_tm6,g
3229@TOP@human_GAPDH_TAA_len41_fa20_ta0_fm14_tm6*121*a,19787,0,3,0,19790,0.0,121,3229@TOP@human_GAPDH_TAA_len41_fa20_ta0_fm14_tm6,a
3229@TOP@human_GAPDH_TAA_len41_fa20_ta0_fm14_tm6*122*g,1,1,19817,0,19819,1.0,122,3229@TOP@human_GAPDH_TAA_len41_fa20_ta0_fm14_tm6,g
3229@TOP@human_GAPDH_TAA_len41_fa20_ta0_fm14_tm6*123*t,3,0,0,19563,19566,0.0,123,3229@TOP@human_GAPDH_TAA_len41_fa20_ta0_fm14_tm6,t
3229@TOP@human_GAPDH_TAA_len41_fa20_ta0_fm14_tm6*124*a,18115,0,1389,0,19504,0.071,124,3229@TOP@human_GAPDH_TAA_len41_fa20_ta0_fm14_tm6,a
3229@TOP@human_GAPDH_TAA_len41_fa20_ta0_fm14_tm6*125*a,18917,2,565,3,19487,0.029,125,3229@TOP@human_GAPDH_TAA_len41_fa20_ta0_fm14_tm6,a
3229@TOP@human_GAPDH_TAA_len41_fa20_ta0_fm14_tm6*126*g,1,0,19552,2,19555,1.0,126,3229@TOP@human_GAPDH_TAA_len41_fa20_ta0_fm14_tm6,g
3229@TOP@human_GAPDH_TAA_len41_fa20_ta0_fm14_tm6*127*a,19729,1,8,0,19738,0.0,127,3229@TOP@human_GAPDH_TAA_len41_fa20_ta0_fm14_tm6,a
3229@TOP@human_GAPDH_TAA_len41_fa20_ta0_fm14_tm6*128*c,0,19851,4,1,19856,0.0,128,3229@TOP@human_GAPDH_TAA_len41_fa20_ta0_fm14_tm6,c
3229@TOP@human_GAPDH_TAA_len41_fa20_ta0_fm14_tm6*129*c,2,19690,0,0,19692,0.0,129,3229@TOP@human_GAPDH_TAA_len41_fa20_ta0_fm14_tm6,c
3229@TOP@human_GAPDH_TAA_len41_fa20_ta0_fm14_tm6*130*c,1,19811,0,0,19812,0.0,130,3229@TOP@human_GAPDH_TAA_len41_fa20_ta0_fm14_tm6,c
3229@TOP@human_GAPDH_TAA_len41_fa20_ta0_fm14_tm6*131*c,3,19867,0,2,19872,0.0,131,3229@TOP@human_GAPDH_TAA_len41_fa20_ta0_fm14_tm6,c
3229@TOP@human_GAPDH_TAA_len41_fa20_ta0_fm14_tm6*132*t,5,7,2,19580,19594,0.0,132,3229@TOP@human_GAPDH_TAA_len41_fa20_ta0_fm14_tm6,t
3229@TOP@human_GAPDH_TAA_len41_fa20_ta0_fm14_tm6*133*g,2,0,19530,5,19537,1.0,133,3229@TOP@human_GAPDH_TAA_len41_fa20_ta0_fm14_tm6,g
3229@TOP@human_GAPDH_TAA_len41_fa20_ta0_fm14_tm6*134*g,2,6,19666,1,19675,1.0,134,3229@TOP@human_GAPDH_TAA_len41_fa20_ta0_fm14_tm6,g
3230@TOP@human_GAPDH_TAA_len41_fa20_ta0_fm14_tm6*114*t,7,4,0,16157,16168,0.0,114,3230@TOP@human_GAPDH_TAA_len41_fa20_ta0_fm14_tm6,t
3230@TOP@human_GAPDH_TAA_len41_fa20_ta0_fm14_tm6*115*c,0,16280,0,0,16280,0.0,115,3230@TOP@human_GAPDH_TAA_len41_fa20_ta0_fm14_tm6,c
3230@TOP@human_GAPDH_TAA_len41_fa20_ta0_fm14_tm6*116*c,0,16225,0,1,16226,0.0,116,3230@TOP@human_GAPDH_TAA_len41_fa20_ta0_fm14_tm6,c
3230@TOP@human_GAPDH_TAA_len41_fa20_ta0_fm14_tm6*117*a,16183,0,28,1,16212,0.002,117,3230@TOP@human_GAPDH_TAA_len41_fa20_ta0_fm14_tm6,a
3230@TOP@human_GAPDH_TAA_len41_fa20_ta0_fm14_tm6*118*a,15920,1,193,0,16114,0.012,118,3230@TOP@human_GAPDH_TAA_len41_fa20_ta0_fm14_tm6,a
3230@TOP@human_GAPDH_TAA_len41_fa20_ta0_fm14_tm6*119*g,0,0,16088,2,16090,1.0,119,3230@TOP@human_GAPDH_TAA_len41_fa20_ta0_fm14_tm6,g
3230@TOP@human_GAPDH_TAA_len41_fa20_ta0_fm14_tm6*120*g,0,0,16048,3,16051,1.0,120,3230@TOP@human_GAPDH_TAA_len41_fa20_ta0_fm14_tm6,g
3230@TOP@human_GAPDH_TAA_len41_fa20_ta0_fm14_tm6*121*a,16170,0,4,0,16174,0.0,121,3230@TOP@human_GAPDH_TAA_len41_fa20_ta0_fm14_tm6,a
3230@TOP@human_GAPDH_TAA_len41_fa20_ta0_fm14_tm6*122*g,1,2,16200,1,16204,1.0,122,3230@TOP@human_GAPDH_TAA_len41_fa20_ta0_fm14_tm6,g
3230@TOP@human_GAPDH_TAA_len41_fa20_ta0_fm14_tm6*123*t,2,0,3,15993,15998,0.0,123,3230@TOP@human_GAPDH_TAA_len41_fa20_ta0_fm14_tm6,t
3230@TOP@human_GAPDH_TAA_len41_fa20_ta0_fm14_tm6*124*a,15036,0,910,0,15946,0.057,124,3230@TOP@human_GAPDH_TAA_len41_fa20_ta0_fm14_tm6,a
3230@TOP@human_GAPDH_TAA_len41_fa20_ta0_fm14_tm6*125*a,15599,0,366,1,15966,0.023,125,3230@TOP@human_GAPDH_TAA_len41_fa20_ta0_fm14_tm6,a
3230@TOP@human_GAPDH_TAA_len41_fa20_ta0_fm14_tm6*126*g,0,0,15995,0,15995,1.0,126,3230@TOP@human_GAPDH_TAA_len41_fa20_ta0_fm14_tm6,g
3230@TOP@human_GAPDH_TAA_len41_fa20_ta0_fm14_tm6*127*a,16130,0,9,0,16139,0.001,127,3230@TOP@human_GAPDH_TAA_len41_fa20_ta0_fm14_tm6,a
3230@TOP@human_GAPDH_TAA_len41_fa20_ta0_fm14_tm6*128*c,0,16241,3,1,16245,0.0,128,3230@TOP@human_GAPDH_TAA_len41_fa20_ta0_fm14_tm6,c
3230@TOP@human_GAPDH_TAA_len41_fa20_ta0_fm14_tm6*129*c,2,16127,0,1,16130,0.0,129,3230@TOP@human_GAPDH_TAA_len41_fa20_ta0_fm14_tm6,c
3230@TOP@human_GAPDH_TAA_len41_fa20_ta0_fm14_tm6*130*c,0,16216,0,1,16217,0.0,130,3230@TOP@human_GAPDH_TAA_len41_fa20_ta0_fm14_tm6,c
3230@TOP@human_GAPDH_TAA_len41_fa20_ta0_fm14_tm6*131*c,0,16259,0,1,16260,0.0,131,3230@TOP@human_GAPDH_TAA_len41_fa20_ta0_fm14_tm6,c
3230@TOP@human_GAPDH_TAA_len41_fa20_ta0_fm14_tm6*132*t,1,3,1,16007,16012,0.0,132,3230@TOP@human_GAPDH_TAA_len41_fa20_ta0_fm14_tm6,t
3230@TOP@human_GAPDH_TAA_len41_fa20_ta0_fm14_tm6*133*g,1,0,15963,1,15965,1.0,133,3230@TOP@human_GAPDH_TAA_len41_fa20_ta0_fm14_tm6,g
3230@TOP@human_GAPDH_TAA_len41_fa20_ta0_fm14_tm6*134*g,3,2,16060,2,16067,1.0,134,3230@TOP@human_GAPDH_TAA_len41_fa20_ta0_fm14_tm6,g
3231@TOP@human_GAPDH_TAA_len41_fa20_ta0_fm14_tm6*114*t,0,3,0,11363,11366,0.0,114,3231@TOP@human_GAPDH_TAA_len41_fa20_ta0_fm14_tm6,t
3231@TOP@human_GAPDH_TAA_len41_fa20_ta0_fm14_tm6*115*c,0,11435,0,0,11435,0.0,115,3231@TOP@human_GAPDH_TAA_len41_fa20_ta0_fm14_tm6,c
3231@TOP@human_GAPDH_TAA_len41_fa20_ta0_fm14_tm6*116*c,0,11385,0,0,11385,0.0,116,3231@TOP@human_GAPDH_TAA_len41_fa20_ta0_fm14_tm6,c
3231@TOP@human_GAPDH_TAA_len41_fa20_ta0_fm14_tm6*117*a,11353,0,35,0,11388,0.003,117,3231@TOP@human_GAPDH_TAA_len41_fa20_ta0_fm14_tm6,a
3231@TOP@human_GAPDH_TAA_len41_fa20_ta0_fm14_tm6*118*a,11003,0,315,1,11319,0.028,118,3231@TOP@human_GAPDH_TAA_len41_fa20_ta0_fm14_tm6,a
3231@TOP@human_GAPDH_TAA_len41_fa20_ta0_fm14_tm6*119*g,2,0,11297,0,11299,1.0,119,3231@TOP@human_GAPDH_TAA_len41_fa20_ta0_fm14_tm6,g
3231@TOP@human_GAPDH_TAA_len41_fa20_ta0_fm14_tm6*120*g,0,0,11238,1,11239,1.0,120,3231@TOP@human_GAPDH_TAA_len41_fa20_ta0_fm14_tm6,g
3231@TOP@human_GAPDH_TAA_len41_fa20_ta0_fm14_tm6*121*a,11369,0,0,0,11369,0.0,121,3231@TOP@human_GAPDH_TAA_len41_fa20_ta0_fm14_tm6,a
3231@TOP@human_GAPDH_TAA_len41_fa20_ta0_fm14_tm6*122*g,3,0,11374,0,11377,1.0,122,3231@TOP@human_GAPDH_TAA_len41_fa20_ta0_fm14_tm6,g
3231@TOP@human_GAPDH_TAA_len41_fa20_ta0_fm14_tm6*123*t,0,1,0,11262,11263,0.0,123,3231@TOP@human_GAPDH_TAA_len41_fa20_ta0_fm14_tm6,t
3231@TOP@human_GAPDH_TAA_len41_fa20_ta0_fm14_tm6*124*a,10769,2,397,0,11168,0.036,124,3231@TOP@human_GAPDH_TAA_len41_fa20_ta0_fm14_tm6,a
3231@TOP@human_GAPDH_TAA_len41_fa20_ta0_fm14_tm6*125*a,10980,1,195,2,11178,0.017,125,3231@TOP@human_GAPDH_TAA_len41_fa20_ta0_fm14_tm6,a
3231@TOP@human_GAPDH_TAA_len41_fa20_ta0_fm14_tm6*126*g,2,0,11248,0,11250,1.0,126,3231@TOP@human_GAPDH_TAA_len41_fa20_ta0_fm14_tm6,g
3231@TOP@human_GAPDH_TAA_len41_fa20_ta0_fm14_tm6*127*a,11342,0,6,0,11348,0.001,127,3231@TOP@human_GAPDH_TAA_len41_fa20_ta0_fm14_tm6,a
3231@TOP@human_GAPDH_TAA_len41_fa20_ta0_fm14_tm6*128*c,0,11405,0,0,11405,0.0,128,3231@TOP@human_GAPDH_TAA_len41_fa20_ta0_fm14_tm6,c
3231@TOP@human_GAPDH_TAA_len41_fa20_ta0_fm14_tm6*129*c,0,11310,0,3,11313,0.0,129,3231@TOP@human_GAPDH_TAA_len41_fa20_ta0_fm14_tm6,c
3231@TOP@human_GAPDH_TAA_len41_fa20_ta0_fm14_tm6*130*c,1,11378,0,0,11379,0.0,130,3231@TOP@human_GAPDH_TAA_len41_fa20_ta0_fm14_tm6,c
3231@TOP@human_GAPDH_TAA_len41_fa20_ta0_fm14_tm6*131*c,4,11401,0,3,11408,0.0,131,3231@TOP@human_GAPDH_TAA_len41_fa20_ta0_fm14_tm6,c
3231@TOP@human_GAPDH_TAA_len41_fa20_ta0_fm14_tm6*132*t,2,4,0,11242,11248,0.0,132,3231@TOP@human_GAPDH_TAA_len41_fa20_ta0_fm14_tm6,t
3231@TOP@human_GAPDH_TAA_len41_fa20_ta0_fm14_tm6*133*g,2,0,11229,1,11232,1.0,133,3231@TOP@human_GAPDH_TAA_len41_fa20_ta0_fm14_tm6,g
3231@TOP@human_GAPDH_TAA_len41_fa20_ta0_fm14_tm6*134*g,0,2,11266,0,11268,1.0,134,3231@TOP@human_GAPDH_TAA_len41_fa20_ta0_fm14_tm6,g
3232@TOP@human_GAPDH_TAA_len41_fa20_ta0_fm14_tm6*114*t,1,1,0,12126,12128,0.0,114,3232@TOP@human_GAPDH_TAA_len41_fa20_ta0_fm14_tm6,t
3232@TOP@human_GAPDH_TAA_len41_fa20_ta0_fm14_tm6*115*c,1,12182,1,0,12184,0.0,115,3232@TOP@human_GAPDH_TAA_len41_fa20_ta0_fm14_tm6,c
3232@TOP@human_GAPDH_TAA_len41_fa20_ta0_fm14_tm6*116*c,0,12134,0,0,12134,0.0,116,3232@TOP@human_GAPDH_TAA_len41_fa20_ta0_fm14_tm6,c
3232@TOP@human_GAPDH_TAA_len41_fa20_ta0_fm14_tm6*117*a,12096,0,32,0,12128,0.003,117,3232@TOP@human_GAPDH_TAA_len41_fa20_ta0_fm14_tm6,a
3232@TOP@human_GAPDH_TAA_len41_fa20_ta0_fm14_tm6*118*a,11825,0,219,0,12044,0.018,118,3232@TOP@human_GAPDH_TAA_len41_fa20_ta0_fm14_tm6,a
3232@TOP@human_GAPDH_TAA_len41_fa20_ta0_fm14_tm6*119*g,0,0,12044,0,12044,1.0,119,3232@TOP@human_GAPDH_TAA_len41_fa20_ta0_fm14_tm6,g
3232@TOP@human_GAPDH_TAA_len41_fa20_ta0_fm14_tm6*120*g,1,0,12004,0,12005,1.0,120,3232@TOP@human_GAPDH_TAA_len41_fa20_ta0_fm14_tm6,g
3232@TOP@human_GAPDH_TAA_len41_fa20_ta0_fm14_tm6*121*a,12123,0,4,0,12127,0.0,121,3232@TOP@human_GAPDH_TAA_len41_fa20_ta0_fm14_tm6,a
3232@TOP@human_GAPDH_TAA_len41_fa20_ta0_fm14_tm6*122*g,2,0,12144,0,12146,1.0,122,3232@TOP@human_GAPDH_TAA_len41_fa20_ta0_fm14_tm6,g
3232@TOP@human_GAPDH_TAA_len41_fa20_ta0_fm14_tm6*123*t,1,1,1,11958,11961,0.0,123,3232@TOP@human_GAPDH_TAA_len41_fa20_ta0_fm14_tm6,t
3232@TOP@human_GAPDH_TAA_len41_fa20_ta0_fm14_tm6*124*a,11574,1,378,1,11954,0.032,124,3232@TOP@human_GAPDH_TAA_len41_fa20_ta0_fm14_tm6,a
3232@TOP@human_GAPDH_TAA_len41_fa20_ta0_fm14_tm6*125*a,11703,1,190,0,11894,0.016,125,3232@TOP@human_GAPDH_TAA_len41_fa20_ta0_fm14_tm6,a
3232@TOP@human_GAPDH_TAA_len41_fa20_ta0_fm14_tm6*126*g,1,0,11985,0,11986,1.0,126,3232@TOP@human_GAPDH_TAA_len41_fa20_ta0_fm14_tm6,g
3232@TOP@human_GAPDH_TAA_len41_fa20_ta0_fm14_tm6*127*a,12081,0,9,0,12090,0.001,127,3232@TOP@human_GAPDH_TAA_len41_fa20_ta0_fm14_tm6,a
3232@TOP@human_GAPDH_TAA_len41_fa20_ta0_fm14_tm6*128*c,0,12153,3,1,12157,0.0,128,3232@TOP@human_GAPDH_TAA_len41_fa20_ta0_fm14_tm6,c
3232@TOP@human_GAPDH_TAA_len41_fa20_ta0_fm14_tm6*129*c,0,12060,0,0,12060,0.0,129,3232@TOP@human_GAPDH_TAA_len41_fa20_ta0_fm14_tm6,c
3232@TOP@human_GAPDH_TAA_len41_fa20_ta0_fm14_tm6*130*c,2,12126,0,1,12129,0.0,130,3232@TOP@human_GAPDH_TAA_len41_fa20_ta0_fm14_tm6,c
3232@TOP@human_GAPDH_TAA_len41_fa20_ta0_fm14_tm6*131*c,2,12161,0,0,12163,0.0,131,3232@TOP@human_GAPDH_TAA_len41_fa20_ta0_fm14_tm6,c
3232@TOP@human_GAPDH_TAA_len41_fa20_ta0_fm14_tm6*132*t,2,3,1,11975,11981,0.0,132,3232@TOP@human_GAPDH_TAA_len41_fa20_ta0_fm14_tm6,t
3232@TOP@human_GAPDH_TAA_len41_fa20_ta0_fm14_tm6*133*g,0,0,11967,0,11967,1.0,133,3232@TOP@human_GAPDH_TAA_len41_fa20_ta0_fm14_tm6,g
3232@TOP@human_GAPDH_TAA_len41_fa20_ta0_fm14_tm6*134*g,0,0,12016,0,12016,1.0,134,3232@TOP@human_GAPDH_TAA_len41_fa20_ta0_fm14_tm6,g
3233@TOP@human_GAPDH_TAA_len41_fa20_ta0_fm14_tm6*114*t,1,1,0,11215,11217,0.0,114,3233@TOP@human_GAPDH_TAA_len41_fa20_ta0_fm14_tm6,t
3233@TOP@human_GAPDH_TAA_len41_fa20_ta0_fm14_tm6*115*c,0,11280,0,0,11280,0.0,115,3233@TOP@human_GAPDH_TAA_len41_fa20_ta0_fm14_tm6,c
3233@TOP@human_GAPDH_TAA_len41_fa20_ta0_fm14_tm6*116*c,0,11236,0,0,11236,0.0,116,3233@TOP@human_GAPDH_TAA_len41_fa20_ta0_fm14_tm6,c
3233@TOP@human_GAPDH_TAA_len41_fa20_ta0_fm14_tm6*117*a,11211,0,20,1,11232,0.002,117,3233@TOP@human_GAPDH_TAA_len41_fa20_ta0_fm14_tm6,a
3233@TOP@human_GAPDH_TAA_len41_fa20_ta0_fm14_tm6*118*a,11049,0,139,0,11188,0.012,118,3233@TOP@human_GAPDH_TAA_len41_fa20_ta0_fm14_tm6,a
3233@TOP@human_GAPDH_TAA_len41_fa20_ta0_fm14_tm6*119*g,0,0,11137,0,11137,1.0,119,3233@TOP@human_GAPDH_TAA_len41_fa20_ta0_fm14_tm6,g
3233@TOP@human_GAPDH_TAA_len41_fa20_ta0_fm14_tm6*120*g,0,0,11127,1,11128,1.0,120,3233@TOP@human_GAPDH_TAA_len41_fa20_ta0_fm14_tm6,g
3233@TOP@human_GAPDH_TAA_len41_fa20_ta0_fm14_tm6*121*a,11224,0,4,0,11228,0.0,121,3233@TOP@human_GAPDH_TAA_len41_fa20_ta0_fm14_tm6,a
3233@TOP@human_GAPDH_TAA_len41_fa20_ta0_fm14_tm6*122*g,4,0,11227,0,11231,1.0,122,3233@TOP@human_GAPDH_TAA_len41_fa20_ta0_fm14_tm6,g
3233@TOP@human_GAPDH_TAA_len41_fa20_ta0_fm14_tm6*123*t,1,1,2,11101,11105,0.0,123,3233@TOP@human_GAPDH_TAA_len41_fa20_ta0_fm14_tm6,t
3233@TOP@human_GAPDH_TAA_len41_fa20_ta0_fm14_tm6*124*a,10678,1,411,0,11090,0.037,124,3233@TOP@human_GAPDH_TAA_len41_fa20_ta0_fm14_tm6,a
3233@TOP@human_GAPDH_TAA_len41_fa20_ta0_fm14_tm6*125*a,10734,0,311,0,11045,0.028,125,3233@TOP@human_GAPDH_TAA_len41_fa20_ta0_fm14_tm6,a
3233@TOP@human_GAPDH_TAA_len41_fa20_ta0_fm14_tm6*126*g,2,1,11092,0,11095,1.0,126,3233@TOP@human_GAPDH_TAA_len41_fa20_ta0_fm14_tm6,g
3233@TOP@human_GAPDH_TAA_len41_fa20_ta0_fm14_tm6*127*a,11204,0,5,0,11209,0.0,127,3233@TOP@human_GAPDH_TAA_len41_fa20_ta0_fm14_tm6,a
3233@TOP@human_GAPDH_TAA_len41_fa20_ta0_fm14_tm6*128*c,1,11263,1,0,11265,0.0,128,3233@TOP@human_GAPDH_TAA_len41_fa20_ta0_fm14_tm6,c
3233@TOP@human_GAPDH_TAA_len41_fa20_ta0_fm14_tm6*129*c,2,11173,0,3,11178,0.0,129,3233@TOP@human_GAPDH_TAA_len41_fa20_ta0_fm14_tm6,c
3233@TOP@human_GAPDH_TAA_len41_fa20_ta0_fm14_tm6*130*c,1,11235,0,0,11236,0.0,130,3233@TOP@human_GAPDH_TAA_len41_fa20_ta0_fm14_tm6,c
3233@TOP@human_GAPDH_TAA_len41_fa20_ta0_fm14_tm6*131*c,2,11265,0,1,11268,0.0,131,3233@TOP@human_GAPDH_TAA_len41_fa20_ta0_fm14_tm6,c
3233@TOP@human_GAPDH_TAA_len41_fa20_ta0_fm14_tm6*132*t,0,3,0,11102,11105,0.0,132,3233@TOP@human_GAPDH_TAA_len41_fa20_ta0_fm14_tm6,t
3233@TOP@human_GAPDH_TAA_len41_fa20_ta0_fm14_tm6*133*g,1,0,11082,0,11083,1.0,133,3233@TOP@human_GAPDH_TAA_len41_fa20_ta0_fm14_tm6,g
3233@TOP@human_GAPDH_TAA_len41_fa20_ta0_fm14_tm6*134*g,1,3,11109,0,11113,1.0,134,3233@TOP@human_GAPDH_TAA_len41_fa20_ta0_fm14_tm6,g
3234@TOP@human_GAPDH_TAA_len41_fa20_ta0_fm14_tm6*114*t,0,6,0,14369,14375,0.0,114,3234@TOP@human_GAPDH_TAA_len41_fa20_ta0_fm14_tm6,t
3234@TOP@human_GAPDH_TAA_len41_fa20_ta0_fm14_tm6*115*c,3,14457,0,0,14460,0.0,115,3234@TOP@human_GAPDH_TAA_len41_fa20_ta0_fm14_tm6,c
3234@TOP@human_GAPDH_TAA_len41_fa20_ta0_fm14_tm6*116*c,0,14416,0,0,14416,0.0,116,3234@TOP@human_GAPDH_TAA_len41_fa20_ta0_fm14_tm6,c
3234@TOP@human_GAPDH_TAA_len41_fa20_ta0_fm14_tm6*117*a,14388,0,22,0,14410,0.002,117,3234@TOP@human_GAPDH_TAA_len41_fa20_ta0_fm14_tm6,a
3234@TOP@human_GAPDH_TAA_len41_fa20_ta0_fm14_tm6*118*a,14150,0,148,0,14298,0.01,118,3234@TOP@human_GAPDH_TAA_len41_fa20_ta0_fm14_tm6,a
3234@TOP@human_GAPDH_TAA_len41_fa20_ta0_fm14_tm6*119*g,0,0,14289,0,14289,1.0,119,3234@TOP@human_GAPDH_TAA_len41_fa20_ta0_fm14_tm6,g
3234@TOP@human_GAPDH_TAA_len41_fa20_ta0_fm14_tm6*120*g,1,1,14231,0,14233,1.0,120,3234@TOP@human_GAPDH_TAA_len41_fa20_ta0_fm14_tm6,g
3234@TOP@human_GAPDH_TAA_len41_fa20_ta0_fm14_tm6*121*a,14369,1,4,0,14374,0.0,121,3234@TOP@human_GAPDH_TAA_len41_fa20_ta0_fm14_tm6,a
3234@TOP@human_GAPDH_TAA_len41_fa20_ta0_fm14_tm6*122*g,0,0,14412,0,14412,1.0,122,3234@TOP@human_GAPDH_TAA_len41_fa20_ta0_fm14_tm6,g
3234@TOP@human_GAPDH_TAA_len41_fa20_ta0_fm14_tm6*123*t,1,1,1,14208,14211,0.0,123,3234@TOP@human_GAPDH_TAA_len41_fa20_ta0_fm14_tm6,t
3234@TOP@human_GAPDH_TAA_len41_fa20_ta0_fm14_tm6*124*a,13151,0,1044,0,14195,0.074,124,3234@TOP@human_GAPDH_TAA_len41_fa20_ta0_fm14_tm6,a
3234@TOP@human_GAPDH_TAA_len41_fa20_ta0_fm14_tm6*125*a,13900,3,261,0,14164,0.018,125,3234@TOP@human_GAPDH_TAA_len41_fa20_ta0_fm14_tm6,a
3234@TOP@human_GAPDH_TAA_len41_fa20_ta0_fm14_tm6*126*g,0,0,14244,1,14245,1.0,126,3234@TOP@human_GAPDH_TAA_len41_fa20_ta0_fm14_tm6,g
3234@TOP@human_GAPDH_TAA_len41_fa20_ta0_fm14_tm6*127*a,14331,1,5,0,14337,0.0,127,3234@TOP@human_GAPDH_TAA_len41_fa20_ta0_fm14_tm6,a
3234@TOP@human_GAPDH_TAA_len41_fa20_ta0_fm14_tm6*128*c,0,14429,1,0,14430,0.0,128,3234@TOP@human_GAPDH_TAA_len41_fa20_ta0_fm14_tm6,c
3234@TOP@human_GAPDH_TAA_len41_fa20_ta0_fm14_tm6*129*c,0,14331,0,0,14331,0.0,129,3234@TOP@human_GAPDH_TAA_len41_fa20_ta0_fm14_tm6,c
3234@TOP@human_GAPDH_TAA_len41_fa20_ta0_fm14_tm6*130*c,0,14409,0,0,14409,0.0,130,3234@TOP@human_GAPDH_TAA_len41_fa20_ta0_fm14_tm6,c
3234@TOP@human_GAPDH_TAA_len41_fa20_ta0_fm14_tm6*131*c,0,14435,0,0,14435,0.0,131,3234@TOP@human_GAPDH_TAA_len41_fa20_ta0_fm14_tm6,c
3234@TOP@human_GAPDH_TAA_len41_fa20_ta0_fm14_tm6*132*t,1,5,0,14258,14264,0.0,132,3234@TOP@human_GAPDH_TAA_len41_fa20_ta0_fm14_tm6,t
3234@TOP@human_GAPDH_TAA_len41_fa20_ta0_fm14_tm6*133*g,0,1,14163,2,14166,1.0,133,3234@TOP@human_GAPDH_TAA_len41_fa20_ta0_fm14_tm6,g
3234@TOP@human_GAPDH_TAA_len41_fa20_ta0_fm14_tm6*134*g,0,1,14282,1,14284,1.0,134,3234@TOP@human_GAPDH_TAA_len41_fa20_ta0_fm14_tm6,g
3235@TOP@human_GAPDH_TAA_len41_fa20_ta0_fm14_tm6*114*t,0,0,0,1412,1412,0.0,114,3235@TOP@human_GAPDH_TAA_len41_fa20_ta0_fm14_tm6,t
3235@TOP@human_GAPDH_TAA_len41_fa20_ta0_fm14_tm6*115*c,0,1424,0,0,1424,0.0,115,3235@TOP@human_GAPDH_TAA_len41_fa20_ta0_fm14_tm6,c
3235@TOP@human_GAPDH_TAA_len41_fa20_ta0_fm14_tm6*116*c,0,1418,0,0,1418,0.0,116,3235@TOP@human_GAPDH_TAA_len41_fa20_ta0_fm14_tm6,c
3235@TOP@human_GAPDH_TAA_len41_fa20_ta0_fm14_tm6*117*a,1403,0,9,0,1412,0.006,117,3235@TOP@human_GAPDH_TAA_len41_fa20_ta0_fm14_tm6,a
3235@TOP@human_GAPDH_TAA_len41_fa20_ta0_fm14_tm6*118*a,1361,0,45,0,1406,0.032,118,3235@TOP@human_GAPDH_TAA_len41_fa20_ta0_fm14_tm6,a
3235@TOP@human_GAPDH_TAA_len41_fa20_ta0_fm14_tm6*119*g,0,0,1404,0,1404,1.0,119,3235@TOP@human_GAPDH_TAA_len41_fa20_ta0_fm14_tm6,g
3235@TOP@human_GAPDH_TAA_len41_fa20_ta0_fm14_tm6*120*g,0,0,1397,0,1397,1.0,120,3235@TOP@human_GAPDH_TAA_len41_fa20_ta0_fm14_tm6,g
3235@TOP@human_GAPDH_TAA_len41_fa20_ta0_fm14_tm6*121*a,1414,0,0,0,1414,0.0,121,3235@TOP@human_GAPDH_TAA_len41_fa20_ta0_fm14_tm6,a
3235@TOP@human_GAPDH_TAA_len41_fa20_ta0_fm14_tm6*122*g,0,0,1416,0,1416,1.0,122,3235@TOP@human_GAPDH_TAA_len41_fa20_ta0_fm14_tm6,g
3235@TOP@human_GAPDH_TAA_len41_fa20_ta0_fm14_tm6*123*t,0,0,0,1394,1394,0.0,123,3235@TOP@human_GAPDH_TAA_len41_fa20_ta0_fm14_tm6,t
3235@TOP@human_GAPDH_TAA_len41_fa20_ta0_fm14_tm6*124*a,1304,1,79,1,1385,0.057,124,3235@TOP@human_GAPDH_TAA_len41_fa20_ta0_fm14_tm6,a
3235@TOP@human_GAPDH_TAA_len41_fa20_ta0_fm14_tm6*125*a,1341,0,56,0,1397,0.04,125,3235@TOP@human_GAPDH_TAA_len41_fa20_ta0_fm14_tm6,a
3235@TOP@human_GAPDH_TAA_len41_fa20_ta0_fm14_tm6*126*g,0,0,1402,0,1402,1.0,126,3235@TOP@human_GAPDH_TAA_len41_fa20_ta0_fm14_tm6,g
3235@TOP@human_GAPDH_TAA_len41_fa20_ta0_fm14_tm6*127*a,1409,0,2,0,1411,0.001,127,3235@TOP@human_GAPDH_TAA_len41_fa20_ta0_fm14_tm6,a
3235@TOP@human_GAPDH_TAA_len41_fa20_ta0_fm14_tm6*128*c,0,1421,0,0,1421,0.0,128,3235@TOP@human_GAPDH_TAA_len41_fa20_ta0_fm14_tm6,c
3235@TOP@human_GAPDH_TAA_len41_fa20_ta0_fm14_tm6*129*c,0,1409,0,0,1409,0.0,129,3235@TOP@human_GAPDH_TAA_len41_fa20_ta0_fm14_tm6,c
3235@TOP@human_GAPDH_TAA_len41_fa20_ta0_fm14_tm6*130*c,0,1413,0,0,1413,0.0,130,3235@TOP@human_GAPDH_TAA_len41_fa20_ta0_fm14_tm6,c
3235@TOP@human_GAPDH_TAA_len41_fa20_ta0_fm14_tm6*131*c,0,1424,0,0,1424,0.0,131,3235@TOP@human_GAPDH_TAA_len41_fa20_ta0_fm14_tm6,c
3235@TOP@human_GAPDH_TAA_len41_fa20_ta0_fm14_tm6*132*t,0,0,0,1395,1395,0.0,132,3235@TOP@human_GAPDH_TAA_len41_fa20_ta0_fm14_tm6,t
3235@TOP@human_GAPDH_TAA_len41_fa20_ta0_fm14_tm6*133*g,0,0,1401,0,1401,1.0,133,3235@TOP@human_GAPDH_TAA_len41_fa20_ta0_fm14_tm6,g
3235@TOP@human_GAPDH_TAA_len41_fa20_ta0_fm14_tm6*134*g,2,0,1405,0,1407,0.999,134,3235@TOP@human_GAPDH_TAA_len41_fa20_ta0_fm14_tm6,g
3236@TOP@human_GAPDH_TAA_len41_fa20_ta0_fm14_tm6*114*t,1,1,0,1343,1345,0.0,114,3236@TOP@human_GAPDH_TAA_len41_fa20_ta0_fm14_tm6,t
3236@TOP@human_GAPDH_TAA_len41_fa20_ta0_fm14_tm6*115*c,0,1352,0,0,1352,0.0,115,3236@TOP@human_GAPDH_TAA_len41_fa20_ta0_fm14_tm6,c
3236@TOP@human_GAPDH_TAA_len41_fa20_ta0_fm14_tm6*116*c,0,1343,0,0,1343,0.0,116,3236@TOP@human_GAPDH_TAA_len41_fa20_ta0_fm14_tm6,c
3236@TOP@human_GAPDH_TAA_len41_fa20_ta0_fm14_tm6*117*a,1345,0,1,0,1346,0.001,117,3236@TOP@human_GAPDH_TAA_len41_fa20_ta0_fm14_tm6,a
3236@TOP@human_GAPDH_TAA_len41_fa20_ta0_fm14_tm6*118*a,1302,0,35,0,1337,0.026,118,3236@TOP@human_GAPDH_TAA_len41_fa20_ta0_fm14_tm6,a
3236@TOP@human_GAPDH_TAA_len41_fa20_ta0_fm14_tm6*119*g,0,0,1336,0,1336,1.0,119,3236@TOP@human_GAPDH_TAA_len41_fa20_ta0_fm14_tm6,g
3236@TOP@human_GAPDH_TAA_len41_fa20_ta0_fm14_tm6*120*g,0,0,1331,0,1331,1.0,120,3236@TOP@human_GAPDH_TAA_len41_fa20_ta0_fm14_tm6,g
3236@TOP@human_GAPDH_TAA_len41_fa20_ta0_fm14_tm6*121*a,1345,0,0,0,1345,0.0,121,3236@TOP@human_GAPDH_TAA_len41_fa20_ta0_fm14_tm6,a
3236@TOP@human_GAPDH_TAA_len41_fa20_ta0_fm14_tm6*122*g,1,0,1348,0,1349,0.999,122,3236@TOP@human_GAPDH_TAA_len41_fa20_ta0_fm14_tm6,g
3236@TOP@human_GAPDH_TAA_len41_fa20_ta0_fm14_tm6*123*t,1,1,0,1322,1324,0.0,123,3236@TOP@human_GAPDH_TAA_len41_fa20_ta0_fm14_tm6,t
3236@TOP@human_GAPDH_TAA_len41_fa20_ta0_fm14_tm6*124*a,1134,0,196,0,1330,0.147,124,3236@TOP@human_GAPDH_TAA_len41_fa20_ta0_fm14_tm6,a
3236@TOP@human_GAPDH_TAA_len41_fa20_ta0_fm14_tm6*125*a,1164,0,158,0,1322,0.12,125,3236@TOP@human_GAPDH_TAA_len41_fa20_ta0_fm14_tm6,a
3236@TOP@human_GAPDH_TAA_len41_fa20_ta0_fm14_tm6*126*g,0,0,1326,0,1326,1.0,126,3236@TOP@human_GAPDH_TAA_len41_fa20_ta0_fm14_tm6,g
3236@TOP@human_GAPDH_TAA_len41_fa20_ta0_fm14_tm6*127*a,1327,0,9,0,1336,0.007,127,3236@TOP@human_GAPDH_TAA_len41_fa20_ta0_fm14_tm6,a
3236@TOP@human_GAPDH_TAA_len41_fa20_ta0_fm14_tm6*128*c,0,1348,0,0,1348,0.0,128,3236@TOP@human_GAPDH_TAA_len41_fa20_ta0_fm14_tm6,c
3236@TOP@human_GAPDH_TAA_len41_fa20_ta0_fm14_tm6*129*c,0,1336,0,0,1336,0.0,129,3236@TOP@human_GAPDH_TAA_len41_fa20_ta0_fm14_tm6,c
3236@TOP@human_GAPDH_TAA_len41_fa20_ta0_fm14_tm6*130*c,0,1347,0,0,1347,0.0,130,3236@TOP@human_GAPDH_TAA_len41_fa20_ta0_fm14_tm6,c
3236@TOP@human_GAPDH_TAA_len41_fa20_ta0_fm14_tm6*131*c,0,1348,0,0,1348,0.0,131,3236@TOP@human_GAPDH_TAA_len41_fa20_ta0_fm14_tm6,c
3236@TOP@human_GAPDH_TAA_len41_fa20_ta0_fm14_tm6*132*t,0,0,0,1326,1326,0.0,132,3236@TOP@human_GAPDH_TAA_len41_fa20_ta0_fm14_tm6,t
3236@TOP@human_GAPDH_TAA_len41_fa20_ta0_fm14_tm6*133*g,0,0,1328,0,1328,1.0,133,3236@TOP@human_GAPDH_TAA_len41_fa20_ta0_fm14_tm6,g
3236@TOP@human_GAPDH_TAA_len41_fa20_ta0_fm14_tm6*134*g,0,0,1319,0,1319,1.0,134,3236@TOP@human_GAPDH_TAA_len41_fa20_ta0_fm14_tm6,g
3237@TOP@human_GAPDH_TAA_len41_fa20_ta0_fm14_tm6*114*t,3,5,0,23741,23749,0.0,114,3237@TOP@human_GAPDH_TAA_len41_fa20_ta0_fm14_tm6,t
3237@TOP@human_GAPDH_TAA_len41_fa20_ta0_fm14_tm6*115*c,1,23871,0,2,23874,0.0,115,3237@TOP@human_GAPDH_TAA_len41_fa20_ta0_fm14_tm6,c
3237@TOP@human_GAPDH_TAA_len41_fa20_ta0_fm14_tm6*116*c,4,23766,0,2,23772,0.0,116,3237@TOP@human_GAPDH_TAA_len41_fa20_ta0_fm14_tm6,c
3237@TOP@human_GAPDH_TAA_len41_fa20_ta0_fm14_tm6*117*a,23735,0,26,0,23761,0.001,117,3237@TOP@human_GAPDH_TAA_len41_fa20_ta0_fm14_tm6,a
3237@TOP@human_GAPDH_TAA_len41_fa20_ta0_fm14_tm6*118*a,23411,1,242,0,23654,0.01,118,3237@TOP@human_GAPDH_TAA_len41_fa20_ta0_fm14_tm6,a
3237@TOP@human_GAPDH_TAA_len41_fa20_ta0_fm14_tm6*119*g,0,0,23564,1,23565,1.0,119,3237@TOP@human_GAPDH_TAA_len41_fa20_ta0_fm14_tm6,g
3237@TOP@human_GAPDH_TAA_len41_fa20_ta0_fm14_tm6*120*g,5,0,23507,1,23513,1.0,120,3237@TOP@human_GAPDH_TAA_len41_fa20_ta0_fm14_tm6,g
3237@TOP@human_GAPDH_TAA_len41_fa20_ta0_fm14_tm6*121*a,23726,0,37,0,23763,0.002,121,3237@TOP@human_GAPDH_TAA_len41_fa20_ta0_fm14_tm6,a
3237@TOP@human_GAPDH_TAA_len41_fa20_ta0_fm14_tm6*122*g,1,0,23787,0,23788,1.0,122,3237@TOP@human_GAPDH_TAA_len41_fa20_ta0_fm14_tm6,g
3237@TOP@human_GAPDH_TAA_len41_fa20_ta0_fm14_tm6*123*t,3,1,2,23491,23497,0.0,123,3237@TOP@human_GAPDH_TAA_len41_fa20_ta0_fm14_tm6,t
3237@TOP@human_GAPDH_TAA_len41_fa20_ta0_fm14_tm6*124*a,21787,2,1622,0,23411,0.069,124,3237@TOP@human_GAPDH_TAA_len41_fa20_ta0_fm14_tm6,a
3237@TOP@human_GAPDH_TAA_len41_fa20_ta0_fm14_tm6*125*a,22978,1,369,1,23349,0.016,125,3237@TOP@human_GAPDH_TAA_len41_fa20_ta0_fm14_tm6,a
3237@TOP@human_GAPDH_TAA_len41_fa20_ta0_fm14_tm6*126*g,0,0,23464,0,23464,1.0,126,3237@TOP@human_GAPDH_TAA_len41_fa20_ta0_fm14_tm6,g
3237@TOP@human_GAPDH_TAA_len41_fa20_ta0_fm14_tm6*127*a,23694,0,20,0,23714,0.001,127,3237@TOP@human_GAPDH_TAA_len41_fa20_ta0_fm14_tm6,a
3237@TOP@human_GAPDH_TAA_len41_fa20_ta0_fm14_tm6*128*c,1,23827,0,0,23828,0.0,128,3237@TOP@human_GAPDH_TAA_len41_fa20_ta0_fm14_tm6,c
3237@TOP@human_GAPDH_TAA_len41_fa20_ta0_fm14_tm6*129*c,5,23620,0,0,23625,0.0,129,3237@TOP@human_GAPDH_TAA_len41_fa20_ta0_fm14_tm6,c
3237@TOP@human_GAPDH_TAA_len41_fa20_ta0_fm14_tm6*130*c,1,23779,0,0,23780,0.0,130,3237@TOP@human_GAPDH_TAA_len41_fa20_ta0_fm14_tm6,c
3237@TOP@human_GAPDH_TAA_len41_fa20_ta0_fm14_tm6*131*c,4,23812,0,3,23819,0.0,131,3237@TOP@human_GAPDH_TAA_len41_fa20_ta0_fm14_tm6,c
3237@TOP@human_GAPDH_TAA_len41_fa20_ta0_fm14_tm6*132*t,3,3,1,23486,23493,0.0,132,3237@TOP@human_GAPDH_TAA_len41_fa20_ta0_fm14_tm6,t
3237@TOP@human_GAPDH_TAA_len41_fa20_ta0_fm14_tm6*133*g,0,1,23451,3,23455,1.0,133,3237@TOP@human_GAPDH_TAA_len41_fa20_ta0_fm14_tm6,g
3237@TOP@human_GAPDH_TAA_len41_fa20_ta0_fm14_tm6*134*g,0,3,23587,1,23591,1.0,134,3237@TOP@human_GAPDH_TAA_len41_fa20_ta0_fm14_tm6,g
3238@TOP@human_GAPDH_TAA_len41_fa20_ta0_fm14_tm6*114*t,1,1,0,4817,4819,0.0,114,3238@TOP@human_GAPDH_TAA_len41_fa20_ta0_fm14_tm6,t
3238@TOP@human_GAPDH_TAA_len41_fa20_ta0_fm14_tm6*115*c,0,4842,0,0,4842,0.0,115,3238@TOP@human_GAPDH_TAA_len41_fa20_ta0_fm14_tm6,c
3238@TOP@human_GAPDH_TAA_len41_fa20_ta0_fm14_tm6*116*c,0,4821,0,0,4821,0.0,116,3238@TOP@human_GAPDH_TAA_len41_fa20_ta0_fm14_tm6,c
3238@TOP@human_GAPDH_TAA_len41_fa20_ta0_fm14_tm6*117*a,4807,0,6,0,4813,0.001,117,3238@TOP@human_GAPDH_TAA_len41_fa20_ta0_fm14_tm6,a
3238@TOP@human_GAPDH_TAA_len41_fa20_ta0_fm14_tm6*118*a,4723,0,70,0,4793,0.015,118,3238@TOP@human_GAPDH_TAA_len41_fa20_ta0_fm14_tm6,a
3238@TOP@human_GAPDH_TAA_len41_fa20_ta0_fm14_tm6*119*g,0,0,4779,0,4779,1.0,119,3238@TOP@human_GAPDH_TAA_len41_fa20_ta0_fm14_tm6,g
3238@TOP@human_GAPDH_TAA_len41_fa20_ta0_fm14_tm6*120*g,0,0,4763,2,4765,1.0,120,3238@TOP@human_GAPDH_TAA_len41_fa20_ta0_fm14_tm6,g
3238@TOP@human_GAPDH_TAA_len41_fa20_ta0_fm14_tm6*121*a,4823,0,1,0,4824,0.0,121,3238@TOP@human_GAPDH_TAA_len41_fa20_ta0_fm14_tm6,a
3238@TOP@human_GAPDH_TAA_len41_fa20_ta0_fm14_tm6*122*g,0,0,4835,0,4835,1.0,122,3238@TOP@human_GAPDH_TAA_len41_fa20_ta0_fm14_tm6,g
3238@TOP@human_GAPDH_TAA_len41_fa20_ta0_fm14_tm6*123*t,0,0,3,4758,4761,0.001,123,3238@TOP@human_GAPDH_TAA_len41_fa20_ta0_fm14_tm6,t
3238@TOP@human_GAPDH_TAA_len41_fa20_ta0_fm14_tm6*124*a,4421,0,310,0,4731,0.066,124,3238@TOP@human_GAPDH_TAA_len41_fa20_ta0_fm14_tm6,a
3238@TOP@human_GAPDH_TAA_len41_fa20_ta0_fm14_tm6*125*a,4608,0,118,0,4726,0.025,125,3238@TOP@human_GAPDH_TAA_len41_fa20_ta0_fm14_tm6,a
3238@TOP@human_GAPDH_TAA_len41_fa20_ta0_fm14_tm6*126*g,0,0,4761,0,4761,1.0,126,3238@TOP@human_GAPDH_TAA_len41_fa20_ta0_fm14_tm6,g
3238@TOP@human_GAPDH_TAA_len41_fa20_ta0_fm14_tm6*127*a,4810,0,3,0,4813,0.001,127,3238@TOP@human_GAPDH_TAA_len41_fa20_ta0_fm14_tm6,a
3238@TOP@human_GAPDH_TAA_len41_fa20_ta0_fm14_tm6*128*c,0,4830,3,0,4833,0.001,128,3238@TOP@human_GAPDH_TAA_len41_fa20_ta0_fm14_tm6,c
3238@TOP@human_GAPDH_TAA_len41_fa20_ta0_fm14_tm6*129*c,0,4796,0,1,4797,0.0,129,3238@TOP@human_GAPDH_TAA_len41_fa20_ta0_fm14_tm6,c
3238@TOP@human_GAPDH_TAA_len41_fa20_ta0_fm14_tm6*130*c,0,4819,0,1,4820,0.0,130,3238@TOP@human_GAPDH_TAA_len41_fa20_ta0_fm14_tm6,c
3238@TOP@human_GAPDH_TAA_len41_fa20_ta0_fm14_tm6*131*c,0,4831,0,0,4831,0.0,131,3238@TOP@human_GAPDH_TAA_len41_fa20_ta0_fm14_tm6,c
3238@TOP@human_GAPDH_TAA_len41_fa20_ta0_fm14_tm6*132*t,0,2,0,4774,4776,0.0,132,3238@TOP@human_GAPDH_TAA_len41_fa20_ta0_fm14_tm6,t
3238@TOP@human_GAPDH_TAA_len41_fa20_ta0_fm14_tm6*133*g,0,0,4757,0,4757,1.0,133,3238@TOP@human_GAPDH_TAA_len41_fa20_ta0_fm14_tm6,g
3238@TOP@human_GAPDH_TAA_len41_fa20_ta0_fm14_tm6*134*g,0,1,4766,0,4767,1.0,134,3238@TOP@human_GAPDH_TAA_len41_fa20_ta0_fm14_tm6,g
3239@TOP@human_GAPDH_TAA_len41_fa20_ta0_fm14_tm6*114*t,0,0,0,1704,1704,0.0,114,3239@TOP@human_GAPDH_TAA_len41_fa20_ta0_fm14_tm6,t
3239@TOP@human_GAPDH_TAA_len41_fa20_ta0_fm14_tm6*115*c,0,1711,1,0,1712,0.001,115,3239@TOP@human_GAPDH_TAA_len41_fa20_ta0_fm14_tm6,c
3239@TOP@human_GAPDH_TAA_len41_fa20_ta0_fm14_tm6*116*c,0,1708,0,0,1708,0.0,116,3239@TOP@human_GAPDH_TAA_len41_fa20_ta0_fm14_tm6,c
3239@TOP@human_GAPDH_TAA_len41_fa20_ta0_fm14_tm6*117*a,1704,0,4,0,1708,0.002,117,3239@TOP@human_GAPDH_TAA_len41_fa20_ta0_fm14_tm6,a
3239@TOP@human_GAPDH_TAA_len41_fa20_ta0_fm14_tm6*118*a,1654,0,44,0,1698,0.026,118,3239@TOP@human_GAPDH_TAA_len41_fa20_ta0_fm14_tm6,a
3239@TOP@human_GAPDH_TAA_len41_fa20_ta0_fm14_tm6*119*g,0,0,1696,0,1696,1.0,119,3239@TOP@human_GAPDH_TAA_len41_fa20_ta0_fm14_tm6,g
3239@TOP@human_GAPDH_TAA_len41_fa20_ta0_fm14_tm6*120*g,0,0,1686,0,1686,1.0,120,3239@TOP@human_GAPDH_TAA_len41_fa20_ta0_fm14_tm6,g
3239@TOP@human_GAPDH_TAA_len41_fa20_ta0_fm14_tm6*121*a,1702,0,0,0,1702,0.0,121,3239@TOP@human_GAPDH_TAA_len41_fa20_ta0_fm14_tm6,a
3239@TOP@human_GAPDH_TAA_len41_fa20_ta0_fm14_tm6*122*g,0,0,1706,0,1706,1.0,122,3239@TOP@human_GAPDH_TAA_len41_fa20_ta0_fm14_tm6,g
3239@TOP@human_GAPDH_TAA_len41_fa20_ta0_fm14_tm6*123*t,1,0,0,1679,1680,0.0,123,3239@TOP@human_GAPDH_TAA_len41_fa20_ta0_fm14_tm6,t
3239@TOP@human_GAPDH_TAA_len41_fa20_ta0_fm14_tm6*124*a,1572,0,104,0,1676,0.062,124,3239@TOP@human_GAPDH_TAA_len41_fa20_ta0_fm14_tm6,a
3239@TOP@human_GAPDH_TAA_len41_fa20_ta0_fm14_tm6*125*a,1630,0,38,0,1668,0.023,125,3239@TOP@human_GAPDH_TAA_len41_fa20_ta0_fm14_tm6,a
3239@TOP@human_GAPDH_TAA_len41_fa20_ta0_fm14_tm6*126*g,0,0,1688,0,1688,1.0,126,3239@TOP@human_GAPDH_TAA_len41_fa20_ta0_fm14_tm6,g
3239@TOP@human_GAPDH_TAA_len41_fa20_ta0_fm14_tm6*127*a,1698,0,1,0,1699,0.001,127,3239@TOP@human_GAPDH_TAA_len41_fa20_ta0_fm14_tm6,a
3239@TOP@human_GAPDH_TAA_len41_fa20_ta0_fm14_tm6*128*c,0,1708,0,0,1708,0.0,128,3239@TOP@human_GAPDH_TAA_len41_fa20_ta0_fm14_tm6,c
3239@TOP@human_GAPDH_TAA_len41_fa20_ta0_fm14_tm6*129*c,0,1700,0,0,1700,0.0,129,3239@TOP@human_GAPDH_TAA_len41_fa20_ta0_fm14_tm6,c
3239@TOP@human_GAPDH_TAA_len41_fa20_ta0_fm14_tm6*130*c,0,1703,0,1,1704,0.0,130,3239@TOP@human_GAPDH_TAA_len41_fa20_ta0_fm14_tm6,c
3239@TOP@human_GAPDH_TAA_len41_fa20_ta0_fm14_tm6*131*c,0,1711,0,0,1711,0.0,131,3239@TOP@human_GAPDH_TAA_len41_fa20_ta0_fm14_tm6,c
3239@TOP@human_GAPDH_TAA_len41_fa20_ta0_fm14_tm6*132*t,0,0,0,1681,1681,0.0,132,3239@TOP@human_GAPDH_TAA_len41_fa20_ta0_fm14_tm6,t
3239@TOP@human_GAPDH_TAA_len41_fa20_ta0_fm14_tm6*133*g,0,1,1691,0,1692,0.999,133,3239@TOP@human_GAPDH_TAA_len41_fa20_ta0_fm14_tm6,g
3239@TOP@human_GAPDH_TAA_len41_fa20_ta0_fm14_tm6*134*g,0,3,1697,0,1700,0.998,134,3239@TOP@human_GAPDH_TAA_len41_fa20_ta0_fm14_tm6,g
3240@TOP@human_GAPDH_TAA_len41_fa20_ta0_fm14_tm6*114*t,1,3,0,9176,9180,0.0,114,3240@TOP@human_GAPDH_TAA_len41_fa20_ta0_fm14_tm6,t
3240@TOP@human_GAPDH_TAA_len41_fa20_ta0_fm14_tm6*115*c,0,9233,0,3,9236,0.0,115,3240@TOP@human_GAPDH_TAA_len41_fa20_ta0_fm14_tm6,c
3240@TOP@human_GAPDH_TAA_len41_fa20_ta0_fm14_tm6*116*c,0,9200,0,1,9201,0.0,116,3240@TOP@human_GAPDH_TAA_len41_fa20_ta0_fm14_tm6,c
3240@TOP@human_GAPDH_TAA_len41_fa20_ta0_fm14_tm6*117*a,9186,0,13,2,9201,0.001,117,3240@TOP@human_GAPDH_TAA_len41_fa20_ta0_fm14_tm6,a
3240@TOP@human_GAPDH_TAA_len41_fa20_ta0_fm14_tm6*118*a,9040,0,114,0,9154,0.012,118,3240@TOP@human_GAPDH_TAA_len41_fa20_ta0_fm14_tm6,a
3240@TOP@human_GAPDH_TAA_len41_fa20_ta0_fm14_tm6*119*g,1,0,9121,0,9122,1.0,119,3240@TOP@human_GAPDH_TAA_len41_fa20_ta0_fm14_tm6,g
3240@TOP@human_GAPDH_TAA_len41_fa20_ta0_fm14_tm6*120*g,0,0,9083,0,9083,1.0,120,3240@TOP@human_GAPDH_TAA_len41_fa20_ta0_fm14_tm6,g
3240@TOP@human_GAPDH_TAA_len41_fa20_ta0_fm14_tm6*121*a,9194,0,4,0,9198,0.0,121,3240@TOP@human_GAPDH_TAA_len41_fa20_ta0_fm14_tm6,a
3240@TOP@human_GAPDH_TAA_len41_fa20_ta0_fm14_tm6*122*g,0,0,9199,0,9199,1.0,122,3240@TOP@human_GAPDH_TAA_len41_fa20_ta0_fm14_tm6,g
3240@TOP@human_GAPDH_TAA_len41_fa20_ta0_fm14_tm6*123*t,0,1,3,9064,9068,0.0,123,3240@TOP@human_GAPDH_TAA_len41_fa20_ta0_fm14_tm6,t
3240@TOP@human_GAPDH_TAA_len41_fa20_ta0_fm14_tm6*124*a,8432,1,603,0,9036,0.067,124,3240@TOP@human_GAPDH_TAA_len41_fa20_ta0_fm14_tm6,a
3240@TOP@human_GAPDH_TAA_len41_fa20_ta0_fm14_tm6*125*a,8801,0,218,0,9019,0.024,125,3240@TOP@human_GAPDH_TAA_len41_fa20_ta0_fm14_tm6,a
3240@TOP@human_GAPDH_TAA_len41_fa20_ta0_fm14_tm6*126*g,0,0,9082,0,9082,1.0,126,3240@TOP@human_GAPDH_TAA_len41_fa20_ta0_fm14_tm6,g
3240@TOP@human_GAPDH_TAA_len41_fa20_ta0_fm14_tm6*127*a,9164,0,6,0,9170,0.001,127,3240@TOP@human_GAPDH_TAA_len41_fa20_ta0_fm14_tm6,a
3240@TOP@human_GAPDH_TAA_len41_fa20_ta0_fm14_tm6*128*c,0,9213,1,0,9214,0.0,128,3240@TOP@human_GAPDH_TAA_len41_fa20_ta0_fm14_tm6,c
3240@TOP@human_GAPDH_TAA_len41_fa20_ta0_fm14_tm6*129*c,0,9143,0,0,9143,0.0,129,3240@TOP@human_GAPDH_TAA_len41_fa20_ta0_fm14_tm6,c
3240@TOP@human_GAPDH_TAA_len41_fa20_ta0_fm14_tm6*130*c,0,9199,0,1,9200,0.0,130,3240@TOP@human_GAPDH_TAA_len41_fa20_ta0_fm14_tm6,c
3240@TOP@human_GAPDH_TAA_len41_fa20_ta0_fm14_tm6*131*c,0,9223,0,0,9223,0.0,131,3240@TOP@human_GAPDH_TAA_len41_fa20_ta0_fm14_tm6,c
3240@TOP@human_GAPDH_TAA_len41_fa20_ta0_fm14_tm6*132*t,0,1,1,9092,9094,0.0,132,3240@TOP@human_GAPDH_TAA_len41_fa20_ta0_fm14_tm6,t
3240@TOP@human_GAPDH_TAA_len41_fa20_ta0_fm14_tm6*133*g,3,0,9068,1,9072,1.0,133,3240@TOP@human_GAPDH_TAA_len41_fa20_ta0_fm14_tm6,g
3240@TOP@human_GAPDH_TAA_len41_fa20_ta0_fm14_tm6*134*g,2,0,9102,0,9104,1.0,134,3240@TOP@human_GAPDH_TAA_len41_fa20_ta0_fm14_tm6,g
3241@TOP@human_GAPDH_TAA_len41_fa20_ta0_fm14_tm6*114*t,0,5,0,22522,22527,0.0,114,3241@TOP@human_GAPDH_TAA_len41_fa20_ta0_fm14_tm6,t
3241@TOP@human_GAPDH_TAA_len41_fa20_ta0_fm14_tm6*115*c,3,22635,0,0,22638,0.0,115,3241@TOP@human_GAPDH_TAA_len41_fa20_ta0_fm14_tm6,c
3241@TOP@human_GAPDH_TAA_len41_fa20_ta0_fm14_tm6*116*c,1,22555,0,2,22558,0.0,116,3241@TOP@human_GAPDH_TAA_len41_fa20_ta0_fm14_tm6,c
3241@TOP@human_GAPDH_TAA_len41_fa20_ta0_fm14_tm6*117*a,22490,0,60,0,22550,0.003,117,3241@TOP@human_GAPDH_TAA_len41_fa20_ta0_fm14_tm6,a
3241@TOP@human_GAPDH_TAA_len41_fa20_ta0_fm14_tm6*118*a,22122,0,286,0,22408,0.013,118,3241@TOP@human_GAPDH_TAA_len41_fa20_ta0_fm14_tm6,a
3241@TOP@human_GAPDH_TAA_len41_fa20_ta0_fm14_tm6*119*g,2,0,22387,1,22390,1.0,119,3241@TOP@human_GAPDH_TAA_len41_fa20_ta0_fm14_tm6,g
3241@TOP@human_GAPDH_TAA_len41_fa20_ta0_fm14_tm6*120*g,1,0,22277,0,22278,1.0,120,3241@TOP@human_GAPDH_TAA_len41_fa20_ta0_fm14_tm6,g
3241@TOP@human_GAPDH_TAA_len41_fa20_ta0_fm14_tm6*121*a,22518,0,8,2,22528,0.0,121,3241@TOP@human_GAPDH_TAA_len41_fa20_ta0_fm14_tm6,a
3241@TOP@human_GAPDH_TAA_len41_fa20_ta0_fm14_tm6*122*g,0,0,22552,0,22552,1.0,122,3241@TOP@human_GAPDH_TAA_len41_fa20_ta0_fm14_tm6,g
3241@TOP@human_GAPDH_TAA_len41_fa20_ta0_fm14_tm6*123*t,2,2,1,22213,22218,0.0,123,3241@TOP@human_GAPDH_TAA_len41_fa20_ta0_fm14_tm6,t
3241@TOP@human_GAPDH_TAA_len41_fa20_ta0_fm14_tm6*124*a,21531,1,667,0,22199,0.03,124,3241@TOP@human_GAPDH_TAA_len41_fa20_ta0_fm14_tm6,a
3241@TOP@human_GAPDH_TAA_len41_fa20_ta0_fm14_tm6*125*a,21831,0,320,0,22151,0.014,125,3241@TOP@human_GAPDH_TAA_len41_fa20_ta0_fm14_tm6,a
3241@TOP@human_GAPDH_TAA_len41_fa20_ta0_fm14_tm6*126*g,1,0,22234,0,22235,1.0,126,3241@TOP@human_GAPDH_TAA_len41_fa20_ta0_fm14_tm6,g
3241@TOP@human_GAPDH_TAA_len41_fa20_ta0_fm14_tm6*127*a,22456,2,16,1,22475,0.001,127,3241@TOP@human_GAPDH_TAA_len41_fa20_ta0_fm14_tm6,a
3241@TOP@human_GAPDH_TAA_len41_fa20_ta0_fm14_tm6*128*c,0,22600,1,0,22601,0.0,128,3241@TOP@human_GAPDH_TAA_len41_fa20_ta0_fm14_tm6,c
3241@TOP@human_GAPDH_TAA_len41_fa20_ta0_fm14_tm6*129*c,2,22444,0,2,22448,0.0,129,3241@TOP@human_GAPDH_TAA_len41_fa20_ta0_fm14_tm6,c
3241@TOP@human_GAPDH_TAA_len41_fa20_ta0_fm14_tm6*130*c,0,22557,1,1,22559,0.0,130,3241@TOP@human_GAPDH_TAA_len41_fa20_ta0_fm14_tm6,c
3241@TOP@human_GAPDH_TAA_len41_fa20_ta0_fm14_tm6*131*c,3,22596,0,2,22601,0.0,131,3241@TOP@human_GAPDH_TAA_len41_fa20_ta0_fm14_tm6,c
3241@TOP@human_GAPDH_TAA_len41_fa20_ta0_fm14_tm6*132*t,4,5,0,22280,22289,0.0,132,3241@TOP@human_GAPDH_TAA_len41_fa20_ta0_fm14_tm6,t
3241@TOP@human_GAPDH_TAA_len41_fa20_ta0_fm14_tm6*133*g,1,0,22243,1,22245,1.0,133,3241@TOP@human_GAPDH_TAA_len41_fa20_ta0_fm14_tm6,g
3241@TOP@human_GAPDH_TAA_len41_fa20_ta0_fm14_tm6*134*g,1,12,22345,0,22358,0.999,134,3241@TOP@human_GAPDH_TAA_len41_fa20_ta0_fm14_tm6,g
3242@TOP@human_GAPDH_TAA_len41_fa20_ta0_fm14_tm6*114*t,0,0,0,1257,1257,0.0,114,3242@TOP@human_GAPDH_TAA_len41_fa20_ta0_fm14_tm6,t
3242@TOP@human_GAPDH_TAA_len41_fa20_ta0_fm14_tm6*115*c,2,1259,0,0,1261,0.0,115,3242@TOP@human_GAPDH_TAA_len41_fa20_ta0_fm14_tm6,c
3242@TOP@human_GAPDH_TAA_len41_fa20_ta0_fm14_tm6*116*c,0,1259,0,0,1259,0.0,116,3242@TOP@human_GAPDH_TAA_len41_fa20_ta0_fm14_tm6,c
3242@TOP@human_GAPDH_TAA_len41_fa20_ta0_fm14_tm6*117*a,1255,0,2,0,1257,0.002,117,3242@TOP@human_GAPDH_TAA_len41_fa20_ta0_fm14_tm6,a
3242@TOP@human_GAPDH_TAA_len41_fa20_ta0_fm14_tm6*118*a,1192,0,52,0,1244,0.042,118,3242@TOP@human_GAPDH_TAA_len41_fa20_ta0_fm14_tm6,a
3242@TOP@human_GAPDH_TAA_len41_fa20_ta0_fm14_tm6*119*g,0,0,1246,0,1246,1.0,119,3242@TOP@human_GAPDH_TAA_len41_fa20_ta0_fm14_tm6,g
3242@TOP@human_GAPDH_TAA_len41_fa20_ta0_fm14_tm6*120*g,0,0,1242,0,1242,1.0,120,3242@TOP@human_GAPDH_TAA_len41_fa20_ta0_fm14_tm6,g
3242@TOP@human_GAPDH_TAA_len41_fa20_ta0_fm14_tm6*121*a,1250,0,0,0,1250,0.0,121,3242@TOP@human_GAPDH_TAA_len41_fa20_ta0_fm14_tm6,a
3242@TOP@human_GAPDH_TAA_len41_fa20_ta0_fm14_tm6*122*g,0,0,1260,0,1260,1.0,122,3242@TOP@human_GAPDH_TAA_len41_fa20_ta0_fm14_tm6,g
3242@TOP@human_GAPDH_TAA_len41_fa20_ta0_fm14_tm6*123*t,0,0,0,1243,1243,0.0,123,3242@TOP@human_GAPDH_TAA_len41_fa20_ta0_fm14_tm6,t
3242@TOP@human_GAPDH_TAA_len41_fa20_ta0_fm14_tm6*124*a,1107,0,117,0,1224,0.096,124,3242@TOP@human_GAPDH_TAA_len41_fa20_ta0_fm14_tm6,a
3242@TOP@human_GAPDH_TAA_len41_fa20_ta0_fm14_tm6*125*a,1183,0,53,0,1236,0.043,125,3242@TOP@human_GAPDH_TAA_len41_fa20_ta0_fm14_tm6,a
3242@TOP@human_GAPDH_TAA_len41_fa20_ta0_fm14_tm6*126*g,0,0,1245,0,1245,1.0,126,3242@TOP@human_GAPDH_TAA_len41_fa20_ta0_fm14_tm6,g
3242@TOP@human_GAPDH_TAA_len41_fa20_ta0_fm14_tm6*127*a,1244,0,4,0,1248,0.003,127,3242@TOP@human_GAPDH_TAA_len41_fa20_ta0_fm14_tm6,a
3242@TOP@human_GAPDH_TAA_len41_fa20_ta0_fm14_tm6*128*c,0,1256,0,0,1256,0.0,128,3242@TOP@human_GAPDH_TAA_len41_fa20_ta0_fm14_tm6,c
3242@TOP@human_GAPDH_TAA_len41_fa20_ta0_fm14_tm6*129*c,0,1251,0,0,1251,0.0,129,3242@TOP@human_GAPDH_TAA_len41_fa20_ta0_fm14_tm6,c
3242@TOP@human_GAPDH_TAA_len41_fa20_ta0_fm14_tm6*130*c,0,1255,0,0,1255,0.0,130,3242@TOP@human_GAPDH_TAA_len41_fa20_ta0_fm14_tm6,c
3242@TOP@human_GAPDH_TAA_len41_fa20_ta0_fm14_tm6*131*c,0,1259,0,0,1259,0.0,131,3242@TOP@human_GAPDH_TAA_len41_fa20_ta0_fm14_tm6,c
3242@TOP@human_GAPDH_TAA_len41_fa20_ta0_fm14_tm6*132*t,0,0,0,1240,1240,0.0,132,3242@TOP@human_GAPDH_TAA_len41_fa20_ta0_fm14_tm6,t
3242@TOP@human_GAPDH_TAA_len41_fa20_ta0_fm14_tm6*133*g,0,0,1235,0,1235,1.0,133,3242@TOP@human_GAPDH_TAA_len41_fa20_ta0_fm14_tm6,g
3242@TOP@human_GAPDH_TAA_len41_fa20_ta0_fm14_tm6*134*g,0,0,1241,0,1241,1.0,134,3242@TOP@human_GAPDH_TAA_len41_fa20_ta0_fm14_tm6,g
3243@TOP@human_GAPDH_TAA_len41_fa20_ta0_fm14_tm6*114*t,0,1,0,1653,1654,0.0,114,3243@TOP@human_GAPDH_TAA_len41_fa20_ta0_fm14_tm6,t
3243@TOP@human_GAPDH_TAA_len41_fa20_ta0_fm14_tm6*115*c,0,1660,0,1,1661,0.0,115,3243@TOP@human_GAPDH_TAA_len41_fa20_ta0_fm14_tm6,c
3243@TOP@human_GAPDH_TAA_len41_fa20_ta0_fm14_tm6*116*c,0,1656,0,0,1656,0.0,116,3243@TOP@human_GAPDH_TAA_len41_fa20_ta0_fm14_tm6,c
3243@TOP@human_GAPDH_TAA_len41_fa20_ta0_fm14_tm6*117*a,1649,0,13,0,1662,0.008,117,3243@TOP@human_GAPDH_TAA_len41_fa20_ta0_fm14_tm6,a
3243@TOP@human_GAPDH_TAA_len41_fa20_ta0_fm14_tm6*118*a,1537,0,113,0,1650,0.068,118,3243@TOP@human_GAPDH_TAA_len41_fa20_ta0_fm14_tm6,a
3243@TOP@human_GAPDH_TAA_len41_fa20_ta0_fm14_tm6*119*g,0,0,1646,0,1646,1.0,119,3243@TOP@human_GAPDH_TAA_len41_fa20_ta0_fm14_tm6,g
3243@TOP@human_GAPDH_TAA_len41_fa20_ta0_fm14_tm6*120*g,0,0,1638,0,1638,1.0,120,3243@TOP@human_GAPDH_TAA_len41_fa20_ta0_fm14_tm6,g
3243@TOP@human_GAPDH_TAA_len41_fa20_ta0_fm14_tm6*121*a,1656,0,1,0,1657,0.001,121,3243@TOP@human_GAPDH_TAA_len41_fa20_ta0_fm14_tm6,a
3243@TOP@human_GAPDH_TAA_len41_fa20_ta0_fm14_tm6*122*g,0,0,1659,0,1659,1.0,122,3243@TOP@human_GAPDH_TAA_len41_fa20_ta0_fm14_tm6,g
3243@TOP@human_GAPDH_TAA_len41_fa20_ta0_fm14_tm6*123*t,0,0,0,1634,1634,0.0,123,3243@TOP@human_GAPDH_TAA_len41_fa20_ta0_fm14_tm6,t
3243@TOP@human_GAPDH_TAA_len41_fa20_ta0_fm14_tm6*124*a,1500,0,129,0,1629,0.079,124,3243@TOP@human_GAPDH_TAA_len41_fa20_ta0_fm14_tm6,a
3243@TOP@human_GAPDH_TAA_len41_fa20_ta0_fm14_tm6*125*a,1554,0,77,0,1631,0.047,125,3243@TOP@human_GAPDH_TAA_len41_fa20_ta0_fm14_tm6,a
3243@TOP@human_GAPDH_TAA_len41_fa20_ta0_fm14_tm6*126*g,0,0,1642,0,1642,1.0,126,3243@TOP@human_GAPDH_TAA_len41_fa20_ta0_fm14_tm6,g
3243@TOP@human_GAPDH_TAA_len41_fa20_ta0_fm14_tm6*127*a,1651,0,1,0,1652,0.001,127,3243@TOP@human_GAPDH_TAA_len41_fa20_ta0_fm14_tm6,a
3243@TOP@human_GAPDH_TAA_len41_fa20_ta0_fm14_tm6*128*c,1,1660,0,0,1661,0.0,128,3243@TOP@human_GAPDH_TAA_len41_fa20_ta0_fm14_tm6,c
3243@TOP@human_GAPDH_TAA_len41_fa20_ta0_fm14_tm6*129*c,0,1637,0,0,1637,0.0,129,3243@TOP@human_GAPDH_TAA_len41_fa20_ta0_fm14_tm6,c
3243@TOP@human_GAPDH_TAA_len41_fa20_ta0_fm14_tm6*130*c,0,1657,0,0,1657,0.0,130,3243@TOP@human_GAPDH_TAA_len41_fa20_ta0_fm14_tm6,c
3243@TOP@human_GAPDH_TAA_len41_fa20_ta0_fm14_tm6*131*c,0,1659,0,0,1659,0.0,131,3243@TOP@human_GAPDH_TAA_len41_fa20_ta0_fm14_tm6,c
3243@TOP@human_GAPDH_TAA_len41_fa20_ta0_fm14_tm6*132*t,1,5,0,1634,1640,0.0,132,3243@TOP@human_GAPDH_TAA_len41_fa20_ta0_fm14_tm6,t
3243@TOP@human_GAPDH_TAA_len41_fa20_ta0_fm14_tm6*133*g,1,0,1638,0,1639,0.999,133,3243@TOP@human_GAPDH_TAA_len41_fa20_ta0_fm14_tm6,g
3243@TOP@human_GAPDH_TAA_len41_fa20_ta0_fm14_tm6*134*g,0,0,1650,0,1650,1.0,134,3243@TOP@human_GAPDH_TAA_len41_fa20_ta0_fm14_tm6,g
3244@TOP@human_GAPDH_TAA_len41_fa20_ta0_fm14_tm6*114*t,0,1,0,852,853,0.0,114,3244@TOP@human_GAPDH_TAA_len41_fa20_ta0_fm14_tm6,t
3244@TOP@human_GAPDH_TAA_len41_fa20_ta0_fm14_tm6*115*c,0,863,0,0,863,0.0,115,3244@TOP@human_GAPDH_TAA_len41_fa20_ta0_fm14_tm6,c
3244@TOP@human_GAPDH_TAA_len41_fa20_ta0_fm14_tm6*116*c,0,860,0,0,860,0.0,116,3244@TOP@human_GAPDH_TAA_len41_fa20_ta0_fm14_tm6,c
3244@TOP@human_GAPDH_TAA_len41_fa20_ta0_fm14_tm6*117*a,850,0,6,0,856,0.007,117,3244@TOP@human_GAPDH_TAA_len41_fa20_ta0_fm14_tm6,a
3244@TOP@human_GAPDH_TAA_len41_fa20_ta0_fm14_tm6*118*a,820,0,34,0,854,0.04,118,3244@TOP@human_GAPDH_TAA_len41_fa20_ta0_fm14_tm6,a
3244@TOP@human_GAPDH_TAA_len41_fa20_ta0_fm14_tm6*119*g,0,0,847,0,847,1.0,119,3244@TOP@human_GAPDH_TAA_len41_fa20_ta0_fm14_tm6,g
3244@TOP@human_GAPDH_TAA_len41_fa20_ta0_fm14_tm6*120*g,0,0,849,0,849,1.0,120,3244@TOP@human_GAPDH_TAA_len41_fa20_ta0_fm14_tm6,g
3244@TOP@human_GAPDH_TAA_len41_fa20_ta0_fm14_tm6*121*a,860,0,0,0,860,0.0,121,3244@TOP@human_GAPDH_TAA_len41_fa20_ta0_fm14_tm6,a
3244@TOP@human_GAPDH_TAA_len41_fa20_ta0_fm14_tm6*122*g,0,0,857,0,857,1.0,122,3244@TOP@human_GAPDH_TAA_len41_fa20_ta0_fm14_tm6,g
3244@TOP@human_GAPDH_TAA_len41_fa20_ta0_fm14_tm6*123*t,0,2,0,837,839,0.0,123,3244@TOP@human_GAPDH_TAA_len41_fa20_ta0_fm14_tm6,t
3244@TOP@human_GAPDH_TAA_len41_fa20_ta0_fm14_tm6*124*a,816,0,31,0,847,0.037,124,3244@TOP@human_GAPDH_TAA_len41_fa20_ta0_fm14_tm6,a
3244@TOP@human_GAPDH_TAA_len41_fa20_ta0_fm14_tm6*125*a,820,0,24,0,844,0.028,125,3244@TOP@human_GAPDH_TAA_len41_fa20_ta0_fm14_tm6,a
3244@TOP@human_GAPDH_TAA_len41_fa20_ta0_fm14_tm6*126*g,0,0,846,0,846,1.0,126,3244@TOP@human_GAPDH_TAA_len41_fa20_ta0_fm14_tm6,g
3244@TOP@human_GAPDH_TAA_len41_fa20_ta0_fm14_tm6*127*a,859,0,0,0,859,0.0,127,3244@TOP@human_GAPDH_TAA_len41_fa20_ta0_fm14_tm6,a
3244@TOP@human_GAPDH_TAA_len41_fa20_ta0_fm14_tm6*128*c,0,860,0,0,860,0.0,128,3244@TOP@human_GAPDH_TAA_len41_fa20_ta0_fm14_tm6,c
3244@TOP@human_GAPDH_TAA_len41_fa20_ta0_fm14_tm6*129*c,0,852,0,0,852,0.0,129,3244@TOP@human_GAPDH_TAA_len41_fa20_ta0_fm14_tm6,c
3244@TOP@human_GAPDH_TAA_len41_fa20_ta0_fm14_tm6*130*c,0,857,0,0,857,0.0,130,3244@TOP@human_GAPDH_TAA_len41_fa20_ta0_fm14_tm6,c
3244@TOP@human_GAPDH_TAA_len41_fa20_ta0_fm14_tm6*131*c,0,860,0,0,860,0.0,131,3244@TOP@human_GAPDH_TAA_len41_fa20_ta0_fm14_tm6,c
3244@TOP@human_GAPDH_TAA_len41_fa20_ta0_fm14_tm6*132*t,0,0,0,847,847,0.0,132,3244@TOP@human_GAPDH_TAA_len41_fa20_ta0_fm14_tm6,t
3244@TOP@human_GAPDH_TAA_len41_fa20_ta0_fm14_tm6*133*g,0,0,843,0,843,1.0,133,3244@TOP@human_GAPDH_TAA_len41_fa20_ta0_fm14_tm6,g
3244@TOP@human_GAPDH_TAA_len41_fa20_ta0_fm14_tm6*134*g,0,1,848,0,849,0.999,134,3244@TOP@human_GAPDH_TAA_len41_fa20_ta0_fm14_tm6,g
3245@TOP@human_GAPDH_TAA_len41_fa20_ta0_fm14_tm6*114*t,0,3,0,1565,1568,0.0,114,3245@TOP@human_GAPDH_TAA_len41_fa20_ta0_fm14_tm6,t
3245@TOP@human_GAPDH_TAA_len41_fa20_ta0_fm14_tm6*115*c,0,1580,0,0,1580,0.0,115,3245@TOP@human_GAPDH_TAA_len41_fa20_ta0_fm14_tm6,c
3245@TOP@human_GAPDH_TAA_len41_fa20_ta0_fm14_tm6*116*c,0,1568,0,0,1568,0.0,116,3245@TOP@human_GAPDH_TAA_len41_fa20_ta0_fm14_tm6,c
3245@TOP@human_GAPDH_TAA_len41_fa20_ta0_fm14_tm6*117*a,1571,0,3,0,1574,0.002,117,3245@TOP@human_GAPDH_TAA_len41_fa20_ta0_fm14_tm6,a
3245@TOP@human_GAPDH_TAA_len41_fa20_ta0_fm14_tm6*118*a,1520,0,27,0,1547,0.017,118,3245@TOP@human_GAPDH_TAA_len41_fa20_ta0_fm14_tm6,a
3245@TOP@human_GAPDH_TAA_len41_fa20_ta0_fm14_tm6*119*g,0,0,1562,0,1562,1.0,119,3245@TOP@human_GAPDH_TAA_len41_fa20_ta0_fm14_tm6,g
3245@TOP@human_GAPDH_TAA_len41_fa20_ta0_fm14_tm6*120*g,0,0,1549,0,1549,1.0,120,3245@TOP@human_GAPDH_TAA_len41_fa20_ta0_fm14_tm6,g
3245@TOP@human_GAPDH_TAA_len41_fa20_ta0_fm14_tm6*121*a,1561,0,2,0,1563,0.001,121,3245@TOP@human_GAPDH_TAA_len41_fa20_ta0_fm14_tm6,a
3245@TOP@human_GAPDH_TAA_len41_fa20_ta0_fm14_tm6*122*g,0,0,1574,0,1574,1.0,122,3245@TOP@human_GAPDH_TAA_len41_fa20_ta0_fm14_tm6,g
3245@TOP@human_GAPDH_TAA_len41_fa20_ta0_fm14_tm6*123*t,0,1,0,1544,1545,0.0,123,3245@TOP@human_GAPDH_TAA_len41_fa20_ta0_fm14_tm6,t
3245@TOP@human_GAPDH_TAA_len41_fa20_ta0_fm14_tm6*124*a,1407,0,132,0,1539,0.086,124,3245@TOP@human_GAPDH_TAA_len41_fa20_ta0_fm14_tm6,a
3245@TOP@human_GAPDH_TAA_len41_fa20_ta0_fm14_tm6*125*a,1474,0,63,1,1538,0.041,125,3245@TOP@human_GAPDH_TAA_len41_fa20_ta0_fm14_tm6,a
3245@TOP@human_GAPDH_TAA_len41_fa20_ta0_fm14_tm6*126*g,0,0,1548,0,1548,1.0,126,3245@TOP@human_GAPDH_TAA_len41_fa20_ta0_fm14_tm6,g
3245@TOP@human_GAPDH_TAA_len41_fa20_ta0_fm14_tm6*127*a,1568,0,0,0,1568,0.0,127,3245@TOP@human_GAPDH_TAA_len41_fa20_ta0_fm14_tm6,a
3245@TOP@human_GAPDH_TAA_len41_fa20_ta0_fm14_tm6*128*c,0,1576,0,0,1576,0.0,128,3245@TOP@human_GAPDH_TAA_len41_fa20_ta0_fm14_tm6,c
3245@TOP@human_GAPDH_TAA_len41_fa20_ta0_fm14_tm6*129*c,0,1563,0,0,1563,0.0,129,3245@TOP@human_GAPDH_TAA_len41_fa20_ta0_fm14_tm6,c
3245@TOP@human_GAPDH_TAA_len41_fa20_ta0_fm14_tm6*130*c,0,1568,0,0,1568,0.0,130,3245@TOP@human_GAPDH_TAA_len41_fa20_ta0_fm14_tm6,c
3245@TOP@human_GAPDH_TAA_len41_fa20_ta0_fm14_tm6*131*c,0,1576,0,0,1576,0.0,131,3245@TOP@human_GAPDH_TAA_len41_fa20_ta0_fm14_tm6,c
3245@TOP@human_GAPDH_TAA_len41_fa20_ta0_fm14_tm6*132*t,0,1,3,1553,1557,0.002,132,3245@TOP@human_GAPDH_TAA_len41_fa20_ta0_fm14_tm6,t
3245@TOP@human_GAPDH_TAA_len41_fa20_ta0_fm14_tm6*133*g,0,0,1551,0,1551,1.0,133,3245@TOP@human_GAPDH_TAA_len41_fa20_ta0_fm14_tm6,g
3245@TOP@human_GAPDH_TAA_len41_fa20_ta0_fm14_tm6*134*g,0,0,1558,0,1558,1.0,134,3245@TOP@human_GAPDH_TAA_len41_fa20_ta0_fm14_tm6,g
3246@TOP@human_GAPDH_TAA_len41_fa20_ta0_fm14_tm6*114*t,3,7,0,36320,36330,0.0,114,3246@TOP@human_GAPDH_TAA_len41_fa20_ta0_fm14_tm6,t
3246@TOP@human_GAPDH_TAA_len41_fa20_ta0_fm14_tm6*115*c,0,36503,0,3,36506,0.0,115,3246@TOP@human_GAPDH_TAA_len41_fa20_ta0_fm14_tm6,c
3246@TOP@human_GAPDH_TAA_len41_fa20_ta0_fm14_tm6*116*c,2,36369,0,1,36372,0.0,116,3246@TOP@human_GAPDH_TAA_len41_fa20_ta0_fm14_tm6,c
3246@TOP@human_GAPDH_TAA_len41_fa20_ta0_fm14_tm6*117*a,36304,0,38,2,36344,0.001,117,3246@TOP@human_GAPDH_TAA_len41_fa20_ta0_fm14_tm6,a
3246@TOP@human_GAPDH_TAA_len41_fa20_ta0_fm14_tm6*118*a,35685,0,458,0,36143,0.013,118,3246@TOP@human_GAPDH_TAA_len41_fa20_ta0_fm14_tm6,a
3246@TOP@human_GAPDH_TAA_len41_fa20_ta0_fm14_tm6*119*g,4,1,36098,0,36103,1.0,119,3246@TOP@human_GAPDH_TAA_len41_fa20_ta0_fm14_tm6,g
3246@TOP@human_GAPDH_TAA_len41_fa20_ta0_fm14_tm6*120*g,2,0,35976,3,35981,1.0,120,3246@TOP@human_GAPDH_TAA_len41_fa20_ta0_fm14_tm6,g
3246@TOP@human_GAPDH_TAA_len41_fa20_ta0_fm14_tm6*121*a,36278,0,17,1,36296,0.0,121,3246@TOP@human_GAPDH_TAA_len41_fa20_ta0_fm14_tm6,a
3246@TOP@human_GAPDH_TAA_len41_fa20_ta0_fm14_tm6*122*g,2,0,36353,1,36356,1.0,122,3246@TOP@human_GAPDH_TAA_len41_fa20_ta0_fm14_tm6,g
3246@TOP@human_GAPDH_TAA_len41_fa20_ta0_fm14_tm6*123*t,2,6,4,35853,35865,0.0,123,3246@TOP@human_GAPDH_TAA_len41_fa20_ta0_fm14_tm6,t
3246@TOP@human_GAPDH_TAA_len41_fa20_ta0_fm14_tm6*124*a,34252,3,1521,0,35776,0.043,124,3246@TOP@human_GAPDH_TAA_len41_fa20_ta0_fm14_tm6,a
3246@TOP@human_GAPDH_TAA_len41_fa20_ta0_fm14_tm6*125*a,35164,4,562,2,35732,0.016,125,3246@TOP@human_GAPDH_TAA_len41_fa20_ta0_fm14_tm6,a
3246@TOP@human_GAPDH_TAA_len41_fa20_ta0_fm14_tm6*126*g,3,0,35933,0,35936,1.0,126,3246@TOP@human_GAPDH_TAA_len41_fa20_ta0_fm14_tm6,g
3246@TOP@human_GAPDH_TAA_len41_fa20_ta0_fm14_tm6*127*a,36222,2,30,0,36254,0.001,127,3246@TOP@human_GAPDH_TAA_len41_fa20_ta0_fm14_tm6,a
3246@TOP@human_GAPDH_TAA_len41_fa20_ta0_fm14_tm6*128*c,0,36424,2,0,36426,0.0,128,3246@TOP@human_GAPDH_TAA_len41_fa20_ta0_fm14_tm6,c
3246@TOP@human_GAPDH_TAA_len41_fa20_ta0_fm14_tm6*129*c,0,36197,0,1,36198,0.0,129,3246@TOP@human_GAPDH_TAA_len41_fa20_ta0_fm14_tm6,c
3246@TOP@human_GAPDH_TAA_len41_fa20_ta0_fm14_tm6*130*c,2,36370,1,1,36374,0.0,130,3246@TOP@human_GAPDH_TAA_len41_fa20_ta0_fm14_tm6,c
3246@TOP@human_GAPDH_TAA_len41_fa20_ta0_fm14_tm6*131*c,1,36457,0,5,36463,0.0,131,3246@TOP@human_GAPDH_TAA_len41_fa20_ta0_fm14_tm6,c
3246@TOP@human_GAPDH_TAA_len41_fa20_ta0_fm14_tm6*132*t,3,4,0,35963,35970,0.0,132,3246@TOP@human_GAPDH_TAA_len41_fa20_ta0_fm14_tm6,t
3246@TOP@human_GAPDH_TAA_len41_fa20_ta0_fm14_tm6*133*g,2,2,35883,0,35887,1.0,133,3246@TOP@human_GAPDH_TAA_len41_fa20_ta0_fm14_tm6,g
3246@TOP@human_GAPDH_TAA_len41_fa20_ta0_fm14_tm6*134*g,5,3,36054,3,36065,1.0,134,3246@TOP@human_GAPDH_TAA_len41_fa20_ta0_fm14_tm6,g
3247@TOP@human_GAPDH_TAA_len41_fa20_ta0_fm14_tm6*114*t,1,0,0,2287,2288,0.0,114,3247@TOP@human_GAPDH_TAA_len41_fa20_ta0_fm14_tm6,t
3247@TOP@human_GAPDH_TAA_len41_fa20_ta0_fm14_tm6*115*c,0,2309,0,0,2309,0.0,115,3247@TOP@human_GAPDH_TAA_len41_fa20_ta0_fm14_tm6,c
3247@TOP@human_GAPDH_TAA_len41_fa20_ta0_fm14_tm6*116*c,0,2297,0,0,2297,0.0,116,3247@TOP@human_GAPDH_TAA_len41_fa20_ta0_fm14_tm6,c
3247@TOP@human_GAPDH_TAA_len41_fa20_ta0_fm14_tm6*117*a,2290,0,6,0,2296,0.003,117,3247@TOP@human_GAPDH_TAA_len41_fa20_ta0_fm14_tm6,a
3247@TOP@human_GAPDH_TAA_len41_fa20_ta0_fm14_tm6*118*a,2223,0,59,0,2282,0.026,118,3247@TOP@human_GAPDH_TAA_len41_fa20_ta0_fm14_tm6,a
3247@TOP@human_GAPDH_TAA_len41_fa20_ta0_fm14_tm6*119*g,0,0,2281,0,2281,1.0,119,3247@TOP@human_GAPDH_TAA_len41_fa20_ta0_fm14_tm6,g
3247@TOP@human_GAPDH_TAA_len41_fa20_ta0_fm14_tm6*120*g,0,0,2271,0,2271,1.0,120,3247@TOP@human_GAPDH_TAA_len41_fa20_ta0_fm14_tm6,g
3247@TOP@human_GAPDH_TAA_len41_fa20_ta0_fm14_tm6*121*a,2291,0,0,0,2291,0.0,121,3247@TOP@human_GAPDH_TAA_len41_fa20_ta0_fm14_tm6,a
3247@TOP@human_GAPDH_TAA_len41_fa20_ta0_fm14_tm6*122*g,0,0,2302,0,2302,1.0,122,3247@TOP@human_GAPDH_TAA_len41_fa20_ta0_fm14_tm6,g
3247@TOP@human_GAPDH_TAA_len41_fa20_ta0_fm14_tm6*123*t,0,0,2,2264,2266,0.001,123,3247@TOP@human_GAPDH_TAA_len41_fa20_ta0_fm14_tm6,t
3247@TOP@human_GAPDH_TAA_len41_fa20_ta0_fm14_tm6*124*a,2086,0,185,0,2271,0.081,124,3247@TOP@human_GAPDH_TAA_len41_fa20_ta0_fm14_tm6,a
3247@TOP@human_GAPDH_TAA_len41_fa20_ta0_fm14_tm6*125*a,2156,2,99,0,2257,0.044,125,3247@TOP@human_GAPDH_TAA_len41_fa20_ta0_fm14_tm6,a
3247@TOP@human_GAPDH_TAA_len41_fa20_ta0_fm14_tm6*126*g,0,0,2269,1,2270,1.0,126,3247@TOP@human_GAPDH_TAA_len41_fa20_ta0_fm14_tm6,g
3247@TOP@human_GAPDH_TAA_len41_fa20_ta0_fm14_tm6*127*a,2289,1,1,0,2291,0.0,127,3247@TOP@human_GAPDH_TAA_len41_fa20_ta0_fm14_tm6,a
3247@TOP@human_GAPDH_TAA_len41_fa20_ta0_fm14_tm6*128*c,0,2303,0,0,2303,0.0,128,3247@TOP@human_GAPDH_TAA_len41_fa20_ta0_fm14_tm6,c
3247@TOP@human_GAPDH_TAA_len41_fa20_ta0_fm14_tm6*129*c,0,2276,0,0,2276,0.0,129,3247@TOP@human_GAPDH_TAA_len41_fa20_ta0_fm14_tm6,c
3247@TOP@human_GAPDH_TAA_len41_fa20_ta0_fm14_tm6*130*c,0,2293,0,0,2293,0.0,130,3247@TOP@human_GAPDH_TAA_len41_fa20_ta0_fm14_tm6,c
3247@TOP@human_GAPDH_TAA_len41_fa20_ta0_fm14_tm6*131*c,0,2298,0,0,2298,0.0,131,3247@TOP@human_GAPDH_TAA_len41_fa20_ta0_fm14_tm6,c
3247@TOP@human_GAPDH_TAA_len41_fa20_ta0_fm14_tm6*132*t,0,0,0,2270,2270,0.0,132,3247@TOP@human_GAPDH_TAA_len41_fa20_ta0_fm14_tm6,t
3247@TOP@human_GAPDH_TAA_len41_fa20_ta0_fm14_tm6*133*g,0,0,2271,0,2271,1.0,133,3247@TOP@human_GAPDH_TAA_len41_fa20_ta0_fm14_tm6,g
3247@TOP@human_GAPDH_TAA_len41_fa20_ta0_fm14_tm6*134*g,0,0,2278,0,2278,1.0,134,3247@TOP@human_GAPDH_TAA_len41_fa20_ta0_fm14_tm6,g
3248@TOP@human_GAPDH_TAA_len41_fa20_ta0_fm14_tm6*114*t,0,1,0,1871,1872,0.0,114,3248@TOP@human_GAPDH_TAA_len41_fa20_ta0_fm14_tm6,t
3248@TOP@human_GAPDH_TAA_len41_fa20_ta0_fm14_tm6*115*c,0,1879,0,0,1879,0.0,115,3248@TOP@human_GAPDH_TAA_len41_fa20_ta0_fm14_tm6,c
3248@TOP@human_GAPDH_TAA_len41_fa20_ta0_fm14_tm6*116*c,0,1871,0,0,1871,0.0,116,3248@TOP@human_GAPDH_TAA_len41_fa20_ta0_fm14_tm6,c
3248@TOP@human_GAPDH_TAA_len41_fa20_ta0_fm14_tm6*117*a,1867,0,3,0,1870,0.002,117,3248@TOP@human_GAPDH_TAA_len41_fa20_ta0_fm14_tm6,a
3248@TOP@human_GAPDH_TAA_len41_fa20_ta0_fm14_tm6*118*a,1824,0,38,0,1862,0.02,118,3248@TOP@human_GAPDH_TAA_len41_fa20_ta0_fm14_tm6,a
3248@TOP@human_GAPDH_TAA_len41_fa20_ta0_fm14_tm6*119*g,0,0,1849,0,1849,1.0,119,3248@TOP@human_GAPDH_TAA_len41_fa20_ta0_fm14_tm6,g
3248@TOP@human_GAPDH_TAA_len41_fa20_ta0_fm14_tm6*120*g,0,0,1849,0,1849,1.0,120,3248@TOP@human_GAPDH_TAA_len41_fa20_ta0_fm14_tm6,g
3248@TOP@human_GAPDH_TAA_len41_fa20_ta0_fm14_tm6*121*a,1871,0,2,0,1873,0.001,121,3248@TOP@human_GAPDH_TAA_len41_fa20_ta0_fm14_tm6,a
3248@TOP@human_GAPDH_TAA_len41_fa20_ta0_fm14_tm6*122*g,0,0,1871,0,1871,1.0,122,3248@TOP@human_GAPDH_TAA_len41_fa20_ta0_fm14_tm6,g
3248@TOP@human_GAPDH_TAA_len41_fa20_ta0_fm14_tm6*123*t,0,0,0,1846,1846,0.0,123,3248@TOP@human_GAPDH_TAA_len41_fa20_ta0_fm14_tm6,t
3248@TOP@human_GAPDH_TAA_len41_fa20_ta0_fm14_tm6*124*a,1720,1,105,0,1826,0.058,124,3248@TOP@human_GAPDH_TAA_len41_fa20_ta0_fm14_tm6,a
3248@TOP@human_GAPDH_TAA_len41_fa20_ta0_fm14_tm6*125*a,1798,0,46,0,1844,0.025,125,3248@TOP@human_GAPDH_TAA_len41_fa20_ta0_fm14_tm6,a
3248@TOP@human_GAPDH_TAA_len41_fa20_ta0_fm14_tm6*126*g,0,0,1847,0,1847,1.0,126,3248@TOP@human_GAPDH_TAA_len41_fa20_ta0_fm14_tm6,g
3248@TOP@human_GAPDH_TAA_len41_fa20_ta0_fm14_tm6*127*a,1862,0,3,0,1865,0.002,127,3248@TOP@human_GAPDH_TAA_len41_fa20_ta0_fm14_tm6,a
3248@TOP@human_GAPDH_TAA_len41_fa20_ta0_fm14_tm6*128*c,0,1874,0,0,1874,0.0,128,3248@TOP@human_GAPDH_TAA_len41_fa20_ta0_fm14_tm6,c
3248@TOP@human_GAPDH_TAA_len41_fa20_ta0_fm14_tm6*129*c,0,1856,0,0,1856,0.0,129,3248@TOP@human_GAPDH_TAA_len41_fa20_ta0_fm14_tm6,c
3248@TOP@human_GAPDH_TAA_len41_fa20_ta0_fm14_tm6*130*c,0,1872,0,0,1872,0.0,130,3248@TOP@human_GAPDH_TAA_len41_fa20_ta0_fm14_tm6,c
3248@TOP@human_GAPDH_TAA_len41_fa20_ta0_fm14_tm6*131*c,0,1876,0,0,1876,0.0,131,3248@TOP@human_GAPDH_TAA_len41_fa20_ta0_fm14_tm6,c
3248@TOP@human_GAPDH_TAA_len41_fa20_ta0_fm14_tm6*132*t,0,2,1,1850,1853,0.001,132,3248@TOP@human_GAPDH_TAA_len41_fa20_ta0_fm14_tm6,t
3248@TOP@human_GAPDH_TAA_len41_fa20_ta0_fm14_tm6*133*g,0,0,1845,0,1845,1.0,133,3248@TOP@human_GAPDH_TAA_len41_fa20_ta0_fm14_tm6,g
3248@TOP@human_GAPDH_TAA_len41_fa20_ta0_fm14_tm6*134*g,0,0,1846,2,1848,0.999,134,3248@TOP@human_GAPDH_TAA_len41_fa20_ta0_fm14_tm6,g
3249@TOP@human_GAPDH_TAA_len41_fa20_ta0_fm14_tm6*114*t,0,2,4,10242,10248,0.0,114,3249@TOP@human_GAPDH_TAA_len41_fa20_ta0_fm14_tm6,t
3249@TOP@human_GAPDH_TAA_len41_fa20_ta0_fm14_tm6*115*c,0,10309,0,0,10309,0.0,115,3249@TOP@human_GAPDH_TAA_len41_fa20_ta0_fm14_tm6,c
3249@TOP@human_GAPDH_TAA_len41_fa20_ta0_fm14_tm6*116*c,0,10264,0,0,10264,0.0,116,3249@TOP@human_GAPDH_TAA_len41_fa20_ta0_fm14_tm6,c
3249@TOP@human_GAPDH_TAA_len41_fa20_ta0_fm14_tm6*117*a,10217,0,21,0,10238,0.002,117,3249@TOP@human_GAPDH_TAA_len41_fa20_ta0_fm14_tm6,a
3249@TOP@human_GAPDH_TAA_len41_fa20_ta0_fm14_tm6*118*a,10013,0,182,1,10196,0.018,118,3249@TOP@human_GAPDH_TAA_len41_fa20_ta0_fm14_tm6,a
3249@TOP@human_GAPDH_TAA_len41_fa20_ta0_fm14_tm6*119*g,0,0,10179,1,10180,1.0,119,3249@TOP@human_GAPDH_TAA_len41_fa20_ta0_fm14_tm6,g
3249@TOP@human_GAPDH_TAA_len41_fa20_ta0_fm14_tm6*120*g,0,0,10159,0,10159,1.0,120,3249@TOP@human_GAPDH_TAA_len41_fa20_ta0_fm14_tm6,g
3249@TOP@human_GAPDH_TAA_len41_fa20_ta0_fm14_tm6*121*a,10247,0,6,0,10253,0.001,121,3249@TOP@human_GAPDH_TAA_len41_fa20_ta0_fm14_tm6,a
3249@TOP@human_GAPDH_TAA_len41_fa20_ta0_fm14_tm6*122*g,2,0,10268,0,10270,1.0,122,3249@TOP@human_GAPDH_TAA_len41_fa20_ta0_fm14_tm6,g
3249@TOP@human_GAPDH_TAA_len41_fa20_ta0_fm14_tm6*123*t,1,5,1,10149,10156,0.0,123,3249@TOP@human_GAPDH_TAA_len41_fa20_ta0_fm14_tm6,t
3249@TOP@human_GAPDH_TAA_len41_fa20_ta0_fm14_tm6*124*a,9661,0,456,0,10117,0.045,124,3249@TOP@human_GAPDH_TAA_len41_fa20_ta0_fm14_tm6,a
3249@TOP@human_GAPDH_TAA_len41_fa20_ta0_fm14_tm6*125*a,9713,1,334,0,10048,0.033,125,3249@TOP@human_GAPDH_TAA_len41_fa20_ta0_fm14_tm6,a
3249@TOP@human_GAPDH_TAA_len41_fa20_ta0_fm14_tm6*126*g,0,0,10140,1,10141,1.0,126,3249@TOP@human_GAPDH_TAA_len41_fa20_ta0_fm14_tm6,g
3249@TOP@human_GAPDH_TAA_len41_fa20_ta0_fm14_tm6*127*a,10235,0,11,0,10246,0.001,127,3249@TOP@human_GAPDH_TAA_len41_fa20_ta0_fm14_tm6,a
3249@TOP@human_GAPDH_TAA_len41_fa20_ta0_fm14_tm6*128*c,0,10287,1,0,10288,0.0,128,3249@TOP@human_GAPDH_TAA_len41_fa20_ta0_fm14_tm6,c
3249@TOP@human_GAPDH_TAA_len41_fa20_ta0_fm14_tm6*129*c,0,10240,0,1,10241,0.0,129,3249@TOP@human_GAPDH_TAA_len41_fa20_ta0_fm14_tm6,c
3249@TOP@human_GAPDH_TAA_len41_fa20_ta0_fm14_tm6*130*c,0,10270,0,0,10270,0.0,130,3249@TOP@human_GAPDH_TAA_len41_fa20_ta0_fm14_tm6,c
3249@TOP@human_GAPDH_TAA_len41_fa20_ta0_fm14_tm6*131*c,0,10298,0,0,10298,0.0,131,3249@TOP@human_GAPDH_TAA_len41_fa20_ta0_fm14_tm6,c
3249@TOP@human_GAPDH_TAA_len41_fa20_ta0_fm14_tm6*132*t,3,8,4,10140,10155,0.0,132,3249@TOP@human_GAPDH_TAA_len41_fa20_ta0_fm14_tm6,t
3249@TOP@human_GAPDH_TAA_len41_fa20_ta0_fm14_tm6*133*g,5,0,10134,0,10139,1.0,133,3249@TOP@human_GAPDH_TAA_len41_fa20_ta0_fm14_tm6,g
3249@TOP@human_GAPDH_TAA_len41_fa20_ta0_fm14_tm6*134*g,0,0,10177,0,10177,1.0,134,3249@TOP@human_GAPDH_TAA_len41_fa20_ta0_fm14_tm6,g
3250@TOP@human_GAPDH_TAA_len41_fa20_ta0_fm14_tm6*114*t,2,2,0,10921,10925,0.0,114,3250@TOP@human_GAPDH_TAA_len41_fa20_ta0_fm14_tm6,t
3250@TOP@human_GAPDH_TAA_len41_fa20_ta0_fm14_tm6*115*c,0,10990,0,0,10990,0.0,115,3250@TOP@human_GAPDH_TAA_len41_fa20_ta0_fm14_tm6,c
3250@TOP@human_GAPDH_TAA_len41_fa20_ta0_fm14_tm6*116*c,1,10938,0,4,10943,0.0,116,3250@TOP@human_GAPDH_TAA_len41_fa20_ta0_fm14_tm6,c
3250@TOP@human_GAPDH_TAA_len41_fa20_ta0_fm14_tm6*117*a,10938,0,11,0,10949,0.001,117,3250@TOP@human_GAPDH_TAA_len41_fa20_ta0_fm14_tm6,a
3250@TOP@human_GAPDH_TAA_len41_fa20_ta0_fm14_tm6*118*a,10773,0,118,0,10891,0.011,118,3250@TOP@human_GAPDH_TAA_len41_fa20_ta0_fm14_tm6,a
3250@TOP@human_GAPDH_TAA_len41_fa20_ta0_fm14_tm6*119*g,0,0,10862,1,10863,1.0,119,3250@TOP@human_GAPDH_TAA_len41_fa20_ta0_fm14_tm6,g
3250@TOP@human_GAPDH_TAA_len41_fa20_ta0_fm14_tm6*120*g,0,0,10828,1,10829,1.0,120,3250@TOP@human_GAPDH_TAA_len41_fa20_ta0_fm14_tm6,g
3250@TOP@human_GAPDH_TAA_len41_fa20_ta0_fm14_tm6*121*a,10927,0,2,0,10929,0.0,121,3250@TOP@human_GAPDH_TAA_len41_fa20_ta0_fm14_tm6,a
3250@TOP@human_GAPDH_TAA_len41_fa20_ta0_fm14_tm6*122*g,0,0,10947,1,10948,1.0,122,3250@TOP@human_GAPDH_TAA_len41_fa20_ta0_fm14_tm6,g
3250@TOP@human_GAPDH_TAA_len41_fa20_ta0_fm14_tm6*123*t,0,3,1,10765,10769,0.0,123,3250@TOP@human_GAPDH_TAA_len41_fa20_ta0_fm14_tm6,t
3250@TOP@human_GAPDH_TAA_len41_fa20_ta0_fm14_tm6*124*a,9972,1,815,0,10788,0.076,124,3250@TOP@human_GAPDH_TAA_len41_fa20_ta0_fm14_tm6,a
3250@TOP@human_GAPDH_TAA_len41_fa20_ta0_fm14_tm6*125*a,10477,1,279,0,10757,0.026,125,3250@TOP@human_GAPDH_TAA_len41_fa20_ta0_fm14_tm6,a
3250@TOP@human_GAPDH_TAA_len41_fa20_ta0_fm14_tm6*126*g,0,0,10800,0,10800,1.0,126,3250@TOP@human_GAPDH_TAA_len41_fa20_ta0_fm14_tm6,g
3250@TOP@human_GAPDH_TAA_len41_fa20_ta0_fm14_tm6*127*a,10925,2,6,0,10933,0.001,127,3250@TOP@human_GAPDH_TAA_len41_fa20_ta0_fm14_tm6,a
3250@TOP@human_GAPDH_TAA_len41_fa20_ta0_fm14_tm6*128*c,0,10970,3,0,10973,0.0,128,3250@TOP@human_GAPDH_TAA_len41_fa20_ta0_fm14_tm6,c
3250@TOP@human_GAPDH_TAA_len41_fa20_ta0_fm14_tm6*129*c,0,10869,0,0,10869,0.0,129,3250@TOP@human_GAPDH_TAA_len41_fa20_ta0_fm14_tm6,c
3250@TOP@human_GAPDH_TAA_len41_fa20_ta0_fm14_tm6*130*c,0,10923,0,4,10927,0.0,130,3250@TOP@human_GAPDH_TAA_len41_fa20_ta0_fm14_tm6,c
3250@TOP@human_GAPDH_TAA_len41_fa20_ta0_fm14_tm6*131*c,2,10961,0,1,10964,0.0,131,3250@TOP@human_GAPDH_TAA_len41_fa20_ta0_fm14_tm6,c
3250@TOP@human_GAPDH_TAA_len41_fa20_ta0_fm14_tm6*132*t,3,5,0,10800,10808,0.0,132,3250@TOP@human_GAPDH_TAA_len41_fa20_ta0_fm14_tm6,t
3250@TOP@human_GAPDH_TAA_len41_fa20_ta0_fm14_tm6*133*g,0,0,10787,1,10788,1.0,133,3250@TOP@human_GAPDH_TAA_len41_fa20_ta0_fm14_tm6,g
3250@TOP@human_GAPDH_TAA_len41_fa20_ta0_fm14_tm6*134*g,1,2,10858,0,10861,1.0,134,3250@TOP@human_GAPDH_TAA_len41_fa20_ta0_fm14_tm6,g
3251@TOP@human_GAPDH_TAA_len41_fa20_ta0_fm14_tm6*114*t,6,14,4,45823,45847,0.0,114,3251@TOP@human_GAPDH_TAA_len41_fa20_ta0_fm14_tm6,t
3251@TOP@human_GAPDH_TAA_len41_fa20_ta0_fm14_tm6*115*c,1,46096,0,5,46102,0.0,115,3251@TOP@human_GAPDH_TAA_len41_fa20_ta0_fm14_tm6,c
3251@TOP@human_GAPDH_TAA_len41_fa20_ta0_fm14_tm6*116*c,2,45895,0,1,45898,0.0,116,3251@TOP@human_GAPDH_TAA_len41_fa20_ta0_fm14_tm6,c
3251@TOP@human_GAPDH_TAA_len41_fa20_ta0_fm14_tm6*117*a,45822,0,62,0,45884,0.001,117,3251@TOP@human_GAPDH_TAA_len41_fa20_ta0_fm14_tm6,a
3251@TOP@human_GAPDH_TAA_len41_fa20_ta0_fm14_tm6*118*a,45166,3,471,0,45640,0.01,118,3251@TOP@human_GAPDH_TAA_len41_fa20_ta0_fm14_tm6,a
3251@TOP@human_GAPDH_TAA_len41_fa20_ta0_fm14_tm6*119*g,2,0,45543,1,45546,1.0,119,3251@TOP@human_GAPDH_TAA_len41_fa20_ta0_fm14_tm6,g
3251@TOP@human_GAPDH_TAA_len41_fa20_ta0_fm14_tm6*120*g,4,0,45385,1,45390,1.0,120,3251@TOP@human_GAPDH_TAA_len41_fa20_ta0_fm14_tm6,g
3251@TOP@human_GAPDH_TAA_len41_fa20_ta0_fm14_tm6*121*a,45842,0,8,1,45851,0.0,121,3251@TOP@human_GAPDH_TAA_len41_fa20_ta0_fm14_tm6,a
3251@TOP@human_GAPDH_TAA_len41_fa20_ta0_fm14_tm6*122*g,2,0,45916,0,45918,1.0,122,3251@TOP@human_GAPDH_TAA_len41_fa20_ta0_fm14_tm6,g
3251@TOP@human_GAPDH_TAA_len41_fa20_ta0_fm14_tm6*123*t,4,2,8,45282,45296,0.0,123,3251@TOP@human_GAPDH_TAA_len41_fa20_ta0_fm14_tm6,t
3251@TOP@human_GAPDH_TAA_len41_fa20_ta0_fm14_tm6*124*a,43924,1,1259,0,45184,0.028,124,3251@TOP@human_GAPDH_TAA_len41_fa20_ta0_fm14_tm6,a
3251@TOP@human_GAPDH_TAA_len41_fa20_ta0_fm14_tm6*125*a,44505,1,617,1,45124,0.014,125,3251@TOP@human_GAPDH_TAA_len41_fa20_ta0_fm14_tm6,a
3251@TOP@human_GAPDH_TAA_len41_fa20_ta0_fm14_tm6*126*g,5,2,45293,2,45302,1.0,126,3251@TOP@human_GAPDH_TAA_len41_fa20_ta0_fm14_tm6,g
3251@TOP@human_GAPDH_TAA_len41_fa20_ta0_fm14_tm6*127*a,45712,2,33,2,45749,0.001,127,3251@TOP@human_GAPDH_TAA_len41_fa20_ta0_fm14_tm6,a
3251@TOP@human_GAPDH_TAA_len41_fa20_ta0_fm14_tm6*128*c,2,45997,5,2,46006,0.0,128,3251@TOP@human_GAPDH_TAA_len41_fa20_ta0_fm14_tm6,c
3251@TOP@human_GAPDH_TAA_len41_fa20_ta0_fm14_tm6*129*c,2,45721,1,1,45725,0.0,129,3251@TOP@human_GAPDH_TAA_len41_fa20_ta0_fm14_tm6,c
3251@TOP@human_GAPDH_TAA_len41_fa20_ta0_fm14_tm6*130*c,7,45912,0,0,45919,0.0,130,3251@TOP@human_GAPDH_TAA_len41_fa20_ta0_fm14_tm6,c
3251@TOP@human_GAPDH_TAA_len41_fa20_ta0_fm14_tm6*131*c,4,46017,0,8,46029,0.0,131,3251@TOP@human_GAPDH_TAA_len41_fa20_ta0_fm14_tm6,c
3251@TOP@human_GAPDH_TAA_len41_fa20_ta0_fm14_tm6*132*t,8,11,1,45390,45410,0.0,132,3251@TOP@human_GAPDH_TAA_len41_fa20_ta0_fm14_tm6,t
3251@TOP@human_GAPDH_TAA_len41_fa20_ta0_fm14_tm6*133*g,1,3,45204,0,45208,1.0,133,3251@TOP@human_GAPDH_TAA_len41_fa20_ta0_fm14_tm6,g
3251@TOP@human_GAPDH_TAA_len41_fa20_ta0_fm14_tm6*134*g,1,2,45571,0,45574,1.0,134,3251@TOP@human_GAPDH_TAA_len41_fa20_ta0_fm14_tm6,g
3252@TOP@human_GAPDH_TAA_len41_fa20_ta0_fm14_tm6*114*t,0,0,0,1018,1018,0.0,114,3252@TOP@human_GAPDH_TAA_len41_fa20_ta0_fm14_tm6,t
3252@TOP@human_GAPDH_TAA_len41_fa20_ta0_fm14_tm6*115*c,0,1032,0,0,1032,0.0,115,3252@TOP@human_GAPDH_TAA_len41_fa20_ta0_fm14_tm6,c
3252@TOP@human_GAPDH_TAA_len41_fa20_ta0_fm14_tm6*116*c,0,1024,1,0,1025,0.001,116,3252@TOP@human_GAPDH_TAA_len41_fa20_ta0_fm14_tm6,c
3252@TOP@human_GAPDH_TAA_len41_fa20_ta0_fm14_tm6*117*a,1021,0,5,0,1026,0.005,117,3252@TOP@human_GAPDH_TAA_len41_fa20_ta0_fm14_tm6,a
3252@TOP@human_GAPDH_TAA_len41_fa20_ta0_fm14_tm6*118*a,991,0,28,0,1019,0.027,118,3252@TOP@human_GAPDH_TAA_len41_fa20_ta0_fm14_tm6,a
3252@TOP@human_GAPDH_TAA_len41_fa20_ta0_fm14_tm6*119*g,0,0,1020,0,1020,1.0,119,3252@TOP@human_GAPDH_TAA_len41_fa20_ta0_fm14_tm6,g
3252@TOP@human_GAPDH_TAA_len41_fa20_ta0_fm14_tm6*120*g,0,0,1015,0,1015,1.0,120,3252@TOP@human_GAPDH_TAA_len41_fa20_ta0_fm14_tm6,g
3252@TOP@human_GAPDH_TAA_len41_fa20_ta0_fm14_tm6*121*a,1025,0,0,0,1025,0.0,121,3252@TOP@human_GAPDH_TAA_len41_fa20_ta0_fm14_tm6,a
3252@TOP@human_GAPDH_TAA_len41_fa20_ta0_fm14_tm6*122*g,0,0,1031,0,1031,1.0,122,3252@TOP@human_GAPDH_TAA_len41_fa20_ta0_fm14_tm6,g
3252@TOP@human_GAPDH_TAA_len41_fa20_ta0_fm14_tm6*123*t,0,0,0,1009,1009,0.0,123,3252@TOP@human_GAPDH_TAA_len41_fa20_ta0_fm14_tm6,t
3252@TOP@human_GAPDH_TAA_len41_fa20_ta0_fm14_tm6*124*a,925,0,84,0,1009,0.083,124,3252@TOP@human_GAPDH_TAA_len41_fa20_ta0_fm14_tm6,a
3252@TOP@human_GAPDH_TAA_len41_fa20_ta0_fm14_tm6*125*a,959,0,42,0,1001,0.042,125,3252@TOP@human_GAPDH_TAA_len41_fa20_ta0_fm14_tm6,a
3252@TOP@human_GAPDH_TAA_len41_fa20_ta0_fm14_tm6*126*g,0,0,1012,0,1012,1.0,126,3252@TOP@human_GAPDH_TAA_len41_fa20_ta0_fm14_tm6,g
3252@TOP@human_GAPDH_TAA_len41_fa20_ta0_fm14_tm6*127*a,1021,0,3,0,1024,0.003,127,3252@TOP@human_GAPDH_TAA_len41_fa20_ta0_fm14_tm6,a
3252@TOP@human_GAPDH_TAA_len41_fa20_ta0_fm14_tm6*128*c,0,1028,0,0,1028,0.0,128,3252@TOP@human_GAPDH_TAA_len41_fa20_ta0_fm14_tm6,c
3252@TOP@human_GAPDH_TAA_len41_fa20_ta0_fm14_tm6*129*c,1,1017,0,0,1018,0.0,129,3252@TOP@human_GAPDH_TAA_len41_fa20_ta0_fm14_tm6,c
3252@TOP@human_GAPDH_TAA_len41_fa20_ta0_fm14_tm6*130*c,0,1027,0,0,1027,0.0,130,3252@TOP@human_GAPDH_TAA_len41_fa20_ta0_fm14_tm6,c
3252@TOP@human_GAPDH_TAA_len41_fa20_ta0_fm14_tm6*131*c,0,1026,0,0,1026,0.0,131,3252@TOP@human_GAPDH_TAA_len41_fa20_ta0_fm14_tm6,c
3252@TOP@human_GAPDH_TAA_len41_fa20_ta0_fm14_tm6*132*t,0,0,0,1006,1006,0.0,132,3252@TOP@human_GAPDH_TAA_len41_fa20_ta0_fm14_tm6,t
3252@TOP@human_GAPDH_TAA_len41_fa20_ta0_fm14_tm6*133*g,0,0,1010,0,1010,1.0,133,3252@TOP@human_GAPDH_TAA_len41_fa20_ta0_fm14_tm6,g
3252@TOP@human_GAPDH_TAA_len41_fa20_ta0_fm14_tm6*134*g,0,0,1016,0,1016,1.0,134,3252@TOP@human_GAPDH_TAA_len41_fa20_ta0_fm14_tm6,g
3253@TOP@human_GAPDH_TAA_len41_fa20_ta0_fm14_tm6*114*t,0,0,0,1492,1492,0.0,114,3253@TOP@human_GAPDH_TAA_len41_fa20_ta0_fm14_tm6,t
3253@TOP@human_GAPDH_TAA_len41_fa20_ta0_fm14_tm6*115*c,0,1498,0,0,1498,0.0,115,3253@TOP@human_GAPDH_TAA_len41_fa20_ta0_fm14_tm6,c
3253@TOP@human_GAPDH_TAA_len41_fa20_ta0_fm14_tm6*116*c,0,1493,0,0,1493,0.0,116,3253@TOP@human_GAPDH_TAA_len41_fa20_ta0_fm14_tm6,c
3253@TOP@human_GAPDH_TAA_len41_fa20_ta0_fm14_tm6*117*a,1485,0,4,0,1489,0.003,117,3253@TOP@human_GAPDH_TAA_len41_fa20_ta0_fm14_tm6,a
3253@TOP@human_GAPDH_TAA_len41_fa20_ta0_fm14_tm6*118*a,1446,0,39,0,1485,0.026,118,3253@TOP@human_GAPDH_TAA_len41_fa20_ta0_fm14_tm6,a
3253@TOP@human_GAPDH_TAA_len41_fa20_ta0_fm14_tm6*119*g,0,0,1476,0,1476,1.0,119,3253@TOP@human_GAPDH_TAA_len41_fa20_ta0_fm14_tm6,g
3253@TOP@human_GAPDH_TAA_len41_fa20_ta0_fm14_tm6*120*g,0,0,1476,0,1476,1.0,120,3253@TOP@human_GAPDH_TAA_len41_fa20_ta0_fm14_tm6,g
3253@TOP@human_GAPDH_TAA_len41_fa20_ta0_fm14_tm6*121*a,1488,0,0,0,1488,0.0,121,3253@TOP@human_GAPDH_TAA_len41_fa20_ta0_fm14_tm6,a
3253@TOP@human_GAPDH_TAA_len41_fa20_ta0_fm14_tm6*122*g,1,0,1490,0,1491,0.999,122,3253@TOP@human_GAPDH_TAA_len41_fa20_ta0_fm14_tm6,g
3253@TOP@human_GAPDH_TAA_len41_fa20_ta0_fm14_tm6*123*t,0,0,0,1468,1468,0.0,123,3253@TOP@human_GAPDH_TAA_len41_fa20_ta0_fm14_tm6,t
3253@TOP@human_GAPDH_TAA_len41_fa20_ta0_fm14_tm6*124*a,1344,0,114,0,1458,0.078,124,3253@TOP@human_GAPDH_TAA_len41_fa20_ta0_fm14_tm6,a
3253@TOP@human_GAPDH_TAA_len41_fa20_ta0_fm14_tm6*125*a,1429,0,26,0,1455,0.018,125,3253@TOP@human_GAPDH_TAA_len41_fa20_ta0_fm14_tm6,a
3253@TOP@human_GAPDH_TAA_len41_fa20_ta0_fm14_tm6*126*g,0,0,1471,0,1471,1.0,126,3253@TOP@human_GAPDH_TAA_len41_fa20_ta0_fm14_tm6,g
3253@TOP@human_GAPDH_TAA_len41_fa20_ta0_fm14_tm6*127*a,1483,0,3,0,1486,0.002,127,3253@TOP@human_GAPDH_TAA_len41_fa20_ta0_fm14_tm6,a
3253@TOP@human_GAPDH_TAA_len41_fa20_ta0_fm14_tm6*128*c,0,1487,0,0,1487,0.0,128,3253@TOP@human_GAPDH_TAA_len41_fa20_ta0_fm14_tm6,c
3253@TOP@human_GAPDH_TAA_len41_fa20_ta0_fm14_tm6*129*c,0,1485,0,0,1485,0.0,129,3253@TOP@human_GAPDH_TAA_len41_fa20_ta0_fm14_tm6,c
3253@TOP@human_GAPDH_TAA_len41_fa20_ta0_fm14_tm6*130*c,0,1493,0,0,1493,0.0,130,3253@TOP@human_GAPDH_TAA_len41_fa20_ta0_fm14_tm6,c
3253@TOP@human_GAPDH_TAA_len41_fa20_ta0_fm14_tm6*131*c,0,1492,0,0,1492,0.0,131,3253@TOP@human_GAPDH_TAA_len41_fa20_ta0_fm14_tm6,c
3253@TOP@human_GAPDH_TAA_len41_fa20_ta0_fm14_tm6*132*t,0,1,0,1468,1469,0.0,132,3253@TOP@human_GAPDH_TAA_len41_fa20_ta0_fm14_tm6,t
3253@TOP@human_GAPDH_TAA_len41_fa20_ta0_fm14_tm6*133*g,0,0,1468,0,1468,1.0,133,3253@TOP@human_GAPDH_TAA_len41_fa20_ta0_fm14_tm6,g
3253@TOP@human_GAPDH_TAA_len41_fa20_ta0_fm14_tm6*134*g,0,0,1476,0,1476,1.0,134,3253@TOP@human_GAPDH_TAA_len41_fa20_ta0_fm14_tm6,g
3254@TOP@human_GAPDH_TAA_len41_fa20_ta0_fm14_tm6*114*t,0,0,0,1558,1558,0.0,114,3254@TOP@human_GAPDH_TAA_len41_fa20_ta0_fm14_tm6,t
3254@TOP@human_GAPDH_TAA_len41_fa20_ta0_fm14_tm6*115*c,0,1571,0,1,1572,0.0,115,3254@TOP@human_GAPDH_TAA_len41_fa20_ta0_fm14_tm6,c
3254@TOP@human_GAPDH_TAA_len41_fa20_ta0_fm14_tm6*116*c,0,1564,0,0,1564,0.0,116,3254@TOP@human_GAPDH_TAA_len41_fa20_ta0_fm14_tm6,c
3254@TOP@human_GAPDH_TAA_len41_fa20_ta0_fm14_tm6*117*a,1560,0,7,0,1567,0.004,117,3254@TOP@human_GAPDH_TAA_len41_fa20_ta0_fm14_tm6,a
3254@TOP@human_GAPDH_TAA_len41_fa20_ta0_fm14_tm6*118*a,1497,0,59,1,1557,0.038,118,3254@TOP@human_GAPDH_TAA_len41_fa20_ta0_fm14_tm6,a
3254@TOP@human_GAPDH_TAA_len41_fa20_ta0_fm14_tm6*119*g,0,0,1550,0,1550,1.0,119,3254@TOP@human_GAPDH_TAA_len41_fa20_ta0_fm14_tm6,g
3254@TOP@human_GAPDH_TAA_len41_fa20_ta0_fm14_tm6*120*g,0,0,1546,1,1547,0.999,120,3254@TOP@human_GAPDH_TAA_len41_fa20_ta0_fm14_tm6,g
3254@TOP@human_GAPDH_TAA_len41_fa20_ta0_fm14_tm6*121*a,1565,0,0,0,1565,0.0,121,3254@TOP@human_GAPDH_TAA_len41_fa20_ta0_fm14_tm6,a
3254@TOP@human_GAPDH_TAA_len41_fa20_ta0_fm14_tm6*122*g,0,0,1562,0,1562,1.0,122,3254@TOP@human_GAPDH_TAA_len41_fa20_ta0_fm14_tm6,g
3254@TOP@human_GAPDH_TAA_len41_fa20_ta0_fm14_tm6*123*t,0,2,0,1540,1542,0.0,123,3254@TOP@human_GAPDH_TAA_len41_fa20_ta0_fm14_tm6,t
3254@TOP@human_GAPDH_TAA_len41_fa20_ta0_fm14_tm6*124*a,1446,0,95,0,1541,0.062,124,3254@TOP@human_GAPDH_TAA_len41_fa20_ta0_fm14_tm6,a
3254@TOP@human_GAPDH_TAA_len41_fa20_ta0_fm14_tm6*125*a,1446,1,90,1,1538,0.059,125,3254@TOP@human_GAPDH_TAA_len41_fa20_ta0_fm14_tm6,a
3254@TOP@human_GAPDH_TAA_len41_fa20_ta0_fm14_tm6*126*g,0,0,1542,0,1542,1.0,126,3254@TOP@human_GAPDH_TAA_len41_fa20_ta0_fm14_tm6,g
3254@TOP@human_GAPDH_TAA_len41_fa20_ta0_fm14_tm6*127*a,1556,0,0,0,1556,0.0,127,3254@TOP@human_GAPDH_TAA_len41_fa20_ta0_fm14_tm6,a
3254@TOP@human_GAPDH_TAA_len41_fa20_ta0_fm14_tm6*128*c,0,1567,0,0,1567,0.0,128,3254@TOP@human_GAPDH_TAA_len41_fa20_ta0_fm14_tm6,c
3254@TOP@human_GAPDH_TAA_len41_fa20_ta0_fm14_tm6*129*c,0,1565,0,0,1565,0.0,129,3254@TOP@human_GAPDH_TAA_len41_fa20_ta0_fm14_tm6,c
3254@TOP@human_GAPDH_TAA_len41_fa20_ta0_fm14_tm6*130*c,0,1562,0,0,1562,0.0,130,3254@TOP@human_GAPDH_TAA_len41_fa20_ta0_fm14_tm6,c
3254@TOP@human_GAPDH_TAA_len41_fa20_ta0_fm14_tm6*131*c,0,1567,0,0,1567,0.0,131,3254@TOP@human_GAPDH_TAA_len41_fa20_ta0_fm14_tm6,c
3254@TOP@human_GAPDH_TAA_len41_fa20_ta0_fm14_tm6*132*t,1,0,0,1547,1548,0.0,132,3254@TOP@human_GAPDH_TAA_len41_fa20_ta0_fm14_tm6,t
3254@TOP@human_GAPDH_TAA_len41_fa20_ta0_fm14_tm6*133*g,0,0,1545,0,1545,1.0,133,3254@TOP@human_GAPDH_TAA_len41_fa20_ta0_fm14_tm6,g
3254@TOP@human_GAPDH_TAA_len41_fa20_ta0_fm14_tm6*134*g,0,1,1547,0,1548,0.999,134,3254@TOP@human_GAPDH_TAA_len41_fa20_ta0_fm14_tm6,g
3255@TOP@human_GAPDH_TAA_len41_fa20_ta0_fm14_tm6*114*t,1,0,0,5889,5890,0.0,114,3255@TOP@human_GAPDH_TAA_len41_fa20_ta0_fm14_tm6,t
3255@TOP@human_GAPDH_TAA_len41_fa20_ta0_fm14_tm6*115*c,0,5923,0,0,5923,0.0,115,3255@TOP@human_GAPDH_TAA_len41_fa20_ta0_fm14_tm6,c
3255@TOP@human_GAPDH_TAA_len41_fa20_ta0_fm14_tm6*116*c,0,5899,0,0,5899,0.0,116,3255@TOP@human_GAPDH_TAA_len41_fa20_ta0_fm14_tm6,c
3255@TOP@human_GAPDH_TAA_len41_fa20_ta0_fm14_tm6*117*a,5881,0,4,0,5885,0.001,117,3255@TOP@human_GAPDH_TAA_len41_fa20_ta0_fm14_tm6,a
3255@TOP@human_GAPDH_TAA_len41_fa20_ta0_fm14_tm6*118*a,5792,1,66,1,5860,0.011,118,3255@TOP@human_GAPDH_TAA_len41_fa20_ta0_fm14_tm6,a
3255@TOP@human_GAPDH_TAA_len41_fa20_ta0_fm14_tm6*119*g,0,0,5867,0,5867,1.0,119,3255@TOP@human_GAPDH_TAA_len41_fa20_ta0_fm14_tm6,g
3255@TOP@human_GAPDH_TAA_len41_fa20_ta0_fm14_tm6*120*g,0,0,5825,2,5827,1.0,120,3255@TOP@human_GAPDH_TAA_len41_fa20_ta0_fm14_tm6,g
3255@TOP@human_GAPDH_TAA_len41_fa20_ta0_fm14_tm6*121*a,5890,0,0,0,5890,0.0,121,3255@TOP@human_GAPDH_TAA_len41_fa20_ta0_fm14_tm6,a
3255@TOP@human_GAPDH_TAA_len41_fa20_ta0_fm14_tm6*122*g,0,0,5900,0,5900,1.0,122,3255@TOP@human_GAPDH_TAA_len41_fa20_ta0_fm14_tm6,g
3255@TOP@human_GAPDH_TAA_len41_fa20_ta0_fm14_tm6*123*t,1,2,3,5794,5800,0.001,123,3255@TOP@human_GAPDH_TAA_len41_fa20_ta0_fm14_tm6,t
3255@TOP@human_GAPDH_TAA_len41_fa20_ta0_fm14_tm6*124*a,5489,1,326,0,5816,0.056,124,3255@TOP@human_GAPDH_TAA_len41_fa20_ta0_fm14_tm6,a
3255@TOP@human_GAPDH_TAA_len41_fa20_ta0_fm14_tm6*125*a,5632,0,170,0,5802,0.029,125,3255@TOP@human_GAPDH_TAA_len41_fa20_ta0_fm14_tm6,a
3255@TOP@human_GAPDH_TAA_len41_fa20_ta0_fm14_tm6*126*g,1,0,5821,0,5822,1.0,126,3255@TOP@human_GAPDH_TAA_len41_fa20_ta0_fm14_tm6,g
3255@TOP@human_GAPDH_TAA_len41_fa20_ta0_fm14_tm6*127*a,5865,0,5,0,5870,0.001,127,3255@TOP@human_GAPDH_TAA_len41_fa20_ta0_fm14_tm6,a
3255@TOP@human_GAPDH_TAA_len41_fa20_ta0_fm14_tm6*128*c,0,5907,3,1,5911,0.001,128,3255@TOP@human_GAPDH_TAA_len41_fa20_ta0_fm14_tm6,c
3255@TOP@human_GAPDH_TAA_len41_fa20_ta0_fm14_tm6*129*c,3,5869,0,0,5872,0.0,129,3255@TOP@human_GAPDH_TAA_len41_fa20_ta0_fm14_tm6,c
3255@TOP@human_GAPDH_TAA_len41_fa20_ta0_fm14_tm6*130*c,0,5896,0,1,5897,0.0,130,3255@TOP@human_GAPDH_TAA_len41_fa20_ta0_fm14_tm6,c
3255@TOP@human_GAPDH_TAA_len41_fa20_ta0_fm14_tm6*131*c,0,5908,0,0,5908,0.0,131,3255@TOP@human_GAPDH_TAA_len41_fa20_ta0_fm14_tm6,c
3255@TOP@human_GAPDH_TAA_len41_fa20_ta0_fm14_tm6*132*t,1,0,1,5819,5821,0.0,132,3255@TOP@human_GAPDH_TAA_len41_fa20_ta0_fm14_tm6,t
3255@TOP@human_GAPDH_TAA_len41_fa20_ta0_fm14_tm6*133*g,0,0,5823,0,5823,1.0,133,3255@TOP@human_GAPDH_TAA_len41_fa20_ta0_fm14_tm6,g
3255@TOP@human_GAPDH_TAA_len41_fa20_ta0_fm14_tm6*134*g,0,0,5836,0,5836,1.0,134,3255@TOP@human_GAPDH_TAA_len41_fa20_ta0_fm14_tm6,g
3256@TOP@human_GAPDH_TAA_len41_fa20_ta0_fm14_tm6*114*t,1,10,0,22937,22948,0.0,114,3256@TOP@human_GAPDH_TAA_len41_fa20_ta0_fm14_tm6,t
3256@TOP@human_GAPDH_TAA_len41_fa20_ta0_fm14_tm6*115*c,1,23081,0,1,23083,0.0,115,3256@TOP@human_GAPDH_TAA_len41_fa20_ta0_fm14_tm6,c
3256@TOP@human_GAPDH_TAA_len41_fa20_ta0_fm14_tm6*116*c,1,23007,0,1,23009,0.0,116,3256@TOP@human_GAPDH_TAA_len41_fa20_ta0_fm14_tm6,c
3256@TOP@human_GAPDH_TAA_len41_fa20_ta0_fm14_tm6*117*a,22939,0,27,0,22966,0.001,117,3256@TOP@human_GAPDH_TAA_len41_fa20_ta0_fm14_tm6,a
3256@TOP@human_GAPDH_TAA_len41_fa20_ta0_fm14_tm6*118*a,22558,2,300,0,22860,0.013,118,3256@TOP@human_GAPDH_TAA_len41_fa20_ta0_fm14_tm6,a
3256@TOP@human_GAPDH_TAA_len41_fa20_ta0_fm14_tm6*119*g,0,0,22802,2,22804,1.0,119,3256@TOP@human_GAPDH_TAA_len41_fa20_ta0_fm14_tm6,g
3256@TOP@human_GAPDH_TAA_len41_fa20_ta0_fm14_tm6*120*g,2,1,22675,0,22678,1.0,120,3256@TOP@human_GAPDH_TAA_len41_fa20_ta0_fm14_tm6,g
3256@TOP@human_GAPDH_TAA_len41_fa20_ta0_fm14_tm6*121*a,22944,1,7,0,22952,0.0,121,3256@TOP@human_GAPDH_TAA_len41_fa20_ta0_fm14_tm6,a
3256@TOP@human_GAPDH_TAA_len41_fa20_ta0_fm14_tm6*122*g,0,0,22985,0,22985,1.0,122,3256@TOP@human_GAPDH_TAA_len41_fa20_ta0_fm14_tm6,g
3256@TOP@human_GAPDH_TAA_len41_fa20_ta0_fm14_tm6*123*t,5,3,2,22690,22700,0.0,123,3256@TOP@human_GAPDH_TAA_len41_fa20_ta0_fm14_tm6,t
3256@TOP@human_GAPDH_TAA_len41_fa20_ta0_fm14_tm6*124*a,21577,1,1017,0,22595,0.045,124,3256@TOP@human_GAPDH_TAA_len41_fa20_ta0_fm14_tm6,a
3256@TOP@human_GAPDH_TAA_len41_fa20_ta0_fm14_tm6*125*a,22217,1,349,1,22568,0.015,125,3256@TOP@human_GAPDH_TAA_len41_fa20_ta0_fm14_tm6,a
3256@TOP@human_GAPDH_TAA_len41_fa20_ta0_fm14_tm6*126*g,1,0,22679,0,22680,1.0,126,3256@TOP@human_GAPDH_TAA_len41_fa20_ta0_fm14_tm6,g
3256@TOP@human_GAPDH_TAA_len41_fa20_ta0_fm14_tm6*127*a,22906,1,14,1,22922,0.001,127,3256@TOP@human_GAPDH_TAA_len41_fa20_ta0_fm14_tm6,a
3256@TOP@human_GAPDH_TAA_len41_fa20_ta0_fm14_tm6*128*c,0,23037,2,0,23039,0.0,128,3256@TOP@human_GAPDH_TAA_len41_fa20_ta0_fm14_tm6,c
3256@TOP@human_GAPDH_TAA_len41_fa20_ta0_fm14_tm6*129*c,1,22867,0,1,22869,0.0,129,3256@TOP@human_GAPDH_TAA_len41_fa20_ta0_fm14_tm6,c
3256@TOP@human_GAPDH_TAA_len41_fa20_ta0_fm14_tm6*130*c,1,23007,0,0,23008,0.0,130,3256@TOP@human_GAPDH_TAA_len41_fa20_ta0_fm14_tm6,c
3256@TOP@human_GAPDH_TAA_len41_fa20_ta0_fm14_tm6*131*c,1,23044,0,3,23048,0.0,131,3256@TOP@human_GAPDH_TAA_len41_fa20_ta0_fm14_tm6,c
3256@TOP@human_GAPDH_TAA_len41_fa20_ta0_fm14_tm6*132*t,2,5,3,22700,22710,0.0,132,3256@TOP@human_GAPDH_TAA_len41_fa20_ta0_fm14_tm6,t
3256@TOP@human_GAPDH_TAA_len41_fa20_ta0_fm14_tm6*133*g,3,0,22655,0,22658,1.0,133,3256@TOP@human_GAPDH_TAA_len41_fa20_ta0_fm14_tm6,g
3256@TOP@human_GAPDH_TAA_len41_fa20_ta0_fm14_tm6*134*g,3,5,22768,0,22776,1.0,134,3256@TOP@human_GAPDH_TAA_len41_fa20_ta0_fm14_tm6,g
3257@TOP@human_GAPDH_TAA_len41_fa20_ta0_fm14_tm6*114*t,2,13,0,28654,28669,0.0,114,3257@TOP@human_GAPDH_TAA_len41_fa20_ta0_fm14_tm6,t
3257@TOP@human_GAPDH_TAA_len41_fa20_ta0_fm14_tm6*115*c,0,28820,0,0,28820,0.0,115,3257@TOP@human_GAPDH_TAA_len41_fa20_ta0_fm14_tm6,c
3257@TOP@human_GAPDH_TAA_len41_fa20_ta0_fm14_tm6*116*c,0,28726,0,0,28726,0.0,116,3257@TOP@human_GAPDH_TAA_len41_fa20_ta0_fm14_tm6,c
3257@TOP@human_GAPDH_TAA_len41_fa20_ta0_fm14_tm6*117*a,28598,1,85,0,28684,0.003,117,3257@TOP@human_GAPDH_TAA_len41_fa20_ta0_fm14_tm6,a
3257@TOP@human_GAPDH_TAA_len41_fa20_ta0_fm14_tm6*118*a,28061,1,508,1,28571,0.018,118,3257@TOP@human_GAPDH_TAA_len41_fa20_ta0_fm14_tm6,a
3257@TOP@human_GAPDH_TAA_len41_fa20_ta0_fm14_tm6*119*g,2,1,28480,4,28487,1.0,119,3257@TOP@human_GAPDH_TAA_len41_fa20_ta0_fm14_tm6,g
3257@TOP@human_GAPDH_TAA_len41_fa20_ta0_fm14_tm6*120*g,2,0,28340,0,28342,1.0,120,3257@TOP@human_GAPDH_TAA_len41_fa20_ta0_fm14_tm6,g
3257@TOP@human_GAPDH_TAA_len41_fa20_ta0_fm14_tm6*121*a,28656,0,10,1,28667,0.0,121,3257@TOP@human_GAPDH_TAA_len41_fa20_ta0_fm14_tm6,a
3257@TOP@human_GAPDH_TAA_len41_fa20_ta0_fm14_tm6*122*g,0,0,28715,1,28716,1.0,122,3257@TOP@human_GAPDH_TAA_len41_fa20_ta0_fm14_tm6,g
3257@TOP@human_GAPDH_TAA_len41_fa20_ta0_fm14_tm6*123*t,2,0,5,28327,28334,0.0,123,3257@TOP@human_GAPDH_TAA_len41_fa20_ta0_fm14_tm6,t
3257@TOP@human_GAPDH_TAA_len41_fa20_ta0_fm14_tm6*124*a,26938,0,1262,2,28202,0.045,124,3257@TOP@human_GAPDH_TAA_len41_fa20_ta0_fm14_tm6,a
3257@TOP@human_GAPDH_TAA_len41_fa20_ta0_fm14_tm6*125*a,27685,3,474,7,28169,0.017,125,3257@TOP@human_GAPDH_TAA_len41_fa20_ta0_fm14_tm6,a
3257@TOP@human_GAPDH_TAA_len41_fa20_ta0_fm14_tm6*126*g,0,0,28320,0,28320,1.0,126,3257@TOP@human_GAPDH_TAA_len41_fa20_ta0_fm14_tm6,g
3257@TOP@human_GAPDH_TAA_len41_fa20_ta0_fm14_tm6*127*a,28564,4,12,0,28580,0.0,127,3257@TOP@human_GAPDH_TAA_len41_fa20_ta0_fm14_tm6,a
3257@TOP@human_GAPDH_TAA_len41_fa20_ta0_fm14_tm6*128*c,1,28746,2,0,28749,0.0,128,3257@TOP@human_GAPDH_TAA_len41_fa20_ta0_fm14_tm6,c
3257@TOP@human_GAPDH_TAA_len41_fa20_ta0_fm14_tm6*129*c,1,28519,0,1,28521,0.0,129,3257@TOP@human_GAPDH_TAA_len41_fa20_ta0_fm14_tm6,c
3257@TOP@human_GAPDH_TAA_len41_fa20_ta0_fm14_tm6*130*c,0,28707,0,1,28708,0.0,130,3257@TOP@human_GAPDH_TAA_len41_fa20_ta0_fm14_tm6,c
3257@TOP@human_GAPDH_TAA_len41_fa20_ta0_fm14_tm6*131*c,5,28759,0,1,28765,0.0,131,3257@TOP@human_GAPDH_TAA_len41_fa20_ta0_fm14_tm6,c
3257@TOP@human_GAPDH_TAA_len41_fa20_ta0_fm14_tm6*132*t,1,7,7,28322,28337,0.0,132,3257@TOP@human_GAPDH_TAA_len41_fa20_ta0_fm14_tm6,t
3257@TOP@human_GAPDH_TAA_len41_fa20_ta0_fm14_tm6*133*g,5,3,28312,0,28320,1.0,133,3257@TOP@human_GAPDH_TAA_len41_fa20_ta0_fm14_tm6,g
3257@TOP@human_GAPDH_TAA_len41_fa20_ta0_fm14_tm6*134*g,2,6,28447,0,28455,1.0,134,3257@TOP@human_GAPDH_TAA_len41_fa20_ta0_fm14_tm6,g
3258@TOP@human_GAPDH_TAA_len41_fa20_ta0_fm14_tm6*114*t,0,0,0,2210,2210,0.0,114,3258@TOP@human_GAPDH_TAA_len41_fa20_ta0_fm14_tm6,t
3258@TOP@human_GAPDH_TAA_len41_fa20_ta0_fm14_tm6*115*c,0,2224,0,0,2224,0.0,115,3258@TOP@human_GAPDH_TAA_len41_fa20_ta0_fm14_tm6,c
3258@TOP@human_GAPDH_TAA_len41_fa20_ta0_fm14_tm6*116*c,2,2217,0,0,2219,0.0,116,3258@TOP@human_GAPDH_TAA_len41_fa20_ta0_fm14_tm6,c
3258@TOP@human_GAPDH_TAA_len41_fa20_ta0_fm14_tm6*117*a,2198,0,15,0,2213,0.007,117,3258@TOP@human_GAPDH_TAA_len41_fa20_ta0_fm14_tm6,a
3258@TOP@human_GAPDH_TAA_len41_fa20_ta0_fm14_tm6*118*a,2143,0,61,0,2204,0.028,118,3258@TOP@human_GAPDH_TAA_len41_fa20_ta0_fm14_tm6,a
3258@TOP@human_GAPDH_TAA_len41_fa20_ta0_fm14_tm6*119*g,0,0,2196,0,2196,1.0,119,3258@TOP@human_GAPDH_TAA_len41_fa20_ta0_fm14_tm6,g
3258@TOP@human_GAPDH_TAA_len41_fa20_ta0_fm14_tm6*120*g,2,0,2179,0,2181,0.999,120,3258@TOP@human_GAPDH_TAA_len41_fa20_ta0_fm14_tm6,g
3258@TOP@human_GAPDH_TAA_len41_fa20_ta0_fm14_tm6*121*a,2210,0,0,0,2210,0.0,121,3258@TOP@human_GAPDH_TAA_len41_fa20_ta0_fm14_tm6,a
3258@TOP@human_GAPDH_TAA_len41_fa20_ta0_fm14_tm6*122*g,0,0,2216,0,2216,1.0,122,3258@TOP@human_GAPDH_TAA_len41_fa20_ta0_fm14_tm6,g
3258@TOP@human_GAPDH_TAA_len41_fa20_ta0_fm14_tm6*123*t,0,0,0,2185,2185,0.0,123,3258@TOP@human_GAPDH_TAA_len41_fa20_ta0_fm14_tm6,t
3258@TOP@human_GAPDH_TAA_len41_fa20_ta0_fm14_tm6*124*a,2114,0,62,0,2176,0.028,124,3258@TOP@human_GAPDH_TAA_len41_fa20_ta0_fm14_tm6,a
3258@TOP@human_GAPDH_TAA_len41_fa20_ta0_fm14_tm6*125*a,2130,0,42,0,2172,0.019,125,3258@TOP@human_GAPDH_TAA_len41_fa20_ta0_fm14_tm6,a
3258@TOP@human_GAPDH_TAA_len41_fa20_ta0_fm14_tm6*126*g,0,0,2188,0,2188,1.0,126,3258@TOP@human_GAPDH_TAA_len41_fa20_ta0_fm14_tm6,g
3258@TOP@human_GAPDH_TAA_len41_fa20_ta0_fm14_tm6*127*a,2211,0,0,0,2211,0.0,127,3258@TOP@human_GAPDH_TAA_len41_fa20_ta0_fm14_tm6,a
3258@TOP@human_GAPDH_TAA_len41_fa20_ta0_fm14_tm6*128*c,0,2216,0,1,2217,0.0,128,3258@TOP@human_GAPDH_TAA_len41_fa20_ta0_fm14_tm6,c
3258@TOP@human_GAPDH_TAA_len41_fa20_ta0_fm14_tm6*129*c,0,2201,0,1,2202,0.0,129,3258@TOP@human_GAPDH_TAA_len41_fa20_ta0_fm14_tm6,c
3258@TOP@human_GAPDH_TAA_len41_fa20_ta0_fm14_tm6*130*c,0,2216,0,0,2216,0.0,130,3258@TOP@human_GAPDH_TAA_len41_fa20_ta0_fm14_tm6,c
3258@TOP@human_GAPDH_TAA_len41_fa20_ta0_fm14_tm6*131*c,0,2218,0,0,2218,0.0,131,3258@TOP@human_GAPDH_TAA_len41_fa20_ta0_fm14_tm6,c
3258@TOP@human_GAPDH_TAA_len41_fa20_ta0_fm14_tm6*132*t,0,0,0,2197,2197,0.0,132,3258@TOP@human_GAPDH_TAA_len41_fa20_ta0_fm14_tm6,t
3258@TOP@human_GAPDH_TAA_len41_fa20_ta0_fm14_tm6*133*g,4,0,2183,0,2187,0.998,133,3258@TOP@human_GAPDH_TAA_len41_fa20_ta0_fm14_tm6,g
3258@TOP@human_GAPDH_TAA_len41_fa20_ta0_fm14_tm6*134*g,0,2,2194,0,2196,0.999,134,3258@TOP@human_GAPDH_TAA_len41_fa20_ta0_fm14_tm6,g
3259@TOP@human_GAPDH_TAA_len41_fa20_ta0_fm14_tm6*114*t,0,0,0,1344,1344,0.0,114,3259@TOP@human_GAPDH_TAA_len41_fa20_ta0_fm14_tm6,t
3259@TOP@human_GAPDH_TAA_len41_fa20_ta0_fm14_tm6*115*c,0,1352,0,0,1352,0.0,115,3259@TOP@human_GAPDH_TAA_len41_fa20_ta0_fm14_tm6,c
3259@TOP@human_GAPDH_TAA_len41_fa20_ta0_fm14_tm6*116*c,0,1349,0,0,1349,0.0,116,3259@TOP@human_GAPDH_TAA_len41_fa20_ta0_fm14_tm6,c
3259@TOP@human_GAPDH_TAA_len41_fa20_ta0_fm14_tm6*117*a,1336,0,12,0,1348,0.009,117,3259@TOP@human_GAPDH_TAA_len41_fa20_ta0_fm14_tm6,a
3259@TOP@human_GAPDH_TAA_len41_fa20_ta0_fm14_tm6*118*a,1280,0,52,0,1332,0.039,118,3259@TOP@human_GAPDH_TAA_len41_fa20_ta0_fm14_tm6,a
3259@TOP@human_GAPDH_TAA_len41_fa20_ta0_fm14_tm6*119*g,0,0,1332,0,1332,1.0,119,3259@TOP@human_GAPDH_TAA_len41_fa20_ta0_fm14_tm6,g
3259@TOP@human_GAPDH_TAA_len41_fa20_ta0_fm14_tm6*120*g,0,1,1327,0,1328,0.999,120,3259@TOP@human_GAPDH_TAA_len41_fa20_ta0_fm14_tm6,g
3259@TOP@human_GAPDH_TAA_len41_fa20_ta0_fm14_tm6*121*a,1343,0,0,0,1343,0.0,121,3259@TOP@human_GAPDH_TAA_len41_fa20_ta0_fm14_tm6,a
3259@TOP@human_GAPDH_TAA_len41_fa20_ta0_fm14_tm6*122*g,0,0,1345,0,1345,1.0,122,3259@TOP@human_GAPDH_TAA_len41_fa20_ta0_fm14_tm6,g
3259@TOP@human_GAPDH_TAA_len41_fa20_ta0_fm14_tm6*123*t,0,1,0,1323,1324,0.0,123,3259@TOP@human_GAPDH_TAA_len41_fa20_ta0_fm14_tm6,t
3259@TOP@human_GAPDH_TAA_len41_fa20_ta0_fm14_tm6*124*a,1254,0,70,0,1324,0.053,124,3259@TOP@human_GAPDH_TAA_len41_fa20_ta0_fm14_tm6,a
3259@TOP@human_GAPDH_TAA_len41_fa20_ta0_fm14_tm6*125*a,1295,0,31,0,1326,0.023,125,3259@TOP@human_GAPDH_TAA_len41_fa20_ta0_fm14_tm6,a
3259@TOP@human_GAPDH_TAA_len41_fa20_ta0_fm14_tm6*126*g,0,0,1327,0,1327,1.0,126,3259@TOP@human_GAPDH_TAA_len41_fa20_ta0_fm14_tm6,g
3259@TOP@human_GAPDH_TAA_len41_fa20_ta0_fm14_tm6*127*a,1342,0,0,0,1342,0.0,127,3259@TOP@human_GAPDH_TAA_len41_fa20_ta0_fm14_tm6,a
3259@TOP@human_GAPDH_TAA_len41_fa20_ta0_fm14_tm6*128*c,2,1349,0,0,1351,0.0,128,3259@TOP@human_GAPDH_TAA_len41_fa20_ta0_fm14_tm6,c
3259@TOP@human_GAPDH_TAA_len41_fa20_ta0_fm14_tm6*129*c,0,1339,0,0,1339,0.0,129,3259@TOP@human_GAPDH_TAA_len41_fa20_ta0_fm14_tm6,c
3259@TOP@human_GAPDH_TAA_len41_fa20_ta0_fm14_tm6*130*c,0,1346,0,0,1346,0.0,130,3259@TOP@human_GAPDH_TAA_len41_fa20_ta0_fm14_tm6,c
3259@TOP@human_GAPDH_TAA_len41_fa20_ta0_fm14_tm6*131*c,0,1346,0,0,1346,0.0,131,3259@TOP@human_GAPDH_TAA_len41_fa20_ta0_fm14_tm6,c
3259@TOP@human_GAPDH_TAA_len41_fa20_ta0_fm14_tm6*132*t,0,0,0,1330,1330,0.0,132,3259@TOP@human_GAPDH_TAA_len41_fa20_ta0_fm14_tm6,t
3259@TOP@human_GAPDH_TAA_len41_fa20_ta0_fm14_tm6*133*g,0,0,1330,0,1330,1.0,133,3259@TOP@human_GAPDH_TAA_len41_fa20_ta0_fm14_tm6,g
3259@TOP@human_GAPDH_TAA_len41_fa20_ta0_fm14_tm6*134*g,0,2,1329,0,1331,0.998,134,3259@TOP@human_GAPDH_TAA_len41_fa20_ta0_fm14_tm6,g
3260@TOP@human_GAPDH_TAA_len41_fa20_ta0_fm14_tm6*114*t,0,0,0,2302,2302,0.0,114,3260@TOP@human_GAPDH_TAA_len41_fa20_ta0_fm14_tm6,t
3260@TOP@human_GAPDH_TAA_len41_fa20_ta0_fm14_tm6*115*c,1,2317,0,0,2318,0.0,115,3260@TOP@human_GAPDH_TAA_len41_fa20_ta0_fm14_tm6,c
3260@TOP@human_GAPDH_TAA_len41_fa20_ta0_fm14_tm6*116*c,0,2308,0,0,2308,0.0,116,3260@TOP@human_GAPDH_TAA_len41_fa20_ta0_fm14_tm6,c
3260@TOP@human_GAPDH_TAA_len41_fa20_ta0_fm14_tm6*117*a,2298,0,1,0,2299,0.0,117,3260@TOP@human_GAPDH_TAA_len41_fa20_ta0_fm14_tm6,a
3260@TOP@human_GAPDH_TAA_len41_fa20_ta0_fm14_tm6*118*a,2262,0,25,0,2287,0.011,118,3260@TOP@human_GAPDH_TAA_len41_fa20_ta0_fm14_tm6,a
3260@TOP@human_GAPDH_TAA_len41_fa20_ta0_fm14_tm6*119*g,0,0,2278,0,2278,1.0,119,3260@TOP@human_GAPDH_TAA_len41_fa20_ta0_fm14_tm6,g
3260@TOP@human_GAPDH_TAA_len41_fa20_ta0_fm14_tm6*120*g,0,0,2282,0,2282,1.0,120,3260@TOP@human_GAPDH_TAA_len41_fa20_ta0_fm14_tm6,g
3260@TOP@human_GAPDH_TAA_len41_fa20_ta0_fm14_tm6*121*a,2307,0,0,0,2307,0.0,121,3260@TOP@human_GAPDH_TAA_len41_fa20_ta0_fm14_tm6,a
3260@TOP@human_GAPDH_TAA_len41_fa20_ta0_fm14_tm6*122*g,0,0,2303,0,2303,1.0,122,3260@TOP@human_GAPDH_TAA_len41_fa20_ta0_fm14_tm6,g
3260@TOP@human_GAPDH_TAA_len41_fa20_ta0_fm14_tm6*123*t,1,1,0,2272,2274,0.0,123,3260@TOP@human_GAPDH_TAA_len41_fa20_ta0_fm14_tm6,t
3260@TOP@human_GAPDH_TAA_len41_fa20_ta0_fm14_tm6*124*a,2161,0,116,0,2277,0.051,124,3260@TOP@human_GAPDH_TAA_len41_fa20_ta0_fm14_tm6,a
3260@TOP@human_GAPDH_TAA_len41_fa20_ta0_fm14_tm6*125*a,2202,0,59,0,2261,0.026,125,3260@TOP@human_GAPDH_TAA_len41_fa20_ta0_fm14_tm6,a
3260@TOP@human_GAPDH_TAA_len41_fa20_ta0_fm14_tm6*126*g,0,0,2280,0,2280,1.0,126,3260@TOP@human_GAPDH_TAA_len41_fa20_ta0_fm14_tm6,g
3260@TOP@human_GAPDH_TAA_len41_fa20_ta0_fm14_tm6*127*a,2291,0,1,1,2293,0.0,127,3260@TOP@human_GAPDH_TAA_len41_fa20_ta0_fm14_tm6,a
3260@TOP@human_GAPDH_TAA_len41_fa20_ta0_fm14_tm6*128*c,0,2313,0,0,2313,0.0,128,3260@TOP@human_GAPDH_TAA_len41_fa20_ta0_fm14_tm6,c
3260@TOP@human_GAPDH_TAA_len41_fa20_ta0_fm14_tm6*129*c,1,2292,0,0,2293,0.0,129,3260@TOP@human_GAPDH_TAA_len41_fa20_ta0_fm14_tm6,c
3260@TOP@human_GAPDH_TAA_len41_fa20_ta0_fm14_tm6*130*c,1,2297,0,0,2298,0.0,130,3260@TOP@human_GAPDH_TAA_len41_fa20_ta0_fm14_tm6,c
3260@TOP@human_GAPDH_TAA_len41_fa20_ta0_fm14_tm6*131*c,0,2316,0,0,2316,0.0,131,3260@TOP@human_GAPDH_TAA_len41_fa20_ta0_fm14_tm6,c
3260@TOP@human_GAPDH_TAA_len41_fa20_ta0_fm14_tm6*132*t,0,4,0,2280,2284,0.0,132,3260@TOP@human_GAPDH_TAA_len41_fa20_ta0_fm14_tm6,t
3260@TOP@human_GAPDH_TAA_len41_fa20_ta0_fm14_tm6*133*g,2,0,2274,0,2276,0.999,133,3260@TOP@human_GAPDH_TAA_len41_fa20_ta0_fm14_tm6,g
3260@TOP@human_GAPDH_TAA_len41_fa20_ta0_fm14_tm6*134*g,0,1,2276,0,2277,1.0,134,3260@TOP@human_GAPDH_TAA_len41_fa20_ta0_fm14_tm6,g
3261@TOP@human_GAPDH_TAA_len41_fa20_ta0_fm14_tm6*114*t,0,0,0,2376,2376,0.0,114,3261@TOP@human_GAPDH_TAA_len41_fa20_ta0_fm14_tm6,t
3261@TOP@human_GAPDH_TAA_len41_fa20_ta0_fm14_tm6*115*c,0,2388,0,0,2388,0.0,115,3261@TOP@human_GAPDH_TAA_len41_fa20_ta0_fm14_tm6,c
3261@TOP@human_GAPDH_TAA_len41_fa20_ta0_fm14_tm6*116*c,0,2380,0,0,2380,0.0,116,3261@TOP@human_GAPDH_TAA_len41_fa20_ta0_fm14_tm6,c
3261@TOP@human_GAPDH_TAA_len41_fa20_ta0_fm14_tm6*117*a,2373,0,3,0,2376,0.001,117,3261@TOP@human_GAPDH_TAA_len41_fa20_ta0_fm14_tm6,a
3261@TOP@human_GAPDH_TAA_len41_fa20_ta0_fm14_tm6*118*a,2338,0,31,0,2369,0.013,118,3261@TOP@human_GAPDH_TAA_len41_fa20_ta0_fm14_tm6,a
3261@TOP@human_GAPDH_TAA_len41_fa20_ta0_fm14_tm6*119*g,0,0,2361,0,2361,1.0,119,3261@TOP@human_GAPDH_TAA_len41_fa20_ta0_fm14_tm6,g
3261@TOP@human_GAPDH_TAA_len41_fa20_ta0_fm14_tm6*120*g,0,0,2345,0,2345,1.0,120,3261@TOP@human_GAPDH_TAA_len41_fa20_ta0_fm14_tm6,g
3261@TOP@human_GAPDH_TAA_len41_fa20_ta0_fm14_tm6*121*a,2363,0,2,0,2365,0.001,121,3261@TOP@human_GAPDH_TAA_len41_fa20_ta0_fm14_tm6,a
3261@TOP@human_GAPDH_TAA_len41_fa20_ta0_fm14_tm6*122*g,0,0,2371,0,2371,1.0,122,3261@TOP@human_GAPDH_TAA_len41_fa20_ta0_fm14_tm6,g
3261@TOP@human_GAPDH_TAA_len41_fa20_ta0_fm14_tm6*123*t,1,0,0,2346,2347,0.0,123,3261@TOP@human_GAPDH_TAA_len41_fa20_ta0_fm14_tm6,t
3261@TOP@human_GAPDH_TAA_len41_fa20_ta0_fm14_tm6*124*a,2252,0,92,0,2344,0.039,124,3261@TOP@human_GAPDH_TAA_len41_fa20_ta0_fm14_tm6,a
3261@TOP@human_GAPDH_TAA_len41_fa20_ta0_fm14_tm6*125*a,2279,0,47,0,2326,0.02,125,3261@TOP@human_GAPDH_TAA_len41_fa20_ta0_fm14_tm6,a
3261@TOP@human_GAPDH_TAA_len41_fa20_ta0_fm14_tm6*126*g,0,0,2346,0,2346,1.0,126,3261@TOP@human_GAPDH_TAA_len41_fa20_ta0_fm14_tm6,g
3261@TOP@human_GAPDH_TAA_len41_fa20_ta0_fm14_tm6*127*a,2370,0,2,0,2372,0.001,127,3261@TOP@human_GAPDH_TAA_len41_fa20_ta0_fm14_tm6,a
3261@TOP@human_GAPDH_TAA_len41_fa20_ta0_fm14_tm6*128*c,0,2380,0,0,2380,0.0,128,3261@TOP@human_GAPDH_TAA_len41_fa20_ta0_fm14_tm6,c
3261@TOP@human_GAPDH_TAA_len41_fa20_ta0_fm14_tm6*129*c,0,2359,0,0,2359,0.0,129,3261@TOP@human_GAPDH_TAA_len41_fa20_ta0_fm14_tm6,c
3261@TOP@human_GAPDH_TAA_len41_fa20_ta0_fm14_tm6*130*c,1,2382,0,0,2383,0.0,130,3261@TOP@human_GAPDH_TAA_len41_fa20_ta0_fm14_tm6,c
3261@TOP@human_GAPDH_TAA_len41_fa20_ta0_fm14_tm6*131*c,0,2379,0,0,2379,0.0,131,3261@TOP@human_GAPDH_TAA_len41_fa20_ta0_fm14_tm6,c
3261@TOP@human_GAPDH_TAA_len41_fa20_ta0_fm14_tm6*132*t,0,2,0,2338,2340,0.0,132,3261@TOP@human_GAPDH_TAA_len41_fa20_ta0_fm14_tm6,t
3261@TOP@human_GAPDH_TAA_len41_fa20_ta0_fm14_tm6*133*g,0,0,2336,0,2336,1.0,133,3261@TOP@human_GAPDH_TAA_len41_fa20_ta0_fm14_tm6,g
3261@TOP@human_GAPDH_TAA_len41_fa20_ta0_fm14_tm6*134*g,0,0,2351,0,2351,1.0,134,3261@TOP@human_GAPDH_TAA_len41_fa20_ta0_fm14_tm6,g
3262@TOP@human_GAPDH_TAA_len41_fa20_ta0_fm14_tm6*114*t,0,0,0,4016,4016,0.0,114,3262@TOP@human_GAPDH_TAA_len41_fa20_ta0_fm14_tm6,t
3262@TOP@human_GAPDH_TAA_len41_fa20_ta0_fm14_tm6*115*c,0,4044,0,0,4044,0.0,115,3262@TOP@human_GAPDH_TAA_len41_fa20_ta0_fm14_tm6,c
3262@TOP@human_GAPDH_TAA_len41_fa20_ta0_fm14_tm6*116*c,0,4022,0,0,4022,0.0,116,3262@TOP@human_GAPDH_TAA_len41_fa20_ta0_fm14_tm6,c
3262@TOP@human_GAPDH_TAA_len41_fa20_ta0_fm14_tm6*117*a,4021,0,4,0,4025,0.001,117,3262@TOP@human_GAPDH_TAA_len41_fa20_ta0_fm14_tm6,a
3262@TOP@human_GAPDH_TAA_len41_fa20_ta0_fm14_tm6*118*a,3949,0,55,0,4004,0.014,118,3262@TOP@human_GAPDH_TAA_len41_fa20_ta0_fm14_tm6,a
3262@TOP@human_GAPDH_TAA_len41_fa20_ta0_fm14_tm6*119*g,0,0,3991,0,3991,1.0,119,3262@TOP@human_GAPDH_TAA_len41_fa20_ta0_fm14_tm6,g
3262@TOP@human_GAPDH_TAA_len41_fa20_ta0_fm14_tm6*120*g,0,0,3979,1,3980,1.0,120,3262@TOP@human_GAPDH_TAA_len41_fa20_ta0_fm14_tm6,g
3262@TOP@human_GAPDH_TAA_len41_fa20_ta0_fm14_tm6*121*a,4018,0,3,0,4021,0.001,121,3262@TOP@human_GAPDH_TAA_len41_fa20_ta0_fm14_tm6,a
3262@TOP@human_GAPDH_TAA_len41_fa20_ta0_fm14_tm6*122*g,0,0,4029,0,4029,1.0,122,3262@TOP@human_GAPDH_TAA_len41_fa20_ta0_fm14_tm6,g
3262@TOP@human_GAPDH_TAA_len41_fa20_ta0_fm14_tm6*123*t,0,0,0,3962,3962,0.0,123,3262@TOP@human_GAPDH_TAA_len41_fa20_ta0_fm14_tm6,t
3262@TOP@human_GAPDH_TAA_len41_fa20_ta0_fm14_tm6*124*a,3646,0,303,0,3949,0.077,124,3262@TOP@human_GAPDH_TAA_len41_fa20_ta0_fm14_tm6,a
3262@TOP@human_GAPDH_TAA_len41_fa20_ta0_fm14_tm6*125*a,3721,0,210,0,3931,0.053,125,3262@TOP@human_GAPDH_TAA_len41_fa20_ta0_fm14_tm6,a
3262@TOP@human_GAPDH_TAA_len41_fa20_ta0_fm14_tm6*126*g,0,0,3971,0,3971,1.0,126,3262@TOP@human_GAPDH_TAA_len41_fa20_ta0_fm14_tm6,g
3262@TOP@human_GAPDH_TAA_len41_fa20_ta0_fm14_tm6*127*a,4001,0,11,0,4012,0.003,127,3262@TOP@human_GAPDH_TAA_len41_fa20_ta0_fm14_tm6,a
3262@TOP@human_GAPDH_TAA_len41_fa20_ta0_fm14_tm6*128*c,0,4037,0,0,4037,0.0,128,3262@TOP@human_GAPDH_TAA_len41_fa20_ta0_fm14_tm6,c
3262@TOP@human_GAPDH_TAA_len41_fa20_ta0_fm14_tm6*129*c,0,4002,0,0,4002,0.0,129,3262@TOP@human_GAPDH_TAA_len41_fa20_ta0_fm14_tm6,c
3262@TOP@human_GAPDH_TAA_len41_fa20_ta0_fm14_tm6*130*c,3,4021,0,0,4024,0.0,130,3262@TOP@human_GAPDH_TAA_len41_fa20_ta0_fm14_tm6,c
3262@TOP@human_GAPDH_TAA_len41_fa20_ta0_fm14_tm6*131*c,0,4039,0,0,4039,0.0,131,3262@TOP@human_GAPDH_TAA_len41_fa20_ta0_fm14_tm6,c
3262@TOP@human_GAPDH_TAA_len41_fa20_ta0_fm14_tm6*132*t,0,0,1,3961,3962,0.0,132,3262@TOP@human_GAPDH_TAA_len41_fa20_ta0_fm14_tm6,t
3262@TOP@human_GAPDH_TAA_len41_fa20_ta0_fm14_tm6*133*g,1,0,3951,0,3952,1.0,133,3262@TOP@human_GAPDH_TAA_len41_fa20_ta0_fm14_tm6,g
3262@TOP@human_GAPDH_TAA_len41_fa20_ta0_fm14_tm6*134*g,0,0,3976,0,3976,1.0,134,3262@TOP@human_GAPDH_TAA_len41_fa20_ta0_fm14_tm6,g
3263@TOP@human_GAPDH_TAA_len41_fa20_ta0_fm14_tm6*114*t,0,3,0,701,704,0.0,114,3263@TOP@human_GAPDH_TAA_len41_fa20_ta0_fm14_tm6,t
3263@TOP@human_GAPDH_TAA_len41_fa20_ta0_fm14_tm6*115*c,0,706,0,0,706,0.0,115,3263@TOP@human_GAPDH_TAA_len41_fa20_ta0_fm14_tm6,c
3263@TOP@human_GAPDH_TAA_len41_fa20_ta0_fm14_tm6*116*c,0,700,0,0,700,0.0,116,3263@TOP@human_GAPDH_TAA_len41_fa20_ta0_fm14_tm6,c
3263@TOP@human_GAPDH_TAA_len41_fa20_ta0_fm14_tm6*117*a,700,0,1,0,701,0.001,117,3263@TOP@human_GAPDH_TAA_len41_fa20_ta0_fm14_tm6,a
3263@TOP@human_GAPDH_TAA_len41_fa20_ta0_fm14_tm6*118*a,688,0,10,0,698,0.014,118,3263@TOP@human_GAPDH_TAA_len41_fa20_ta0_fm14_tm6,a
3263@TOP@human_GAPDH_TAA_len41_fa20_ta0_fm14_tm6*119*g,0,0,695,0,695,1.0,119,3263@TOP@human_GAPDH_TAA_len41_fa20_ta0_fm14_tm6,g
3263@TOP@human_GAPDH_TAA_len41_fa20_ta0_fm14_tm6*120*g,0,0,690,0,690,1.0,120,3263@TOP@human_GAPDH_TAA_len41_fa20_ta0_fm14_tm6,g
3263@TOP@human_GAPDH_TAA_len41_fa20_ta0_fm14_tm6*121*a,703,0,0,0,703,0.0,121,3263@TOP@human_GAPDH_TAA_len41_fa20_ta0_fm14_tm6,a
3263@TOP@human_GAPDH_TAA_len41_fa20_ta0_fm14_tm6*122*g,0,0,702,0,702,1.0,122,3263@TOP@human_GAPDH_TAA_len41_fa20_ta0_fm14_tm6,g
3263@TOP@human_GAPDH_TAA_len41_fa20_ta0_fm14_tm6*123*t,0,0,0,697,697,0.0,123,3263@TOP@human_GAPDH_TAA_len41_fa20_ta0_fm14_tm6,t
3263@TOP@human_GAPDH_TAA_len41_fa20_ta0_fm14_tm6*124*a,657,0,22,0,679,0.032,124,3263@TOP@human_GAPDH_TAA_len41_fa20_ta0_fm14_tm6,a
3263@TOP@human_GAPDH_TAA_len41_fa20_ta0_fm14_tm6*125*a,671,0,18,0,689,0.026,125,3263@TOP@human_GAPDH_TAA_len41_fa20_ta0_fm14_tm6,a
3263@TOP@human_GAPDH_TAA_len41_fa20_ta0_fm14_tm6*126*g,0,0,690,0,690,1.0,126,3263@TOP@human_GAPDH_TAA_len41_fa20_ta0_fm14_tm6,g
3263@TOP@human_GAPDH_TAA_len41_fa20_ta0_fm14_tm6*127*a,692,0,0,0,692,0.0,127,3263@TOP@human_GAPDH_TAA_len41_fa20_ta0_fm14_tm6,a
3263@TOP@human_GAPDH_TAA_len41_fa20_ta0_fm14_tm6*128*c,0,702,0,0,702,0.0,128,3263@TOP@human_GAPDH_TAA_len41_fa20_ta0_fm14_tm6,c
3263@TOP@human_GAPDH_TAA_len41_fa20_ta0_fm14_tm6*129*c,0,698,0,0,698,0.0,129,3263@TOP@human_GAPDH_TAA_len41_fa20_ta0_fm14_tm6,c
3263@TOP@human_GAPDH_TAA_len41_fa20_ta0_fm14_tm6*130*c,0,698,0,0,698,0.0,130,3263@TOP@human_GAPDH_TAA_len41_fa20_ta0_fm14_tm6,c
3263@TOP@human_GAPDH_TAA_len41_fa20_ta0_fm14_tm6*131*c,0,704,0,0,704,0.0,131,3263@TOP@human_GAPDH_TAA_len41_fa20_ta0_fm14_tm6,c
3263@TOP@human_GAPDH_TAA_len41_fa20_ta0_fm14_tm6*132*t,0,0,0,692,692,0.0,132,3263@TOP@human_GAPDH_TAA_len41_fa20_ta0_fm14_tm6,t
3263@TOP@human_GAPDH_TAA_len41_fa20_ta0_fm14_tm6*133*g,0,0,686,0,686,1.0,133,3263@TOP@human_GAPDH_TAA_len41_fa20_ta0_fm14_tm6,g
3263@TOP@human_GAPDH_TAA_len41_fa20_ta0_fm14_tm6*134*g,0,0,695,0,695,1.0,134,3263@TOP@human_GAPDH_TAA_len41_fa20_ta0_fm14_tm6,g
3264@TOP@human_GAPDH_TAA_len41_fa20_ta0_fm14_tm6*114*t,0,1,0,1912,1913,0.0,114,3264@TOP@human_GAPDH_TAA_len41_fa20_ta0_fm14_tm6,t
3264@TOP@human_GAPDH_TAA_len41_fa20_ta0_fm14_tm6*115*c,0,1937,0,0,1937,0.0,115,3264@TOP@human_GAPDH_TAA_len41_fa20_ta0_fm14_tm6,c
3264@TOP@human_GAPDH_TAA_len41_fa20_ta0_fm14_tm6*116*c,0,1920,0,0,1920,0.0,116,3264@TOP@human_GAPDH_TAA_len41_fa20_ta0_fm14_tm6,c
3264@TOP@human_GAPDH_TAA_len41_fa20_ta0_fm14_tm6*117*a,1910,0,9,0,1919,0.005,117,3264@TOP@human_GAPDH_TAA_len41_fa20_ta0_fm14_tm6,a
3264@TOP@human_GAPDH_TAA_len41_fa20_ta0_fm14_tm6*118*a,1865,0,50,0,1915,0.026,118,3264@TOP@human_GAPDH_TAA_len41_fa20_ta0_fm14_tm6,a
3264@TOP@human_GAPDH_TAA_len41_fa20_ta0_fm14_tm6*119*g,0,0,1901,0,1901,1.0,119,3264@TOP@human_GAPDH_TAA_len41_fa20_ta0_fm14_tm6,g
3264@TOP@human_GAPDH_TAA_len41_fa20_ta0_fm14_tm6*120*g,0,0,1885,1,1886,0.999,120,3264@TOP@human_GAPDH_TAA_len41_fa20_ta0_fm14_tm6,g
3264@TOP@human_GAPDH_TAA_len41_fa20_ta0_fm14_tm6*121*a,1925,0,0,0,1925,0.0,121,3264@TOP@human_GAPDH_TAA_len41_fa20_ta0_fm14_tm6,a
3264@TOP@human_GAPDH_TAA_len41_fa20_ta0_fm14_tm6*122*g,0,0,1926,0,1926,1.0,122,3264@TOP@human_GAPDH_TAA_len41_fa20_ta0_fm14_tm6,g
3264@TOP@human_GAPDH_TAA_len41_fa20_ta0_fm14_tm6*123*t,1,0,0,1894,1895,0.0,123,3264@TOP@human_GAPDH_TAA_len41_fa20_ta0_fm14_tm6,t
3264@TOP@human_GAPDH_TAA_len41_fa20_ta0_fm14_tm6*124*a,1725,0,162,0,1887,0.086,124,3264@TOP@human_GAPDH_TAA_len41_fa20_ta0_fm14_tm6,a
3264@TOP@human_GAPDH_TAA_len41_fa20_ta0_fm14_tm6*125*a,1873,1,36,0,1910,0.019,125,3264@TOP@human_GAPDH_TAA_len41_fa20_ta0_fm14_tm6,a
3264@TOP@human_GAPDH_TAA_len41_fa20_ta0_fm14_tm6*126*g,0,0,1891,0,1891,1.0,126,3264@TOP@human_GAPDH_TAA_len41_fa20_ta0_fm14_tm6,g
3264@TOP@human_GAPDH_TAA_len41_fa20_ta0_fm14_tm6*127*a,1917,0,1,0,1918,0.001,127,3264@TOP@human_GAPDH_TAA_len41_fa20_ta0_fm14_tm6,a
3264@TOP@human_GAPDH_TAA_len41_fa20_ta0_fm14_tm6*128*c,0,1931,0,0,1931,0.0,128,3264@TOP@human_GAPDH_TAA_len41_fa20_ta0_fm14_tm6,c
3264@TOP@human_GAPDH_TAA_len41_fa20_ta0_fm14_tm6*129*c,0,1902,0,0,1902,0.0,129,3264@TOP@human_GAPDH_TAA_len41_fa20_ta0_fm14_tm6,c
3264@TOP@human_GAPDH_TAA_len41_fa20_ta0_fm14_tm6*130*c,1,1925,0,2,1928,0.0,130,3264@TOP@human_GAPDH_TAA_len41_fa20_ta0_fm14_tm6,c
3264@TOP@human_GAPDH_TAA_len41_fa20_ta0_fm14_tm6*131*c,0,1927,0,0,1927,0.0,131,3264@TOP@human_GAPDH_TAA_len41_fa20_ta0_fm14_tm6,c
3264@TOP@human_GAPDH_TAA_len41_fa20_ta0_fm14_tm6*132*t,0,0,0,1880,1880,0.0,132,3264@TOP@human_GAPDH_TAA_len41_fa20_ta0_fm14_tm6,t
3264@TOP@human_GAPDH_TAA_len41_fa20_ta0_fm14_tm6*133*g,0,0,1892,0,1892,1.0,133,3264@TOP@human_GAPDH_TAA_len41_fa20_ta0_fm14_tm6,g
3264@TOP@human_GAPDH_TAA_len41_fa20_ta0_fm14_tm6*134*g,0,0,1900,0,1900,1.0,134,3264@TOP@human_GAPDH_TAA_len41_fa20_ta0_fm14_tm6,g
3265@TOP@human_GAPDH_TAA_len41_fa20_ta0_fm14_tm6*114*t,2,12,0,51150,51164,0.0,114,3265@TOP@human_GAPDH_TAA_len41_fa20_ta0_fm14_tm6,t
3265@TOP@human_GAPDH_TAA_len41_fa20_ta0_fm14_tm6*115*c,0,51443,0,1,51444,0.0,115,3265@TOP@human_GAPDH_TAA_len41_fa20_ta0_fm14_tm6,c
3265@TOP@human_GAPDH_TAA_len41_fa20_ta0_fm14_tm6*116*c,1,51279,0,5,51285,0.0,116,3265@TOP@human_GAPDH_TAA_len41_fa20_ta0_fm14_tm6,c
3265@TOP@human_GAPDH_TAA_len41_fa20_ta0_fm14_tm6*117*a,51056,0,96,1,51153,0.002,117,3265@TOP@human_GAPDH_TAA_len41_fa20_ta0_fm14_tm6,a
3265@TOP@human_GAPDH_TAA_len41_fa20_ta0_fm14_tm6*118*a,50334,0,555,1,50890,0.011,118,3265@TOP@human_GAPDH_TAA_len41_fa20_ta0_fm14_tm6,a
3265@TOP@human_GAPDH_TAA_len41_fa20_ta0_fm14_tm6*119*g,5,2,50808,0,50815,1.0,119,3265@TOP@human_GAPDH_TAA_len41_fa20_ta0_fm14_tm6,g
3265@TOP@human_GAPDH_TAA_len41_fa20_ta0_fm14_tm6*120*g,2,0,50623,1,50626,1.0,120,3265@TOP@human_GAPDH_TAA_len41_fa20_ta0_fm14_tm6,g
3265@TOP@human_GAPDH_TAA_len41_fa20_ta0_fm14_tm6*121*a,51123,0,16,1,51140,0.0,121,3265@TOP@human_GAPDH_TAA_len41_fa20_ta0_fm14_tm6,a
3265@TOP@human_GAPDH_TAA_len41_fa20_ta0_fm14_tm6*122*g,4,0,51231,2,51237,1.0,122,3265@TOP@human_GAPDH_TAA_len41_fa20_ta0_fm14_tm6,g
3265@TOP@human_GAPDH_TAA_len41_fa20_ta0_fm14_tm6*123*t,3,12,6,50428,50449,0.0,123,3265@TOP@human_GAPDH_TAA_len41_fa20_ta0_fm14_tm6,t
3265@TOP@human_GAPDH_TAA_len41_fa20_ta0_fm14_tm6*124*a,47997,2,2236,0,50235,0.045,124,3265@TOP@human_GAPDH_TAA_len41_fa20_ta0_fm14_tm6,a
3265@TOP@human_GAPDH_TAA_len41_fa20_ta0_fm14_tm6*125*a,49403,9,824,3,50239,0.016,125,3265@TOP@human_GAPDH_TAA_len41_fa20_ta0_fm14_tm6,a
3265@TOP@human_GAPDH_TAA_len41_fa20_ta0_fm14_tm6*126*g,3,0,50595,1,50599,1.0,126,3265@TOP@human_GAPDH_TAA_len41_fa20_ta0_fm14_tm6,g
3265@TOP@human_GAPDH_TAA_len41_fa20_ta0_fm14_tm6*127*a,51009,6,29,1,51045,0.001,127,3265@TOP@human_GAPDH_TAA_len41_fa20_ta0_fm14_tm6,a
3265@TOP@human_GAPDH_TAA_len41_fa20_ta0_fm14_tm6*128*c,1,51291,3,0,51295,0.0,128,3265@TOP@human_GAPDH_TAA_len41_fa20_ta0_fm14_tm6,c
3265@TOP@human_GAPDH_TAA_len41_fa20_ta0_fm14_tm6*129*c,0,50936,1,1,50938,0.0,129,3265@TOP@human_GAPDH_TAA_len41_fa20_ta0_fm14_tm6,c
3265@TOP@human_GAPDH_TAA_len41_fa20_ta0_fm14_tm6*130*c,1,51233,0,2,51236,0.0,130,3265@TOP@human_GAPDH_TAA_len41_fa20_ta0_fm14_tm6,c
3265@TOP@human_GAPDH_TAA_len41_fa20_ta0_fm14_tm6*131*c,6,51331,0,2,51339,0.0,131,3265@TOP@human_GAPDH_TAA_len41_fa20_ta0_fm14_tm6,c
3265@TOP@human_GAPDH_TAA_len41_fa20_ta0_fm14_tm6*132*t,6,9,1,50590,50606,0.0,132,3265@TOP@human_GAPDH_TAA_len41_fa20_ta0_fm14_tm6,t
3265@TOP@human_GAPDH_TAA_len41_fa20_ta0_fm14_tm6*133*g,3,3,50528,1,50535,1.0,133,3265@TOP@human_GAPDH_TAA_len41_fa20_ta0_fm14_tm6,g
3265@TOP@human_GAPDH_TAA_len41_fa20_ta0_fm14_tm6*134*g,1,1,50781,3,50786,1.0,134,3265@TOP@human_GAPDH_TAA_len41_fa20_ta0_fm14_tm6,g
3266@TOP@human_GAPDH_TAA_len41_fa20_ta0_fm14_tm6*114*t,1,0,0,2319,2320,0.0,114,3266@TOP@human_GAPDH_TAA_len41_fa20_ta0_fm14_tm6,t
3266@TOP@human_GAPDH_TAA_len41_fa20_ta0_fm14_tm6*115*c,0,2331,0,0,2331,0.0,115,3266@TOP@human_GAPDH_TAA_len41_fa20_ta0_fm14_tm6,c
3266@TOP@human_GAPDH_TAA_len41_fa20_ta0_fm14_tm6*116*c,0,2325,0,0,2325,0.0,116,3266@TOP@human_GAPDH_TAA_len41_fa20_ta0_fm14_tm6,c
3266@TOP@human_GAPDH_TAA_len41_fa20_ta0_fm14_tm6*117*a,2327,0,1,0,2328,0.0,117,3266@TOP@human_GAPDH_TAA_len41_fa20_ta0_fm14_tm6,a
3266@TOP@human_GAPDH_TAA_len41_fa20_ta0_fm14_tm6*118*a,2247,0,60,0,2307,0.026,118,3266@TOP@human_GAPDH_TAA_len41_fa20_ta0_fm14_tm6,a
3266@TOP@human_GAPDH_TAA_len41_fa20_ta0_fm14_tm6*119*g,1,0,2284,1,2286,0.999,119,3266@TOP@human_GAPDH_TAA_len41_fa20_ta0_fm14_tm6,g
3266@TOP@human_GAPDH_TAA_len41_fa20_ta0_fm14_tm6*120*g,0,0,2278,0,2278,1.0,120,3266@TOP@human_GAPDH_TAA_len41_fa20_ta0_fm14_tm6,g
3266@TOP@human_GAPDH_TAA_len41_fa20_ta0_fm14_tm6*121*a,2319,0,3,0,2322,0.001,121,3266@TOP@human_GAPDH_TAA_len41_fa20_ta0_fm14_tm6,a
3266@TOP@human_GAPDH_TAA_len41_fa20_ta0_fm14_tm6*122*g,0,0,2319,0,2319,1.0,122,3266@TOP@human_GAPDH_TAA_len41_fa20_ta0_fm14_tm6,g
3266@TOP@human_GAPDH_TAA_len41_fa20_ta0_fm14_tm6*123*t,0,0,1,2274,2275,0.0,123,3266@TOP@human_GAPDH_TAA_len41_fa20_ta0_fm14_tm6,t
3266@TOP@human_GAPDH_TAA_len41_fa20_ta0_fm14_tm6*124*a,2099,0,185,0,2284,0.081,124,3266@TOP@human_GAPDH_TAA_len41_fa20_ta0_fm14_tm6,a
3266@TOP@human_GAPDH_TAA_len41_fa20_ta0_fm14_tm6*125*a,2162,0,97,0,2259,0.043,125,3266@TOP@human_GAPDH_TAA_len41_fa20_ta0_fm14_tm6,a
3266@TOP@human_GAPDH_TAA_len41_fa20_ta0_fm14_tm6*126*g,0,0,2284,0,2284,1.0,126,3266@TOP@human_GAPDH_TAA_len41_fa20_ta0_fm14_tm6,g
3266@TOP@human_GAPDH_TAA_len41_fa20_ta0_fm14_tm6*127*a,2305,0,4,0,2309,0.002,127,3266@TOP@human_GAPDH_TAA_len41_fa20_ta0_fm14_tm6,a
3266@TOP@human_GAPDH_TAA_len41_fa20_ta0_fm14_tm6*128*c,0,2326,0,0,2326,0.0,128,3266@TOP@human_GAPDH_TAA_len41_fa20_ta0_fm14_tm6,c
3266@TOP@human_GAPDH_TAA_len41_fa20_ta0_fm14_tm6*129*c,0,2299,0,0,2299,0.0,129,3266@TOP@human_GAPDH_TAA_len41_fa20_ta0_fm14_tm6,c
3266@TOP@human_GAPDH_TAA_len41_fa20_ta0_fm14_tm6*130*c,0,2308,0,0,2308,0.0,130,3266@TOP@human_GAPDH_TAA_len41_fa20_ta0_fm14_tm6,c
3266@TOP@human_GAPDH_TAA_len41_fa20_ta0_fm14_tm6*131*c,0,2322,0,0,2322,0.0,131,3266@TOP@human_GAPDH_TAA_len41_fa20_ta0_fm14_tm6,c
3266@TOP@human_GAPDH_TAA_len41_fa20_ta0_fm14_tm6*132*t,0,0,0,2290,2290,0.0,132,3266@TOP@human_GAPDH_TAA_len41_fa20_ta0_fm14_tm6,t
3266@TOP@human_GAPDH_TAA_len41_fa20_ta0_fm14_tm6*133*g,0,0,2286,0,2286,1.0,133,3266@TOP@human_GAPDH_TAA_len41_fa20_ta0_fm14_tm6,g
3266@TOP@human_GAPDH_TAA_len41_fa20_ta0_fm14_tm6*134*g,0,0,2277,1,2278,1.0,134,3266@TOP@human_GAPDH_TAA_len41_fa20_ta0_fm14_tm6,g
3267@TOP@human_GAPDH_TAA_len41_fa20_ta0_fm14_tm6*114*t,4,14,0,28394,28412,0.0,114,3267@TOP@human_GAPDH_TAA_len41_fa20_ta0_fm14_tm6,t
3267@TOP@human_GAPDH_TAA_len41_fa20_ta0_fm14_tm6*115*c,0,28552,1,0,28553,0.0,115,3267@TOP@human_GAPDH_TAA_len41_fa20_ta0_fm14_tm6,c
3267@TOP@human_GAPDH_TAA_len41_fa20_ta0_fm14_tm6*116*c,0,28438,0,3,28441,0.0,116,3267@TOP@human_GAPDH_TAA_len41_fa20_ta0_fm14_tm6,c
3267@TOP@human_GAPDH_TAA_len41_fa20_ta0_fm14_tm6*117*a,28407,1,40,2,28450,0.001,117,3267@TOP@human_GAPDH_TAA_len41_fa20_ta0_fm14_tm6,a
3267@TOP@human_GAPDH_TAA_len41_fa20_ta0_fm14_tm6*118*a,27973,0,295,0,28268,0.01,118,3267@TOP@human_GAPDH_TAA_len41_fa20_ta0_fm14_tm6,a
3267@TOP@human_GAPDH_TAA_len41_fa20_ta0_fm14_tm6*119*g,1,0,28222,1,28224,1.0,119,3267@TOP@human_GAPDH_TAA_len41_fa20_ta0_fm14_tm6,g
3267@TOP@human_GAPDH_TAA_len41_fa20_ta0_fm14_tm6*120*g,3,0,28154,1,28158,1.0,120,3267@TOP@human_GAPDH_TAA_len41_fa20_ta0_fm14_tm6,g
3267@TOP@human_GAPDH_TAA_len41_fa20_ta0_fm14_tm6*121*a,28401,0,6,1,28408,0.0,121,3267@TOP@human_GAPDH_TAA_len41_fa20_ta0_fm14_tm6,a
3267@TOP@human_GAPDH_TAA_len41_fa20_ta0_fm14_tm6*122*g,0,1,28434,0,28435,1.0,122,3267@TOP@human_GAPDH_TAA_len41_fa20_ta0_fm14_tm6,g
3267@TOP@human_GAPDH_TAA_len41_fa20_ta0_fm14_tm6*123*t,3,1,0,28045,28049,0.0,123,3267@TOP@human_GAPDH_TAA_len41_fa20_ta0_fm14_tm6,t
3267@TOP@human_GAPDH_TAA_len41_fa20_ta0_fm14_tm6*124*a,27279,0,689,0,27968,0.025,124,3267@TOP@human_GAPDH_TAA_len41_fa20_ta0_fm14_tm6,a
3267@TOP@human_GAPDH_TAA_len41_fa20_ta0_fm14_tm6*125*a,27501,4,389,8,27902,0.014,125,3267@TOP@human_GAPDH_TAA_len41_fa20_ta0_fm14_tm6,a
3267@TOP@human_GAPDH_TAA_len41_fa20_ta0_fm14_tm6*126*g,1,0,28063,1,28065,1.0,126,3267@TOP@human_GAPDH_TAA_len41_fa20_ta0_fm14_tm6,g
3267@TOP@human_GAPDH_TAA_len41_fa20_ta0_fm14_tm6*127*a,28308,3,19,1,28331,0.001,127,3267@TOP@human_GAPDH_TAA_len41_fa20_ta0_fm14_tm6,a
3267@TOP@human_GAPDH_TAA_len41_fa20_ta0_fm14_tm6*128*c,2,28480,1,2,28485,0.0,128,3267@TOP@human_GAPDH_TAA_len41_fa20_ta0_fm14_tm6,c
3267@TOP@human_GAPDH_TAA_len41_fa20_ta0_fm14_tm6*129*c,0,28291,0,0,28291,0.0,129,3267@TOP@human_GAPDH_TAA_len41_fa20_ta0_fm14_tm6,c
3267@TOP@human_GAPDH_TAA_len41_fa20_ta0_fm14_tm6*130*c,3,28421,0,0,28424,0.0,130,3267@TOP@human_GAPDH_TAA_len41_fa20_ta0_fm14_tm6,c
3267@TOP@human_GAPDH_TAA_len41_fa20_ta0_fm14_tm6*131*c,4,28493,0,1,28498,0.0,131,3267@TOP@human_GAPDH_TAA_len41_fa20_ta0_fm14_tm6,c
3267@TOP@human_GAPDH_TAA_len41_fa20_ta0_fm14_tm6*132*t,3,8,3,28068,28082,0.0,132,3267@TOP@human_GAPDH_TAA_len41_fa20_ta0_fm14_tm6,t
3267@TOP@human_GAPDH_TAA_len41_fa20_ta0_fm14_tm6*133*g,2,3,28074,5,28084,1.0,133,3267@TOP@human_GAPDH_TAA_len41_fa20_ta0_fm14_tm6,g
3267@TOP@human_GAPDH_TAA_len41_fa20_ta0_fm14_tm6*134*g,6,6,28215,4,28231,0.999,134,3267@TOP@human_GAPDH_TAA_len41_fa20_ta0_fm14_tm6,g
3268@TOP@human_GAPDH_TAA_len41_fa20_ta0_fm14_tm6*114*t,4,7,0,28410,28421,0.0,114,3268@TOP@human_GAPDH_TAA_len41_fa20_ta0_fm14_tm6,t
3268@TOP@human_GAPDH_TAA_len41_fa20_ta0_fm14_tm6*115*c,0,28580,0,3,28583,0.0,115,3268@TOP@human_GAPDH_TAA_len41_fa20_ta0_fm14_tm6,c
3268@TOP@human_GAPDH_TAA_len41_fa20_ta0_fm14_tm6*116*c,3,28447,0,1,28451,0.0,116,3268@TOP@human_GAPDH_TAA_len41_fa20_ta0_fm14_tm6,c
3268@TOP@human_GAPDH_TAA_len41_fa20_ta0_fm14_tm6*117*a,28403,1,29,1,28434,0.001,117,3268@TOP@human_GAPDH_TAA_len41_fa20_ta0_fm14_tm6,a
3268@TOP@human_GAPDH_TAA_len41_fa20_ta0_fm14_tm6*118*a,27988,0,295,2,28285,0.01,118,3268@TOP@human_GAPDH_TAA_len41_fa20_ta0_fm14_tm6,a
3268@TOP@human_GAPDH_TAA_len41_fa20_ta0_fm14_tm6*119*g,1,2,28258,1,28262,1.0,119,3268@TOP@human_GAPDH_TAA_len41_fa20_ta0_fm14_tm6,g
3268@TOP@human_GAPDH_TAA_len41_fa20_ta0_fm14_tm6*120*g,0,1,28130,0,28131,1.0,120,3268@TOP@human_GAPDH_TAA_len41_fa20_ta0_fm14_tm6,g
3268@TOP@human_GAPDH_TAA_len41_fa20_ta0_fm14_tm6*121*a,28409,1,7,0,28417,0.0,121,3268@TOP@human_GAPDH_TAA_len41_fa20_ta0_fm14_tm6,a
3268@TOP@human_GAPDH_TAA_len41_fa20_ta0_fm14_tm6*122*g,1,0,28479,0,28480,1.0,122,3268@TOP@human_GAPDH_TAA_len41_fa20_ta0_fm14_tm6,g
3268@TOP@human_GAPDH_TAA_len41_fa20_ta0_fm14_tm6*123*t,2,0,2,28032,28036,0.0,123,3268@TOP@human_GAPDH_TAA_len41_fa20_ta0_fm14_tm6,t
3268@TOP@human_GAPDH_TAA_len41_fa20_ta0_fm14_tm6*124*a,27110,1,803,1,27915,0.029,124,3268@TOP@human_GAPDH_TAA_len41_fa20_ta0_fm14_tm6,a
3268@TOP@human_GAPDH_TAA_len41_fa20_ta0_fm14_tm6*125*a,27443,1,428,0,27872,0.015,125,3268@TOP@human_GAPDH_TAA_len41_fa20_ta0_fm14_tm6,a
3268@TOP@human_GAPDH_TAA_len41_fa20_ta0_fm14_tm6*126*g,2,0,28049,0,28051,1.0,126,3268@TOP@human_GAPDH_TAA_len41_fa20_ta0_fm14_tm6,g
3268@TOP@human_GAPDH_TAA_len41_fa20_ta0_fm14_tm6*127*a,28340,2,22,0,28364,0.001,127,3268@TOP@human_GAPDH_TAA_len41_fa20_ta0_fm14_tm6,a
3268@TOP@human_GAPDH_TAA_len41_fa20_ta0_fm14_tm6*128*c,0,28519,0,0,28519,0.0,128,3268@TOP@human_GAPDH_TAA_len41_fa20_ta0_fm14_tm6,c
3268@TOP@human_GAPDH_TAA_len41_fa20_ta0_fm14_tm6*129*c,1,28328,1,2,28332,0.0,129,3268@TOP@human_GAPDH_TAA_len41_fa20_ta0_fm14_tm6,c
3268@TOP@human_GAPDH_TAA_len41_fa20_ta0_fm14_tm6*130*c,0,28456,0,0,28456,0.0,130,3268@TOP@human_GAPDH_TAA_len41_fa20_ta0_fm14_tm6,c
3268@TOP@human_GAPDH_TAA_len41_fa20_ta0_fm14_tm6*131*c,1,28543,1,1,28546,0.0,131,3268@TOP@human_GAPDH_TAA_len41_fa20_ta0_fm14_tm6,c
3268@TOP@human_GAPDH_TAA_len41_fa20_ta0_fm14_tm6*132*t,0,4,3,28120,28127,0.0,132,3268@TOP@human_GAPDH_TAA_len41_fa20_ta0_fm14_tm6,t
3268@TOP@human_GAPDH_TAA_len41_fa20_ta0_fm14_tm6*133*g,1,1,28057,3,28062,1.0,133,3268@TOP@human_GAPDH_TAA_len41_fa20_ta0_fm14_tm6,g
3268@TOP@human_GAPDH_TAA_len41_fa20_ta0_fm14_tm6*134*g,3,1,28228,4,28236,1.0,134,3268@TOP@human_GAPDH_TAA_len41_fa20_ta0_fm14_tm6,g
3269@TOP@human_GAPDH_TAA_len41_fa20_ta0_fm14_tm6*114*t,3,8,0,10605,10616,0.0,114,3269@TOP@human_GAPDH_TAA_len41_fa20_ta0_fm14_tm6,t
3269@TOP@human_GAPDH_TAA_len41_fa20_ta0_fm14_tm6*115*c,0,10671,0,1,10672,0.0,115,3269@TOP@human_GAPDH_TAA_len41_fa20_ta0_fm14_tm6,c
3269@TOP@human_GAPDH_TAA_len41_fa20_ta0_fm14_tm6*116*c,0,10643,0,0,10643,0.0,116,3269@TOP@human_GAPDH_TAA_len41_fa20_ta0_fm14_tm6,c
3269@TOP@human_GAPDH_TAA_len41_fa20_ta0_fm14_tm6*117*a,10626,0,8,1,10635,0.001,117,3269@TOP@human_GAPDH_TAA_len41_fa20_ta0_fm14_tm6,a
3269@TOP@human_GAPDH_TAA_len41_fa20_ta0_fm14_tm6*118*a,10428,0,142,0,10570,0.013,118,3269@TOP@human_GAPDH_TAA_len41_fa20_ta0_fm14_tm6,a
3269@TOP@human_GAPDH_TAA_len41_fa20_ta0_fm14_tm6*119*g,5,0,10528,0,10533,1.0,119,3269@TOP@human_GAPDH_TAA_len41_fa20_ta0_fm14_tm6,g
3269@TOP@human_GAPDH_TAA_len41_fa20_ta0_fm14_tm6*120*g,1,1,10525,0,10527,1.0,120,3269@TOP@human_GAPDH_TAA_len41_fa20_ta0_fm14_tm6,g
3269@TOP@human_GAPDH_TAA_len41_fa20_ta0_fm14_tm6*121*a,10605,0,9,0,10614,0.001,121,3269@TOP@human_GAPDH_TAA_len41_fa20_ta0_fm14_tm6,a
3269@TOP@human_GAPDH_TAA_len41_fa20_ta0_fm14_tm6*122*g,0,0,10629,0,10629,1.0,122,3269@TOP@human_GAPDH_TAA_len41_fa20_ta0_fm14_tm6,g
3269@TOP@human_GAPDH_TAA_len41_fa20_ta0_fm14_tm6*123*t,1,0,1,10498,10500,0.0,123,3269@TOP@human_GAPDH_TAA_len41_fa20_ta0_fm14_tm6,t
3269@TOP@human_GAPDH_TAA_len41_fa20_ta0_fm14_tm6*124*a,9999,0,469,0,10468,0.045,124,3269@TOP@human_GAPDH_TAA_len41_fa20_ta0_fm14_tm6,a
3269@TOP@human_GAPDH_TAA_len41_fa20_ta0_fm14_tm6*125*a,10053,0,401,0,10454,0.038,125,3269@TOP@human_GAPDH_TAA_len41_fa20_ta0_fm14_tm6,a
3269@TOP@human_GAPDH_TAA_len41_fa20_ta0_fm14_tm6*126*g,0,0,10491,1,10492,1.0,126,3269@TOP@human_GAPDH_TAA_len41_fa20_ta0_fm14_tm6,g
3269@TOP@human_GAPDH_TAA_len41_fa20_ta0_fm14_tm6*127*a,10593,1,12,0,10606,0.001,127,3269@TOP@human_GAPDH_TAA_len41_fa20_ta0_fm14_tm6,a
3269@TOP@human_GAPDH_TAA_len41_fa20_ta0_fm14_tm6*128*c,1,10649,1,0,10651,0.0,128,3269@TOP@human_GAPDH_TAA_len41_fa20_ta0_fm14_tm6,c
3269@TOP@human_GAPDH_TAA_len41_fa20_ta0_fm14_tm6*129*c,1,10560,0,0,10561,0.0,129,3269@TOP@human_GAPDH_TAA_len41_fa20_ta0_fm14_tm6,c
3269@TOP@human_GAPDH_TAA_len41_fa20_ta0_fm14_tm6*130*c,2,10624,0,2,10628,0.0,130,3269@TOP@human_GAPDH_TAA_len41_fa20_ta0_fm14_tm6,c
3269@TOP@human_GAPDH_TAA_len41_fa20_ta0_fm14_tm6*131*c,1,10653,0,0,10654,0.0,131,3269@TOP@human_GAPDH_TAA_len41_fa20_ta0_fm14_tm6,c
3269@TOP@human_GAPDH_TAA_len41_fa20_ta0_fm14_tm6*132*t,1,0,1,10511,10513,0.0,132,3269@TOP@human_GAPDH_TAA_len41_fa20_ta0_fm14_tm6,t
3269@TOP@human_GAPDH_TAA_len41_fa20_ta0_fm14_tm6*133*g,1,0,10491,0,10492,1.0,133,3269@TOP@human_GAPDH_TAA_len41_fa20_ta0_fm14_tm6,g
3269@TOP@human_GAPDH_TAA_len41_fa20_ta0_fm14_tm6*134*g,1,1,10544,0,10546,1.0,134,3269@TOP@human_GAPDH_TAA_len41_fa20_ta0_fm14_tm6,g
3270@TOP@human_GAPDH_TAA_len41_fa20_ta0_fm14_tm6*114*t,4,4,0,26352,26360,0.0,114,3270@TOP@human_GAPDH_TAA_len41_fa20_ta0_fm14_tm6,t
3270@TOP@human_GAPDH_TAA_len41_fa20_ta0_fm14_tm6*115*c,3,26494,0,0,26497,0.0,115,3270@TOP@human_GAPDH_TAA_len41_fa20_ta0_fm14_tm6,c
3270@TOP@human_GAPDH_TAA_len41_fa20_ta0_fm14_tm6*116*c,1,26396,0,3,26400,0.0,116,3270@TOP@human_GAPDH_TAA_len41_fa20_ta0_fm14_tm6,c
3270@TOP@human_GAPDH_TAA_len41_fa20_ta0_fm14_tm6*117*a,26356,0,34,0,26390,0.001,117,3270@TOP@human_GAPDH_TAA_len41_fa20_ta0_fm14_tm6,a
3270@TOP@human_GAPDH_TAA_len41_fa20_ta0_fm14_tm6*118*a,25954,0,292,0,26246,0.011,118,3270@TOP@human_GAPDH_TAA_len41_fa20_ta0_fm14_tm6,a
3270@TOP@human_GAPDH_TAA_len41_fa20_ta0_fm14_tm6*119*g,0,0,26223,1,26224,1.0,119,3270@TOP@human_GAPDH_TAA_len41_fa20_ta0_fm14_tm6,g
3270@TOP@human_GAPDH_TAA_len41_fa20_ta0_fm14_tm6*120*g,5,0,26118,0,26123,1.0,120,3270@TOP@human_GAPDH_TAA_len41_fa20_ta0_fm14_tm6,g
3270@TOP@human_GAPDH_TAA_len41_fa20_ta0_fm14_tm6*121*a,26339,0,16,1,26356,0.001,121,3270@TOP@human_GAPDH_TAA_len41_fa20_ta0_fm14_tm6,a
3270@TOP@human_GAPDH_TAA_len41_fa20_ta0_fm14_tm6*122*g,0,0,26383,0,26383,1.0,122,3270@TOP@human_GAPDH_TAA_len41_fa20_ta0_fm14_tm6,g
3270@TOP@human_GAPDH_TAA_len41_fa20_ta0_fm14_tm6*123*t,1,1,6,26044,26052,0.0,123,3270@TOP@human_GAPDH_TAA_len41_fa20_ta0_fm14_tm6,t
3270@TOP@human_GAPDH_TAA_len41_fa20_ta0_fm14_tm6*124*a,24241,0,1707,0,25948,0.066,124,3270@TOP@human_GAPDH_TAA_len41_fa20_ta0_fm14_tm6,a
3270@TOP@human_GAPDH_TAA_len41_fa20_ta0_fm14_tm6*125*a,25424,1,515,1,25941,0.02,125,3270@TOP@human_GAPDH_TAA_len41_fa20_ta0_fm14_tm6,a
3270@TOP@human_GAPDH_TAA_len41_fa20_ta0_fm14_tm6*126*g,1,0,26054,2,26057,1.0,126,3270@TOP@human_GAPDH_TAA_len41_fa20_ta0_fm14_tm6,g
3270@TOP@human_GAPDH_TAA_len41_fa20_ta0_fm14_tm6*127*a,26250,0,20,1,26271,0.001,127,3270@TOP@human_GAPDH_TAA_len41_fa20_ta0_fm14_tm6,a
3270@TOP@human_GAPDH_TAA_len41_fa20_ta0_fm14_tm6*128*c,0,26423,1,0,26424,0.0,128,3270@TOP@human_GAPDH_TAA_len41_fa20_ta0_fm14_tm6,c
3270@TOP@human_GAPDH_TAA_len41_fa20_ta0_fm14_tm6*129*c,0,26259,0,0,26259,0.0,129,3270@TOP@human_GAPDH_TAA_len41_fa20_ta0_fm14_tm6,c
3270@TOP@human_GAPDH_TAA_len41_fa20_ta0_fm14_tm6*130*c,1,26408,1,0,26410,0.0,130,3270@TOP@human_GAPDH_TAA_len41_fa20_ta0_fm14_tm6,c
3270@TOP@human_GAPDH_TAA_len41_fa20_ta0_fm14_tm6*131*c,1,26455,0,0,26456,0.0,131,3270@TOP@human_GAPDH_TAA_len41_fa20_ta0_fm14_tm6,c
3270@TOP@human_GAPDH_TAA_len41_fa20_ta0_fm14_tm6*132*t,4,10,3,26055,26072,0.0,132,3270@TOP@human_GAPDH_TAA_len41_fa20_ta0_fm14_tm6,t
3270@TOP@human_GAPDH_TAA_len41_fa20_ta0_fm14_tm6*133*g,2,1,26005,3,26011,1.0,133,3270@TOP@human_GAPDH_TAA_len41_fa20_ta0_fm14_tm6,g
3270@TOP@human_GAPDH_TAA_len41_fa20_ta0_fm14_tm6*134*g,0,0,26163,3,26166,1.0,134,3270@TOP@human_GAPDH_TAA_len41_fa20_ta0_fm14_tm6,g
3271@TOP@human_GAPDH_TAA_len41_fa20_ta0_fm14_tm6*114*t,1,1,0,7198,7200,0.0,114,3271@TOP@human_GAPDH_TAA_len41_fa20_ta0_fm14_tm6,t
3271@TOP@human_GAPDH_TAA_len41_fa20_ta0_fm14_tm6*115*c,0,7250,0,0,7250,0.0,115,3271@TOP@human_GAPDH_TAA_len41_fa20_ta0_fm14_tm6,c
3271@TOP@human_GAPDH_TAA_len41_fa20_ta0_fm14_tm6*116*c,0,7214,0,1,7215,0.0,116,3271@TOP@human_GAPDH_TAA_len41_fa20_ta0_fm14_tm6,c
3271@TOP@human_GAPDH_TAA_len41_fa20_ta0_fm14_tm6*117*a,7202,0,10,0,7212,0.001,117,3271@TOP@human_GAPDH_TAA_len41_fa20_ta0_fm14_tm6,a
3271@TOP@human_GAPDH_TAA_len41_fa20_ta0_fm14_tm6*118*a,7084,0,88,1,7173,0.012,118,3271@TOP@human_GAPDH_TAA_len41_fa20_ta0_fm14_tm6,a
3271@TOP@human_GAPDH_TAA_len41_fa20_ta0_fm14_tm6*119*g,0,0,7167,0,7167,1.0,119,3271@TOP@human_GAPDH_TAA_len41_fa20_ta0_fm14_tm6,g
3271@TOP@human_GAPDH_TAA_len41_fa20_ta0_fm14_tm6*120*g,2,0,7124,1,7127,1.0,120,3271@TOP@human_GAPDH_TAA_len41_fa20_ta0_fm14_tm6,g
3271@TOP@human_GAPDH_TAA_len41_fa20_ta0_fm14_tm6*121*a,7192,0,3,0,7195,0.0,121,3271@TOP@human_GAPDH_TAA_len41_fa20_ta0_fm14_tm6,a
3271@TOP@human_GAPDH_TAA_len41_fa20_ta0_fm14_tm6*122*g,3,0,7220,0,7223,1.0,122,3271@TOP@human_GAPDH_TAA_len41_fa20_ta0_fm14_tm6,g
3271@TOP@human_GAPDH_TAA_len41_fa20_ta0_fm14_tm6*123*t,0,0,1,7121,7122,0.0,123,3271@TOP@human_GAPDH_TAA_len41_fa20_ta0_fm14_tm6,t
3271@TOP@human_GAPDH_TAA_len41_fa20_ta0_fm14_tm6*124*a,6867,1,233,1,7102,0.033,124,3271@TOP@human_GAPDH_TAA_len41_fa20_ta0_fm14_tm6,a
3271@TOP@human_GAPDH_TAA_len41_fa20_ta0_fm14_tm6*125*a,6767,0,314,3,7084,0.044,125,3271@TOP@human_GAPDH_TAA_len41_fa20_ta0_fm14_tm6,a
3271@TOP@human_GAPDH_TAA_len41_fa20_ta0_fm14_tm6*126*g,0,0,7113,0,7113,1.0,126,3271@TOP@human_GAPDH_TAA_len41_fa20_ta0_fm14_tm6,g
3271@TOP@human_GAPDH_TAA_len41_fa20_ta0_fm14_tm6*127*a,7179,0,7,0,7186,0.001,127,3271@TOP@human_GAPDH_TAA_len41_fa20_ta0_fm14_tm6,a
3271@TOP@human_GAPDH_TAA_len41_fa20_ta0_fm14_tm6*128*c,0,7241,0,0,7241,0.0,128,3271@TOP@human_GAPDH_TAA_len41_fa20_ta0_fm14_tm6,c
3271@TOP@human_GAPDH_TAA_len41_fa20_ta0_fm14_tm6*129*c,1,7161,0,0,7162,0.0,129,3271@TOP@human_GAPDH_TAA_len41_fa20_ta0_fm14_tm6,c
3271@TOP@human_GAPDH_TAA_len41_fa20_ta0_fm14_tm6*130*c,0,7217,0,0,7217,0.0,130,3271@TOP@human_GAPDH_TAA_len41_fa20_ta0_fm14_tm6,c
3271@TOP@human_GAPDH_TAA_len41_fa20_ta0_fm14_tm6*131*c,0,7237,0,0,7237,0.0,131,3271@TOP@human_GAPDH_TAA_len41_fa20_ta0_fm14_tm6,c
3271@TOP@human_GAPDH_TAA_len41_fa20_ta0_fm14_tm6*132*t,0,0,0,7142,7142,0.0,132,3271@TOP@human_GAPDH_TAA_len41_fa20_ta0_fm14_tm6,t
3271@TOP@human_GAPDH_TAA_len41_fa20_ta0_fm14_tm6*133*g,2,0,7075,0,7077,1.0,133,3271@TOP@human_GAPDH_TAA_len41_fa20_ta0_fm14_tm6,g
3271@TOP@human_GAPDH_TAA_len41_fa20_ta0_fm14_tm6*134*g,0,0,7138,0,7138,1.0,134,3271@TOP@human_GAPDH_TAA_len41_fa20_ta0_fm14_tm6,g
3272@TOP@human_GAPDH_TAA_len41_fa20_ta0_fm14_tm6*114*t,0,2,0,11730,11732,0.0,114,3272@TOP@human_GAPDH_TAA_len41_fa20_ta0_fm14_tm6,t
3272@TOP@human_GAPDH_TAA_len41_fa20_ta0_fm14_tm6*115*c,1,11801,0,0,11802,0.0,115,3272@TOP@human_GAPDH_TAA_len41_fa20_ta0_fm14_tm6,c
3272@TOP@human_GAPDH_TAA_len41_fa20_ta0_fm14_tm6*116*c,0,11767,0,1,11768,0.0,116,3272@TOP@human_GAPDH_TAA_len41_fa20_ta0_fm14_tm6,c
3272@TOP@human_GAPDH_TAA_len41_fa20_ta0_fm14_tm6*117*a,11733,0,25,0,11758,0.002,117,3272@TOP@human_GAPDH_TAA_len41_fa20_ta0_fm14_tm6,a
3272@TOP@human_GAPDH_TAA_len41_fa20_ta0_fm14_tm6*118*a,11492,0,189,0,11681,0.016,118,3272@TOP@human_GAPDH_TAA_len41_fa20_ta0_fm14_tm6,a
3272@TOP@human_GAPDH_TAA_len41_fa20_ta0_fm14_tm6*119*g,0,0,11669,0,11669,1.0,119,3272@TOP@human_GAPDH_TAA_len41_fa20_ta0_fm14_tm6,g
3272@TOP@human_GAPDH_TAA_len41_fa20_ta0_fm14_tm6*120*g,0,0,11617,0,11617,1.0,120,3272@TOP@human_GAPDH_TAA_len41_fa20_ta0_fm14_tm6,g
3272@TOP@human_GAPDH_TAA_len41_fa20_ta0_fm14_tm6*121*a,11743,0,1,0,11744,0.0,121,3272@TOP@human_GAPDH_TAA_len41_fa20_ta0_fm14_tm6,a
3272@TOP@human_GAPDH_TAA_len41_fa20_ta0_fm14_tm6*122*g,0,0,11742,0,11742,1.0,122,3272@TOP@human_GAPDH_TAA_len41_fa20_ta0_fm14_tm6,g
3272@TOP@human_GAPDH_TAA_len41_fa20_ta0_fm14_tm6*123*t,0,2,1,11600,11603,0.0,123,3272@TOP@human_GAPDH_TAA_len41_fa20_ta0_fm14_tm6,t
3272@TOP@human_GAPDH_TAA_len41_fa20_ta0_fm14_tm6*124*a,10706,1,829,0,11536,0.072,124,3272@TOP@human_GAPDH_TAA_len41_fa20_ta0_fm14_tm6,a
3272@TOP@human_GAPDH_TAA_len41_fa20_ta0_fm14_tm6*125*a,11251,0,324,1,11576,0.028,125,3272@TOP@human_GAPDH_TAA_len41_fa20_ta0_fm14_tm6,a
3272@TOP@human_GAPDH_TAA_len41_fa20_ta0_fm14_tm6*126*g,0,0,11627,0,11627,1.0,126,3272@TOP@human_GAPDH_TAA_len41_fa20_ta0_fm14_tm6,g
3272@TOP@human_GAPDH_TAA_len41_fa20_ta0_fm14_tm6*127*a,11698,1,11,0,11710,0.001,127,3272@TOP@human_GAPDH_TAA_len41_fa20_ta0_fm14_tm6,a
3272@TOP@human_GAPDH_TAA_len41_fa20_ta0_fm14_tm6*128*c,0,11778,1,1,11780,0.0,128,3272@TOP@human_GAPDH_TAA_len41_fa20_ta0_fm14_tm6,c
3272@TOP@human_GAPDH_TAA_len41_fa20_ta0_fm14_tm6*129*c,2,11681,0,0,11683,0.0,129,3272@TOP@human_GAPDH_TAA_len41_fa20_ta0_fm14_tm6,c
3272@TOP@human_GAPDH_TAA_len41_fa20_ta0_fm14_tm6*130*c,1,11747,0,1,11749,0.0,130,3272@TOP@human_GAPDH_TAA_len41_fa20_ta0_fm14_tm6,c
3272@TOP@human_GAPDH_TAA_len41_fa20_ta0_fm14_tm6*131*c,0,11786,0,0,11786,0.0,131,3272@TOP@human_GAPDH_TAA_len41_fa20_ta0_fm14_tm6,c
3272@TOP@human_GAPDH_TAA_len41_fa20_ta0_fm14_tm6*132*t,4,4,0,11600,11608,0.0,132,3272@TOP@human_GAPDH_TAA_len41_fa20_ta0_fm14_tm6,t
3272@TOP@human_GAPDH_TAA_len41_fa20_ta0_fm14_tm6*133*g,2,0,11572,0,11574,1.0,133,3272@TOP@human_GAPDH_TAA_len41_fa20_ta0_fm14_tm6,g
3272@TOP@human_GAPDH_TAA_len41_fa20_ta0_fm14_tm6*134*g,0,1,11670,0,11671,1.0,134,3272@TOP@human_GAPDH_TAA_len41_fa20_ta0_fm14_tm6,g
3273@TOP@human_GAPDH_TAA_len41_fa20_ta0_fm14_tm6*114*t,0,1,0,3070,3071,0.0,114,3273@TOP@human_GAPDH_TAA_len41_fa20_ta0_fm14_tm6,t
3273@TOP@human_GAPDH_TAA_len41_fa20_ta0_fm14_tm6*115*c,0,3094,0,0,3094,0.0,115,3273@TOP@human_GAPDH_TAA_len41_fa20_ta0_fm14_tm6,c
3273@TOP@human_GAPDH_TAA_len41_fa20_ta0_fm14_tm6*116*c,0,3079,0,0,3079,0.0,116,3273@TOP@human_GAPDH_TAA_len41_fa20_ta0_fm14_tm6,c
3273@TOP@human_GAPDH_TAA_len41_fa20_ta0_fm14_tm6*117*a,3056,0,21,0,3077,0.007,117,3273@TOP@human_GAPDH_TAA_len41_fa20_ta0_fm14_tm6,a
3273@TOP@human_GAPDH_TAA_len41_fa20_ta0_fm14_tm6*118*a,2993,0,60,0,3053,0.02,118,3273@TOP@human_GAPDH_TAA_len41_fa20_ta0_fm14_tm6,a
3273@TOP@human_GAPDH_TAA_len41_fa20_ta0_fm14_tm6*119*g,0,0,3057,0,3057,1.0,119,3273@TOP@human_GAPDH_TAA_len41_fa20_ta0_fm14_tm6,g
3273@TOP@human_GAPDH_TAA_len41_fa20_ta0_fm14_tm6*120*g,0,0,3052,0,3052,1.0,120,3273@TOP@human_GAPDH_TAA_len41_fa20_ta0_fm14_tm6,g
3273@TOP@human_GAPDH_TAA_len41_fa20_ta0_fm14_tm6*121*a,3074,0,2,0,3076,0.001,121,3273@TOP@human_GAPDH_TAA_len41_fa20_ta0_fm14_tm6,a
3273@TOP@human_GAPDH_TAA_len41_fa20_ta0_fm14_tm6*122*g,0,0,3075,0,3075,1.0,122,3273@TOP@human_GAPDH_TAA_len41_fa20_ta0_fm14_tm6,g
3273@TOP@human_GAPDH_TAA_len41_fa20_ta0_fm14_tm6*123*t,0,0,0,3023,3023,0.0,123,3273@TOP@human_GAPDH_TAA_len41_fa20_ta0_fm14_tm6,t
3273@TOP@human_GAPDH_TAA_len41_fa20_ta0_fm14_tm6*124*a,2830,0,196,0,3026,0.065,124,3273@TOP@human_GAPDH_TAA_len41_fa20_ta0_fm14_tm6,a
3273@TOP@human_GAPDH_TAA_len41_fa20_ta0_fm14_tm6*125*a,2933,0,81,0,3014,0.027,125,3273@TOP@human_GAPDH_TAA_len41_fa20_ta0_fm14_tm6,a
3273@TOP@human_GAPDH_TAA_len41_fa20_ta0_fm14_tm6*126*g,0,0,3039,0,3039,1.0,126,3273@TOP@human_GAPDH_TAA_len41_fa20_ta0_fm14_tm6,g
3273@TOP@human_GAPDH_TAA_len41_fa20_ta0_fm14_tm6*127*a,3069,0,2,0,3071,0.001,127,3273@TOP@human_GAPDH_TAA_len41_fa20_ta0_fm14_tm6,a
3273@TOP@human_GAPDH_TAA_len41_fa20_ta0_fm14_tm6*128*c,0,3080,1,0,3081,0.0,128,3273@TOP@human_GAPDH_TAA_len41_fa20_ta0_fm14_tm6,c
3273@TOP@human_GAPDH_TAA_len41_fa20_ta0_fm14_tm6*129*c,0,3061,0,0,3061,0.0,129,3273@TOP@human_GAPDH_TAA_len41_fa20_ta0_fm14_tm6,c
3273@TOP@human_GAPDH_TAA_len41_fa20_ta0_fm14_tm6*130*c,2,3082,0,0,3084,0.0,130,3273@TOP@human_GAPDH_TAA_len41_fa20_ta0_fm14_tm6,c
3273@TOP@human_GAPDH_TAA_len41_fa20_ta0_fm14_tm6*131*c,0,3088,0,0,3088,0.0,131,3273@TOP@human_GAPDH_TAA_len41_fa20_ta0_fm14_tm6,c
3273@TOP@human_GAPDH_TAA_len41_fa20_ta0_fm14_tm6*132*t,1,0,0,3045,3046,0.0,132,3273@TOP@human_GAPDH_TAA_len41_fa20_ta0_fm14_tm6,t
3273@TOP@human_GAPDH_TAA_len41_fa20_ta0_fm14_tm6*133*g,0,0,3034,0,3034,1.0,133,3273@TOP@human_GAPDH_TAA_len41_fa20_ta0_fm14_tm6,g
3273@TOP@human_GAPDH_TAA_len41_fa20_ta0_fm14_tm6*134*g,0,0,3054,0,3054,1.0,134,3273@TOP@human_GAPDH_TAA_len41_fa20_ta0_fm14_tm6,g
3274@TOP@human_GAPDH_TAA_len41_fa20_ta0_fm14_tm6*114*t,0,5,0,12814,12819,0.0,114,3274@TOP@human_GAPDH_TAA_len41_fa20_ta0_fm14_tm6,t
3274@TOP@human_GAPDH_TAA_len41_fa20_ta0_fm14_tm6*115*c,0,12901,0,0,12901,0.0,115,3274@TOP@human_GAPDH_TAA_len41_fa20_ta0_fm14_tm6,c
3274@TOP@human_GAPDH_TAA_len41_fa20_ta0_fm14_tm6*116*c,0,12855,0,2,12857,0.0,116,3274@TOP@human_GAPDH_TAA_len41_fa20_ta0_fm14_tm6,c
3274@TOP@human_GAPDH_TAA_len41_fa20_ta0_fm14_tm6*117*a,12837,1,15,0,12853,0.001,117,3274@TOP@human_GAPDH_TAA_len41_fa20_ta0_fm14_tm6,a
3274@TOP@human_GAPDH_TAA_len41_fa20_ta0_fm14_tm6*118*a,12609,0,165,3,12777,0.013,118,3274@TOP@human_GAPDH_TAA_len41_fa20_ta0_fm14_tm6,a
3274@TOP@human_GAPDH_TAA_len41_fa20_ta0_fm14_tm6*119*g,0,0,12751,1,12752,1.0,119,3274@TOP@human_GAPDH_TAA_len41_fa20_ta0_fm14_tm6,g
3274@TOP@human_GAPDH_TAA_len41_fa20_ta0_fm14_tm6*120*g,1,0,12699,0,12700,1.0,120,3274@TOP@human_GAPDH_TAA_len41_fa20_ta0_fm14_tm6,g
3274@TOP@human_GAPDH_TAA_len41_fa20_ta0_fm14_tm6*121*a,12855,1,4,0,12860,0.0,121,3274@TOP@human_GAPDH_TAA_len41_fa20_ta0_fm14_tm6,a
3274@TOP@human_GAPDH_TAA_len41_fa20_ta0_fm14_tm6*122*g,0,0,12852,0,12852,1.0,122,3274@TOP@human_GAPDH_TAA_len41_fa20_ta0_fm14_tm6,g
3274@TOP@human_GAPDH_TAA_len41_fa20_ta0_fm14_tm6*123*t,1,2,0,12674,12677,0.0,123,3274@TOP@human_GAPDH_TAA_len41_fa20_ta0_fm14_tm6,t
3274@TOP@human_GAPDH_TAA_len41_fa20_ta0_fm14_tm6*124*a,12289,3,350,0,12642,0.028,124,3274@TOP@human_GAPDH_TAA_len41_fa20_ta0_fm14_tm6,a
3274@TOP@human_GAPDH_TAA_len41_fa20_ta0_fm14_tm6*125*a,12404,3,215,0,12622,0.017,125,3274@TOP@human_GAPDH_TAA_len41_fa20_ta0_fm14_tm6,a
3274@TOP@human_GAPDH_TAA_len41_fa20_ta0_fm14_tm6*126*g,1,0,12681,0,12682,1.0,126,3274@TOP@human_GAPDH_TAA_len41_fa20_ta0_fm14_tm6,g
3274@TOP@human_GAPDH_TAA_len41_fa20_ta0_fm14_tm6*127*a,12794,0,11,0,12805,0.001,127,3274@TOP@human_GAPDH_TAA_len41_fa20_ta0_fm14_tm6,a
3274@TOP@human_GAPDH_TAA_len41_fa20_ta0_fm14_tm6*128*c,0,12868,0,0,12868,0.0,128,3274@TOP@human_GAPDH_TAA_len41_fa20_ta0_fm14_tm6,c
3274@TOP@human_GAPDH_TAA_len41_fa20_ta0_fm14_tm6*129*c,3,12755,0,1,12759,0.0,129,3274@TOP@human_GAPDH_TAA_len41_fa20_ta0_fm14_tm6,c
3274@TOP@human_GAPDH_TAA_len41_fa20_ta0_fm14_tm6*130*c,1,12842,0,3,12846,0.0,130,3274@TOP@human_GAPDH_TAA_len41_fa20_ta0_fm14_tm6,c
3274@TOP@human_GAPDH_TAA_len41_fa20_ta0_fm14_tm6*131*c,0,12885,0,0,12885,0.0,131,3274@TOP@human_GAPDH_TAA_len41_fa20_ta0_fm14_tm6,c
3274@TOP@human_GAPDH_TAA_len41_fa20_ta0_fm14_tm6*132*t,7,3,1,12674,12685,0.0,132,3274@TOP@human_GAPDH_TAA_len41_fa20_ta0_fm14_tm6,t
3274@TOP@human_GAPDH_TAA_len41_fa20_ta0_fm14_tm6*133*g,0,0,12638,0,12638,1.0,133,3274@TOP@human_GAPDH_TAA_len41_fa20_ta0_fm14_tm6,g
3274@TOP@human_GAPDH_TAA_len41_fa20_ta0_fm14_tm6*134*g,1,2,12728,0,12731,1.0,134,3274@TOP@human_GAPDH_TAA_len41_fa20_ta0_fm14_tm6,g
3275@TOP@human_GAPDH_TAA_len41_fa20_ta0_fm14_tm6*114*t,2,4,0,22905,22911,0.0,114,3275@TOP@human_GAPDH_TAA_len41_fa20_ta0_fm14_tm6,t
3275@TOP@human_GAPDH_TAA_len41_fa20_ta0_fm14_tm6*115*c,0,23042,1,5,23048,0.0,115,3275@TOP@human_GAPDH_TAA_len41_fa20_ta0_fm14_tm6,c
3275@TOP@human_GAPDH_TAA_len41_fa20_ta0_fm14_tm6*116*c,1,22962,0,2,22965,0.0,116,3275@TOP@human_GAPDH_TAA_len41_fa20_ta0_fm14_tm6,c
3275@TOP@human_GAPDH_TAA_len41_fa20_ta0_fm14_tm6*117*a,22909,1,29,0,22939,0.001,117,3275@TOP@human_GAPDH_TAA_len41_fa20_ta0_fm14_tm6,a
3275@TOP@human_GAPDH_TAA_len41_fa20_ta0_fm14_tm6*118*a,22553,0,236,0,22789,0.01,118,3275@TOP@human_GAPDH_TAA_len41_fa20_ta0_fm14_tm6,a
3275@TOP@human_GAPDH_TAA_len41_fa20_ta0_fm14_tm6*119*g,1,1,22783,1,22786,1.0,119,3275@TOP@human_GAPDH_TAA_len41_fa20_ta0_fm14_tm6,g
3275@TOP@human_GAPDH_TAA_len41_fa20_ta0_fm14_tm6*120*g,0,1,22686,0,22687,1.0,120,3275@TOP@human_GAPDH_TAA_len41_fa20_ta0_fm14_tm6,g
3275@TOP@human_GAPDH_TAA_len41_fa20_ta0_fm14_tm6*121*a,22908,0,4,0,22912,0.0,121,3275@TOP@human_GAPDH_TAA_len41_fa20_ta0_fm14_tm6,a
3275@TOP@human_GAPDH_TAA_len41_fa20_ta0_fm14_tm6*122*g,1,0,22963,0,22964,1.0,122,3275@TOP@human_GAPDH_TAA_len41_fa20_ta0_fm14_tm6,g
3275@TOP@human_GAPDH_TAA_len41_fa20_ta0_fm14_tm6*123*t,4,3,1,22615,22623,0.0,123,3275@TOP@human_GAPDH_TAA_len41_fa20_ta0_fm14_tm6,t
3275@TOP@human_GAPDH_TAA_len41_fa20_ta0_fm14_tm6*124*a,21926,1,646,0,22573,0.029,124,3275@TOP@human_GAPDH_TAA_len41_fa20_ta0_fm14_tm6,a
3275@TOP@human_GAPDH_TAA_len41_fa20_ta0_fm14_tm6*125*a,22210,2,343,0,22555,0.015,125,3275@TOP@human_GAPDH_TAA_len41_fa20_ta0_fm14_tm6,a
3275@TOP@human_GAPDH_TAA_len41_fa20_ta0_fm14_tm6*126*g,2,1,22656,0,22659,1.0,126,3275@TOP@human_GAPDH_TAA_len41_fa20_ta0_fm14_tm6,g
3275@TOP@human_GAPDH_TAA_len41_fa20_ta0_fm14_tm6*127*a,22847,0,10,0,22857,0.0,127,3275@TOP@human_GAPDH_TAA_len41_fa20_ta0_fm14_tm6,a
3275@TOP@human_GAPDH_TAA_len41_fa20_ta0_fm14_tm6*128*c,3,23005,4,1,23013,0.0,128,3275@TOP@human_GAPDH_TAA_len41_fa20_ta0_fm14_tm6,c
3275@TOP@human_GAPDH_TAA_len41_fa20_ta0_fm14_tm6*129*c,4,22831,0,5,22840,0.0,129,3275@TOP@human_GAPDH_TAA_len41_fa20_ta0_fm14_tm6,c
3275@TOP@human_GAPDH_TAA_len41_fa20_ta0_fm14_tm6*130*c,3,22954,0,0,22957,0.0,130,3275@TOP@human_GAPDH_TAA_len41_fa20_ta0_fm14_tm6,c
3275@TOP@human_GAPDH_TAA_len41_fa20_ta0_fm14_tm6*131*c,0,23002,0,1,23003,0.0,131,3275@TOP@human_GAPDH_TAA_len41_fa20_ta0_fm14_tm6,c
3275@TOP@human_GAPDH_TAA_len41_fa20_ta0_fm14_tm6*132*t,5,7,0,22649,22661,0.0,132,3275@TOP@human_GAPDH_TAA_len41_fa20_ta0_fm14_tm6,t
3275@TOP@human_GAPDH_TAA_len41_fa20_ta0_fm14_tm6*133*g,2,2,22651,1,22656,1.0,133,3275@TOP@human_GAPDH_TAA_len41_fa20_ta0_fm14_tm6,g
3275@TOP@human_GAPDH_TAA_len41_fa20_ta0_fm14_tm6*134*g,7,4,22746,0,22757,1.0,134,3275@TOP@human_GAPDH_TAA_len41_fa20_ta0_fm14_tm6,g
3276@TOP@human_GAPDH_TAA_len41_fa20_ta0_fm14_tm6*114*t,0,0,0,2705,2705,0.0,114,3276@TOP@human_GAPDH_TAA_len41_fa20_ta0_fm14_tm6,t
3276@TOP@human_GAPDH_TAA_len41_fa20_ta0_fm14_tm6*115*c,0,2719,0,3,2722,0.0,115,3276@TOP@human_GAPDH_TAA_len41_fa20_ta0_fm14_tm6,c
3276@TOP@human_GAPDH_TAA_len41_fa20_ta0_fm14_tm6*116*c,0,2716,0,0,2716,0.0,116,3276@TOP@human_GAPDH_TAA_len41_fa20_ta0_fm14_tm6,c
3276@TOP@human_GAPDH_TAA_len41_fa20_ta0_fm14_tm6*117*a,2707,0,5,0,2712,0.002,117,3276@TOP@human_GAPDH_TAA_len41_fa20_ta0_fm14_tm6,a
3276@TOP@human_GAPDH_TAA_len41_fa20_ta0_fm14_tm6*118*a,2629,0,58,0,2687,0.022,118,3276@TOP@human_GAPDH_TAA_len41_fa20_ta0_fm14_tm6,a
3276@TOP@human_GAPDH_TAA_len41_fa20_ta0_fm14_tm6*119*g,0,0,2694,0,2694,1.0,119,3276@TOP@human_GAPDH_TAA_len41_fa20_ta0_fm14_tm6,g
3276@TOP@human_GAPDH_TAA_len41_fa20_ta0_fm14_tm6*120*g,0,0,2672,0,2672,1.0,120,3276@TOP@human_GAPDH_TAA_len41_fa20_ta0_fm14_tm6,g
3276@TOP@human_GAPDH_TAA_len41_fa20_ta0_fm14_tm6*121*a,2706,0,1,0,2707,0.0,121,3276@TOP@human_GAPDH_TAA_len41_fa20_ta0_fm14_tm6,a
3276@TOP@human_GAPDH_TAA_len41_fa20_ta0_fm14_tm6*122*g,0,0,2707,0,2707,1.0,122,3276@TOP@human_GAPDH_TAA_len41_fa20_ta0_fm14_tm6,g
3276@TOP@human_GAPDH_TAA_len41_fa20_ta0_fm14_tm6*123*t,0,0,3,2673,2676,0.001,123,3276@TOP@human_GAPDH_TAA_len41_fa20_ta0_fm14_tm6,t
3276@TOP@human_GAPDH_TAA_len41_fa20_ta0_fm14_tm6*124*a,2557,0,97,0,2654,0.037,124,3276@TOP@human_GAPDH_TAA_len41_fa20_ta0_fm14_tm6,a
3276@TOP@human_GAPDH_TAA_len41_fa20_ta0_fm14_tm6*125*a,2601,0,56,1,2658,0.021,125,3276@TOP@human_GAPDH_TAA_len41_fa20_ta0_fm14_tm6,a
3276@TOP@human_GAPDH_TAA_len41_fa20_ta0_fm14_tm6*126*g,0,0,2664,1,2665,1.0,126,3276@TOP@human_GAPDH_TAA_len41_fa20_ta0_fm14_tm6,g
3276@TOP@human_GAPDH_TAA_len41_fa20_ta0_fm14_tm6*127*a,2699,0,0,0,2699,0.0,127,3276@TOP@human_GAPDH_TAA_len41_fa20_ta0_fm14_tm6,a
3276@TOP@human_GAPDH_TAA_len41_fa20_ta0_fm14_tm6*128*c,0,2713,0,0,2713,0.0,128,3276@TOP@human_GAPDH_TAA_len41_fa20_ta0_fm14_tm6,c
3276@TOP@human_GAPDH_TAA_len41_fa20_ta0_fm14_tm6*129*c,1,2690,0,0,2691,0.0,129,3276@TOP@human_GAPDH_TAA_len41_fa20_ta0_fm14_tm6,c
3276@TOP@human_GAPDH_TAA_len41_fa20_ta0_fm14_tm6*130*c,0,2711,0,0,2711,0.0,130,3276@TOP@human_GAPDH_TAA_len41_fa20_ta0_fm14_tm6,c
3276@TOP@human_GAPDH_TAA_len41_fa20_ta0_fm14_tm6*131*c,0,2716,0,0,2716,0.0,131,3276@TOP@human_GAPDH_TAA_len41_fa20_ta0_fm14_tm6,c
3276@TOP@human_GAPDH_TAA_len41_fa20_ta0_fm14_tm6*132*t,0,0,0,2679,2679,0.0,132,3276@TOP@human_GAPDH_TAA_len41_fa20_ta0_fm14_tm6,t
3276@TOP@human_GAPDH_TAA_len41_fa20_ta0_fm14_tm6*133*g,0,0,2677,0,2677,1.0,133,3276@TOP@human_GAPDH_TAA_len41_fa20_ta0_fm14_tm6,g
3276@TOP@human_GAPDH_TAA_len41_fa20_ta0_fm14_tm6*134*g,0,0,2679,0,2679,1.0,134,3276@TOP@human_GAPDH_TAA_len41_fa20_ta0_fm14_tm6,g
3277@TOP@human_GAPDH_TAA_len41_fa20_ta0_fm14_tm6*114*t,0,2,0,3745,3747,0.0,114,3277@TOP@human_GAPDH_TAA_len41_fa20_ta0_fm14_tm6,t
3277@TOP@human_GAPDH_TAA_len41_fa20_ta0_fm14_tm6*115*c,0,3761,0,0,3761,0.0,115,3277@TOP@human_GAPDH_TAA_len41_fa20_ta0_fm14_tm6,c
3277@TOP@human_GAPDH_TAA_len41_fa20_ta0_fm14_tm6*116*c,0,3745,0,0,3745,0.0,116,3277@TOP@human_GAPDH_TAA_len41_fa20_ta0_fm14_tm6,c
3277@TOP@human_GAPDH_TAA_len41_fa20_ta0_fm14_tm6*117*a,3739,0,2,0,3741,0.001,117,3277@TOP@human_GAPDH_TAA_len41_fa20_ta0_fm14_tm6,a
3277@TOP@human_GAPDH_TAA_len41_fa20_ta0_fm14_tm6*118*a,3687,0,45,3,3735,0.012,118,3277@TOP@human_GAPDH_TAA_len41_fa20_ta0_fm14_tm6,a
3277@TOP@human_GAPDH_TAA_len41_fa20_ta0_fm14_tm6*119*g,1,0,3724,0,3725,1.0,119,3277@TOP@human_GAPDH_TAA_len41_fa20_ta0_fm14_tm6,g
3277@TOP@human_GAPDH_TAA_len41_fa20_ta0_fm14_tm6*120*g,1,0,3700,0,3701,1.0,120,3277@TOP@human_GAPDH_TAA_len41_fa20_ta0_fm14_tm6,g
3277@TOP@human_GAPDH_TAA_len41_fa20_ta0_fm14_tm6*121*a,3735,0,4,0,3739,0.001,121,3277@TOP@human_GAPDH_TAA_len41_fa20_ta0_fm14_tm6,a
3277@TOP@human_GAPDH_TAA_len41_fa20_ta0_fm14_tm6*122*g,0,0,3751,0,3751,1.0,122,3277@TOP@human_GAPDH_TAA_len41_fa20_ta0_fm14_tm6,g
3277@TOP@human_GAPDH_TAA_len41_fa20_ta0_fm14_tm6*123*t,0,1,1,3705,3707,0.0,123,3277@TOP@human_GAPDH_TAA_len41_fa20_ta0_fm14_tm6,t
3277@TOP@human_GAPDH_TAA_len41_fa20_ta0_fm14_tm6*124*a,3542,0,171,0,3713,0.046,124,3277@TOP@human_GAPDH_TAA_len41_fa20_ta0_fm14_tm6,a
3277@TOP@human_GAPDH_TAA_len41_fa20_ta0_fm14_tm6*125*a,3579,0,77,0,3656,0.021,125,3277@TOP@human_GAPDH_TAA_len41_fa20_ta0_fm14_tm6,a
3277@TOP@human_GAPDH_TAA_len41_fa20_ta0_fm14_tm6*126*g,0,0,3686,1,3687,1.0,126,3277@TOP@human_GAPDH_TAA_len41_fa20_ta0_fm14_tm6,g
3277@TOP@human_GAPDH_TAA_len41_fa20_ta0_fm14_tm6*127*a,3736,0,1,0,3737,0.0,127,3277@TOP@human_GAPDH_TAA_len41_fa20_ta0_fm14_tm6,a
3277@TOP@human_GAPDH_TAA_len41_fa20_ta0_fm14_tm6*128*c,0,3753,0,1,3754,0.0,128,3277@TOP@human_GAPDH_TAA_len41_fa20_ta0_fm14_tm6,c
3277@TOP@human_GAPDH_TAA_len41_fa20_ta0_fm14_tm6*129*c,0,3735,0,0,3735,0.0,129,3277@TOP@human_GAPDH_TAA_len41_fa20_ta0_fm14_tm6,c
3277@TOP@human_GAPDH_TAA_len41_fa20_ta0_fm14_tm6*130*c,0,3745,0,0,3745,0.0,130,3277@TOP@human_GAPDH_TAA_len41_fa20_ta0_fm14_tm6,c
3277@TOP@human_GAPDH_TAA_len41_fa20_ta0_fm14_tm6*131*c,0,3758,0,0,3758,0.0,131,3277@TOP@human_GAPDH_TAA_len41_fa20_ta0_fm14_tm6,c
3277@TOP@human_GAPDH_TAA_len41_fa20_ta0_fm14_tm6*132*t,2,2,0,3705,3709,0.0,132,3277@TOP@human_GAPDH_TAA_len41_fa20_ta0_fm14_tm6,t
3277@TOP@human_GAPDH_TAA_len41_fa20_ta0_fm14_tm6*133*g,0,1,3690,0,3691,1.0,133,3277@TOP@human_GAPDH_TAA_len41_fa20_ta0_fm14_tm6,g
3277@TOP@human_GAPDH_TAA_len41_fa20_ta0_fm14_tm6*134*g,0,0,3718,0,3718,1.0,134,3277@TOP@human_GAPDH_TAA_len41_fa20_ta0_fm14_tm6,g
3278@TOP@human_GAPDH_TAA_len41_fa20_ta0_fm14_tm6*114*t,1,0,0,7429,7430,0.0,114,3278@TOP@human_GAPDH_TAA_len41_fa20_ta0_fm14_tm6,t
3278@TOP@human_GAPDH_TAA_len41_fa20_ta0_fm14_tm6*115*c,0,7471,0,0,7471,0.0,115,3278@TOP@human_GAPDH_TAA_len41_fa20_ta0_fm14_tm6,c
3278@TOP@human_GAPDH_TAA_len41_fa20_ta0_fm14_tm6*116*c,0,7446,0,0,7446,0.0,116,3278@TOP@human_GAPDH_TAA_len41_fa20_ta0_fm14_tm6,c
3278@TOP@human_GAPDH_TAA_len41_fa20_ta0_fm14_tm6*117*a,7421,0,17,1,7439,0.002,117,3278@TOP@human_GAPDH_TAA_len41_fa20_ta0_fm14_tm6,a
3278@TOP@human_GAPDH_TAA_len41_fa20_ta0_fm14_tm6*118*a,7301,0,97,2,7400,0.013,118,3278@TOP@human_GAPDH_TAA_len41_fa20_ta0_fm14_tm6,a
3278@TOP@human_GAPDH_TAA_len41_fa20_ta0_fm14_tm6*119*g,0,0,7372,0,7372,1.0,119,3278@TOP@human_GAPDH_TAA_len41_fa20_ta0_fm14_tm6,g
3278@TOP@human_GAPDH_TAA_len41_fa20_ta0_fm14_tm6*120*g,1,0,7357,0,7358,1.0,120,3278@TOP@human_GAPDH_TAA_len41_fa20_ta0_fm14_tm6,g
3278@TOP@human_GAPDH_TAA_len41_fa20_ta0_fm14_tm6*121*a,7419,0,2,0,7421,0.0,121,3278@TOP@human_GAPDH_TAA_len41_fa20_ta0_fm14_tm6,a
3278@TOP@human_GAPDH_TAA_len41_fa20_ta0_fm14_tm6*122*g,0,0,7438,0,7438,1.0,122,3278@TOP@human_GAPDH_TAA_len41_fa20_ta0_fm14_tm6,g
3278@TOP@human_GAPDH_TAA_len41_fa20_ta0_fm14_tm6*123*t,2,0,2,7337,7341,0.0,123,3278@TOP@human_GAPDH_TAA_len41_fa20_ta0_fm14_tm6,t
3278@TOP@human_GAPDH_TAA_len41_fa20_ta0_fm14_tm6*124*a,7080,1,232,0,7313,0.032,124,3278@TOP@human_GAPDH_TAA_len41_fa20_ta0_fm14_tm6,a
3278@TOP@human_GAPDH_TAA_len41_fa20_ta0_fm14_tm6*125*a,7074,0,217,0,7291,0.03,125,3278@TOP@human_GAPDH_TAA_len41_fa20_ta0_fm14_tm6,a
3278@TOP@human_GAPDH_TAA_len41_fa20_ta0_fm14_tm6*126*g,2,0,7373,1,7376,1.0,126,3278@TOP@human_GAPDH_TAA_len41_fa20_ta0_fm14_tm6,g
3278@TOP@human_GAPDH_TAA_len41_fa20_ta0_fm14_tm6*127*a,7388,2,5,0,7395,0.001,127,3278@TOP@human_GAPDH_TAA_len41_fa20_ta0_fm14_tm6,a
3278@TOP@human_GAPDH_TAA_len41_fa20_ta0_fm14_tm6*128*c,0,7449,1,0,7450,0.0,128,3278@TOP@human_GAPDH_TAA_len41_fa20_ta0_fm14_tm6,c
3278@TOP@human_GAPDH_TAA_len41_fa20_ta0_fm14_tm6*129*c,0,7417,0,2,7419,0.0,129,3278@TOP@human_GAPDH_TAA_len41_fa20_ta0_fm14_tm6,c
3278@TOP@human_GAPDH_TAA_len41_fa20_ta0_fm14_tm6*130*c,2,7450,0,0,7452,0.0,130,3278@TOP@human_GAPDH_TAA_len41_fa20_ta0_fm14_tm6,c
3278@TOP@human_GAPDH_TAA_len41_fa20_ta0_fm14_tm6*131*c,0,7454,0,4,7458,0.0,131,3278@TOP@human_GAPDH_TAA_len41_fa20_ta0_fm14_tm6,c
3278@TOP@human_GAPDH_TAA_len41_fa20_ta0_fm14_tm6*132*t,2,1,1,7334,7338,0.0,132,3278@TOP@human_GAPDH_TAA_len41_fa20_ta0_fm14_tm6,t
3278@TOP@human_GAPDH_TAA_len41_fa20_ta0_fm14_tm6*133*g,2,0,7350,1,7353,1.0,133,3278@TOP@human_GAPDH_TAA_len41_fa20_ta0_fm14_tm6,g
3278@TOP@human_GAPDH_TAA_len41_fa20_ta0_fm14_tm6*134*g,1,0,7400,0,7401,1.0,134,3278@TOP@human_GAPDH_TAA_len41_fa20_ta0_fm14_tm6,g
3279@TOP@human_GAPDH_TAA_len41_fa20_ta0_fm14_tm6*114*t,1,5,0,9910,9916,0.0,114,3279@TOP@human_GAPDH_TAA_len41_fa20_ta0_fm14_tm6,t
3279@TOP@human_GAPDH_TAA_len41_fa20_ta0_fm14_tm6*115*c,0,9987,0,0,9987,0.0,115,3279@TOP@human_GAPDH_TAA_len41_fa20_ta0_fm14_tm6,c
3279@TOP@human_GAPDH_TAA_len41_fa20_ta0_fm14_tm6*116*c,1,9950,0,1,9952,0.0,116,3279@TOP@human_GAPDH_TAA_len41_fa20_ta0_fm14_tm6,c
3279@TOP@human_GAPDH_TAA_len41_fa20_ta0_fm14_tm6*117*a,9939,0,14,0,9953,0.001,117,3279@TOP@human_GAPDH_TAA_len41_fa20_ta0_fm14_tm6,a
3279@TOP@human_GAPDH_TAA_len41_fa20_ta0_fm14_tm6*118*a,9775,0,96,0,9871,0.01,118,3279@TOP@human_GAPDH_TAA_len41_fa20_ta0_fm14_tm6,a
3279@TOP@human_GAPDH_TAA_len41_fa20_ta0_fm14_tm6*119*g,0,1,9860,2,9863,1.0,119,3279@TOP@human_GAPDH_TAA_len41_fa20_ta0_fm14_tm6,g
3279@TOP@human_GAPDH_TAA_len41_fa20_ta0_fm14_tm6*120*g,0,0,9838,0,9838,1.0,120,3279@TOP@human_GAPDH_TAA_len41_fa20_ta0_fm14_tm6,g
3279@TOP@human_GAPDH_TAA_len41_fa20_ta0_fm14_tm6*121*a,9930,0,1,0,9931,0.0,121,3279@TOP@human_GAPDH_TAA_len41_fa20_ta0_fm14_tm6,a
3279@TOP@human_GAPDH_TAA_len41_fa20_ta0_fm14_tm6*122*g,0,0,9930,0,9930,1.0,122,3279@TOP@human_GAPDH_TAA_len41_fa20_ta0_fm14_tm6,g
3279@TOP@human_GAPDH_TAA_len41_fa20_ta0_fm14_tm6*123*t,0,0,1,9831,9832,0.0,123,3279@TOP@human_GAPDH_TAA_len41_fa20_ta0_fm14_tm6,t
3279@TOP@human_GAPDH_TAA_len41_fa20_ta0_fm14_tm6*124*a,9069,0,737,0,9806,0.075,124,3279@TOP@human_GAPDH_TAA_len41_fa20_ta0_fm14_tm6,a
3279@TOP@human_GAPDH_TAA_len41_fa20_ta0_fm14_tm6*125*a,9552,0,215,0,9767,0.022,125,3279@TOP@human_GAPDH_TAA_len41_fa20_ta0_fm14_tm6,a
3279@TOP@human_GAPDH_TAA_len41_fa20_ta0_fm14_tm6*126*g,2,0,9818,0,9820,1.0,126,3279@TOP@human_GAPDH_TAA_len41_fa20_ta0_fm14_tm6,g
3279@TOP@human_GAPDH_TAA_len41_fa20_ta0_fm14_tm6*127*a,9904,1,3,1,9909,0.0,127,3279@TOP@human_GAPDH_TAA_len41_fa20_ta0_fm14_tm6,a
3279@TOP@human_GAPDH_TAA_len41_fa20_ta0_fm14_tm6*128*c,0,9963,1,0,9964,0.0,128,3279@TOP@human_GAPDH_TAA_len41_fa20_ta0_fm14_tm6,c
3279@TOP@human_GAPDH_TAA_len41_fa20_ta0_fm14_tm6*129*c,2,9882,0,0,9884,0.0,129,3279@TOP@human_GAPDH_TAA_len41_fa20_ta0_fm14_tm6,c
3279@TOP@human_GAPDH_TAA_len41_fa20_ta0_fm14_tm6*130*c,1,9965,0,1,9967,0.0,130,3279@TOP@human_GAPDH_TAA_len41_fa20_ta0_fm14_tm6,c
3279@TOP@human_GAPDH_TAA_len41_fa20_ta0_fm14_tm6*131*c,0,9971,0,0,9971,0.0,131,3279@TOP@human_GAPDH_TAA_len41_fa20_ta0_fm14_tm6,c
3279@TOP@human_GAPDH_TAA_len41_fa20_ta0_fm14_tm6*132*t,1,1,0,9841,9843,0.0,132,3279@TOP@human_GAPDH_TAA_len41_fa20_ta0_fm14_tm6,t
3279@TOP@human_GAPDH_TAA_len41_fa20_ta0_fm14_tm6*133*g,0,0,9815,1,9816,1.0,133,3279@TOP@human_GAPDH_TAA_len41_fa20_ta0_fm14_tm6,g
3279@TOP@human_GAPDH_TAA_len41_fa20_ta0_fm14_tm6*134*g,1,2,9868,1,9872,1.0,134,3279@TOP@human_GAPDH_TAA_len41_fa20_ta0_fm14_tm6,g
3280@TOP@human_GAPDH_TAA_len41_fa20_ta0_fm14_tm6*114*t,2,8,0,20778,20788,0.0,114,3280@TOP@human_GAPDH_TAA_len41_fa20_ta0_fm14_tm6,t
3280@TOP@human_GAPDH_TAA_len41_fa20_ta0_fm14_tm6*115*c,1,20897,0,1,20899,0.0,115,3280@TOP@human_GAPDH_TAA_len41_fa20_ta0_fm14_tm6,c
3280@TOP@human_GAPDH_TAA_len41_fa20_ta0_fm14_tm6*116*c,1,20824,0,2,20827,0.0,116,3280@TOP@human_GAPDH_TAA_len41_fa20_ta0_fm14_tm6,c
3280@TOP@human_GAPDH_TAA_len41_fa20_ta0_fm14_tm6*117*a,20794,1,34,1,20830,0.002,117,3280@TOP@human_GAPDH_TAA_len41_fa20_ta0_fm14_tm6,a
3280@TOP@human_GAPDH_TAA_len41_fa20_ta0_fm14_tm6*118*a,20465,1,236,0,20702,0.011,118,3280@TOP@human_GAPDH_TAA_len41_fa20_ta0_fm14_tm6,a
3280@TOP@human_GAPDH_TAA_len41_fa20_ta0_fm14_tm6*119*g,0,1,20663,0,20664,1.0,119,3280@TOP@human_GAPDH_TAA_len41_fa20_ta0_fm14_tm6,g
3280@TOP@human_GAPDH_TAA_len41_fa20_ta0_fm14_tm6*120*g,1,0,20563,0,20564,1.0,120,3280@TOP@human_GAPDH_TAA_len41_fa20_ta0_fm14_tm6,g
3280@TOP@human_GAPDH_TAA_len41_fa20_ta0_fm14_tm6*121*a,20782,0,4,0,20786,0.0,121,3280@TOP@human_GAPDH_TAA_len41_fa20_ta0_fm14_tm6,a
3280@TOP@human_GAPDH_TAA_len41_fa20_ta0_fm14_tm6*122*g,3,0,20817,0,20820,1.0,122,3280@TOP@human_GAPDH_TAA_len41_fa20_ta0_fm14_tm6,g
3280@TOP@human_GAPDH_TAA_len41_fa20_ta0_fm14_tm6*123*t,0,3,2,20502,20507,0.0,123,3280@TOP@human_GAPDH_TAA_len41_fa20_ta0_fm14_tm6,t
3280@TOP@human_GAPDH_TAA_len41_fa20_ta0_fm14_tm6*124*a,19681,0,816,0,20497,0.04,124,3280@TOP@human_GAPDH_TAA_len41_fa20_ta0_fm14_tm6,a
3280@TOP@human_GAPDH_TAA_len41_fa20_ta0_fm14_tm6*125*a,20057,3,377,3,20440,0.018,125,3280@TOP@human_GAPDH_TAA_len41_fa20_ta0_fm14_tm6,a
3280@TOP@human_GAPDH_TAA_len41_fa20_ta0_fm14_tm6*126*g,2,0,20539,0,20541,1.0,126,3280@TOP@human_GAPDH_TAA_len41_fa20_ta0_fm14_tm6,g
3280@TOP@human_GAPDH_TAA_len41_fa20_ta0_fm14_tm6*127*a,20748,0,11,2,20761,0.001,127,3280@TOP@human_GAPDH_TAA_len41_fa20_ta0_fm14_tm6,a
3280@TOP@human_GAPDH_TAA_len41_fa20_ta0_fm14_tm6*128*c,0,20860,0,2,20862,0.0,128,3280@TOP@human_GAPDH_TAA_len41_fa20_ta0_fm14_tm6,c
3280@TOP@human_GAPDH_TAA_len41_fa20_ta0_fm14_tm6*129*c,0,20691,0,1,20692,0.0,129,3280@TOP@human_GAPDH_TAA_len41_fa20_ta0_fm14_tm6,c
3280@TOP@human_GAPDH_TAA_len41_fa20_ta0_fm14_tm6*130*c,1,20807,0,4,20812,0.0,130,3280@TOP@human_GAPDH_TAA_len41_fa20_ta0_fm14_tm6,c
3280@TOP@human_GAPDH_TAA_len41_fa20_ta0_fm14_tm6*131*c,3,20862,0,1,20866,0.0,131,3280@TOP@human_GAPDH_TAA_len41_fa20_ta0_fm14_tm6,c
3280@TOP@human_GAPDH_TAA_len41_fa20_ta0_fm14_tm6*132*t,2,3,4,20608,20617,0.0,132,3280@TOP@human_GAPDH_TAA_len41_fa20_ta0_fm14_tm6,t
3280@TOP@human_GAPDH_TAA_len41_fa20_ta0_fm14_tm6*133*g,1,0,20517,2,20520,1.0,133,3280@TOP@human_GAPDH_TAA_len41_fa20_ta0_fm14_tm6,g
3280@TOP@human_GAPDH_TAA_len41_fa20_ta0_fm14_tm6*134*g,1,5,20650,0,20656,1.0,134,3280@TOP@human_GAPDH_TAA_len41_fa20_ta0_fm14_tm6,g
3281@TOP@human_GAPDH_TAA_len41_fa20_ta0_fm14_tm6*114*t,0,7,0,18695,18702,0.0,114,3281@TOP@human_GAPDH_TAA_len41_fa20_ta0_fm14_tm6,t
3281@TOP@human_GAPDH_TAA_len41_fa20_ta0_fm14_tm6*115*c,0,18802,0,0,18802,0.0,115,3281@TOP@human_GAPDH_TAA_len41_fa20_ta0_fm14_tm6,c
3281@TOP@human_GAPDH_TAA_len41_fa20_ta0_fm14_tm6*116*c,0,18748,0,3,18751,0.0,116,3281@TOP@human_GAPDH_TAA_len41_fa20_ta0_fm14_tm6,c
3281@TOP@human_GAPDH_TAA_len41_fa20_ta0_fm14_tm6*117*a,18723,0,10,1,18734,0.001,117,3281@TOP@human_GAPDH_TAA_len41_fa20_ta0_fm14_tm6,a
3281@TOP@human_GAPDH_TAA_len41_fa20_ta0_fm14_tm6*118*a,18443,0,197,2,18642,0.011,118,3281@TOP@human_GAPDH_TAA_len41_fa20_ta0_fm14_tm6,a
3281@TOP@human_GAPDH_TAA_len41_fa20_ta0_fm14_tm6*119*g,2,0,18597,0,18599,1.0,119,3281@TOP@human_GAPDH_TAA_len41_fa20_ta0_fm14_tm6,g
3281@TOP@human_GAPDH_TAA_len41_fa20_ta0_fm14_tm6*120*g,0,0,18530,1,18531,1.0,120,3281@TOP@human_GAPDH_TAA_len41_fa20_ta0_fm14_tm6,g
3281@TOP@human_GAPDH_TAA_len41_fa20_ta0_fm14_tm6*121*a,18707,0,8,0,18715,0.0,121,3281@TOP@human_GAPDH_TAA_len41_fa20_ta0_fm14_tm6,a
3281@TOP@human_GAPDH_TAA_len41_fa20_ta0_fm14_tm6*122*g,0,1,18757,0,18758,1.0,122,3281@TOP@human_GAPDH_TAA_len41_fa20_ta0_fm14_tm6,g
3281@TOP@human_GAPDH_TAA_len41_fa20_ta0_fm14_tm6*123*t,1,1,1,18484,18487,0.0,123,3281@TOP@human_GAPDH_TAA_len41_fa20_ta0_fm14_tm6,t
3281@TOP@human_GAPDH_TAA_len41_fa20_ta0_fm14_tm6*124*a,17893,0,529,0,18422,0.029,124,3281@TOP@human_GAPDH_TAA_len41_fa20_ta0_fm14_tm6,a
3281@TOP@human_GAPDH_TAA_len41_fa20_ta0_fm14_tm6*125*a,18136,1,255,0,18392,0.014,125,3281@TOP@human_GAPDH_TAA_len41_fa20_ta0_fm14_tm6,a
3281@TOP@human_GAPDH_TAA_len41_fa20_ta0_fm14_tm6*126*g,0,0,18476,0,18476,1.0,126,3281@TOP@human_GAPDH_TAA_len41_fa20_ta0_fm14_tm6,g
3281@TOP@human_GAPDH_TAA_len41_fa20_ta0_fm14_tm6*127*a,18626,1,8,0,18635,0.0,127,3281@TOP@human_GAPDH_TAA_len41_fa20_ta0_fm14_tm6,a
3281@TOP@human_GAPDH_TAA_len41_fa20_ta0_fm14_tm6*128*c,3,18763,1,1,18768,0.0,128,3281@TOP@human_GAPDH_TAA_len41_fa20_ta0_fm14_tm6,c
3281@TOP@human_GAPDH_TAA_len41_fa20_ta0_fm14_tm6*129*c,1,18630,0,1,18632,0.0,129,3281@TOP@human_GAPDH_TAA_len41_fa20_ta0_fm14_tm6,c
3281@TOP@human_GAPDH_TAA_len41_fa20_ta0_fm14_tm6*130*c,0,18720,1,2,18723,0.0,130,3281@TOP@human_GAPDH_TAA_len41_fa20_ta0_fm14_tm6,c
3281@TOP@human_GAPDH_TAA_len41_fa20_ta0_fm14_tm6*131*c,1,18777,1,1,18780,0.0,131,3281@TOP@human_GAPDH_TAA_len41_fa20_ta0_fm14_tm6,c
3281@TOP@human_GAPDH_TAA_len41_fa20_ta0_fm14_tm6*132*t,2,3,0,18519,18524,0.0,132,3281@TOP@human_GAPDH_TAA_len41_fa20_ta0_fm14_tm6,t
3281@TOP@human_GAPDH_TAA_len41_fa20_ta0_fm14_tm6*133*g,0,0,18487,0,18487,1.0,133,3281@TOP@human_GAPDH_TAA_len41_fa20_ta0_fm14_tm6,g
3281@TOP@human_GAPDH_TAA_len41_fa20_ta0_fm14_tm6*134*g,4,4,18564,2,18574,0.999,134,3281@TOP@human_GAPDH_TAA_len41_fa20_ta0_fm14_tm6,g
3282@TOP@human_GAPDH_TAA_len41_fa20_ta0_fm14_tm6*114*t,2,6,0,15566,15574,0.0,114,3282@TOP@human_GAPDH_TAA_len41_fa20_ta0_fm14_tm6,t
3282@TOP@human_GAPDH_TAA_len41_fa20_ta0_fm14_tm6*115*c,2,15642,1,0,15645,0.0,115,3282@TOP@human_GAPDH_TAA_len41_fa20_ta0_fm14_tm6,c
3282@TOP@human_GAPDH_TAA_len41_fa20_ta0_fm14_tm6*116*c,0,15577,0,2,15579,0.0,116,3282@TOP@human_GAPDH_TAA_len41_fa20_ta0_fm14_tm6,c
3282@TOP@human_GAPDH_TAA_len41_fa20_ta0_fm14_tm6*117*a,15553,0,34,0,15587,0.002,117,3282@TOP@human_GAPDH_TAA_len41_fa20_ta0_fm14_tm6,a
3282@TOP@human_GAPDH_TAA_len41_fa20_ta0_fm14_tm6*118*a,15254,1,224,0,15479,0.014,118,3282@TOP@human_GAPDH_TAA_len41_fa20_ta0_fm14_tm6,a
3282@TOP@human_GAPDH_TAA_len41_fa20_ta0_fm14_tm6*119*g,0,0,15482,0,15482,1.0,119,3282@TOP@human_GAPDH_TAA_len41_fa20_ta0_fm14_tm6,g
3282@TOP@human_GAPDH_TAA_len41_fa20_ta0_fm14_tm6*120*g,0,1,15399,1,15401,1.0,120,3282@TOP@human_GAPDH_TAA_len41_fa20_ta0_fm14_tm6,g
3282@TOP@human_GAPDH_TAA_len41_fa20_ta0_fm14_tm6*121*a,15542,1,4,2,15549,0.0,121,3282@TOP@human_GAPDH_TAA_len41_fa20_ta0_fm14_tm6,a
3282@TOP@human_GAPDH_TAA_len41_fa20_ta0_fm14_tm6*122*g,0,0,15591,0,15591,1.0,122,3282@TOP@human_GAPDH_TAA_len41_fa20_ta0_fm14_tm6,g
3282@TOP@human_GAPDH_TAA_len41_fa20_ta0_fm14_tm6*123*t,1,2,2,15376,15381,0.0,123,3282@TOP@human_GAPDH_TAA_len41_fa20_ta0_fm14_tm6,t
3282@TOP@human_GAPDH_TAA_len41_fa20_ta0_fm14_tm6*124*a,14742,0,565,0,15307,0.037,124,3282@TOP@human_GAPDH_TAA_len41_fa20_ta0_fm14_tm6,a
3282@TOP@human_GAPDH_TAA_len41_fa20_ta0_fm14_tm6*125*a,15074,2,231,0,15307,0.015,125,3282@TOP@human_GAPDH_TAA_len41_fa20_ta0_fm14_tm6,a
3282@TOP@human_GAPDH_TAA_len41_fa20_ta0_fm14_tm6*126*g,0,1,15397,0,15398,1.0,126,3282@TOP@human_GAPDH_TAA_len41_fa20_ta0_fm14_tm6,g
3282@TOP@human_GAPDH_TAA_len41_fa20_ta0_fm14_tm6*127*a,15509,1,13,0,15523,0.001,127,3282@TOP@human_GAPDH_TAA_len41_fa20_ta0_fm14_tm6,a
3282@TOP@human_GAPDH_TAA_len41_fa20_ta0_fm14_tm6*128*c,0,15611,1,0,15612,0.0,128,3282@TOP@human_GAPDH_TAA_len41_fa20_ta0_fm14_tm6,c
3282@TOP@human_GAPDH_TAA_len41_fa20_ta0_fm14_tm6*129*c,0,15515,0,0,15515,0.0,129,3282@TOP@human_GAPDH_TAA_len41_fa20_ta0_fm14_tm6,c
3282@TOP@human_GAPDH_TAA_len41_fa20_ta0_fm14_tm6*130*c,0,15583,0,3,15586,0.0,130,3282@TOP@human_GAPDH_TAA_len41_fa20_ta0_fm14_tm6,c
3282@TOP@human_GAPDH_TAA_len41_fa20_ta0_fm14_tm6*131*c,3,15620,0,3,15626,0.0,131,3282@TOP@human_GAPDH_TAA_len41_fa20_ta0_fm14_tm6,c
3282@TOP@human_GAPDH_TAA_len41_fa20_ta0_fm14_tm6*132*t,1,8,0,15388,15397,0.0,132,3282@TOP@human_GAPDH_TAA_len41_fa20_ta0_fm14_tm6,t
3282@TOP@human_GAPDH_TAA_len41_fa20_ta0_fm14_tm6*133*g,1,0,15378,5,15384,1.0,133,3282@TOP@human_GAPDH_TAA_len41_fa20_ta0_fm14_tm6,g
3282@TOP@human_GAPDH_TAA_len41_fa20_ta0_fm14_tm6*134*g,0,0,15460,0,15460,1.0,134,3282@TOP@human_GAPDH_TAA_len41_fa20_ta0_fm14_tm6,g
3283@TOP@human_GAPDH_TAA_len41_fa20_ta0_fm14_tm6*114*t,0,2,0,11286,11288,0.0,114,3283@TOP@human_GAPDH_TAA_len41_fa20_ta0_fm14_tm6,t
3283@TOP@human_GAPDH_TAA_len41_fa20_ta0_fm14_tm6*115*c,0,11341,0,0,11341,0.0,115,3283@TOP@human_GAPDH_TAA_len41_fa20_ta0_fm14_tm6,c
3283@TOP@human_GAPDH_TAA_len41_fa20_ta0_fm14_tm6*116*c,2,11298,0,2,11302,0.0,116,3283@TOP@human_GAPDH_TAA_len41_fa20_ta0_fm14_tm6,c
3283@TOP@human_GAPDH_TAA_len41_fa20_ta0_fm14_tm6*117*a,11268,0,21,0,11289,0.002,117,3283@TOP@human_GAPDH_TAA_len41_fa20_ta0_fm14_tm6,a
3283@TOP@human_GAPDH_TAA_len41_fa20_ta0_fm14_tm6*118*a,11078,0,147,0,11225,0.013,118,3283@TOP@human_GAPDH_TAA_len41_fa20_ta0_fm14_tm6,a
3283@TOP@human_GAPDH_TAA_len41_fa20_ta0_fm14_tm6*119*g,0,0,11199,0,11199,1.0,119,3283@TOP@human_GAPDH_TAA_len41_fa20_ta0_fm14_tm6,g
3283@TOP@human_GAPDH_TAA_len41_fa20_ta0_fm14_tm6*120*g,0,0,11169,0,11169,1.0,120,3283@TOP@human_GAPDH_TAA_len41_fa20_ta0_fm14_tm6,g
3283@TOP@human_GAPDH_TAA_len41_fa20_ta0_fm14_tm6*121*a,11283,0,4,1,11288,0.0,121,3283@TOP@human_GAPDH_TAA_len41_fa20_ta0_fm14_tm6,a
3283@TOP@human_GAPDH_TAA_len41_fa20_ta0_fm14_tm6*122*g,1,0,11299,0,11300,1.0,122,3283@TOP@human_GAPDH_TAA_len41_fa20_ta0_fm14_tm6,g
3283@TOP@human_GAPDH_TAA_len41_fa20_ta0_fm14_tm6*123*t,0,1,3,11136,11140,0.0,123,3283@TOP@human_GAPDH_TAA_len41_fa20_ta0_fm14_tm6,t
3283@TOP@human_GAPDH_TAA_len41_fa20_ta0_fm14_tm6*124*a,10582,0,533,0,11115,0.048,124,3283@TOP@human_GAPDH_TAA_len41_fa20_ta0_fm14_tm6,a
3283@TOP@human_GAPDH_TAA_len41_fa20_ta0_fm14_tm6*125*a,10900,0,205,2,11107,0.018,125,3283@TOP@human_GAPDH_TAA_len41_fa20_ta0_fm14_tm6,a
3283@TOP@human_GAPDH_TAA_len41_fa20_ta0_fm14_tm6*126*g,4,0,11151,0,11155,1.0,126,3283@TOP@human_GAPDH_TAA_len41_fa20_ta0_fm14_tm6,g
3283@TOP@human_GAPDH_TAA_len41_fa20_ta0_fm14_tm6*127*a,11254,0,3,0,11257,0.0,127,3283@TOP@human_GAPDH_TAA_len41_fa20_ta0_fm14_tm6,a
3283@TOP@human_GAPDH_TAA_len41_fa20_ta0_fm14_tm6*128*c,0,11313,2,0,11315,0.0,128,3283@TOP@human_GAPDH_TAA_len41_fa20_ta0_fm14_tm6,c
3283@TOP@human_GAPDH_TAA_len41_fa20_ta0_fm14_tm6*129*c,1,11229,0,0,11230,0.0,129,3283@TOP@human_GAPDH_TAA_len41_fa20_ta0_fm14_tm6,c
3283@TOP@human_GAPDH_TAA_len41_fa20_ta0_fm14_tm6*130*c,2,11294,0,0,11296,0.0,130,3283@TOP@human_GAPDH_TAA_len41_fa20_ta0_fm14_tm6,c
3283@TOP@human_GAPDH_TAA_len41_fa20_ta0_fm14_tm6*131*c,1,11314,0,1,11316,0.0,131,3283@TOP@human_GAPDH_TAA_len41_fa20_ta0_fm14_tm6,c
3283@TOP@human_GAPDH_TAA_len41_fa20_ta0_fm14_tm6*132*t,1,0,0,11169,11170,0.0,132,3283@TOP@human_GAPDH_TAA_len41_fa20_ta0_fm14_tm6,t
3283@TOP@human_GAPDH_TAA_len41_fa20_ta0_fm14_tm6*133*g,0,0,11124,0,11124,1.0,133,3283@TOP@human_GAPDH_TAA_len41_fa20_ta0_fm14_tm6,g
3283@TOP@human_GAPDH_TAA_len41_fa20_ta0_fm14_tm6*134*g,0,3,11196,1,11200,1.0,134,3283@TOP@human_GAPDH_TAA_len41_fa20_ta0_fm14_tm6,g
3284@TOP@human_GAPDH_TAA_len41_fa20_ta0_fm14_tm6*114*t,0,0,0,1388,1388,0.0,114,3284@TOP@human_GAPDH_TAA_len41_fa20_ta0_fm14_tm6,t
3284@TOP@human_GAPDH_TAA_len41_fa20_ta0_fm14_tm6*115*c,0,1402,0,0,1402,0.0,115,3284@TOP@human_GAPDH_TAA_len41_fa20_ta0_fm14_tm6,c
3284@TOP@human_GAPDH_TAA_len41_fa20_ta0_fm14_tm6*116*c,0,1397,0,0,1397,0.0,116,3284@TOP@human_GAPDH_TAA_len41_fa20_ta0_fm14_tm6,c
3284@TOP@human_GAPDH_TAA_len41_fa20_ta0_fm14_tm6*117*a,1399,0,2,0,1401,0.001,117,3284@TOP@human_GAPDH_TAA_len41_fa20_ta0_fm14_tm6,a
3284@TOP@human_GAPDH_TAA_len41_fa20_ta0_fm14_tm6*118*a,1351,0,31,0,1382,0.022,118,3284@TOP@human_GAPDH_TAA_len41_fa20_ta0_fm14_tm6,a
3284@TOP@human_GAPDH_TAA_len41_fa20_ta0_fm14_tm6*119*g,0,0,1389,0,1389,1.0,119,3284@TOP@human_GAPDH_TAA_len41_fa20_ta0_fm14_tm6,g
3284@TOP@human_GAPDH_TAA_len41_fa20_ta0_fm14_tm6*120*g,0,0,1383,0,1383,1.0,120,3284@TOP@human_GAPDH_TAA_len41_fa20_ta0_fm14_tm6,g
3284@TOP@human_GAPDH_TAA_len41_fa20_ta0_fm14_tm6*121*a,1399,0,0,0,1399,0.0,121,3284@TOP@human_GAPDH_TAA_len41_fa20_ta0_fm14_tm6,a
3284@TOP@human_GAPDH_TAA_len41_fa20_ta0_fm14_tm6*122*g,0,0,1396,0,1396,1.0,122,3284@TOP@human_GAPDH_TAA_len41_fa20_ta0_fm14_tm6,g
3284@TOP@human_GAPDH_TAA_len41_fa20_ta0_fm14_tm6*123*t,1,0,0,1363,1364,0.0,123,3284@TOP@human_GAPDH_TAA_len41_fa20_ta0_fm14_tm6,t
3284@TOP@human_GAPDH_TAA_len41_fa20_ta0_fm14_tm6*124*a,1311,0,68,0,1379,0.049,124,3284@TOP@human_GAPDH_TAA_len41_fa20_ta0_fm14_tm6,a
3284@TOP@human_GAPDH_TAA_len41_fa20_ta0_fm14_tm6*125*a,1325,0,38,0,1363,0.028,125,3284@TOP@human_GAPDH_TAA_len41_fa20_ta0_fm14_tm6,a
3284@TOP@human_GAPDH_TAA_len41_fa20_ta0_fm14_tm6*126*g,0,0,1375,1,1376,0.999,126,3284@TOP@human_GAPDH_TAA_len41_fa20_ta0_fm14_tm6,g
3284@TOP@human_GAPDH_TAA_len41_fa20_ta0_fm14_tm6*127*a,1394,0,0,0,1394,0.0,127,3284@TOP@human_GAPDH_TAA_len41_fa20_ta0_fm14_tm6,a
3284@TOP@human_GAPDH_TAA_len41_fa20_ta0_fm14_tm6*128*c,0,1403,0,0,1403,0.0,128,3284@TOP@human_GAPDH_TAA_len41_fa20_ta0_fm14_tm6,c
3284@TOP@human_GAPDH_TAA_len41_fa20_ta0_fm14_tm6*129*c,0,1398,0,0,1398,0.0,129,3284@TOP@human_GAPDH_TAA_len41_fa20_ta0_fm14_tm6,c
3284@TOP@human_GAPDH_TAA_len41_fa20_ta0_fm14_tm6*130*c,5,1397,0,0,1402,0.0,130,3284@TOP@human_GAPDH_TAA_len41_fa20_ta0_fm14_tm6,c
3284@TOP@human_GAPDH_TAA_len41_fa20_ta0_fm14_tm6*131*c,0,1398,0,0,1398,0.0,131,3284@TOP@human_GAPDH_TAA_len41_fa20_ta0_fm14_tm6,c
3284@TOP@human_GAPDH_TAA_len41_fa20_ta0_fm14_tm6*132*t,1,0,0,1375,1376,0.0,132,3284@TOP@human_GAPDH_TAA_len41_fa20_ta0_fm14_tm6,t
3284@TOP@human_GAPDH_TAA_len41_fa20_ta0_fm14_tm6*133*g,0,0,1373,1,1374,0.999,133,3284@TOP@human_GAPDH_TAA_len41_fa20_ta0_fm14_tm6,g
3284@TOP@human_GAPDH_TAA_len41_fa20_ta0_fm14_tm6*134*g,0,0,1387,0,1387,1.0,134,3284@TOP@human_GAPDH_TAA_len41_fa20_ta0_fm14_tm6,g
3285@TOP@human_GAPDH_TAA_len41_fa20_ta0_fm14_tm6*114*t,0,0,0,4629,4629,0.0,114,3285@TOP@human_GAPDH_TAA_len41_fa20_ta0_fm14_tm6,t
3285@TOP@human_GAPDH_TAA_len41_fa20_ta0_fm14_tm6*115*c,1,4657,0,0,4658,0.0,115,3285@TOP@human_GAPDH_TAA_len41_fa20_ta0_fm14_tm6,c
3285@TOP@human_GAPDH_TAA_len41_fa20_ta0_fm14_tm6*116*c,0,4647,0,0,4647,0.0,116,3285@TOP@human_GAPDH_TAA_len41_fa20_ta0_fm14_tm6,c
3285@TOP@human_GAPDH_TAA_len41_fa20_ta0_fm14_tm6*117*a,4646,0,1,0,4647,0.0,117,3285@TOP@human_GAPDH_TAA_len41_fa20_ta0_fm14_tm6,a
3285@TOP@human_GAPDH_TAA_len41_fa20_ta0_fm14_tm6*118*a,4564,0,41,0,4605,0.009,118,3285@TOP@human_GAPDH_TAA_len41_fa20_ta0_fm14_tm6,a
3285@TOP@human_GAPDH_TAA_len41_fa20_ta0_fm14_tm6*119*g,0,0,4607,1,4608,1.0,119,3285@TOP@human_GAPDH_TAA_len41_fa20_ta0_fm14_tm6,g
3285@TOP@human_GAPDH_TAA_len41_fa20_ta0_fm14_tm6*120*g,0,0,4586,0,4586,1.0,120,3285@TOP@human_GAPDH_TAA_len41_fa20_ta0_fm14_tm6,g
3285@TOP@human_GAPDH_TAA_len41_fa20_ta0_fm14_tm6*121*a,4633,0,0,0,4633,0.0,121,3285@TOP@human_GAPDH_TAA_len41_fa20_ta0_fm14_tm6,a
3285@TOP@human_GAPDH_TAA_len41_fa20_ta0_fm14_tm6*122*g,0,1,4637,0,4638,1.0,122,3285@TOP@human_GAPDH_TAA_len41_fa20_ta0_fm14_tm6,g
3285@TOP@human_GAPDH_TAA_len41_fa20_ta0_fm14_tm6*123*t,1,0,1,4587,4589,0.0,123,3285@TOP@human_GAPDH_TAA_len41_fa20_ta0_fm14_tm6,t
3285@TOP@human_GAPDH_TAA_len41_fa20_ta0_fm14_tm6*124*a,4433,1,123,0,4557,0.027,124,3285@TOP@human_GAPDH_TAA_len41_fa20_ta0_fm14_tm6,a
3285@TOP@human_GAPDH_TAA_len41_fa20_ta0_fm14_tm6*125*a,4469,0,76,0,4545,0.017,125,3285@TOP@human_GAPDH_TAA_len41_fa20_ta0_fm14_tm6,a
3285@TOP@human_GAPDH_TAA_len41_fa20_ta0_fm14_tm6*126*g,0,0,4569,0,4569,1.0,126,3285@TOP@human_GAPDH_TAA_len41_fa20_ta0_fm14_tm6,g
3285@TOP@human_GAPDH_TAA_len41_fa20_ta0_fm14_tm6*127*a,4620,0,3,0,4623,0.001,127,3285@TOP@human_GAPDH_TAA_len41_fa20_ta0_fm14_tm6,a
3285@TOP@human_GAPDH_TAA_len41_fa20_ta0_fm14_tm6*128*c,1,4639,1,0,4641,0.0,128,3285@TOP@human_GAPDH_TAA_len41_fa20_ta0_fm14_tm6,c
3285@TOP@human_GAPDH_TAA_len41_fa20_ta0_fm14_tm6*129*c,0,4613,0,0,4613,0.0,129,3285@TOP@human_GAPDH_TAA_len41_fa20_ta0_fm14_tm6,c
3285@TOP@human_GAPDH_TAA_len41_fa20_ta0_fm14_tm6*130*c,0,4643,1,0,4644,0.0,130,3285@TOP@human_GAPDH_TAA_len41_fa20_ta0_fm14_tm6,c
3285@TOP@human_GAPDH_TAA_len41_fa20_ta0_fm14_tm6*131*c,0,4646,0,0,4646,0.0,131,3285@TOP@human_GAPDH_TAA_len41_fa20_ta0_fm14_tm6,c
3285@TOP@human_GAPDH_TAA_len41_fa20_ta0_fm14_tm6*132*t,1,1,0,4570,4572,0.0,132,3285@TOP@human_GAPDH_TAA_len41_fa20_ta0_fm14_tm6,t
3285@TOP@human_GAPDH_TAA_len41_fa20_ta0_fm14_tm6*133*g,1,0,4559,0,4560,1.0,133,3285@TOP@human_GAPDH_TAA_len41_fa20_ta0_fm14_tm6,g
3285@TOP@human_GAPDH_TAA_len41_fa20_ta0_fm14_tm6*134*g,0,2,4589,0,4591,1.0,134,3285@TOP@human_GAPDH_TAA_len41_fa20_ta0_fm14_tm6,g
3286@TOP@human_GAPDH_TAA_len41_fa20_ta0_fm14_tm6*114*t,2,5,0,18466,18473,0.0,114,3286@TOP@human_GAPDH_TAA_len41_fa20_ta0_fm14_tm6,t
3286@TOP@human_GAPDH_TAA_len41_fa20_ta0_fm14_tm6*115*c,0,18555,0,0,18555,0.0,115,3286@TOP@human_GAPDH_TAA_len41_fa20_ta0_fm14_tm6,c
3286@TOP@human_GAPDH_TAA_len41_fa20_ta0_fm14_tm6*116*c,0,18475,0,2,18477,0.0,116,3286@TOP@human_GAPDH_TAA_len41_fa20_ta0_fm14_tm6,c
3286@TOP@human_GAPDH_TAA_len41_fa20_ta0_fm14_tm6*117*a,18448,0,30,0,18478,0.002,117,3286@TOP@human_GAPDH_TAA_len41_fa20_ta0_fm14_tm6,a
3286@TOP@human_GAPDH_TAA_len41_fa20_ta0_fm14_tm6*118*a,18156,1,233,0,18390,0.013,118,3286@TOP@human_GAPDH_TAA_len41_fa20_ta0_fm14_tm6,a
3286@TOP@human_GAPDH_TAA_len41_fa20_ta0_fm14_tm6*119*g,0,0,18337,0,18337,1.0,119,3286@TOP@human_GAPDH_TAA_len41_fa20_ta0_fm14_tm6,g
3286@TOP@human_GAPDH_TAA_len41_fa20_ta0_fm14_tm6*120*g,2,0,18236,2,18240,1.0,120,3286@TOP@human_GAPDH_TAA_len41_fa20_ta0_fm14_tm6,g
3286@TOP@human_GAPDH_TAA_len41_fa20_ta0_fm14_tm6*121*a,18449,0,2,0,18451,0.0,121,3286@TOP@human_GAPDH_TAA_len41_fa20_ta0_fm14_tm6,a
3286@TOP@human_GAPDH_TAA_len41_fa20_ta0_fm14_tm6*122*g,0,1,18481,0,18482,1.0,122,3286@TOP@human_GAPDH_TAA_len41_fa20_ta0_fm14_tm6,g
3286@TOP@human_GAPDH_TAA_len41_fa20_ta0_fm14_tm6*123*t,1,0,4,18205,18210,0.0,123,3286@TOP@human_GAPDH_TAA_len41_fa20_ta0_fm14_tm6,t
3286@TOP@human_GAPDH_TAA_len41_fa20_ta0_fm14_tm6*124*a,17552,1,606,0,18159,0.033,124,3286@TOP@human_GAPDH_TAA_len41_fa20_ta0_fm14_tm6,a
3286@TOP@human_GAPDH_TAA_len41_fa20_ta0_fm14_tm6*125*a,17758,1,363,0,18122,0.02,125,3286@TOP@human_GAPDH_TAA_len41_fa20_ta0_fm14_tm6,a
3286@TOP@human_GAPDH_TAA_len41_fa20_ta0_fm14_tm6*126*g,1,0,18217,0,18218,1.0,126,3286@TOP@human_GAPDH_TAA_len41_fa20_ta0_fm14_tm6,g
3286@TOP@human_GAPDH_TAA_len41_fa20_ta0_fm14_tm6*127*a,18402,2,18,0,18422,0.001,127,3286@TOP@human_GAPDH_TAA_len41_fa20_ta0_fm14_tm6,a
3286@TOP@human_GAPDH_TAA_len41_fa20_ta0_fm14_tm6*128*c,0,18513,4,1,18518,0.0,128,3286@TOP@human_GAPDH_TAA_len41_fa20_ta0_fm14_tm6,c
3286@TOP@human_GAPDH_TAA_len41_fa20_ta0_fm14_tm6*129*c,0,18388,0,0,18388,0.0,129,3286@TOP@human_GAPDH_TAA_len41_fa20_ta0_fm14_tm6,c
3286@TOP@human_GAPDH_TAA_len41_fa20_ta0_fm14_tm6*130*c,2,18464,0,3,18469,0.0,130,3286@TOP@human_GAPDH_TAA_len41_fa20_ta0_fm14_tm6,c
3286@TOP@human_GAPDH_TAA_len41_fa20_ta0_fm14_tm6*131*c,0,18528,0,0,18528,0.0,131,3286@TOP@human_GAPDH_TAA_len41_fa20_ta0_fm14_tm6,c
3286@TOP@human_GAPDH_TAA_len41_fa20_ta0_fm14_tm6*132*t,6,1,3,18264,18274,0.0,132,3286@TOP@human_GAPDH_TAA_len41_fa20_ta0_fm14_tm6,t
3286@TOP@human_GAPDH_TAA_len41_fa20_ta0_fm14_tm6*133*g,0,0,18204,1,18205,1.0,133,3286@TOP@human_GAPDH_TAA_len41_fa20_ta0_fm14_tm6,g
3286@TOP@human_GAPDH_TAA_len41_fa20_ta0_fm14_tm6*134*g,2,2,18310,0,18314,1.0,134,3286@TOP@human_GAPDH_TAA_len41_fa20_ta0_fm14_tm6,g
3287@TOP@human_GAPDH_TAA_len41_fa20_ta0_fm14_tm6*114*t,2,6,1,23122,23131,0.0,114,3287@TOP@human_GAPDH_TAA_len41_fa20_ta0_fm14_tm6,t
3287@TOP@human_GAPDH_TAA_len41_fa20_ta0_fm14_tm6*115*c,0,23253,1,1,23255,0.0,115,3287@TOP@human_GAPDH_TAA_len41_fa20_ta0_fm14_tm6,c
3287@TOP@human_GAPDH_TAA_len41_fa20_ta0_fm14_tm6*116*c,1,23146,0,0,23147,0.0,116,3287@TOP@human_GAPDH_TAA_len41_fa20_ta0_fm14_tm6,c
3287@TOP@human_GAPDH_TAA_len41_fa20_ta0_fm14_tm6*117*a,23122,0,29,0,23151,0.001,117,3287@TOP@human_GAPDH_TAA_len41_fa20_ta0_fm14_tm6,a
3287@TOP@human_GAPDH_TAA_len41_fa20_ta0_fm14_tm6*118*a,22790,0,250,0,23040,0.011,118,3287@TOP@human_GAPDH_TAA_len41_fa20_ta0_fm14_tm6,a
3287@TOP@human_GAPDH_TAA_len41_fa20_ta0_fm14_tm6*119*g,7,0,23001,1,23009,1.0,119,3287@TOP@human_GAPDH_TAA_len41_fa20_ta0_fm14_tm6,g
3287@TOP@human_GAPDH_TAA_len41_fa20_ta0_fm14_tm6*120*g,2,0,22876,1,22879,1.0,120,3287@TOP@human_GAPDH_TAA_len41_fa20_ta0_fm14_tm6,g
3287@TOP@human_GAPDH_TAA_len41_fa20_ta0_fm14_tm6*121*a,23125,0,3,1,23129,0.0,121,3287@TOP@human_GAPDH_TAA_len41_fa20_ta0_fm14_tm6,a
3287@TOP@human_GAPDH_TAA_len41_fa20_ta0_fm14_tm6*122*g,2,0,23180,1,23183,1.0,122,3287@TOP@human_GAPDH_TAA_len41_fa20_ta0_fm14_tm6,g
3287@TOP@human_GAPDH_TAA_len41_fa20_ta0_fm14_tm6*123*t,2,3,5,22860,22870,0.0,123,3287@TOP@human_GAPDH_TAA_len41_fa20_ta0_fm14_tm6,t
3287@TOP@human_GAPDH_TAA_len41_fa20_ta0_fm14_tm6*124*a,22123,1,661,0,22785,0.029,124,3287@TOP@human_GAPDH_TAA_len41_fa20_ta0_fm14_tm6,a
3287@TOP@human_GAPDH_TAA_len41_fa20_ta0_fm14_tm6*125*a,22357,0,390,3,22750,0.017,125,3287@TOP@human_GAPDH_TAA_len41_fa20_ta0_fm14_tm6,a
3287@TOP@human_GAPDH_TAA_len41_fa20_ta0_fm14_tm6*126*g,0,0,22852,1,22853,1.0,126,3287@TOP@human_GAPDH_TAA_len41_fa20_ta0_fm14_tm6,g
3287@TOP@human_GAPDH_TAA_len41_fa20_ta0_fm14_tm6*127*a,23037,0,24,3,23064,0.001,127,3287@TOP@human_GAPDH_TAA_len41_fa20_ta0_fm14_tm6,a
3287@TOP@human_GAPDH_TAA_len41_fa20_ta0_fm14_tm6*128*c,0,23196,2,2,23200,0.0,128,3287@TOP@human_GAPDH_TAA_len41_fa20_ta0_fm14_tm6,c
3287@TOP@human_GAPDH_TAA_len41_fa20_ta0_fm14_tm6*129*c,0,22986,0,5,22991,0.0,129,3287@TOP@human_GAPDH_TAA_len41_fa20_ta0_fm14_tm6,c
3287@TOP@human_GAPDH_TAA_len41_fa20_ta0_fm14_tm6*130*c,7,23164,0,1,23172,0.0,130,3287@TOP@human_GAPDH_TAA_len41_fa20_ta0_fm14_tm6,c
3287@TOP@human_GAPDH_TAA_len41_fa20_ta0_fm14_tm6*131*c,1,23214,0,0,23215,0.0,131,3287@TOP@human_GAPDH_TAA_len41_fa20_ta0_fm14_tm6,c
3287@TOP@human_GAPDH_TAA_len41_fa20_ta0_fm14_tm6*132*t,3,4,2,22879,22888,0.0,132,3287@TOP@human_GAPDH_TAA_len41_fa20_ta0_fm14_tm6,t
3287@TOP@human_GAPDH_TAA_len41_fa20_ta0_fm14_tm6*133*g,5,1,22827,0,22833,1.0,133,3287@TOP@human_GAPDH_TAA_len41_fa20_ta0_fm14_tm6,g
3287@TOP@human_GAPDH_TAA_len41_fa20_ta0_fm14_tm6*134*g,2,1,22991,0,22994,1.0,134,3287@TOP@human_GAPDH_TAA_len41_fa20_ta0_fm14_tm6,g
3288@TOP@human_GAPDH_TAA_len41_fa20_ta0_fm14_tm6*114*t,0,1,0,1702,1703,0.0,114,3288@TOP@human_GAPDH_TAA_len41_fa20_ta0_fm14_tm6,t
3288@TOP@human_GAPDH_TAA_len41_fa20_ta0_fm14_tm6*115*c,0,1714,0,0,1714,0.0,115,3288@TOP@human_GAPDH_TAA_len41_fa20_ta0_fm14_tm6,c
3288@TOP@human_GAPDH_TAA_len41_fa20_ta0_fm14_tm6*116*c,0,1711,0,0,1711,0.0,116,3288@TOP@human_GAPDH_TAA_len41_fa20_ta0_fm14_tm6,c
3288@TOP@human_GAPDH_TAA_len41_fa20_ta0_fm14_tm6*117*a,1704,0,1,0,1705,0.001,117,3288@TOP@human_GAPDH_TAA_len41_fa20_ta0_fm14_tm6,a
3288@TOP@human_GAPDH_TAA_len41_fa20_ta0_fm14_tm6*118*a,1668,0,23,0,1691,0.014,118,3288@TOP@human_GAPDH_TAA_len41_fa20_ta0_fm14_tm6,a
3288@TOP@human_GAPDH_TAA_len41_fa20_ta0_fm14_tm6*119*g,0,0,1690,0,1690,1.0,119,3288@TOP@human_GAPDH_TAA_len41_fa20_ta0_fm14_tm6,g
3288@TOP@human_GAPDH_TAA_len41_fa20_ta0_fm14_tm6*120*g,1,0,1689,0,1690,0.999,120,3288@TOP@human_GAPDH_TAA_len41_fa20_ta0_fm14_tm6,g
3288@TOP@human_GAPDH_TAA_len41_fa20_ta0_fm14_tm6*121*a,1699,0,3,0,1702,0.002,121,3288@TOP@human_GAPDH_TAA_len41_fa20_ta0_fm14_tm6,a
3288@TOP@human_GAPDH_TAA_len41_fa20_ta0_fm14_tm6*122*g,0,0,1711,0,1711,1.0,122,3288@TOP@human_GAPDH_TAA_len41_fa20_ta0_fm14_tm6,g
3288@TOP@human_GAPDH_TAA_len41_fa20_ta0_fm14_tm6*123*t,0,0,0,1687,1687,0.0,123,3288@TOP@human_GAPDH_TAA_len41_fa20_ta0_fm14_tm6,t
3288@TOP@human_GAPDH_TAA_len41_fa20_ta0_fm14_tm6*124*a,1599,0,82,0,1681,0.049,124,3288@TOP@human_GAPDH_TAA_len41_fa20_ta0_fm14_tm6,a
3288@TOP@human_GAPDH_TAA_len41_fa20_ta0_fm14_tm6*125*a,1630,0,35,1,1666,0.021,125,3288@TOP@human_GAPDH_TAA_len41_fa20_ta0_fm14_tm6,a
3288@TOP@human_GAPDH_TAA_len41_fa20_ta0_fm14_tm6*126*g,0,0,1678,0,1678,1.0,126,3288@TOP@human_GAPDH_TAA_len41_fa20_ta0_fm14_tm6,g
3288@TOP@human_GAPDH_TAA_len41_fa20_ta0_fm14_tm6*127*a,1690,0,4,0,1694,0.002,127,3288@TOP@human_GAPDH_TAA_len41_fa20_ta0_fm14_tm6,a
3288@TOP@human_GAPDH_TAA_len41_fa20_ta0_fm14_tm6*128*c,0,1711,0,0,1711,0.0,128,3288@TOP@human_GAPDH_TAA_len41_fa20_ta0_fm14_tm6,c
3288@TOP@human_GAPDH_TAA_len41_fa20_ta0_fm14_tm6*129*c,0,1706,0,1,1707,0.0,129,3288@TOP@human_GAPDH_TAA_len41_fa20_ta0_fm14_tm6,c
3288@TOP@human_GAPDH_TAA_len41_fa20_ta0_fm14_tm6*130*c,2,1710,0,0,1712,0.0,130,3288@TOP@human_GAPDH_TAA_len41_fa20_ta0_fm14_tm6,c
3288@TOP@human_GAPDH_TAA_len41_fa20_ta0_fm14_tm6*131*c,0,1710,0,0,1710,0.0,131,3288@TOP@human_GAPDH_TAA_len41_fa20_ta0_fm14_tm6,c
3288@TOP@human_GAPDH_TAA_len41_fa20_ta0_fm14_tm6*132*t,0,2,0,1683,1685,0.0,132,3288@TOP@human_GAPDH_TAA_len41_fa20_ta0_fm14_tm6,t
3288@TOP@human_GAPDH_TAA_len41_fa20_ta0_fm14_tm6*133*g,0,0,1691,0,1691,1.0,133,3288@TOP@human_GAPDH_TAA_len41_fa20_ta0_fm14_tm6,g
3288@TOP@human_GAPDH_TAA_len41_fa20_ta0_fm14_tm6*134*g,0,0,1700,0,1700,1.0,134,3288@TOP@human_GAPDH_TAA_len41_fa20_ta0_fm14_tm6,g
3289@TOP@human_GAPDH_TAA_len41_fa20_ta0_fm14_tm6*114*t,1,1,0,2102,2104,0.0,114,3289@TOP@human_GAPDH_TAA_len41_fa20_ta0_fm14_tm6,t
3289@TOP@human_GAPDH_TAA_len41_fa20_ta0_fm14_tm6*115*c,0,2118,0,0,2118,0.0,115,3289@TOP@human_GAPDH_TAA_len41_fa20_ta0_fm14_tm6,c
3289@TOP@human_GAPDH_TAA_len41_fa20_ta0_fm14_tm6*116*c,0,2105,0,0,2105,0.0,116,3289@TOP@human_GAPDH_TAA_len41_fa20_ta0_fm14_tm6,c
3289@TOP@human_GAPDH_TAA_len41_fa20_ta0_fm14_tm6*117*a,2101,0,6,0,2107,0.003,117,3289@TOP@human_GAPDH_TAA_len41_fa20_ta0_fm14_tm6,a
3289@TOP@human_GAPDH_TAA_len41_fa20_ta0_fm14_tm6*118*a,2054,0,32,0,2086,0.015,118,3289@TOP@human_GAPDH_TAA_len41_fa20_ta0_fm14_tm6,a
3289@TOP@human_GAPDH_TAA_len41_fa20_ta0_fm14_tm6*119*g,0,0,2092,0,2092,1.0,119,3289@TOP@human_GAPDH_TAA_len41_fa20_ta0_fm14_tm6,g
3289@TOP@human_GAPDH_TAA_len41_fa20_ta0_fm14_tm6*120*g,0,0,2078,1,2079,1.0,120,3289@TOP@human_GAPDH_TAA_len41_fa20_ta0_fm14_tm6,g
3289@TOP@human_GAPDH_TAA_len41_fa20_ta0_fm14_tm6*121*a,2107,0,0,0,2107,0.0,121,3289@TOP@human_GAPDH_TAA_len41_fa20_ta0_fm14_tm6,a
3289@TOP@human_GAPDH_TAA_len41_fa20_ta0_fm14_tm6*122*g,1,0,2103,0,2104,1.0,122,3289@TOP@human_GAPDH_TAA_len41_fa20_ta0_fm14_tm6,g
3289@TOP@human_GAPDH_TAA_len41_fa20_ta0_fm14_tm6*123*t,0,0,0,2073,2073,0.0,123,3289@TOP@human_GAPDH_TAA_len41_fa20_ta0_fm14_tm6,t
3289@TOP@human_GAPDH_TAA_len41_fa20_ta0_fm14_tm6*124*a,1957,0,113,0,2070,0.055,124,3289@TOP@human_GAPDH_TAA_len41_fa20_ta0_fm14_tm6,a
3289@TOP@human_GAPDH_TAA_len41_fa20_ta0_fm14_tm6*125*a,2021,1,49,0,2071,0.024,125,3289@TOP@human_GAPDH_TAA_len41_fa20_ta0_fm14_tm6,a
3289@TOP@human_GAPDH_TAA_len41_fa20_ta0_fm14_tm6*126*g,1,0,2084,0,2085,1.0,126,3289@TOP@human_GAPDH_TAA_len41_fa20_ta0_fm14_tm6,g
3289@TOP@human_GAPDH_TAA_len41_fa20_ta0_fm14_tm6*127*a,2094,0,4,0,2098,0.002,127,3289@TOP@human_GAPDH_TAA_len41_fa20_ta0_fm14_tm6,a
3289@TOP@human_GAPDH_TAA_len41_fa20_ta0_fm14_tm6*128*c,0,2112,0,1,2113,0.0,128,3289@TOP@human_GAPDH_TAA_len41_fa20_ta0_fm14_tm6,c
3289@TOP@human_GAPDH_TAA_len41_fa20_ta0_fm14_tm6*129*c,0,2102,0,0,2102,0.0,129,3289@TOP@human_GAPDH_TAA_len41_fa20_ta0_fm14_tm6,c
3289@TOP@human_GAPDH_TAA_len41_fa20_ta0_fm14_tm6*130*c,0,2113,0,0,2113,0.0,130,3289@TOP@human_GAPDH_TAA_len41_fa20_ta0_fm14_tm6,c
3289@TOP@human_GAPDH_TAA_len41_fa20_ta0_fm14_tm6*131*c,0,2113,0,0,2113,0.0,131,3289@TOP@human_GAPDH_TAA_len41_fa20_ta0_fm14_tm6,c
3289@TOP@human_GAPDH_TAA_len41_fa20_ta0_fm14_tm6*132*t,0,0,0,2083,2083,0.0,132,3289@TOP@human_GAPDH_TAA_len41_fa20_ta0_fm14_tm6,t
3289@TOP@human_GAPDH_TAA_len41_fa20_ta0_fm14_tm6*133*g,0,1,2078,0,2079,1.0,133,3289@TOP@human_GAPDH_TAA_len41_fa20_ta0_fm14_tm6,g
3289@TOP@human_GAPDH_TAA_len41_fa20_ta0_fm14_tm6*134*g,0,0,2089,0,2089,1.0,134,3289@TOP@human_GAPDH_TAA_len41_fa20_ta0_fm14_tm6,g
3290@TOP@human_GAPDH_TAA_len41_fa20_ta0_fm14_tm6*114*t,0,1,0,1840,1841,0.0,114,3290@TOP@human_GAPDH_TAA_len41_fa20_ta0_fm14_tm6,t
3290@TOP@human_GAPDH_TAA_len41_fa20_ta0_fm14_tm6*115*c,0,1851,0,0,1851,0.0,115,3290@TOP@human_GAPDH_TAA_len41_fa20_ta0_fm14_tm6,c
3290@TOP@human_GAPDH_TAA_len41_fa20_ta0_fm14_tm6*116*c,0,1844,0,0,1844,0.0,116,3290@TOP@human_GAPDH_TAA_len41_fa20_ta0_fm14_tm6,c
3290@TOP@human_GAPDH_TAA_len41_fa20_ta0_fm14_tm6*117*a,1839,0,2,0,1841,0.001,117,3290@TOP@human_GAPDH_TAA_len41_fa20_ta0_fm14_tm6,a
3290@TOP@human_GAPDH_TAA_len41_fa20_ta0_fm14_tm6*118*a,1807,0,25,0,1832,0.014,118,3290@TOP@human_GAPDH_TAA_len41_fa20_ta0_fm14_tm6,a
3290@TOP@human_GAPDH_TAA_len41_fa20_ta0_fm14_tm6*119*g,0,0,1825,0,1825,1.0,119,3290@TOP@human_GAPDH_TAA_len41_fa20_ta0_fm14_tm6,g
3290@TOP@human_GAPDH_TAA_len41_fa20_ta0_fm14_tm6*120*g,1,0,1824,0,1825,0.999,120,3290@TOP@human_GAPDH_TAA_len41_fa20_ta0_fm14_tm6,g
3290@TOP@human_GAPDH_TAA_len41_fa20_ta0_fm14_tm6*121*a,1836,0,1,0,1837,0.001,121,3290@TOP@human_GAPDH_TAA_len41_fa20_ta0_fm14_tm6,a
3290@TOP@human_GAPDH_TAA_len41_fa20_ta0_fm14_tm6*122*g,0,0,1843,0,1843,1.0,122,3290@TOP@human_GAPDH_TAA_len41_fa20_ta0_fm14_tm6,g
3290@TOP@human_GAPDH_TAA_len41_fa20_ta0_fm14_tm6*123*t,0,0,0,1818,1818,0.0,123,3290@TOP@human_GAPDH_TAA_len41_fa20_ta0_fm14_tm6,t
3290@TOP@human_GAPDH_TAA_len41_fa20_ta0_fm14_tm6*124*a,1762,0,50,0,1812,0.028,124,3290@TOP@human_GAPDH_TAA_len41_fa20_ta0_fm14_tm6,a
3290@TOP@human_GAPDH_TAA_len41_fa20_ta0_fm14_tm6*125*a,1773,3,32,0,1808,0.018,125,3290@TOP@human_GAPDH_TAA_len41_fa20_ta0_fm14_tm6,a
3290@TOP@human_GAPDH_TAA_len41_fa20_ta0_fm14_tm6*126*g,0,0,1819,0,1819,1.0,126,3290@TOP@human_GAPDH_TAA_len41_fa20_ta0_fm14_tm6,g
3290@TOP@human_GAPDH_TAA_len41_fa20_ta0_fm14_tm6*127*a,1837,0,0,0,1837,0.0,127,3290@TOP@human_GAPDH_TAA_len41_fa20_ta0_fm14_tm6,a
3290@TOP@human_GAPDH_TAA_len41_fa20_ta0_fm14_tm6*128*c,0,1850,0,0,1850,0.0,128,3290@TOP@human_GAPDH_TAA_len41_fa20_ta0_fm14_tm6,c
3290@TOP@human_GAPDH_TAA_len41_fa20_ta0_fm14_tm6*129*c,0,1834,0,0,1834,0.0,129,3290@TOP@human_GAPDH_TAA_len41_fa20_ta0_fm14_tm6,c
3290@TOP@human_GAPDH_TAA_len41_fa20_ta0_fm14_tm6*130*c,1,1844,0,0,1845,0.0,130,3290@TOP@human_GAPDH_TAA_len41_fa20_ta0_fm14_tm6,c
3290@TOP@human_GAPDH_TAA_len41_fa20_ta0_fm14_tm6*131*c,0,1850,0,0,1850,0.0,131,3290@TOP@human_GAPDH_TAA_len41_fa20_ta0_fm14_tm6,c
3290@TOP@human_GAPDH_TAA_len41_fa20_ta0_fm14_tm6*132*t,1,0,0,1824,1825,0.0,132,3290@TOP@human_GAPDH_TAA_len41_fa20_ta0_fm14_tm6,t
3290@TOP@human_GAPDH_TAA_len41_fa20_ta0_fm14_tm6*133*g,3,0,1814,0,1817,0.998,133,3290@TOP@human_GAPDH_TAA_len41_fa20_ta0_fm14_tm6,g
3290@TOP@human_GAPDH_TAA_len41_fa20_ta0_fm14_tm6*134*g,0,0,1825,0,1825,1.0,134,3290@TOP@human_GAPDH_TAA_len41_fa20_ta0_fm14_tm6,g
3291@TOP@human_GAPDH_TAA_len41_fa20_ta0_fm14_tm6*114*t,0,5,0,24672,24677,0.0,114,3291@TOP@human_GAPDH_TAA_len41_fa20_ta0_fm14_tm6,t
3291@TOP@human_GAPDH_TAA_len41_fa20_ta0_fm14_tm6*115*c,0,24826,0,1,24827,0.0,115,3291@TOP@human_GAPDH_TAA_len41_fa20_ta0_fm14_tm6,c
3291@TOP@human_GAPDH_TAA_len41_fa20_ta0_fm14_tm6*116*c,0,24733,0,0,24733,0.0,116,3291@TOP@human_GAPDH_TAA_len41_fa20_ta0_fm14_tm6,c
3291@TOP@human_GAPDH_TAA_len41_fa20_ta0_fm14_tm6*117*a,24655,0,56,3,24714,0.002,117,3291@TOP@human_GAPDH_TAA_len41_fa20_ta0_fm14_tm6,a
3291@TOP@human_GAPDH_TAA_len41_fa20_ta0_fm14_tm6*118*a,24267,0,312,2,24581,0.013,118,3291@TOP@human_GAPDH_TAA_len41_fa20_ta0_fm14_tm6,a
3291@TOP@human_GAPDH_TAA_len41_fa20_ta0_fm14_tm6*119*g,0,0,24538,0,24538,1.0,119,3291@TOP@human_GAPDH_TAA_len41_fa20_ta0_fm14_tm6,g
3291@TOP@human_GAPDH_TAA_len41_fa20_ta0_fm14_tm6*120*g,2,0,24430,2,24434,1.0,120,3291@TOP@human_GAPDH_TAA_len41_fa20_ta0_fm14_tm6,g
3291@TOP@human_GAPDH_TAA_len41_fa20_ta0_fm14_tm6*121*a,24708,0,2,0,24710,0.0,121,3291@TOP@human_GAPDH_TAA_len41_fa20_ta0_fm14_tm6,a
3291@TOP@human_GAPDH_TAA_len41_fa20_ta0_fm14_tm6*122*g,1,0,24704,1,24706,1.0,122,3291@TOP@human_GAPDH_TAA_len41_fa20_ta0_fm14_tm6,g
3291@TOP@human_GAPDH_TAA_len41_fa20_ta0_fm14_tm6*123*t,2,1,3,24384,24390,0.0,123,3291@TOP@human_GAPDH_TAA_len41_fa20_ta0_fm14_tm6,t
3291@TOP@human_GAPDH_TAA_len41_fa20_ta0_fm14_tm6*124*a,23605,2,743,0,24350,0.031,124,3291@TOP@human_GAPDH_TAA_len41_fa20_ta0_fm14_tm6,a
3291@TOP@human_GAPDH_TAA_len41_fa20_ta0_fm14_tm6*125*a,23866,1,412,0,24279,0.017,125,3291@TOP@human_GAPDH_TAA_len41_fa20_ta0_fm14_tm6,a
3291@TOP@human_GAPDH_TAA_len41_fa20_ta0_fm14_tm6*126*g,1,0,24391,1,24393,1.0,126,3291@TOP@human_GAPDH_TAA_len41_fa20_ta0_fm14_tm6,g
3291@TOP@human_GAPDH_TAA_len41_fa20_ta0_fm14_tm6*127*a,24640,1,15,0,24656,0.001,127,3291@TOP@human_GAPDH_TAA_len41_fa20_ta0_fm14_tm6,a
3291@TOP@human_GAPDH_TAA_len41_fa20_ta0_fm14_tm6*128*c,2,24758,4,2,24766,0.0,128,3291@TOP@human_GAPDH_TAA_len41_fa20_ta0_fm14_tm6,c
3291@TOP@human_GAPDH_TAA_len41_fa20_ta0_fm14_tm6*129*c,1,24554,1,7,24563,0.0,129,3291@TOP@human_GAPDH_TAA_len41_fa20_ta0_fm14_tm6,c
3291@TOP@human_GAPDH_TAA_len41_fa20_ta0_fm14_tm6*130*c,0,24718,4,0,24722,0.0,130,3291@TOP@human_GAPDH_TAA_len41_fa20_ta0_fm14_tm6,c
3291@TOP@human_GAPDH_TAA_len41_fa20_ta0_fm14_tm6*131*c,3,24764,0,8,24775,0.0,131,3291@TOP@human_GAPDH_TAA_len41_fa20_ta0_fm14_tm6,c
3291@TOP@human_GAPDH_TAA_len41_fa20_ta0_fm14_tm6*132*t,3,3,0,24429,24435,0.0,132,3291@TOP@human_GAPDH_TAA_len41_fa20_ta0_fm14_tm6,t
3291@TOP@human_GAPDH_TAA_len41_fa20_ta0_fm14_tm6*133*g,0,0,24375,2,24377,1.0,133,3291@TOP@human_GAPDH_TAA_len41_fa20_ta0_fm14_tm6,g
3291@TOP@human_GAPDH_TAA_len41_fa20_ta0_fm14_tm6*134*g,0,6,24462,0,24468,1.0,134,3291@TOP@human_GAPDH_TAA_len41_fa20_ta0_fm14_tm6,g
3292@TOP@human_GAPDH_TAA_len41_fa20_ta0_fm14_tm6*114*t,2,2,0,4975,4979,0.0,114,3292@TOP@human_GAPDH_TAA_len41_fa20_ta0_fm14_tm6,t
3292@TOP@human_GAPDH_TAA_len41_fa20_ta0_fm14_tm6*115*c,0,5014,0,0,5014,0.0,115,3292@TOP@human_GAPDH_TAA_len41_fa20_ta0_fm14_tm6,c
3292@TOP@human_GAPDH_TAA_len41_fa20_ta0_fm14_tm6*116*c,1,4986,0,0,4987,0.0,116,3292@TOP@human_GAPDH_TAA_len41_fa20_ta0_fm14_tm6,c
3292@TOP@human_GAPDH_TAA_len41_fa20_ta0_fm14_tm6*117*a,4975,0,10,0,4985,0.002,117,3292@TOP@human_GAPDH_TAA_len41_fa20_ta0_fm14_tm6,a
3292@TOP@human_GAPDH_TAA_len41_fa20_ta0_fm14_tm6*118*a,4875,0,96,0,4971,0.019,118,3292@TOP@human_GAPDH_TAA_len41_fa20_ta0_fm14_tm6,a
3292@TOP@human_GAPDH_TAA_len41_fa20_ta0_fm14_tm6*119*g,0,0,4939,0,4939,1.0,119,3292@TOP@human_GAPDH_TAA_len41_fa20_ta0_fm14_tm6,g
3292@TOP@human_GAPDH_TAA_len41_fa20_ta0_fm14_tm6*120*g,1,0,4937,0,4938,1.0,120,3292@TOP@human_GAPDH_TAA_len41_fa20_ta0_fm14_tm6,g
3292@TOP@human_GAPDH_TAA_len41_fa20_ta0_fm14_tm6*121*a,4984,0,1,0,4985,0.0,121,3292@TOP@human_GAPDH_TAA_len41_fa20_ta0_fm14_tm6,a
3292@TOP@human_GAPDH_TAA_len41_fa20_ta0_fm14_tm6*122*g,2,0,4990,0,4992,1.0,122,3292@TOP@human_GAPDH_TAA_len41_fa20_ta0_fm14_tm6,g
3292@TOP@human_GAPDH_TAA_len41_fa20_ta0_fm14_tm6*123*t,1,0,0,4921,4922,0.0,123,3292@TOP@human_GAPDH_TAA_len41_fa20_ta0_fm14_tm6,t
3292@TOP@human_GAPDH_TAA_len41_fa20_ta0_fm14_tm6*124*a,4692,0,218,0,4910,0.044,124,3292@TOP@human_GAPDH_TAA_len41_fa20_ta0_fm14_tm6,a
3292@TOP@human_GAPDH_TAA_len41_fa20_ta0_fm14_tm6*125*a,4791,1,115,1,4908,0.023,125,3292@TOP@human_GAPDH_TAA_len41_fa20_ta0_fm14_tm6,a
3292@TOP@human_GAPDH_TAA_len41_fa20_ta0_fm14_tm6*126*g,0,0,4921,0,4921,1.0,126,3292@TOP@human_GAPDH_TAA_len41_fa20_ta0_fm14_tm6,g
3292@TOP@human_GAPDH_TAA_len41_fa20_ta0_fm14_tm6*127*a,4971,0,6,0,4977,0.001,127,3292@TOP@human_GAPDH_TAA_len41_fa20_ta0_fm14_tm6,a
3292@TOP@human_GAPDH_TAA_len41_fa20_ta0_fm14_tm6*128*c,0,4994,0,1,4995,0.0,128,3292@TOP@human_GAPDH_TAA_len41_fa20_ta0_fm14_tm6,c
3292@TOP@human_GAPDH_TAA_len41_fa20_ta0_fm14_tm6*129*c,1,4966,0,0,4967,0.0,129,3292@TOP@human_GAPDH_TAA_len41_fa20_ta0_fm14_tm6,c
3292@TOP@human_GAPDH_TAA_len41_fa20_ta0_fm14_tm6*130*c,0,4988,1,1,4990,0.0,130,3292@TOP@human_GAPDH_TAA_len41_fa20_ta0_fm14_tm6,c
3292@TOP@human_GAPDH_TAA_len41_fa20_ta0_fm14_tm6*131*c,0,5002,0,2,5004,0.0,131,3292@TOP@human_GAPDH_TAA_len41_fa20_ta0_fm14_tm6,c
3292@TOP@human_GAPDH_TAA_len41_fa20_ta0_fm14_tm6*132*t,0,1,1,4927,4929,0.0,132,3292@TOP@human_GAPDH_TAA_len41_fa20_ta0_fm14_tm6,t
3292@TOP@human_GAPDH_TAA_len41_fa20_ta0_fm14_tm6*133*g,0,0,4917,0,4917,1.0,133,3292@TOP@human_GAPDH_TAA_len41_fa20_ta0_fm14_tm6,g
3292@TOP@human_GAPDH_TAA_len41_fa20_ta0_fm14_tm6*134*g,1,1,4950,0,4952,1.0,134,3292@TOP@human_GAPDH_TAA_len41_fa20_ta0_fm14_tm6,g
3293@TOP@human_GAPDH_TAA_len41_fa20_ta0_fm14_tm6*114*t,1,0,0,3335,3336,0.0,114,3293@TOP@human_GAPDH_TAA_len41_fa20_ta0_fm14_tm6,t
3293@TOP@human_GAPDH_TAA_len41_fa20_ta0_fm14_tm6*115*c,0,3361,0,0,3361,0.0,115,3293@TOP@human_GAPDH_TAA_len41_fa20_ta0_fm14_tm6,c
3293@TOP@human_GAPDH_TAA_len41_fa20_ta0_fm14_tm6*116*c,0,3347,0,0,3347,0.0,116,3293@TOP@human_GAPDH_TAA_len41_fa20_ta0_fm14_tm6,c
3293@TOP@human_GAPDH_TAA_len41_fa20_ta0_fm14_tm6*117*a,3339,0,8,0,3347,0.002,117,3293@TOP@human_GAPDH_TAA_len41_fa20_ta0_fm14_tm6,a
3293@TOP@human_GAPDH_TAA_len41_fa20_ta0_fm14_tm6*118*a,3266,0,52,0,3318,0.016,118,3293@TOP@human_GAPDH_TAA_len41_fa20_ta0_fm14_tm6,a
3293@TOP@human_GAPDH_TAA_len41_fa20_ta0_fm14_tm6*119*g,0,0,3312,0,3312,1.0,119,3293@TOP@human_GAPDH_TAA_len41_fa20_ta0_fm14_tm6,g
3293@TOP@human_GAPDH_TAA_len41_fa20_ta0_fm14_tm6*120*g,0,0,3305,0,3305,1.0,120,3293@TOP@human_GAPDH_TAA_len41_fa20_ta0_fm14_tm6,g
3293@TOP@human_GAPDH_TAA_len41_fa20_ta0_fm14_tm6*121*a,3341,0,1,0,3342,0.0,121,3293@TOP@human_GAPDH_TAA_len41_fa20_ta0_fm14_tm6,a
3293@TOP@human_GAPDH_TAA_len41_fa20_ta0_fm14_tm6*122*g,0,0,3341,0,3341,1.0,122,3293@TOP@human_GAPDH_TAA_len41_fa20_ta0_fm14_tm6,g
3293@TOP@human_GAPDH_TAA_len41_fa20_ta0_fm14_tm6*123*t,0,0,0,3290,3290,0.0,123,3293@TOP@human_GAPDH_TAA_len41_fa20_ta0_fm14_tm6,t
3293@TOP@human_GAPDH_TAA_len41_fa20_ta0_fm14_tm6*124*a,3147,0,146,0,3293,0.044,124,3293@TOP@human_GAPDH_TAA_len41_fa20_ta0_fm14_tm6,a
3293@TOP@human_GAPDH_TAA_len41_fa20_ta0_fm14_tm6*125*a,3234,0,66,0,3300,0.02,125,3293@TOP@human_GAPDH_TAA_len41_fa20_ta0_fm14_tm6,a
3293@TOP@human_GAPDH_TAA_len41_fa20_ta0_fm14_tm6*126*g,0,0,3290,0,3290,1.0,126,3293@TOP@human_GAPDH_TAA_len41_fa20_ta0_fm14_tm6,g
3293@TOP@human_GAPDH_TAA_len41_fa20_ta0_fm14_tm6*127*a,3315,0,7,0,3322,0.002,127,3293@TOP@human_GAPDH_TAA_len41_fa20_ta0_fm14_tm6,a
3293@TOP@human_GAPDH_TAA_len41_fa20_ta0_fm14_tm6*128*c,0,3346,0,0,3346,0.0,128,3293@TOP@human_GAPDH_TAA_len41_fa20_ta0_fm14_tm6,c
3293@TOP@human_GAPDH_TAA_len41_fa20_ta0_fm14_tm6*129*c,0,3318,0,0,3318,0.0,129,3293@TOP@human_GAPDH_TAA_len41_fa20_ta0_fm14_tm6,c
3293@TOP@human_GAPDH_TAA_len41_fa20_ta0_fm14_tm6*130*c,0,3342,0,3,3345,0.0,130,3293@TOP@human_GAPDH_TAA_len41_fa20_ta0_fm14_tm6,c
3293@TOP@human_GAPDH_TAA_len41_fa20_ta0_fm14_tm6*131*c,0,3355,0,1,3356,0.0,131,3293@TOP@human_GAPDH_TAA_len41_fa20_ta0_fm14_tm6,c
3293@TOP@human_GAPDH_TAA_len41_fa20_ta0_fm14_tm6*132*t,2,1,4,3289,3296,0.001,132,3293@TOP@human_GAPDH_TAA_len41_fa20_ta0_fm14_tm6,t
3293@TOP@human_GAPDH_TAA_len41_fa20_ta0_fm14_tm6*133*g,0,0,3302,0,3302,1.0,133,3293@TOP@human_GAPDH_TAA_len41_fa20_ta0_fm14_tm6,g
3293@TOP@human_GAPDH_TAA_len41_fa20_ta0_fm14_tm6*134*g,0,0,3312,1,3313,1.0,134,3293@TOP@human_GAPDH_TAA_len41_fa20_ta0_fm14_tm6,g
3294@TOP@human_GAPDH_TAA_len41_fa20_ta0_fm14_tm6*114*t,0,2,0,12468,12470,0.0,114,3294@TOP@human_GAPDH_TAA_len41_fa20_ta0_fm14_tm6,t
3294@TOP@human_GAPDH_TAA_len41_fa20_ta0_fm14_tm6*115*c,0,12532,0,1,12533,0.0,115,3294@TOP@human_GAPDH_TAA_len41_fa20_ta0_fm14_tm6,c
3294@TOP@human_GAPDH_TAA_len41_fa20_ta0_fm14_tm6*116*c,1,12473,0,0,12474,0.0,116,3294@TOP@human_GAPDH_TAA_len41_fa20_ta0_fm14_tm6,c
3294@TOP@human_GAPDH_TAA_len41_fa20_ta0_fm14_tm6*117*a,12454,0,28,0,12482,0.002,117,3294@TOP@human_GAPDH_TAA_len41_fa20_ta0_fm14_tm6,a
3294@TOP@human_GAPDH_TAA_len41_fa20_ta0_fm14_tm6*118*a,12255,0,146,1,12402,0.012,118,3294@TOP@human_GAPDH_TAA_len41_fa20_ta0_fm14_tm6,a
3294@TOP@human_GAPDH_TAA_len41_fa20_ta0_fm14_tm6*119*g,1,0,12399,0,12400,1.0,119,3294@TOP@human_GAPDH_TAA_len41_fa20_ta0_fm14_tm6,g
3294@TOP@human_GAPDH_TAA_len41_fa20_ta0_fm14_tm6*120*g,0,0,12339,0,12339,1.0,120,3294@TOP@human_GAPDH_TAA_len41_fa20_ta0_fm14_tm6,g
3294@TOP@human_GAPDH_TAA_len41_fa20_ta0_fm14_tm6*121*a,12485,0,2,0,12487,0.0,121,3294@TOP@human_GAPDH_TAA_len41_fa20_ta0_fm14_tm6,a
3294@TOP@human_GAPDH_TAA_len41_fa20_ta0_fm14_tm6*122*g,0,0,12481,0,12481,1.0,122,3294@TOP@human_GAPDH_TAA_len41_fa20_ta0_fm14_tm6,g
3294@TOP@human_GAPDH_TAA_len41_fa20_ta0_fm14_tm6*123*t,1,0,4,12284,12289,0.0,123,3294@TOP@human_GAPDH_TAA_len41_fa20_ta0_fm14_tm6,t
3294@TOP@human_GAPDH_TAA_len41_fa20_ta0_fm14_tm6*124*a,11943,0,343,0,12286,0.028,124,3294@TOP@human_GAPDH_TAA_len41_fa20_ta0_fm14_tm6,a
3294@TOP@human_GAPDH_TAA_len41_fa20_ta0_fm14_tm6*125*a,12030,0,204,0,12234,0.017,125,3294@TOP@human_GAPDH_TAA_len41_fa20_ta0_fm14_tm6,a
3294@TOP@human_GAPDH_TAA_len41_fa20_ta0_fm14_tm6*126*g,1,0,12333,0,12334,1.0,126,3294@TOP@human_GAPDH_TAA_len41_fa20_ta0_fm14_tm6,g
3294@TOP@human_GAPDH_TAA_len41_fa20_ta0_fm14_tm6*127*a,12442,3,8,0,12453,0.001,127,3294@TOP@human_GAPDH_TAA_len41_fa20_ta0_fm14_tm6,a
3294@TOP@human_GAPDH_TAA_len41_fa20_ta0_fm14_tm6*128*c,0,12506,1,1,12508,0.0,128,3294@TOP@human_GAPDH_TAA_len41_fa20_ta0_fm14_tm6,c
3294@TOP@human_GAPDH_TAA_len41_fa20_ta0_fm14_tm6*129*c,1,12419,0,0,12420,0.0,129,3294@TOP@human_GAPDH_TAA_len41_fa20_ta0_fm14_tm6,c
3294@TOP@human_GAPDH_TAA_len41_fa20_ta0_fm14_tm6*130*c,2,12487,0,0,12489,0.0,130,3294@TOP@human_GAPDH_TAA_len41_fa20_ta0_fm14_tm6,c
3294@TOP@human_GAPDH_TAA_len41_fa20_ta0_fm14_tm6*131*c,1,12522,1,0,12524,0.0,131,3294@TOP@human_GAPDH_TAA_len41_fa20_ta0_fm14_tm6,c
3294@TOP@human_GAPDH_TAA_len41_fa20_ta0_fm14_tm6*132*t,1,1,0,12327,12329,0.0,132,3294@TOP@human_GAPDH_TAA_len41_fa20_ta0_fm14_tm6,t
3294@TOP@human_GAPDH_TAA_len41_fa20_ta0_fm14_tm6*133*g,0,0,12317,0,12317,1.0,133,3294@TOP@human_GAPDH_TAA_len41_fa20_ta0_fm14_tm6,g
3294@TOP@human_GAPDH_TAA_len41_fa20_ta0_fm14_tm6*134*g,3,4,12370,0,12377,0.999,134,3294@TOP@human_GAPDH_TAA_len41_fa20_ta0_fm14_tm6,g
3295@TOP@human_GAPDH_TAA_len41_fa20_ta0_fm14_tm6*114*t,4,6,0,11248,11258,0.0,114,3295@TOP@human_GAPDH_TAA_len41_fa20_ta0_fm14_tm6,t
3295@TOP@human_GAPDH_TAA_len41_fa20_ta0_fm14_tm6*115*c,0,11316,0,0,11316,0.0,115,3295@TOP@human_GAPDH_TAA_len41_fa20_ta0_fm14_tm6,c
3295@TOP@human_GAPDH_TAA_len41_fa20_ta0_fm14_tm6*116*c,0,11273,0,1,11274,0.0,116,3295@TOP@human_GAPDH_TAA_len41_fa20_ta0_fm14_tm6,c
3295@TOP@human_GAPDH_TAA_len41_fa20_ta0_fm14_tm6*117*a,11270,0,13,1,11284,0.001,117,3295@TOP@human_GAPDH_TAA_len41_fa20_ta0_fm14_tm6,a
3295@TOP@human_GAPDH_TAA_len41_fa20_ta0_fm14_tm6*118*a,11062,1,138,0,11201,0.012,118,3295@TOP@human_GAPDH_TAA_len41_fa20_ta0_fm14_tm6,a
3295@TOP@human_GAPDH_TAA_len41_fa20_ta0_fm14_tm6*119*g,3,0,11162,2,11167,1.0,119,3295@TOP@human_GAPDH_TAA_len41_fa20_ta0_fm14_tm6,g
3295@TOP@human_GAPDH_TAA_len41_fa20_ta0_fm14_tm6*120*g,0,0,11134,1,11135,1.0,120,3295@TOP@human_GAPDH_TAA_len41_fa20_ta0_fm14_tm6,g
3295@TOP@human_GAPDH_TAA_len41_fa20_ta0_fm14_tm6*121*a,11257,0,3,0,11260,0.0,121,3295@TOP@human_GAPDH_TAA_len41_fa20_ta0_fm14_tm6,a
3295@TOP@human_GAPDH_TAA_len41_fa20_ta0_fm14_tm6*122*g,0,0,11262,0,11262,1.0,122,3295@TOP@human_GAPDH_TAA_len41_fa20_ta0_fm14_tm6,g
3295@TOP@human_GAPDH_TAA_len41_fa20_ta0_fm14_tm6*123*t,1,1,1,11132,11135,0.0,123,3295@TOP@human_GAPDH_TAA_len41_fa20_ta0_fm14_tm6,t
3295@TOP@human_GAPDH_TAA_len41_fa20_ta0_fm14_tm6*124*a,10698,0,387,1,11086,0.035,124,3295@TOP@human_GAPDH_TAA_len41_fa20_ta0_fm14_tm6,a
3295@TOP@human_GAPDH_TAA_len41_fa20_ta0_fm14_tm6*125*a,10893,2,157,1,11053,0.014,125,3295@TOP@human_GAPDH_TAA_len41_fa20_ta0_fm14_tm6,a
3295@TOP@human_GAPDH_TAA_len41_fa20_ta0_fm14_tm6*126*g,0,0,11097,1,11098,1.0,126,3295@TOP@human_GAPDH_TAA_len41_fa20_ta0_fm14_tm6,g
3295@TOP@human_GAPDH_TAA_len41_fa20_ta0_fm14_tm6*127*a,11235,0,4,0,11239,0.0,127,3295@TOP@human_GAPDH_TAA_len41_fa20_ta0_fm14_tm6,a
3295@TOP@human_GAPDH_TAA_len41_fa20_ta0_fm14_tm6*128*c,0,11290,1,3,11294,0.0,128,3295@TOP@human_GAPDH_TAA_len41_fa20_ta0_fm14_tm6,c
3295@TOP@human_GAPDH_TAA_len41_fa20_ta0_fm14_tm6*129*c,3,11195,0,3,11201,0.0,129,3295@TOP@human_GAPDH_TAA_len41_fa20_ta0_fm14_tm6,c
3295@TOP@human_GAPDH_TAA_len41_fa20_ta0_fm14_tm6*130*c,0,11272,0,2,11274,0.0,130,3295@TOP@human_GAPDH_TAA_len41_fa20_ta0_fm14_tm6,c
3295@TOP@human_GAPDH_TAA_len41_fa20_ta0_fm14_tm6*131*c,2,11290,0,0,11292,0.0,131,3295@TOP@human_GAPDH_TAA_len41_fa20_ta0_fm14_tm6,c
3295@TOP@human_GAPDH_TAA_len41_fa20_ta0_fm14_tm6*132*t,2,2,0,11126,11130,0.0,132,3295@TOP@human_GAPDH_TAA_len41_fa20_ta0_fm14_tm6,t
3295@TOP@human_GAPDH_TAA_len41_fa20_ta0_fm14_tm6*133*g,3,0,11121,0,11124,1.0,133,3295@TOP@human_GAPDH_TAA_len41_fa20_ta0_fm14_tm6,g
3295@TOP@human_GAPDH_TAA_len41_fa20_ta0_fm14_tm6*134*g,0,3,11155,0,11158,1.0,134,3295@TOP@human_GAPDH_TAA_len41_fa20_ta0_fm14_tm6,g
3296@TOP@human_GAPDH_TAA_len41_fa20_ta0_fm14_tm6*114*t,0,0,0,2901,2901,0.0,114,3296@TOP@human_GAPDH_TAA_len41_fa20_ta0_fm14_tm6,t
3296@TOP@human_GAPDH_TAA_len41_fa20_ta0_fm14_tm6*115*c,0,2924,0,0,2924,0.0,115,3296@TOP@human_GAPDH_TAA_len41_fa20_ta0_fm14_tm6,c
3296@TOP@human_GAPDH_TAA_len41_fa20_ta0_fm14_tm6*116*c,0,2917,1,0,2918,0.0,116,3296@TOP@human_GAPDH_TAA_len41_fa20_ta0_fm14_tm6,c
3296@TOP@human_GAPDH_TAA_len41_fa20_ta0_fm14_tm6*117*a,2898,0,9,0,2907,0.003,117,3296@TOP@human_GAPDH_TAA_len41_fa20_ta0_fm14_tm6,a
3296@TOP@human_GAPDH_TAA_len41_fa20_ta0_fm14_tm6*118*a,2855,0,41,0,2896,0.014,118,3296@TOP@human_GAPDH_TAA_len41_fa20_ta0_fm14_tm6,a
3296@TOP@human_GAPDH_TAA_len41_fa20_ta0_fm14_tm6*119*g,1,0,2890,0,2891,1.0,119,3296@TOP@human_GAPDH_TAA_len41_fa20_ta0_fm14_tm6,g
3296@TOP@human_GAPDH_TAA_len41_fa20_ta0_fm14_tm6*120*g,0,0,2877,0,2877,1.0,120,3296@TOP@human_GAPDH_TAA_len41_fa20_ta0_fm14_tm6,g
3296@TOP@human_GAPDH_TAA_len41_fa20_ta0_fm14_tm6*121*a,2908,0,0,0,2908,0.0,121,3296@TOP@human_GAPDH_TAA_len41_fa20_ta0_fm14_tm6,a
3296@TOP@human_GAPDH_TAA_len41_fa20_ta0_fm14_tm6*122*g,0,0,2913,0,2913,1.0,122,3296@TOP@human_GAPDH_TAA_len41_fa20_ta0_fm14_tm6,g
3296@TOP@human_GAPDH_TAA_len41_fa20_ta0_fm14_tm6*123*t,0,0,3,2870,2873,0.001,123,3296@TOP@human_GAPDH_TAA_len41_fa20_ta0_fm14_tm6,t
3296@TOP@human_GAPDH_TAA_len41_fa20_ta0_fm14_tm6*124*a,2776,0,80,0,2856,0.028,124,3296@TOP@human_GAPDH_TAA_len41_fa20_ta0_fm14_tm6,a
3296@TOP@human_GAPDH_TAA_len41_fa20_ta0_fm14_tm6*125*a,2778,0,85,0,2863,0.03,125,3296@TOP@human_GAPDH_TAA_len41_fa20_ta0_fm14_tm6,a
3296@TOP@human_GAPDH_TAA_len41_fa20_ta0_fm14_tm6*126*g,0,0,2864,0,2864,1.0,126,3296@TOP@human_GAPDH_TAA_len41_fa20_ta0_fm14_tm6,g
3296@TOP@human_GAPDH_TAA_len41_fa20_ta0_fm14_tm6*127*a,2893,0,8,0,2901,0.003,127,3296@TOP@human_GAPDH_TAA_len41_fa20_ta0_fm14_tm6,a
3296@TOP@human_GAPDH_TAA_len41_fa20_ta0_fm14_tm6*128*c,0,2917,0,0,2917,0.0,128,3296@TOP@human_GAPDH_TAA_len41_fa20_ta0_fm14_tm6,c
3296@TOP@human_GAPDH_TAA_len41_fa20_ta0_fm14_tm6*129*c,0,2909,0,0,2909,0.0,129,3296@TOP@human_GAPDH_TAA_len41_fa20_ta0_fm14_tm6,c
3296@TOP@human_GAPDH_TAA_len41_fa20_ta0_fm14_tm6*130*c,0,2911,0,0,2911,0.0,130,3296@TOP@human_GAPDH_TAA_len41_fa20_ta0_fm14_tm6,c
3296@TOP@human_GAPDH_TAA_len41_fa20_ta0_fm14_tm6*131*c,0,2914,0,0,2914,0.0,131,3296@TOP@human_GAPDH_TAA_len41_fa20_ta0_fm14_tm6,c
3296@TOP@human_GAPDH_TAA_len41_fa20_ta0_fm14_tm6*132*t,0,0,0,2871,2871,0.0,132,3296@TOP@human_GAPDH_TAA_len41_fa20_ta0_fm14_tm6,t
3296@TOP@human_GAPDH_TAA_len41_fa20_ta0_fm14_tm6*133*g,0,0,2876,0,2876,1.0,133,3296@TOP@human_GAPDH_TAA_len41_fa20_ta0_fm14_tm6,g
3296@TOP@human_GAPDH_TAA_len41_fa20_ta0_fm14_tm6*134*g,0,1,2893,0,2894,1.0,134,3296@TOP@human_GAPDH_TAA_len41_fa20_ta0_fm14_tm6,g
3297@TOP@human_GAPDH_TAA_len41_fa20_ta0_fm14_tm6*114*t,1,3,0,4063,4067,0.0,114,3297@TOP@human_GAPDH_TAA_len41_fa20_ta0_fm14_tm6,t
3297@TOP@human_GAPDH_TAA_len41_fa20_ta0_fm14_tm6*115*c,0,4088,0,0,4088,0.0,115,3297@TOP@human_GAPDH_TAA_len41_fa20_ta0_fm14_tm6,c
3297@TOP@human_GAPDH_TAA_len41_fa20_ta0_fm14_tm6*116*c,1,4072,0,0,4073,0.0,116,3297@TOP@human_GAPDH_TAA_len41_fa20_ta0_fm14_tm6,c
3297@TOP@human_GAPDH_TAA_len41_fa20_ta0_fm14_tm6*117*a,4057,0,12,0,4069,0.003,117,3297@TOP@human_GAPDH_TAA_len41_fa20_ta0_fm14_tm6,a
3297@TOP@human_GAPDH_TAA_len41_fa20_ta0_fm14_tm6*118*a,3991,0,51,0,4042,0.013,118,3297@TOP@human_GAPDH_TAA_len41_fa20_ta0_fm14_tm6,a
3297@TOP@human_GAPDH_TAA_len41_fa20_ta0_fm14_tm6*119*g,1,0,4048,0,4049,1.0,119,3297@TOP@human_GAPDH_TAA_len41_fa20_ta0_fm14_tm6,g
3297@TOP@human_GAPDH_TAA_len41_fa20_ta0_fm14_tm6*120*g,0,0,4010,0,4010,1.0,120,3297@TOP@human_GAPDH_TAA_len41_fa20_ta0_fm14_tm6,g
3297@TOP@human_GAPDH_TAA_len41_fa20_ta0_fm14_tm6*121*a,4061,0,1,0,4062,0.0,121,3297@TOP@human_GAPDH_TAA_len41_fa20_ta0_fm14_tm6,a
3297@TOP@human_GAPDH_TAA_len41_fa20_ta0_fm14_tm6*122*g,0,0,4072,0,4072,1.0,122,3297@TOP@human_GAPDH_TAA_len41_fa20_ta0_fm14_tm6,g
3297@TOP@human_GAPDH_TAA_len41_fa20_ta0_fm14_tm6*123*t,2,0,0,4019,4021,0.0,123,3297@TOP@human_GAPDH_TAA_len41_fa20_ta0_fm14_tm6,t
3297@TOP@human_GAPDH_TAA_len41_fa20_ta0_fm14_tm6*124*a,3900,0,118,0,4018,0.029,124,3297@TOP@human_GAPDH_TAA_len41_fa20_ta0_fm14_tm6,a
3297@TOP@human_GAPDH_TAA_len41_fa20_ta0_fm14_tm6*125*a,3937,0,63,0,4000,0.016,125,3297@TOP@human_GAPDH_TAA_len41_fa20_ta0_fm14_tm6,a
3297@TOP@human_GAPDH_TAA_len41_fa20_ta0_fm14_tm6*126*g,0,0,4025,0,4025,1.0,126,3297@TOP@human_GAPDH_TAA_len41_fa20_ta0_fm14_tm6,g
3297@TOP@human_GAPDH_TAA_len41_fa20_ta0_fm14_tm6*127*a,4057,1,1,0,4059,0.0,127,3297@TOP@human_GAPDH_TAA_len41_fa20_ta0_fm14_tm6,a
3297@TOP@human_GAPDH_TAA_len41_fa20_ta0_fm14_tm6*128*c,0,4073,2,0,4075,0.0,128,3297@TOP@human_GAPDH_TAA_len41_fa20_ta0_fm14_tm6,c
3297@TOP@human_GAPDH_TAA_len41_fa20_ta0_fm14_tm6*129*c,0,4036,0,0,4036,0.0,129,3297@TOP@human_GAPDH_TAA_len41_fa20_ta0_fm14_tm6,c
3297@TOP@human_GAPDH_TAA_len41_fa20_ta0_fm14_tm6*130*c,1,4076,0,0,4077,0.0,130,3297@TOP@human_GAPDH_TAA_len41_fa20_ta0_fm14_tm6,c
3297@TOP@human_GAPDH_TAA_len41_fa20_ta0_fm14_tm6*131*c,0,4082,0,0,4082,0.0,131,3297@TOP@human_GAPDH_TAA_len41_fa20_ta0_fm14_tm6,c
3297@TOP@human_GAPDH_TAA_len41_fa20_ta0_fm14_tm6*132*t,0,1,0,4017,4018,0.0,132,3297@TOP@human_GAPDH_TAA_len41_fa20_ta0_fm14_tm6,t
3297@TOP@human_GAPDH_TAA_len41_fa20_ta0_fm14_tm6*133*g,0,0,4012,0,4012,1.0,133,3297@TOP@human_GAPDH_TAA_len41_fa20_ta0_fm14_tm6,g
3297@TOP@human_GAPDH_TAA_len41_fa20_ta0_fm14_tm6*134*g,0,0,4038,0,4038,1.0,134,3297@TOP@human_GAPDH_TAA_len41_fa20_ta0_fm14_tm6,g
3298@TOP@human_GAPDH_TAA_len41_fa20_ta0_fm14_tm6*114*t,0,2,1,8926,8929,0.0,114,3298@TOP@human_GAPDH_TAA_len41_fa20_ta0_fm14_tm6,t
3298@TOP@human_GAPDH_TAA_len41_fa20_ta0_fm14_tm6*115*c,0,8975,0,0,8975,0.0,115,3298@TOP@human_GAPDH_TAA_len41_fa20_ta0_fm14_tm6,c
3298@TOP@human_GAPDH_TAA_len41_fa20_ta0_fm14_tm6*116*c,0,8923,1,0,8924,0.0,116,3298@TOP@human_GAPDH_TAA_len41_fa20_ta0_fm14_tm6,c
3298@TOP@human_GAPDH_TAA_len41_fa20_ta0_fm14_tm6*117*a,8922,0,15,0,8937,0.002,117,3298@TOP@human_GAPDH_TAA_len41_fa20_ta0_fm14_tm6,a
3298@TOP@human_GAPDH_TAA_len41_fa20_ta0_fm14_tm6*118*a,8740,0,150,0,8890,0.017,118,3298@TOP@human_GAPDH_TAA_len41_fa20_ta0_fm14_tm6,a
3298@TOP@human_GAPDH_TAA_len41_fa20_ta0_fm14_tm6*119*g,0,0,8868,0,8868,1.0,119,3298@TOP@human_GAPDH_TAA_len41_fa20_ta0_fm14_tm6,g
3298@TOP@human_GAPDH_TAA_len41_fa20_ta0_fm14_tm6*120*g,0,0,8849,0,8849,1.0,120,3298@TOP@human_GAPDH_TAA_len41_fa20_ta0_fm14_tm6,g
3298@TOP@human_GAPDH_TAA_len41_fa20_ta0_fm14_tm6*121*a,8925,0,1,0,8926,0.0,121,3298@TOP@human_GAPDH_TAA_len41_fa20_ta0_fm14_tm6,a
3298@TOP@human_GAPDH_TAA_len41_fa20_ta0_fm14_tm6*122*g,0,0,8946,0,8946,1.0,122,3298@TOP@human_GAPDH_TAA_len41_fa20_ta0_fm14_tm6,g
3298@TOP@human_GAPDH_TAA_len41_fa20_ta0_fm14_tm6*123*t,2,1,1,8817,8821,0.0,123,3298@TOP@human_GAPDH_TAA_len41_fa20_ta0_fm14_tm6,t
3298@TOP@human_GAPDH_TAA_len41_fa20_ta0_fm14_tm6*124*a,8291,1,507,0,8799,0.058,124,3298@TOP@human_GAPDH_TAA_len41_fa20_ta0_fm14_tm6,a
3298@TOP@human_GAPDH_TAA_len41_fa20_ta0_fm14_tm6*125*a,8614,1,153,0,8768,0.017,125,3298@TOP@human_GAPDH_TAA_len41_fa20_ta0_fm14_tm6,a
3298@TOP@human_GAPDH_TAA_len41_fa20_ta0_fm14_tm6*126*g,0,0,8803,0,8803,1.0,126,3298@TOP@human_GAPDH_TAA_len41_fa20_ta0_fm14_tm6,g
3298@TOP@human_GAPDH_TAA_len41_fa20_ta0_fm14_tm6*127*a,8892,2,3,0,8897,0.0,127,3298@TOP@human_GAPDH_TAA_len41_fa20_ta0_fm14_tm6,a
3298@TOP@human_GAPDH_TAA_len41_fa20_ta0_fm14_tm6*128*c,1,8951,0,0,8952,0.0,128,3298@TOP@human_GAPDH_TAA_len41_fa20_ta0_fm14_tm6,c
3298@TOP@human_GAPDH_TAA_len41_fa20_ta0_fm14_tm6*129*c,1,8884,0,0,8885,0.0,129,3298@TOP@human_GAPDH_TAA_len41_fa20_ta0_fm14_tm6,c
3298@TOP@human_GAPDH_TAA_len41_fa20_ta0_fm14_tm6*130*c,1,8918,0,0,8919,0.0,130,3298@TOP@human_GAPDH_TAA_len41_fa20_ta0_fm14_tm6,c
3298@TOP@human_GAPDH_TAA_len41_fa20_ta0_fm14_tm6*131*c,0,8961,0,1,8962,0.0,131,3298@TOP@human_GAPDH_TAA_len41_fa20_ta0_fm14_tm6,c
3298@TOP@human_GAPDH_TAA_len41_fa20_ta0_fm14_tm6*132*t,0,0,0,8843,8843,0.0,132,3298@TOP@human_GAPDH_TAA_len41_fa20_ta0_fm14_tm6,t
3298@TOP@human_GAPDH_TAA_len41_fa20_ta0_fm14_tm6*133*g,0,0,8822,0,8822,1.0,133,3298@TOP@human_GAPDH_TAA_len41_fa20_ta0_fm14_tm6,g
3298@TOP@human_GAPDH_TAA_len41_fa20_ta0_fm14_tm6*134*g,0,0,8847,2,8849,1.0,134,3298@TOP@human_GAPDH_TAA_len41_fa20_ta0_fm14_tm6,g
3299@TOP@human_GAPDH_TAA_len41_fa20_ta0_fm14_tm6*114*t,1,1,0,2395,2397,0.0,114,3299@TOP@human_GAPDH_TAA_len41_fa20_ta0_fm14_tm6,t
3299@TOP@human_GAPDH_TAA_len41_fa20_ta0_fm14_tm6*115*c,0,2413,0,0,2413,0.0,115,3299@TOP@human_GAPDH_TAA_len41_fa20_ta0_fm14_tm6,c
3299@TOP@human_GAPDH_TAA_len41_fa20_ta0_fm14_tm6*116*c,0,2392,0,0,2392,0.0,116,3299@TOP@human_GAPDH_TAA_len41_fa20_ta0_fm14_tm6,c
3299@TOP@human_GAPDH_TAA_len41_fa20_ta0_fm14_tm6*117*a,2402,0,6,0,2408,0.002,117,3299@TOP@human_GAPDH_TAA_len41_fa20_ta0_fm14_tm6,a
3299@TOP@human_GAPDH_TAA_len41_fa20_ta0_fm14_tm6*118*a,2319,1,56,0,2376,0.024,118,3299@TOP@human_GAPDH_TAA_len41_fa20_ta0_fm14_tm6,a
3299@TOP@human_GAPDH_TAA_len41_fa20_ta0_fm14_tm6*119*g,0,0,2375,0,2375,1.0,119,3299@TOP@human_GAPDH_TAA_len41_fa20_ta0_fm14_tm6,g
3299@TOP@human_GAPDH_TAA_len41_fa20_ta0_fm14_tm6*120*g,0,0,2372,0,2372,1.0,120,3299@TOP@human_GAPDH_TAA_len41_fa20_ta0_fm14_tm6,g
3299@TOP@human_GAPDH_TAA_len41_fa20_ta0_fm14_tm6*121*a,2404,0,1,0,2405,0.0,121,3299@TOP@human_GAPDH_TAA_len41_fa20_ta0_fm14_tm6,a
3299@TOP@human_GAPDH_TAA_len41_fa20_ta0_fm14_tm6*122*g,0,0,2399,0,2399,1.0,122,3299@TOP@human_GAPDH_TAA_len41_fa20_ta0_fm14_tm6,g
3299@TOP@human_GAPDH_TAA_len41_fa20_ta0_fm14_tm6*123*t,0,0,0,2366,2366,0.0,123,3299@TOP@human_GAPDH_TAA_len41_fa20_ta0_fm14_tm6,t
3299@TOP@human_GAPDH_TAA_len41_fa20_ta0_fm14_tm6*124*a,2270,0,95,0,2365,0.04,124,3299@TOP@human_GAPDH_TAA_len41_fa20_ta0_fm14_tm6,a
3299@TOP@human_GAPDH_TAA_len41_fa20_ta0_fm14_tm6*125*a,2289,0,69,0,2358,0.029,125,3299@TOP@human_GAPDH_TAA_len41_fa20_ta0_fm14_tm6,a
3299@TOP@human_GAPDH_TAA_len41_fa20_ta0_fm14_tm6*126*g,0,1,2363,0,2364,1.0,126,3299@TOP@human_GAPDH_TAA_len41_fa20_ta0_fm14_tm6,g
3299@TOP@human_GAPDH_TAA_len41_fa20_ta0_fm14_tm6*127*a,2387,0,4,0,2391,0.002,127,3299@TOP@human_GAPDH_TAA_len41_fa20_ta0_fm14_tm6,a
3299@TOP@human_GAPDH_TAA_len41_fa20_ta0_fm14_tm6*128*c,0,2410,0,0,2410,0.0,128,3299@TOP@human_GAPDH_TAA_len41_fa20_ta0_fm14_tm6,c
3299@TOP@human_GAPDH_TAA_len41_fa20_ta0_fm14_tm6*129*c,0,2383,0,0,2383,0.0,129,3299@TOP@human_GAPDH_TAA_len41_fa20_ta0_fm14_tm6,c
3299@TOP@human_GAPDH_TAA_len41_fa20_ta0_fm14_tm6*130*c,0,2407,0,0,2407,0.0,130,3299@TOP@human_GAPDH_TAA_len41_fa20_ta0_fm14_tm6,c
3299@TOP@human_GAPDH_TAA_len41_fa20_ta0_fm14_tm6*131*c,1,2411,0,0,2412,0.0,131,3299@TOP@human_GAPDH_TAA_len41_fa20_ta0_fm14_tm6,c
3299@TOP@human_GAPDH_TAA_len41_fa20_ta0_fm14_tm6*132*t,1,0,0,2377,2378,0.0,132,3299@TOP@human_GAPDH_TAA_len41_fa20_ta0_fm14_tm6,t
3299@TOP@human_GAPDH_TAA_len41_fa20_ta0_fm14_tm6*133*g,0,0,2368,0,2368,1.0,133,3299@TOP@human_GAPDH_TAA_len41_fa20_ta0_fm14_tm6,g
3299@TOP@human_GAPDH_TAA_len41_fa20_ta0_fm14_tm6*134*g,0,0,2376,1,2377,1.0,134,3299@TOP@human_GAPDH_TAA_len41_fa20_ta0_fm14_tm6,g
0@Leaper@human_GAPDH_TAA_len41_fa0_ta20_fm6_tm14*114*t,0,0,0,57,57,0.0,114,0@Leaper@human_GAPDH_TAA_len41_fa0_ta20_fm6_tm14,t
0@Leaper@human_GAPDH_TAA_len41_fa0_ta20_fm6_tm14*115*c,0,61,0,0,61,0.0,115,0@Leaper@human_GAPDH_TAA_len41_fa0_ta20_fm6_tm14,c
0@Leaper@human_GAPDH_TAA_len41_fa0_ta20_fm6_tm14*116*c,0,61,0,0,61,0.0,116,0@Leaper@human_GAPDH_TAA_len41_fa0_ta20_fm6_tm14,c
0@Leaper@human_GAPDH_TAA_len41_fa0_ta20_fm6_tm14*117*a,62,0,0,0,62,0.0,117,0@Leaper@human_GAPDH_TAA_len41_fa0_ta20_fm6_tm14,a
0@Leaper@human_GAPDH_TAA_len41_fa0_ta20_fm6_tm14*118*a,56,0,2,0,58,0.034,118,0@Leaper@human_GAPDH_TAA_len41_fa0_ta20_fm6_tm14,a
0@Leaper@human_GAPDH_TAA_len41_fa0_ta20_fm6_tm14*119*g,0,0,59,0,59,1.0,119,0@Leaper@human_GAPDH_TAA_len41_fa0_ta20_fm6_tm14,g
0@Leaper@human_GAPDH_TAA_len41_fa0_ta20_fm6_tm14*120*g,0,0,59,0,59,1.0,120,0@Leaper@human_GAPDH_TAA_len41_fa0_ta20_fm6_tm14,g
0@Leaper@human_GAPDH_TAA_len41_fa0_ta20_fm6_tm14*121*a,61,0,0,0,61,0.0,121,0@Leaper@human_GAPDH_TAA_len41_fa0_ta20_fm6_tm14,a
0@Leaper@human_GAPDH_TAA_len41_fa0_ta20_fm6_tm14*122*g,0,0,59,0,59,1.0,122,0@Leaper@human_GAPDH_TAA_len41_fa0_ta20_fm6_tm14,g
0@Leaper@human_GAPDH_TAA_len41_fa0_ta20_fm6_tm14*123*t,0,0,0,60,60,0.0,123,0@Leaper@human_GAPDH_TAA_len41_fa0_ta20_fm6_tm14,t
0@Leaper@human_GAPDH_TAA_len41_fa0_ta20_fm6_tm14*124*a,56,0,4,0,60,0.067,124,0@Leaper@human_GAPDH_TAA_len41_fa0_ta20_fm6_tm14,a
0@Leaper@human_GAPDH_TAA_len41_fa0_ta20_fm6_tm14*125*a,54,0,2,0,56,0.036,125,0@Leaper@human_GAPDH_TAA_len41_fa0_ta20_fm6_tm14,a
0@Leaper@human_GAPDH_TAA_len41_fa0_ta20_fm6_tm14*126*g,0,0,59,0,59,1.0,126,0@Leaper@human_GAPDH_TAA_len41_fa0_ta20_fm6_tm14,g
0@Leaper@human_GAPDH_TAA_len41_fa0_ta20_fm6_tm14*127*a,61,0,0,0,61,0.0,127,0@Leaper@human_GAPDH_TAA_len41_fa0_ta20_fm6_tm14,a
0@Leaper@human_GAPDH_TAA_len41_fa0_ta20_fm6_tm14*128*c,0,61,0,0,61,0.0,128,0@Leaper@human_GAPDH_TAA_len41_fa0_ta20_fm6_tm14,c
0@Leaper@human_GAPDH_TAA_len41_fa0_ta20_fm6_tm14*129*c,0,61,0,0,61,0.0,129,0@Leaper@human_GAPDH_TAA_len41_fa0_ta20_fm6_tm14,c
0@Leaper@human_GAPDH_TAA_len41_fa0_ta20_fm6_tm14*130*c,0,61,0,0,61,0.0,130,0@Leaper@human_GAPDH_TAA_len41_fa0_ta20_fm6_tm14,c
0@Leaper@human_GAPDH_TAA_len41_fa0_ta20_fm6_tm14*131*c,0,60,0,0,60,0.0,131,0@Leaper@human_GAPDH_TAA_len41_fa0_ta20_fm6_tm14,c
0@Leaper@human_GAPDH_TAA_len41_fa0_ta20_fm6_tm14*132*t,0,0,0,59,59,0.0,132,0@Leaper@human_GAPDH_TAA_len41_fa0_ta20_fm6_tm14,t
0@Leaper@human_GAPDH_TAA_len41_fa0_ta20_fm6_tm14*133*g,0,0,60,0,60,1.0,133,0@Leaper@human_GAPDH_TAA_len41_fa0_ta20_fm6_tm14,g
0@Leaper@human_GAPDH_TAA_len41_fa0_ta20_fm6_tm14*134*g,0,0,59,0,59,1.0,134,0@Leaper@human_GAPDH_TAA_len41_fa0_ta20_fm6_tm14,g
0@Leaper@human_GAPDH_TAA_len41_fa10_ta10_fm10_tm10*114*t,0,0,0,1074,1074,0.0,114,0@Leaper@human_GAPDH_TAA_len41_fa10_ta10_fm10_tm10,t
0@Leaper@human_GAPDH_TAA_len41_fa10_ta10_fm10_tm10*115*c,0,1082,0,0,1082,0.0,115,0@Leaper@human_GAPDH_TAA_len41_fa10_ta10_fm10_tm10,c
0@Leaper@human_GAPDH_TAA_len41_fa10_ta10_fm10_tm10*116*c,0,1078,0,1,1079,0.0,116,0@Leaper@human_GAPDH_TAA_len41_fa10_ta10_fm10_tm10,c
0@Leaper@human_GAPDH_TAA_len41_fa10_ta10_fm10_tm10*117*a,1068,0,9,0,1077,0.008,117,0@Leaper@human_GAPDH_TAA_len41_fa10_ta10_fm10_tm10,a
0@Leaper@human_GAPDH_TAA_len41_fa10_ta10_fm10_tm10*118*a,978,0,90,0,1068,0.084,118,0@Leaper@human_GAPDH_TAA_len41_fa10_ta10_fm10_tm10,a
0@Leaper@human_GAPDH_TAA_len41_fa10_ta10_fm10_tm10*119*g,0,0,1064,0,1064,1.0,119,0@Leaper@human_GAPDH_TAA_len41_fa10_ta10_fm10_tm10,g
0@Leaper@human_GAPDH_TAA_len41_fa10_ta10_fm10_tm10*120*g,0,0,1056,0,1056,1.0,120,0@Leaper@human_GAPDH_TAA_len41_fa10_ta10_fm10_tm10,g
0@Leaper@human_GAPDH_TAA_len41_fa10_ta10_fm10_tm10*121*a,1073,0,1,0,1074,0.001,121,0@Leaper@human_GAPDH_TAA_len41_fa10_ta10_fm10_tm10,a
0@Leaper@human_GAPDH_TAA_len41_fa10_ta10_fm10_tm10*122*g,0,0,1077,0,1077,1.0,122,0@Leaper@human_GAPDH_TAA_len41_fa10_ta10_fm10_tm10,g
0@Leaper@human_GAPDH_TAA_len41_fa10_ta10_fm10_tm10*123*t,0,0,0,1062,1062,0.0,123,0@Leaper@human_GAPDH_TAA_len41_fa10_ta10_fm10_tm10,t
0@Leaper@human_GAPDH_TAA_len41_fa10_ta10_fm10_tm10*124*a,874,0,197,0,1071,0.184,124,0@Leaper@human_GAPDH_TAA_len41_fa10_ta10_fm10_tm10,a
0@Leaper@human_GAPDH_TAA_len41_fa10_ta10_fm10_tm10*125*a,990,1,68,0,1059,0.064,125,0@Leaper@human_GAPDH_TAA_len41_fa10_ta10_fm10_tm10,a
0@Leaper@human_GAPDH_TAA_len41_fa10_ta10_fm10_tm10*126*g,0,0,1054,0,1054,1.0,126,0@Leaper@human_GAPDH_TAA_len41_fa10_ta10_fm10_tm10,g
0@Leaper@human_GAPDH_TAA_len41_fa10_ta10_fm10_tm10*127*a,1070,0,0,0,1070,0.0,127,0@Leaper@human_GAPDH_TAA_len41_fa10_ta10_fm10_tm10,a
0@Leaper@human_GAPDH_TAA_len41_fa10_ta10_fm10_tm10*128*c,0,1080,0,0,1080,0.0,128,0@Leaper@human_GAPDH_TAA_len41_fa10_ta10_fm10_tm10,c
0@Leaper@human_GAPDH_TAA_len41_fa10_ta10_fm10_tm10*129*c,0,1067,0,0,1067,0.0,129,0@Leaper@human_GAPDH_TAA_len41_fa10_ta10_fm10_tm10,c
0@Leaper@human_GAPDH_TAA_len41_fa10_ta10_fm10_tm10*130*c,0,1074,0,0,1074,0.0,130,0@Leaper@human_GAPDH_TAA_len41_fa10_ta10_fm10_tm10,c
0@Leaper@human_GAPDH_TAA_len41_fa10_ta10_fm10_tm10*131*c,0,1078,0,0,1078,0.0,131,0@Leaper@human_GAPDH_TAA_len41_fa10_ta10_fm10_tm10,c
0@Leaper@human_GAPDH_TAA_len41_fa10_ta10_fm10_tm10*132*t,0,0,0,1059,1059,0.0,132,0@Leaper@human_GAPDH_TAA_len41_fa10_ta10_fm10_tm10,t
0@Leaper@human_GAPDH_TAA_len41_fa10_ta10_fm10_tm10*133*g,0,0,1068,0,1068,1.0,133,0@Leaper@human_GAPDH_TAA_len41_fa10_ta10_fm10_tm10,g
0@Leaper@human_GAPDH_TAA_len41_fa10_ta10_fm10_tm10*134*g,0,1,1066,0,1067,0.999,134,0@Leaper@human_GAPDH_TAA_len41_fa10_ta10_fm10_tm10,g
0@Leaper@human_GAPDH_TAA_len41_fa20_ta0_fm14_tm6*114*t,0,3,0,1263,1266,0.0,114,0@Leaper@human_GAPDH_TAA_len41_fa20_ta0_fm14_tm6,t
0@Leaper@human_GAPDH_TAA_len41_fa20_ta0_fm14_tm6*115*c,0,1274,0,0,1274,0.0,115,0@Leaper@human_GAPDH_TAA_len41_fa20_ta0_fm14_tm6,c
0@Leaper@human_GAPDH_TAA_len41_fa20_ta0_fm14_tm6*116*c,0,1263,0,0,1263,0.0,116,0@Leaper@human_GAPDH_TAA_len41_fa20_ta0_fm14_tm6,c
0@Leaper@human_GAPDH_TAA_len41_fa20_ta0_fm14_tm6*117*a,1267,0,2,0,1269,0.002,117,0@Leaper@human_GAPDH_TAA_len41_fa20_ta0_fm14_tm6,a
0@Leaper@human_GAPDH_TAA_len41_fa20_ta0_fm14_tm6*118*a,1241,0,14,0,1255,0.011,118,0@Leaper@human_GAPDH_TAA_len41_fa20_ta0_fm14_tm6,a
0@Leaper@human_GAPDH_TAA_len41_fa20_ta0_fm14_tm6*119*g,0,0,1256,0,1256,1.0,119,0@Leaper@human_GAPDH_TAA_len41_fa20_ta0_fm14_tm6,g
0@Leaper@human_GAPDH_TAA_len41_fa20_ta0_fm14_tm6*120*g,0,0,1252,0,1252,1.0,120,0@Leaper@human_GAPDH_TAA_len41_fa20_ta0_fm14_tm6,g
0@Leaper@human_GAPDH_TAA_len41_fa20_ta0_fm14_tm6*121*a,1264,0,0,0,1264,0.0,121,0@Leaper@human_GAPDH_TAA_len41_fa20_ta0_fm14_tm6,a
0@Leaper@human_GAPDH_TAA_len41_fa20_ta0_fm14_tm6*122*g,0,0,1265,0,1265,1.0,122,0@Leaper@human_GAPDH_TAA_len41_fa20_ta0_fm14_tm6,g
0@Leaper@human_GAPDH_TAA_len41_fa20_ta0_fm14_tm6*123*t,1,2,0,1238,1241,0.0,123,0@Leaper@human_GAPDH_TAA_len41_fa20_ta0_fm14_tm6,t
0@Leaper@human_GAPDH_TAA_len41_fa20_ta0_fm14_tm6*124*a,1175,0,65,0,1240,0.052,124,0@Leaper@human_GAPDH_TAA_len41_fa20_ta0_fm14_tm6,a
0@Leaper@human_GAPDH_TAA_len41_fa20_ta0_fm14_tm6*125*a,1209,0,27,0,1236,0.022,125,0@Leaper@human_GAPDH_TAA_len41_fa20_ta0_fm14_tm6,a
0@Leaper@human_GAPDH_TAA_len41_fa20_ta0_fm14_tm6*126*g,2,0,1245,0,1247,0.998,126,0@Leaper@human_GAPDH_TAA_len41_fa20_ta0_fm14_tm6,g
0@Leaper@human_GAPDH_TAA_len41_fa20_ta0_fm14_tm6*127*a,1266,0,0,0,1266,0.0,127,0@Leaper@human_GAPDH_TAA_len41_fa20_ta0_fm14_tm6,a
0@Leaper@human_GAPDH_TAA_len41_fa20_ta0_fm14_tm6*128*c,0,1267,0,0,1267,0.0,128,0@Leaper@human_GAPDH_TAA_len41_fa20_ta0_fm14_tm6,c
0@Leaper@human_GAPDH_TAA_len41_fa20_ta0_fm14_tm6*129*c,0,1267,0,0,1267,0.0,129,0@Leaper@human_GAPDH_TAA_len41_fa20_ta0_fm14_tm6,c
0@Leaper@human_GAPDH_TAA_len41_fa20_ta0_fm14_tm6*130*c,0,1265,1,0,1266,0.001,130,0@Leaper@human_GAPDH_TAA_len41_fa20_ta0_fm14_tm6,c
0@Leaper@human_GAPDH_TAA_len41_fa20_ta0_fm14_tm6*131*c,0,1273,0,0,1273,0.0,131,0@Leaper@human_GAPDH_TAA_len41_fa20_ta0_fm14_tm6,c
0@Leaper@human_GAPDH_TAA_len41_fa20_ta0_fm14_tm6*132*t,0,0,0,1257,1257,0.0,132,0@Leaper@human_GAPDH_TAA_len41_fa20_ta0_fm14_tm6,t
0@Leaper@human_GAPDH_TAA_len41_fa20_ta0_fm14_tm6*133*g,0,0,1240,0,1240,1.0,133,0@Leaper@human_GAPDH_TAA_len41_fa20_ta0_fm14_tm6,g
0@Leaper@human_GAPDH_TAA_len41_fa20_ta0_fm14_tm6*134*g,0,0,1251,0,1251,1.0,134,0@Leaper@human_GAPDH_TAA_len41_fa20_ta0_fm14_tm6,g
